"()                 begin try                 declare @enable int;                 select top 1 @enable = convert(int,value_in_use) from sys.configurations where name = 'default trace enabled'                 if @enable = 1 --default trace is enabled                 begin                 declare @curr_tracefilename varchar(500);                 declare @base_tracefilename varchar(500);                 declare @indx int ;                 declare @temp_trace table (                 StartTime datetime                 ,       EventSubClass int                 ,       IntegerData int                 );                 declare @path_separator CHAR(1) ;                 set @path_separator = ISNULL(CONVERT(CHAR(1), serverproperty('PathSeparator')), '\') ;                  select @curr_tracefilename = path from sys.traces where is_default = 1 ;                 set @curr_tracefilename = reverse(@curr_tracefilename)                 select @indx  = PATINDEX('%'+@path_separator+'%', @curr_tracefilename)                 set @curr_tracefilename = reverse(@curr_tracefilename)                 set @base_tracefilename = LEFT( @curr_tracefilename, len(@curr_tracefilename) - @indx) + @path_separator + 'log.trc';                  insert into @temp_trace                 select StartTime                 ,       EventSubClass                 ,       IntegerData                 from ::fn_trace_gettable( @base_tracefilename, default )                 where EventClass = 81;                  update @temp_trace set IntegerData = -IntegerData where EventSubClass = 2;                  select   1 as row_no                 ,       StartTime                 ,       EventSubClass                 ,       IntegerData                 ,       case when IntegerData < 0                 then -IntegerData                 else IntegerData                 end ""Absolute""                 from @temp_trace                 where (datediff(dd,StartTime,getdate()) < 7) order by StartTime ;                 end                 else                 begin                 select top 0 1 as row_no, 1 as StartTime , 1 as EventSubClass, 1 as IntegerData, 1 as Absolute                 end                 end try                 begin catch                 select  -100 as row_no                 ,       ERROR_NUMBER()  as StartTime                 ,       ERROR_SEVERITY() as EventSubClass                 ,       ERROR_STATE()  as   IntegerData                 ,       ERROR_MESSAGE() as Absolute                 end catch               ",425,424,1,0,0,1277
"       SELECT       db_id() AS database_id,       c.system_type_id,       c.user_type_id,       c.is_sparse,       c.is_column_set,       c.is_filestream,       c.encryption_type,       CASE WHEN o.object_id IS NOT NULL THEN 1 ELSE 0 END AS is_user,       COUNT_BIG(*) AS [ColCount],       CASE WHEN c.collation_name IS NULL THEN CONVERT(VARCHAR(128), SERVERPROPERTY('Collation')) ELSE c.collation_name END AS collation_name,       AVG(c.max_length) AS avg_max_length       FROM sys.columns c WITH (NOLOCK)       LEFT OUTER JOIN sys.objects o WITH (NOLOCK)       ON o.object_id = c.object_id       AND o.type = 'U'       GROUP BY       c.system_type_id,       c.user_type_id,       c.is_sparse,       c.is_column_set,       c.encryption_type,       c.is_filestream,       CASE WHEN o.object_id IS NOT NULL THEN 1 ELSE 0 END,       CASE WHEN c.collation_name IS NULL THEN CONVERT(VARCHAR(128), SERVERPROPERTY('Collation')) ELSE c.collation_name END     ",224,126,98,122,0,20176
"(@DatabaseName NVarChar(max))begin try   use msdb;  Select distinct t1.name ,       (dense_rank() over (order by backup_start_date desc,t3.backup_set_id))%2 as l1 ,       (dense_rank() over (order by backup_start_date desc,t3.backup_set_id,t6.physical_device_name))%2 as l2 ,       t3.user_name ,       t3.backup_set_id ,       t3.name as backup_name ,       t3.description ,       (datediff( ss,  t3.backup_start_date, t3.backup_finish_date))/60.0 as duration ,       t3.backup_start_date ,       t3.backup_finish_date ,       t3.type as [type] ,       case when (t3.backup_size/1024.0) < 1024 then (t3.backup_size/1024.0)                  when (t3.backup_size/1048576.0) < 1024 then (t3.backup_size/1048576.0)          else (t3.backup_size/1048576.0/1024.0)          end as backup_size  ,       case when (t3.backup_size/1024.0) < 1024 then 'KB'                  when (t3.backup_size/1048576.0) < 1024 then 'MB'          else 'GB'          end as backup_size_unit  ,       t3.first_lsn ,       t3.last_lsn ,       case when t3.differential_base_lsn is null then 'Not Applicable'          else convert( varchar(100),t3.differential_base_lsn)          end as [differential_base_lsn] ,       t6.physical_device_name ,       t6.device_type as [device_type] ,       t3.recovery_model   from sys.databases t1  inner join backupset t3 on (t3.database_name = t1.name )   left outer join backupmediaset t5 on ( t3.media_set_id = t5.media_set_id )  left outer join backupmediafamily t6 on ( t6.media_set_id = t5.media_set_id )  where (t1.name = @DatabaseName)  order by backup_start_date desc,t3.backup_set_id,t6.physical_device_name;   end try  begin catch   select 1 as user_name, 1 as backup_set_id, 1 as backup_name, 1 as description, 1 as duration, 1 as backup_start_date, 1 as backup_finish_date,1 as type, 1 as backup_size, 1 as backup_size_unit ,       ERROR_SEVERITY() as first_lsn ,       ERROR_STATE() as last_lsn ,       1 as differential_base_lsn ,       ERROR_MESSAGE() as physical_device_name ,       1 as device_type, 1 as recovery_model ,       -100 as l1 ,       ERROR_NUMBER() as l2  end catch",199,79,120,371,0,199
"SELECT     DB_NAME (database_id) as [Database Name],     name as [Database File Name],     [Type] = CASE WHEN Type_Desc = 'ROWS' THEN 'Data File(s)'             WHEN Type_Desc = 'LOG'  THEN 'Log File(s)'             ELSE Type_Desc END,     size*8/1024 as 'Size (MB)',     physical_name as [Database_File_Location] FROM sys.master_files ORDER BY 1,3  IF OBJECT_ID('tempdb.dbo.#space') IS NOT NULL     DROP TABLE #space  CREATE TABLE #space (       database_id INT PRIMARY KEY     , data_used_size DECIMAL(18,2)     , log_used_size DECIMAL(18,2) )  DECLARE @SQL NVARCHAR(MAX)  SELECT @SQL = STUFF((     SELECT '     USE [' + d.name + ']     INSERT INTO #space (database_id, data_used_size, log_used_size)     SELECT           DB_ID()         , SUM(CASE WHEN [type] = 0 THEN space_used END)         , SUM(CASE WHEN [type] = 1 THEN space_used END)     FROM (         SELECT s.[type], space_used = SUM(FILEPROPERTY(s.name, ''SpaceUsed'') * 8. / 1024)         FROM sys.database_files s         GROUP BY s.[type]     ) t;'     FROM sys.databases d     WHERE d.[state] = 0     FOR XML PATH(''), TYPE).value('.', 'NVARCHAR(MAX)'), 1, 2, '')  EXEC sys.sp_executesql @SQL  SELECT       d.database_id     , d.name     , d.state_desc     , d.recovery_model_desc     , t.total_size     , t.data_size     , s.data_used_size     , t.log_size     , s.log_used_size     , bu.full_last_date     , bu.full_size     , bu.log_last_date     , bu.log_size FROM (     SELECT           database_id         , log_size = CAST(SUM(CASE WHEN [type] = 1 THEN size END) * 8. / 1024 AS DECIMAL(18,2))         , data_size = CAST(SUM(CASE WHEN [type] = 0 THEN size END) * 8. / 1024 AS DECIMAL(18,2))         , total_size = CAST(SUM(size) * 8. / 1024 AS DECIMAL(18,2))     FROM sys.master_files     GROUP BY database_id ) t JOIN sys.databases d ON d.database_id = t.database_id LEFT JOIN #space s ON d.database_id = s.database_id LEFT JOIN (     SELECT           database_name         , full_last_date = MAX(CASE WHEN [type] = 'D' THEN backup_finish_date END)         , full_size = MAX(CASE WHEN [type] = 'D' THEN backup_size END)         , log_last_date = MAX(CASE WHEN [type] = 'L' THEN backup_finish_date END)         , log_size = MAX(CASE WHEN [type] = 'L' THEN backup_size END)     FROM (         SELECT               s.database_name             , s.[type]             , s.backup_finish_date             , backup_size =                         CAST(CASE WHEN s.backup_size = s.compressed_backup_size                                     THEN s.backup_size                                     ELSE s.compressed_backup_size                         END / 1048576.0 AS DECIMAL(18,2))             , RowNum = ROW_NUMBER() OVER (PARTITION BY s.database_name, s.[type] ORDER BY s.backup_finish_date DESC)         FROM msdb.dbo.backupset s         WHERE s.[type] IN ('D', 'L')     ) f     WHERE f.RowNum = 1     GROUP BY f.database_name ) bu ON d.name = bu.database_name ORDER BY t.total_size DESC  SELECT      req.session_id     , req.total_elapsed_time AS duration_ms     , req.cpu_time AS cpu_time_ms     , req.total_elapsed_time - req.cpu_time AS wait_time     , req.logical_reads     , SUBSTRING (REPLACE (REPLACE (SUBSTRING (ST.text, (req.statement_start_offset/2) + 1,         ((CASE statement_end_offset            WHEN -1            THEN DATALENGTH(ST.text)              ELSE req.statement_end_offset          END - req.statement_start_offset)/2) + 1) , CHAR(10), ' '), CHAR(13), ' '),        1, 512)  AS statement_text   FROM sys.dm_exec_requests AS req     CROSS APPLY sys.dm_exec_sql_text(req.sql_handle) AS ST ORDER BY total_elapsed_time DESC;  SELECT top 100 t.text,      (qs.total_elapsed_time/1000) / qs.execution_count AS avg_elapsed_time,      (qs.total_worker_time/1000) / qs.execution_count AS avg_cpu_time,      ((qs.total_elapsed_time/1000) / qs.execution_count ) - ((qs.total_worker_time/1000) / qs.execution_count) AS avg_wait_time,      qs.total_logical_reads / qs.execution_count AS avg_logical_reads,      qs.total_logical_writes / qs.execution_count AS avg_writes,      (qs.total_elapsed_time/1000) AS cumulative_elapsed_time_all_executions FROM sys.dm_exec_query_stats qs      CROSS apply sys.Dm_exec_sql_text (sql_handle) t -- WHERE t.text like '<Your Query>%' -- Replace <Your Query> with your query or the beginning part of your query. The special chars like '[','_','%','^' in the query should be escaped. ORDER BY (qs.total_elapsed_time / qs.execution_count) DESC  --Deadlock sql check SELECT     session_id,     start_time,      [status],     command,     blocking_session_id,     wait_type,     wait_time,     open_transaction_count,     transaction_id,     total_elapsed_time,     Definition = CAST(text AS VARCHAR(MAX)) FROM     SYS.DM_EXEC_REQUESTS     CROSS APPLY sys.dm_exec_sql_text(sql_handle)  WHERE blocking_session_id != 0  SELECT sqlserver_start_time, (committed_kb/1024) AS Total_Server_Memory_MB, (committed_target_kb/1024)  AS Target_Server_Memory_MB FROM sys.dm_os_sys_info; ",178,14,164,7198,354,357
"SELECT     DB_NAME (database_id) as [Database Name],     name as [Database File Name],     [Type] = CASE WHEN Type_Desc = 'ROWS' THEN 'Data File(s)'             WHEN Type_Desc = 'LOG'  THEN 'Log File(s)'             ELSE Type_Desc END,     size*8/1024 as 'Size (MB)',     physical_name as [Database_File_Location] FROM sys.master_files ORDER BY 1,3  IF OBJECT_ID('tempdb.dbo.#space') IS NOT NULL     DROP TABLE #space  CREATE TABLE #space (       database_id INT PRIMARY KEY     , data_used_size DECIMAL(18,2)     , log_used_size DECIMAL(18,2) )  DECLARE @SQL NVARCHAR(MAX)  SELECT @SQL = STUFF((     SELECT '     USE [' + d.name + ']     INSERT INTO #space (database_id, data_used_size, log_used_size)     SELECT           DB_ID()         , SUM(CASE WHEN [type] = 0 THEN space_used END)         , SUM(CASE WHEN [type] = 1 THEN space_used END)     FROM (         SELECT s.[type], space_used = SUM(FILEPROPERTY(s.name, ''SpaceUsed'') * 8. / 1024)         FROM sys.database_files s         GROUP BY s.[type]     ) t;'     FROM sys.databases d     WHERE d.[state] = 0     FOR XML PATH(''), TYPE).value('.', 'NVARCHAR(MAX)'), 1, 2, '')  EXEC sys.sp_executesql @SQL  SELECT       d.database_id     , d.name     , d.state_desc     , d.recovery_model_desc     , t.total_size     , t.data_size     , s.data_used_size     , t.log_size     , s.log_used_size     , bu.full_last_date     , bu.full_size     , bu.log_last_date     , bu.log_size FROM (     SELECT           database_id         , log_size = CAST(SUM(CASE WHEN [type] = 1 THEN size END) * 8. / 1024 AS DECIMAL(18,2))         , data_size = CAST(SUM(CASE WHEN [type] = 0 THEN size END) * 8. / 1024 AS DECIMAL(18,2))         , total_size = CAST(SUM(size) * 8. / 1024 AS DECIMAL(18,2))     FROM sys.master_files     GROUP BY database_id ) t JOIN sys.databases d ON d.database_id = t.database_id LEFT JOIN #space s ON d.database_id = s.database_id LEFT JOIN (     SELECT           database_name         , full_last_date = MAX(CASE WHEN [type] = 'D' THEN backup_finish_date END)         , full_size = MAX(CASE WHEN [type] = 'D' THEN backup_size END)         , log_last_date = MAX(CASE WHEN [type] = 'L' THEN backup_finish_date END)         , log_size = MAX(CASE WHEN [type] = 'L' THEN backup_size END)     FROM (         SELECT               s.database_name             , s.[type]             , s.backup_finish_date             , backup_size =                         CAST(CASE WHEN s.backup_size = s.compressed_backup_size                                     THEN s.backup_size                                     ELSE s.compressed_backup_size                         END / 1048576.0 AS DECIMAL(18,2))             , RowNum = ROW_NUMBER() OVER (PARTITION BY s.database_name, s.[type] ORDER BY s.backup_finish_date DESC)         FROM msdb.dbo.backupset s         WHERE s.[type] IN ('D', 'L')     ) f     WHERE f.RowNum = 1     GROUP BY f.database_name ) bu ON d.name = bu.database_name ORDER BY t.total_size DESC  SELECT      req.session_id     , req.total_elapsed_time AS duration_ms     , req.cpu_time AS cpu_time_ms     , req.total_elapsed_time - req.cpu_time AS wait_time     , req.logical_reads     , SUBSTRING (REPLACE (REPLACE (SUBSTRING (ST.text, (req.statement_start_offset/2) + 1,         ((CASE statement_end_offset            WHEN -1            THEN DATALENGTH(ST.text)              ELSE req.statement_end_offset          END - req.statement_start_offset)/2) + 1) , CHAR(10), ' '), CHAR(13), ' '),        1, 512)  AS statement_text   FROM sys.dm_exec_requests AS req     CROSS APPLY sys.dm_exec_sql_text(req.sql_handle) AS ST ORDER BY total_elapsed_time DESC;  SELECT top 100 t.text,      (qs.total_elapsed_time/1000) / qs.execution_count AS avg_elapsed_time,      (qs.total_worker_time/1000) / qs.execution_count AS avg_cpu_time,      ((qs.total_elapsed_time/1000) / qs.execution_count ) - ((qs.total_worker_time/1000) / qs.execution_count) AS avg_wait_time,      qs.total_logical_reads / qs.execution_count AS avg_logical_reads,      qs.total_logical_writes / qs.execution_count AS avg_writes,      (qs.total_elapsed_time/1000) AS cumulative_elapsed_time_all_executions FROM sys.dm_exec_query_stats qs      CROSS apply sys.Dm_exec_sql_text (sql_handle) t -- WHERE t.text like '<Your Query>%' -- Replace <Your Query> with your query or the beginning part of your query. The special chars like '[','_','%','^' in the query should be escaped. ORDER BY (qs.total_elapsed_time / qs.execution_count) DESC  --Deadlock sql check SELECT     session_id,     start_time,      [status],     command,     blocking_session_id,     wait_type,     wait_time,     open_transaction_count,     transaction_id,     total_elapsed_time,     Definition = CAST(text AS VARCHAR(MAX)) FROM     SYS.DM_EXEC_REQUESTS     CROSS APPLY sys.dm_exec_sql_text(sql_handle)  WHERE blocking_session_id != 0   ",152,13,139,7000,338,305
"(@_msparam_0 nvarchar(4000),@_msparam_1 nvarchar(4000),@_msparam_2 nvarchar(4000))SELECT SCHEMA_NAME(sp.schema_id) AS [Schema], sp.name AS [Name], sp.object_id AS [ID], CAST(  case      when sp.is_ms_shipped = 1 then 1     when (         select              major_id          from              sys.extended_properties          where              major_id = sp.object_id and              minor_id = 0 and              class = 1 and              name = N'microsoft_database_tools_support')          is not null then 1     else 0 end                        AS bit) AS [IsSystemObject], CASE WHEN sp.type = N'P' THEN 1 WHEN sp.type = N'PC' THEN 2 ELSE 1 END AS [ImplementationType], CAST(CASE WHEN ISNULL(smsp.definition, ssmsp.definition) IS NULL THEN 1 ELSE 0 END AS bit) AS [IsEncrypted] FROM sys.all_objects AS sp LEFT OUTER JOIN sys.sql_modules AS smsp ON smsp.object_id = sp.object_id LEFT OUTER JOIN sys.system_sql_modules AS ssmsp ON ssmsp.object_id = sp.object_id WHERE (sp.type = @_msparam_0 OR sp.type = @_msparam_1 OR sp.type=@_msparam_2) ORDER BY [Schema] ASC,[Name] ASC",71,59,12,87232,0,358
" 	SELECT 	CASE 		WHEN name like  '%msdtcprx.dll%' THEN 'msdtcprx' 		WHEN name like  '%sqljdbc_xa.dll%' THEN 'sqljdbc_xa' 		ELSE NULL 	END AS LoadedModules, 	COUNT(1) AS ModuleCount         FROM sys.dm_os_loaded_modules WITH (NOLOCK)         WHERE name like  '%msdtcprx.dll%' 	OR name like  '%sqljdbc_xa.dll%'         GROUP BY 	CASE WHEN name like  '%msdtcprx.dll%' THEN 'msdtcprx' 		WHEN name like  '%sqljdbc_xa.dll%' THEN 'sqljdbc_xa' 		ELSE NULL 	END;     ",68,68,0,0,0,6173
"(@_msparam_0 nvarchar(4000))       select * into #tmpag_availability_groups from master.sys.availability_groups               select replica_id, group_id into #tmpardb_availability_replicas from master.sys.availability_replicas              select replica_id, group_database_id, database_name,is_database_joined,is_failover_ready,is_pending_secondary_suspend,recovery_lsn,truncation_lsn into #tmpardb_database_replica_cluster_states from master.sys.dm_hadr_database_replica_cluster_states              select replica_id, is_local into #tmpardb_availability_replica_states from master.sys.dm_hadr_availability_replica_states              select replica_id, group_database_id,synchronization_state, is_suspended into #tmpardb_database_replica_states from master.sys.dm_hadr_database_replica_states        SELECT dbcs.database_name AS [Name], 'Server[@Name=' + quotename(CAST(         serverproperty(N'Servername')        AS sysname),'''') + ']' + '/AvailabilityGroup[@Name=' + quotename(AG.name,'''') + ']' + '/AvailabilityDatabase[@Name=' + quotename(dbcs.database_name,'''') + ']' AS [Urn], ISNULL(dbrs.synchronization_state, 0) AS [SynchronizationState], ISNULL(dbrs.is_suspended, 0) AS [IsSuspended], ISNULL(dbcs.is_database_joined, 0) AS [IsJoined] FROM #tmpag_availability_groups AS AG INNER JOIN #tmpardb_availability_replicas AS AR ON AR.group_id=AG.group_id INNER JOIN #tmpardb_availability_replica_states AS arstates ON AR.replica_id = arstates.replica_id AND arstates.is_local = 1 INNER JOIN #tmpardb_database_replica_cluster_states AS dbcs ON arstates.replica_id = dbcs.replica_id LEFT OUTER JOIN #tmpardb_database_replica_states AS dbrs ON dbcs.replica_id = dbrs.replica_id AND dbcs.group_database_id = dbrs.group_database_id WHERE (AG.name=@_msparam_0) ORDER BY [Name] ASC        DROP TABLE #tmpardb_availability_replicas              DROP TABLE #tmpardb_database_replica_cluster_states              DROP TABLE #tmpardb_availability_replica_states              DROP TABLE #tmpardb_database_replica_states              drop table #tmpag_availability_groups       ",60,44,16,262,1,60
" CREATE   PROCEDURE autoadmin_fetch_system_flags AS BEGIN 	BEGIN TRANSACTION 		DECLARE @value NVARCHAR(MAX)  		SELECT @value = value FROM autoadmin_system_flags WHERE LOWER(name) = LOWER(N'SSMBackup2WAEverConfigured') 		 		IF (LOWER(ISNULL(@value, '')) <> N'true') 		BEGIN 			DECLARE @is_configured BIT 			SET @is_configured = 0 			 			IF EXISTS (SELECT TOP 1 container_url FROM managed_backup.fn_backup_db_config(NULL) WHERE container_url IS NOT NULL) 			BEGIN 				SET @is_configured = 1	 			END 			ELSE IF EXISTS (SELECT TOP 1 container_url FROM managed_backup.fn_backup_instance_config() WHERE container_url IS NOT NULL) 			BEGIN 				SET @is_configured = 1	 			END 			ELSE IF EXISTS (SELECT TOP 1 credential_name FROM smart_admin.fn_backup_db_config(NULL) WHERE credential_name IS NOT NULL) 			BEGIN 				SET @is_configured = 1	 			END 			ELSE IF EXISTS (SELECT TOP 1 credential_name FROM smart_admin.fn_backup_instance_config() WHERE credential_name IS NOT NULL) 			BEGIN 				SET @is_configured = 1	 			END 			 			IF (@is_configured = 1) 			BEGIN 				MERGE autoadmin_system_flags AS target 				USING (SELECT LOWER(N'SSMBackup2WAEverConfigured') as name) AS source 				ON source.name = target.name 				WHEN MATCHED THEN UPDATE SET target.value = N'true' 				WHEN NOT MATCHED THEN INSERT VALUES (N'SSMBackup2WAEverConfigured', N'true'); 			END 		END 	COMMIT TRANSACTION 	     SELECT name, 	value  	FROM autoadmin_system_flags END ",58,57,1,581,7,58
"(@_msparam_0 nvarchar(4000),@_msparam_1 nvarchar(4000),@_msparam_2 nvarchar(4000))SELECT SCHEMA_NAME(sp.schema_id) AS [Schema], sp.name AS [Name], sp.object_id AS [ID], CAST(  case      when sp.is_ms_shipped = 1 then 1     when (         select              major_id          from              sys.extended_properties          where              major_id = sp.object_id and              minor_id = 0 and              class = 1 and              name = N'microsoft_database_tools_support')          is not null then 1     else 0 end                        AS bit) AS [IsSystemObject], CASE WHEN sp.type = N'P' THEN 1 WHEN sp.type = N'PC' THEN 2 ELSE 1 END AS [ImplementationType], CAST(CASE WHEN ISNULL(smsp.definition, ssmsp.definition) IS NULL THEN 1 ELSE 0 END AS bit) AS [IsEncrypted] FROM sys.all_objects AS sp LEFT OUTER JOIN sys.sql_modules AS smsp ON smsp.object_id = sp.object_id LEFT OUTER JOIN sys.system_sql_modules AS ssmsp ON ssmsp.object_id = sp.object_id WHERE (sp.type = @_msparam_0 OR sp.type = @_msparam_1 OR sp.type=@_msparam_2) ORDER BY [Schema] ASC,[Name] ASC",56,44,12,81216,0,450
"(@_msparam_0 nvarchar(4000))       select * into #tmpag_availability_groups from master.sys.availability_groups                 select group_id, replica_id, replica_server_name,create_date, modify_date, endpoint_url, read_only_routing_url, primary_role_allow_connections, secondary_role_allow_connections, availability_mode,failover_mode, session_timeout, backup_priority, owner_sid, seeding_mode into #tmpar_availability_replicas from master.sys.availability_replicas                select group_id, replica_id, role,operational_state,recovery_health,synchronization_health,connected_state, last_connect_error_number,last_connect_error_description, last_connect_error_timestamp into #tmpar_availability_replica_states from master.sys.dm_hadr_availability_replica_states              select * into #tmpar_ags from master.sys.dm_hadr_availability_group_states       select ar.group_id, ar.replica_id, ar.replica_server_name, ar.availability_mode, (case when UPPER(ags.primary_replica) = UPPER(ar.replica_server_name) then 1 else 0 end) as role, ars.synchronization_health into #tmpar_availabilty_mode from #tmpar_availability_replicas as ar       left join #tmpar_ags as ags on ags.group_id = ar.group_id       left join #tmpar_availability_replica_states as ars on ar.group_id = ars.group_id and ar.replica_id = ars.replica_id       select am1.replica_id, am1.role, (case when (am1.synchronization_health is null) then 3 else am1.synchronization_health end) as sync_state, (case when (am1.availability_mode is NULL) or (am3.availability_mode is NULL) then null when (am1.role = 1) then 1 when (am1.availability_mode = 0 or am3.availability_mode = 0) then 0 else 1 end) as effective_availability_mode       into #tmpar_replica_rollupstate from #tmpar_availabilty_mode as am1 left join (select group_id, role, availability_mode from #tmpar_availabilty_mode as am2 where am2.role = 1) as am3 on am1.group_id = am3.group_id       drop table #tmpar_availabilty_mode       drop table #tmpar_ags              select replica_id,join_state into #tmpar_availability_replica_cluster_states from master.sys.dm_hadr_availability_replica_cluster_states        SELECT AR.replica_server_name AS [Name], 'Server[@Name=' + quotename(CAST(         serverproperty(N'Servername')        AS sysname),'''') + ']' + '/AvailabilityGroup[@Name=' + quotename(AG.name,'''') + ']' + '/AvailabilityReplica[@Name=' + quotename(AR.replica_server_name,'''') + ']' AS [Urn], ISNULL(arstates.role, 3) AS [Role], ISNULL(AR.primary_role_allow_connections, 4) AS [ConnectionModeInPrimaryRole], ISNULL(AR.secondary_role_allow_connections, 3) AS [ConnectionModeInSecondaryRole], ISNULL(arstates.connected_state, 2) AS [ConnectionState], (case when arrollupstates.sync_state = 3 then 3 when (arrollupstates.effective_availability_mode = 1 or arrollupstates.role = 1) then arrollupstates.sync_state when arrollupstates.sync_state = 2 then 1 else 0 end) AS [RollupSynchronizationState], ISNULL(arcs.join_state, 99) AS [JoinState] FROM #tmpag_availability_groups AS AG INNER JOIN #tmpar_availability_replicas AS AR ON (AR.replica_server_name IS NOT NULL) AND (AR.group_id=AG.group_id) LEFT OUTER JOIN #tmpar_availability_replica_states AS arstates ON AR.replica_id = arstates.replica_id LEFT OUTER JOIN #tmpar_replica_rollupstate AS arrollupstates ON AR.replica_id = arrollupstates.replica_id LEFT OUTER JOIN #tmpar_availability_replica_cluster_states AS arcs ON AR.replica_id = arcs.replica_id WHERE (AG.name=@_msparam_0) ORDER BY [Name] ASC        DROP TABLE #tmpar_availability_replicas              DROP TABLE #tmpar_availability_replica_states              DROP TABLE #tmpar_replica_rollupstate              DROP TABLE #tmpar_availability_replica_cluster_states              drop table #tmpag_availability_groups       ",53,40,13,95,1,212
"()                 begin try                 if (select convert(int,value_in_use) from sys.configurations where name = 'default trace enabled' ) = 1                 begin                 declare @curr_tracefilename varchar(500) ;                 declare @base_tracefilename varchar(500) ;                 declare @indx int ;                 declare @path_separator CHAR(1) ;                 set @path_separator = ISNULL(CONVERT(CHAR(1), serverproperty('PathSeparator')), '\') ;                  select @curr_tracefilename = path from sys.traces where is_default = 1 ;                 set @curr_tracefilename = reverse(@curr_tracefilename);                 select @indx  = patindex('%'+@path_separator+'%', @curr_tracefilename) ;                 set @curr_tracefilename = reverse(@curr_tracefilename) ;                 set @base_tracefilename = left( @curr_tracefilename,len(@curr_tracefilename) - @indx) + @path_separator + 'log.trc';                  select  (dense_rank() over (order by StartTime desc))%2 as l1                 ,       convert(int, EventClass) as EventClass                 ,       DatabaseName                 ,       Filename                 ,       (Duration/1000) as Duration                 ,       StartTime                 ,       EndTime                 ,       (IntegerData*8.0/1024) as ChangeInSize                 from ::fn_trace_gettable( @base_tracefilename, default )                 left outer join sys.databases as d on (d.name = DB_NAME())                 where EventClass >=  92      and EventClass <=  95        and ServerName = @@servername   and DatabaseName = db_name()  and (d.create_date < EndTime)                 order by StartTime desc ;                 end     else                 select -1 as l1, 0 as EventClass, 0 DatabaseName, 0 as Filename, 0 as Duration, 0 as StartTime, 0 as EndTime,0 as ChangeInSize                 end try                 begin catch                 select -100 as l1                 ,       ERROR_NUMBER() as EventClass                 ,       ERROR_SEVERITY() DatabaseName                 ,       ERROR_STATE() as Filename                 ,       ERROR_MESSAGE() as Duration                 ,       1 as StartTime, 1 as EndTime,1 as ChangeInSize                 end catch               ",50,49,1,4,0,50
"()begin try  use msdb;  declare @enable int; select @enable = convert(int, value_in_use) from sys.configurations where name = 'default trace enabled'  if @enable = 1   begin          declare @curr_tracefilename varchar(500);         declare @base_tracefilename varchar(500);         declare @status int;          declare @indx int;            declare @temp_trace table (                  Error int         ,       StartTime datetime         ,       HostName sysname collate database_default null         ,       ApplicationName sysname collate database_default  null         ,       LoginName sysname collate database_default null         ,       Severity int         ,       DatabaseName sysname collate database_default null         ,       TextData nvarchar(max) collate database_default          );          declare @path_separator CHAR(1) ;         set @path_separator = ISNULL(CONVERT(CHAR(1), serverproperty('PathSeparator')), '\') ;          select @status=status, @curr_tracefilename=path from sys.traces where is_default = 1 ;         set @curr_tracefilename = reverse(@curr_tracefilename)          select @indx  = patindex('%'+@path_separator+'%', @curr_tracefilename)           set @curr_tracefilename = reverse(@curr_tracefilename)          set @base_tracefilename = left( @curr_tracefilename,len(@curr_tracefilename) - @indx) + @path_separator + 'log.trc';                  insert into @temp_trace          select Error         ,       StartTime         ,       HostName         ,       ApplicationName         ,       LoginName         ,       Severity         ,       DatabaseName         ,       TextData           from ::fn_trace_gettable( @base_tracefilename, default )          where substring(TextData, 20, 15) like '%Backup%' and TextData like '%Error%' and ServerName = @@servername ;                    select (row_number() over(order by StartTime desc))%2 as l1         ,       right( right( TextData, len(TextData) - patindex('%BACKUP%',TextData) ) , len(right( TextData, len(TextData) - patindex('%BACKUP%',TextData) )) - patindex('%BACKUP%',right( TextData, len(TextData) - patindex('%BACKUP%',TextData) )) - 10 ) as ErrorMessage         ,       Error         ,       Severity         ,       StartTime         ,       HostName         ,       ApplicationName         ,       LoginName         ,       DatabaseName           from @temp_trace            where DatabaseName = '""  & Parameters!DatabaseName.Value &  ""'           order by StartTime desc  end else  begin          select top 0 1 as ErrorMessage, 1 as Error, 1 as Severity, 1 as StartTime,1 as HostName, 1 as ApplicationName,1 as LoginName, 1 as DatabaseName, 1 as l1  end  end try  begin catch  select ERROR_MESSAGE() as ErrorMessage ,       ERROR_NUMBER() as Error ,       ERROR_SEVERITY() as Severity ,       ERROR_STATE() as StartTime ,       1 as HostName, 1 as ApplicationName,1 as LoginName, 1 as DatabaseName ,       -100 as l1  end catch",49,47,2,0,0,147
" CREATE   PROCEDURE autoadmin_fetch_system_flags AS BEGIN 	BEGIN TRANSACTION 		DECLARE @value NVARCHAR(MAX)  		SELECT @value = value FROM autoadmin_system_flags WHERE LOWER(name) = LOWER(N'SSMBackup2WAEverConfigured') 		 		IF (LOWER(ISNULL(@value, '')) <> N'true') 		BEGIN 			DECLARE @is_configured BIT 			SET @is_configured = 0 			 			IF EXISTS (SELECT TOP 1 container_url FROM managed_backup.fn_backup_db_config(NULL) WHERE container_url IS NOT NULL) 			BEGIN 				SET @is_configured = 1	 			END 			ELSE IF EXISTS (SELECT TOP 1 container_url FROM managed_backup.fn_backup_instance_config() WHERE container_url IS NOT NULL) 			BEGIN 				SET @is_configured = 1	 			END 			ELSE IF EXISTS (SELECT TOP 1 credential_name FROM smart_admin.fn_backup_db_config(NULL) WHERE credential_name IS NOT NULL) 			BEGIN 				SET @is_configured = 1	 			END 			ELSE IF EXISTS (SELECT TOP 1 credential_name FROM smart_admin.fn_backup_instance_config() WHERE credential_name IS NOT NULL) 			BEGIN 				SET @is_configured = 1	 			END 			 			IF (@is_configured = 1) 			BEGIN 				MERGE autoadmin_system_flags AS target 				USING (SELECT LOWER(N'SSMBackup2WAEverConfigured') as name) AS source 				ON source.name = target.name 				WHEN MATCHED THEN UPDATE SET target.value = N'true' 				WHEN NOT MATCHED THEN INSERT VALUES (N'SSMBackup2WAEverConfigured', N'true'); 			END 		END 	COMMIT TRANSACTION 	     SELECT name, 	value  	FROM autoadmin_system_flags END ",46,46,0,275,3,46
"       WITH CTE AS (       SELECT DISTINCT i.object_id oid, i.index_id iid       FROM sys.indexes i WITH(nolock)       JOIN sys.index_columns ic WITH(nolock) ON i.object_id = ic.object_id       JOIN sys.columns c WITH(nolock) ON ic.column_id = c.column_id AND c.object_id = i.object_id       WHERE c.system_type_id = 43 AND c.user_type_id = 43 -- only datetimeoffset columns       AND ic.key_ordinal != 0 -- only key columns       )       SELECT COUNT_BIG(*) AS [NumDatetimeoffsetCols], db_id() AS database_id       FROM CTE     ",40,22,18,739,0,3688
"       SELECT       db_id() AS database_id,       o.[type] AS object_type,       i.[type] AS index_type,       p.[data_compression],       COUNT_BIG(DISTINCT p.[object_id]) AS NumTables,       COUNT_BIG(DISTINCT CAST(p.[object_id] AS VARCHAR(30)) + '|' + CAST(p.[index_id] AS VARCHAR(10))) AS NumIndexes,       ISNULL(px.[IsPartitioned], 0) AS IsPartitioned,       IIF(px.[IsPartitioned] = 1, COUNT_BIG(1), 0) NumPartitions,       SUM(p.[rows]) NumRows       FROM sys.partitions p       INNER JOIN sys.objects o       ON o.[object_id] = p.[object_id]       INNER JOIN sys.indexes i       ON i.[object_id] = p.[object_id]       AND i.[index_id] = p.[index_id]       OUTER APPLY (SELECT       x.[object_id], 1 AS [IsPartitioned]       FROM sys.partitions x       WHERE x.[object_id] = p.[object_id]       GROUP by       x.[object_id]       HAVING MAX(x.partition_number) > 1) px       WHERE o.[type] NOT IN ('S', 'IT')       GROUP BY       o.[type]       ,i.[type]       ,p.[data_compression]       ,px.[IsPartitioned]     ",40,25,15,1757,0,3608
"       WITH CTE AS (       SELECT DISTINCT i.object_id oid, i.index_id iid       FROM sys.indexes i WITH(nolock)       JOIN sys.index_columns ic WITH(nolock) ON i.object_id = ic.object_id       JOIN sys.columns c WITH(nolock) ON ic.column_id = c.column_id AND c.object_id = i.object_id       WHERE c.system_type_id = 42 AND c.user_type_id = 42 -- only datetime2 columns       AND ic.key_ordinal != 0 -- only key columns       )       SELECT COUNT_BIG(*) AS [NumDatetime2Indices], db_id() AS database_id       FROM CTE     ",37,20,17,531,0,3353
"(@_msparam_0 nvarchar(4000))SELECT SCHEMA_NAME(udf.schema_id) AS [Schema], udf.name AS [Name], udf.object_id AS [ID], (case when 'FN' = udf.type then 1 when 'FS' = udf.type then 1 when 'IF' = udf.type then 3 when 'TF' = udf.type then 2 when 'FT' = udf.type then 2 else 0 end) AS [FunctionType], CASE WHEN udf.type IN ('FN','IF','TF') THEN 1 WHEN udf.type IN ('FS','FT') THEN 2 ELSE 1 END AS [ImplementationType], CAST(  case      when udf.is_ms_shipped = 1 then 1     when (         select              major_id          from              sys.extended_properties          where              major_id = udf.object_id and              minor_id = 0 and              class = 1 and              name = N'microsoft_database_tools_support')          is not null then 1     else 0 end                        AS bit) AS [IsSystemObject], CAST(CASE WHEN ISNULL(smudf.definition, ssmudf.definition) IS NULL THEN 1 ELSE 0 END AS bit) AS [IsEncrypted], CAST(ISNULL(OBJECTPROPERTYEX(udf.object_id, N'IsSchemaBound'),0) AS bit) AS [IsSchemaBound], usrt.name AS [DataType] FROM sys.all_objects AS udf LEFT OUTER JOIN sys.sql_modules AS smudf ON smudf.object_id = udf.object_id LEFT OUTER JOIN sys.system_sql_modules AS ssmudf ON ssmudf.object_id = udf.object_id LEFT OUTER JOIN sys.all_parameters AS ret_param ON ret_param.object_id = udf.object_id and ret_param.is_output = @_msparam_0 LEFT OUTER JOIN sys.types AS usrt ON usrt.user_type_id = ret_param.user_type_id WHERE (udf.type in ('TF', 'FN', 'IF', 'FS', 'FT')) ORDER BY [Schema] ASC,[Name] ASC",36,35,1,6012,81,182
"       WITH TablesAndViews AS       (SELECT object_id, 'table' AS object_type FROM sys.tables WITH(nolock) UNION ALL SELECT object_id, 'view' AS object_type FROM sys.views WITH(nolock))       SELECT       db_id() as database_id,       i.type,       i.is_unique,       i.is_primary_key,       i.is_unique_constraint,       i.is_disabled,       i.has_filter,       i.optimize_for_sequential_key,       COUNT_BIG(1) CountOfIndexes,       t.object_type       FROM sys.indexes i WITH(nolock)       INNER JOIN TablesAndViews t       ON t.object_id = i.object_id       GROUP BY i.type,       i.is_unique,       i.is_primary_key,       i.is_unique_constraint,       i.has_filter,       i.optimize_for_sequential_key,       t.object_type,       i.is_disabled     ",35,20,15,89,0,3222
"       WITH CTE AS (       SELECT DISTINCT i.object_id oid, i.index_id iid       FROM sys.indexes i WITH(nolock)       JOIN sys.index_columns ic WITH(nolock) ON i.object_id = ic.object_id       JOIN sys.columns c WITH(nolock) ON ic.column_id = c.column_id AND c.object_id = i.object_id       WHERE c.system_type_id = 41 AND c.user_type_id = 41 -- only time columns       AND ic.key_ordinal != 0 -- only key columns       )       SELECT COUNT_BIG(*) AS [NumTimeIndices], db_id() AS database_id       FROM CTE     ",35,19,16,475,0,3184
"       SELECT ISNULL(AVG(c),0) AS [XTPAvgNumOfIndexes],       ISNULL(MAX(c),0) AS [XTPMaxNumOfIndexes], db_id() AS database_id       FROM (SELECT COUNT_BIG(*) AS c       FROM sys.indexes i WITH(nolock) JOIN sys.tables t WITH(nolock) ON i.object_id=t.object_id WHERE t.is_memory_optimized=1       GROUP BY i.object_id) a     ",33,18,15,402,0,3021
"       SELECT       db_id() as database_id,       sm.[is_inlineable] AS InlineableScalarCount,​       sm.[inline_type] AS InlineType,​       COUNT_BIG(*) AS ScalarCount, ​       COUNT_BIG(CASE WHEN sm.[definition] LIKE '%getdate%' OR       sm.[definition] LIKE '%getutcdate%' OR ​       sm.[definition] LIKE '%sysdatetime%' OR​       sm.[definition] LIKE '%sysu​tcdatetime%' OR​       sm.[definition] LIKE '%sysdatetimeoffset%' OR​       sm.[definition] LIKE '%CURRENT_TIMESTAMP%'​       THEN 1       END) AS ScalarCountWithDate       FROM    [sys].[objects] o​       INNER JOIN    [sys].[sql_modules] sm       ON o.[object_id] = sm.[object_id]​       WHERE   o.[type] = 'FN'​       GROUP BY ​       sm.[is_inlineable],​       sm.[inline_type]     ",32,22,10,2093,0,2888
" CREATE   PROCEDURE autoadmin_fetch_system_flags AS BEGIN 	BEGIN TRANSACTION 		DECLARE @value NVARCHAR(MAX)  		SELECT @value = value FROM autoadmin_system_flags WHERE LOWER(name) = LOWER(N'SSMBackup2WAEverConfigured') 		 		IF (LOWER(ISNULL(@value, '')) <> N'true') 		BEGIN 			DECLARE @is_configured BIT 			SET @is_configured = 0 			 			IF EXISTS (SELECT TOP 1 container_url FROM managed_backup.fn_backup_db_config(NULL) WHERE container_url IS NOT NULL) 			BEGIN 				SET @is_configured = 1	 			END 			ELSE IF EXISTS (SELECT TOP 1 container_url FROM managed_backup.fn_backup_instance_config() WHERE container_url IS NOT NULL) 			BEGIN 				SET @is_configured = 1	 			END 			ELSE IF EXISTS (SELECT TOP 1 credential_name FROM smart_admin.fn_backup_db_config(NULL) WHERE credential_name IS NOT NULL) 			BEGIN 				SET @is_configured = 1	 			END 			ELSE IF EXISTS (SELECT TOP 1 credential_name FROM smart_admin.fn_backup_instance_config() WHERE credential_name IS NOT NULL) 			BEGIN 				SET @is_configured = 1	 			END 			 			IF (@is_configured = 1) 			BEGIN 				MERGE autoadmin_system_flags AS target 				USING (SELECT LOWER(N'SSMBackup2WAEverConfigured') as name) AS source 				ON source.name = target.name 				WHEN MATCHED THEN UPDATE SET target.value = N'true' 				WHEN NOT MATCHED THEN INSERT VALUES (N'SSMBackup2WAEverConfigured', N'true'); 			END 		END 	COMMIT TRANSACTION 	     SELECT name, 	value  	FROM autoadmin_system_flags END ",29,29,0,202,3,29
"       select 1 as name, -- Temp DB       case mf.type_desc       when 'ROWS' then 1       when 'LOG' then 2       end as 'type',       CAST(SUM(num_of_reads) as nvarchar(128)) as total_num_of_reads,       CAST(SUM(num_of_bytes_read) as nvarchar(128)) as total_num_of_bytes_read,       CAST(SUM(io_stall_read_ms) as nvarchar(128)) as total_io_stall_read_ms,       CAST(SUM(num_of_writes) as nvarchar(128)) as total_num_of_writes,       CAST(SUM(num_of_bytes_written) as nvarchar(128)) as total_num_of_bytes_written,       CAST(SUM(io_stall_write_ms) as nvarchar(128)) as total_io_stall_write_ms,       COUNT_BIG(*) as total       from sys.dm_io_virtual_file_stats(NULL, NULL) fs, sys.master_files mf       where fs.database_id = mf.database_id and fs.file_id = mf.file_id and fs.database_id = 2 and (fs.num_of_reads != 0 OR fs.num_of_writes != 0)       group by mf.name, mf.type, mf.type_desc        UNION ALL        select 2 as name, -- User DBs       case mf.type_desc       when 'ROWS' then 1       when 'LOG' then 2       end as 'type',       CAST(SUM(num_of_reads) as nvarchar(128)) as total_num_of_reads,       CAST(SUM(num_of_bytes_read) as nvarchar(128)) as total_num_of_bytes_read,       CAST(SUM(io_stall_read_ms) as nvarchar(128)) as total_io_stall_read_ms,       CAST(SUM(num_of_writes) as nvarchar(128)) as total_num_of_writes,       CAST(SUM(num_of_bytes_written) as nvarchar(128)) as total_num_of_bytes_written,       CAST(SUM(io_stall_write_ms) as nvarchar(128)) as total_io_stall_write_ms,       COUNT_BIG(*) as total       from sys.dm_io_virtual_file_stats(NULL, NULL) fs, sys.master_files mf       where fs.database_id = mf.database_id and fs.file_id = mf.file_id and fs.database_id > 4 and (fs.num_of_reads != 0 OR fs.num_of_writes != 0)       group by mf.type, mf.type_desc        UNION ALL        select 3 as name, -- System DBs       case mf.type_desc       when 'ROWS' then 1       when 'LOG' then 2       end as 'type',       CAST(SUM(num_of_reads) as nvarchar(128)) as total_num_of_reads,       CAST(SUM(num_of_bytes_read) as nvarchar(128)) as total_num_of_bytes_read,       CAST(SUM(io_stall_read_ms) as nvarchar(128)) as total_io_stall_read_ms,       CAST(SUM(num_of_writes) as nvarchar(128)) as total_num_of_writes,       CAST(SUM(num_of_bytes_written) as nvarchar(128)) as total_num_of_bytes_written,       CAST(SUM(io_stall_write_ms) as nvarchar(128)) as total_io_stall_write_ms,       COUNT_BIG(*) as total       from sys.dm_io_virtual_file_stats(NULL, NULL) fs, sys.master_files mf WITH(nolock)       where fs.database_id = mf.database_id and fs.file_id = mf.file_id and (fs.database_id = 1 OR fs.database_id = 3 OR fs.database_id = 4) and (fs.num_of_reads != 0 OR fs.num_of_writes != 0)       group by mf.type, mf.type_desc      ",28,27,1,103,0,141
"(@_msparam_0 nvarchar(4000),@_msparam_1 nvarchar(4000),@_msparam_2 nvarchar(4000),@_msparam_3 nvarchar(4000),@_msparam_4 nvarchar(4000))SELECT sp.name AS [Name], sp.object_id AS [ID], sp.create_date AS [CreateDate], sp.modify_date AS [DateLastModified], ISNULL(ssp.name, N'') AS [Owner], CAST(case when sp.principal_id is null then 1 else 0 end AS bit) AS [IsSchemaOwned], SCHEMA_NAME(sp.schema_id) AS [Schema], CAST(  case      when sp.is_ms_shipped = 1 then 1     when (         select              major_id          from              sys.extended_properties          where              major_id = sp.object_id and              minor_id = 0 and              class = 1 and              name = N'microsoft_database_tools_support')          is not null then 1     else 0 end                        AS bit) AS [IsSystemObject], CAST(ISNULL(OBJECTPROPERTYEX(sp.object_id,N'ExecIsAnsiNullsOn'),0) AS bit) AS [AnsiNullsStatus], CAST(ISNULL(OBJECTPROPERTYEX(sp.object_id,N'ExecIsQuotedIdentOn'),0) AS bit) AS [QuotedIdentifierStatus], CAST(ISNULL(OBJECTPROPERTYEX(sp.object_id, N'IsSchemaBound'),0) AS bit) AS [IsSchemaBound], CAST(CASE WHEN ISNULL(smsp.definition, ssmsp.definition) IS NULL THEN 1 ELSE 0 END AS bit) AS [IsEncrypted], CAST(ISNULL(smsp.is_recompiled, ssmsp.is_recompiled) AS bit) AS [Recompile], case when amsp.object_id is null then N'' else asmblsp.name end AS [AssemblyName], case when amsp.object_id is null then N'' else amsp.assembly_class end AS [ClassName], case when amsp.object_id is null then N'' else amsp.assembly_method end AS [MethodName], case when amsp.object_id is null then case isnull(smsp.execute_as_principal_id, -1) when -1 then 1 when -2 then 2 else 3 end else case isnull(amsp.execute_as_principal_id, -1) when -1 then 1 when -2 then 2 else 3 end end AS [ExecutionContext], case when amsp.object_id is null then ISNULL(user_name(smsp.execute_as_principal_id),N'') else ISNULL(user_name(amsp.execute_as_principal_id), N'') end AS [ExecutionContextPrincipal], CAST(ISNULL(spp.is_auto_executed,0) AS bit) AS [Startup], CASE WHEN sp.type = N'P' THEN 1 WHEN sp.type = N'PC' THEN 2 ELSE 1 END AS [ImplementationType], CAST(CASE sp.type WHEN N'RF' THEN 1 ELSE 0 END AS bit) AS [ForReplication], ISNULL(sm.uses_native_compilation,0) AS [IsNativelyCompiled] FROM sys.all_objects AS sp LEFT OUTER JOIN sys.database_principals AS ssp ON ssp.principal_id = ISNULL(sp.principal_id, (OBJECTPROPERTY(sp.object_id, 'OwnerId'))) LEFT OUTER JOIN sys.sql_modules AS smsp ON smsp.object_id = sp.object_id LEFT OUTER JOIN sys.system_sql_modules AS ssmsp ON ssmsp.object_id = sp.object_id LEFT OUTER JOIN sys.assembly_modules AS amsp ON amsp.object_id = sp.object_id LEFT OUTER JOIN sys.assemblies AS asmblsp ON asmblsp.assembly_id = amsp.assembly_id LEFT OUTER JOIN sys.procedures AS spp ON spp.object_id = sp.object_id LEFT OUTER JOIN sys.all_sql_modules AS sm ON sm.object_id = sp.object_id WHERE (sp.type = @_msparam_0 OR sp.type = @_msparam_1 OR sp.type=@_msparam_2)and(sp.name=@_msparam_3 and SCHEMA_NAME(sp.schema_id)=@_msparam_4)",26,26,0,241,0,161
"         create table #tmp_sp_get_sqlagent_properties         (auto_start int null, msx_server_name sysname null, sqlagent_type int null, startup_account nvarchar(255) null, sqlserver_restart int null, jobhistory_max_rows int null, jobhistory_max_rows_per_job int null, errorlog_file nvarchar(255) null, errorlogging_level int null, error_recipient nvarchar(30) null, monitor_autostart int null, local_host_server sysname null, job_shutdown_timeout int null, cmdexec_account varbinary(64) null, regular_connections int null, host_login_name sysname null, host_login_password varbinary(512) null, login_timeout int null, idle_cpu_percent int null, idle_cpu_duration int null, oem_errorlog int null, sysadmin_only int null, email_profile nvarchar(64) null, email_save_in_sent_folder int null, cpu_poller_enabled int null, replace_alert_tokens_enabled int null)         insert into #tmp_sp_get_sqlagent_properties(auto_start, msx_server_name, sqlagent_type, startup_account, sqlserver_restart, jobhistory_max_rows, jobhistory_max_rows_per_job, errorlog_file, errorlogging_level, error_recipient, monitor_autostart, local_host_server, job_shutdown_timeout, cmdexec_account, regular_connections, host_login_name, host_login_password, login_timeout, idle_cpu_percent, idle_cpu_duration, oem_errorlog, sysadmin_only, email_profile, email_save_in_sent_folder, cpu_poller_enabled, replace_alert_tokens_enabled)         exec msdb.dbo.sp_get_sqlagent_properties                  declare @DatabaseMailProfile nvarchar(255)         exec master.dbo.xp_instance_regread N'HKEY_LOCAL_MACHINE', N'SOFTWARE\Microsoft\MSSQLServer\SQLServerAgent', N'DatabaseMailProfile', @param = @DatabaseMailProfile OUT, @no_output = N'no_output'                  declare @AgentMailType int         exec master.dbo.xp_instance_regread N'HKEY_LOCAL_MACHINE', N'SOFTWARE\Microsoft\MSSQLServer\SQLServerAgent', N'UseDatabaseMail', @param = @AgentMailType OUT, @no_output = N'no_output'                  declare @ServiceStartMode int         set @ServiceStartMode = 2         EXEC master.sys.xp_instance_regread 'HKEY_LOCAL_MACHINE', 'SYSTEM\CurrentControlSet\Services\SQLSERVERAGENT', N'Start', @ServiceStartMode OUTPUT                  declare @ServiceAccount nvarchar(512)         EXEC master.sys.xp_instance_regread 'HKEY_LOCAL_MACHINE', 'SYSTEM\CurrentControlSet\Services\SQLSERVERAGENT', N'ObjectName', @ServiceAccount OUTPUT                  declare @AgtGroup nvarchar(512)         exec master.dbo.xp_instance_regread N'HKEY_LOCAL_MACHINE', N'SOFTWARE\Microsoft\MSSQLServer\Setup', N'AGTGroup', @AgtGroup OUTPUT          SELECT CAST(serverproperty(N'Servername') AS sysname) AS [Name], ISNULL(tsgsp.msx_server_name,N'') AS [MsxServerName], tsgsp.sqlagent_type AS [JobServerType], CAST(tsgsp.sqlserver_restart AS bit) AS [SqlServerRestart], CAST(tsgsp.monitor_autostart AS bit) AS [SqlAgentRestart], tsgsp.jobhistory_max_rows AS [MaximumHistoryRows], tsgsp.jobhistory_max_rows_per_job AS [MaximumJobHistoryRows], tsgsp.errorlog_file AS [ErrorLogFile], tsgsp.errorlogging_level AS [AgentLogLevel], ISNULL(tsgsp.error_recipient,N'') AS [NetSendRecipient], tsgsp.job_shutdown_timeout AS [AgentShutdownWaitTime], ISNULL(tsgsp.email_profile,N'') AS [SqlAgentMailProfile], CAST(tsgsp.email_save_in_sent_folder AS bit) AS [SaveInSentFolder], CAST(tsgsp.oem_errorlog AS bit) AS [WriteOemErrorLog], CAST(tsgsp.cpu_poller_enabled AS bit) AS [IsCpuPollingEnabled], tsgsp.idle_cpu_percent AS [IdleCpuPercentage], tsgsp.idle_cpu_duration AS [IdleCpuDuration], tsgsp.login_timeout AS [LoginTimeout], ISNULL(tsgsp.host_login_name,N'') AS [HostLoginName], ISNULL(tsgsp.local_host_server,N'') AS [LocalHostAlias], CAST(tsgsp.auto_start AS bit) AS [SqlAgentAutoStart], CAST(tsgsp.replace_alert_tokens_enabled AS bit) AS [ReplaceAlertTokensEnabled], ISNULL(@DatabaseMailProfile,N'') AS [DatabaseMailProfile], ISNULL(@AgentMailType, 0) AS [AgentMailType], CAST(1 AS bit) AS [SysAdminOnly], @ServiceStartMode AS [ServiceStartMode], ISNULL(@ServiceAccount,N'') AS [ServiceAccount], ISNULL(suser_sname(sid_binary(ISNULL(@AgtGroup,N''))),N'') AS [AgentDomainGroup] FROM #tmp_sp_get_sqlagent_properties AS tsgsp  drop table #tmp_sp_get_sqlagent_properties          ",25,9,16,27,1,259
"()           declare @ms_now bigint            select @ms_now = ms_ticks from sys.dm_os_sys_info;            select top 15 record_id,           dateadd(ms, -1 * (@ms_now - [timestamp]), GetDate()) as EventTime,           SQLProcessUtilization,           SystemIdle,           100 - SystemIdle - SQLProcessUtilization as OtherProcessUtilization           from (           select           record.value('(./Record/@id)[1]', 'int') as record_id,           record.value('(./Record/SchedulerMonitorEvent/SystemHealth/SystemIdle)[1]', 'int') as SystemIdle,           record.value('(./Record/SchedulerMonitorEvent/SystemHealth/ProcessUtilization)[1]', 'int') as SQLProcessUtilization,           timestamp           from (           select timestamp, convert(xml, record) as record           from sys.dm_os_ring_buffers           where ring_buffer_type = N'RING_BUFFER_SCHEDULER_MONITOR'           and record like '%SystemHealth%') as x 		) as y  	order by record_id desc",25,25,0,0,0,76
" CREATE   PROCEDURE autoadmin_fetch_system_flags AS BEGIN 	BEGIN TRANSACTION 		DECLARE @value NVARCHAR(MAX)  		SELECT @value = value FROM autoadmin_system_flags WHERE LOWER(name) = LOWER(N'SSMBackup2WAEverConfigured') 		 		IF (LOWER(ISNULL(@value, '')) <> N'true') 		BEGIN 			DECLARE @is_configured BIT 			SET @is_configured = 0 			 			IF EXISTS (SELECT TOP 1 container_url FROM managed_backup.fn_backup_db_config(NULL) WHERE container_url IS NOT NULL) 			BEGIN 				SET @is_configured = 1	 			END 			ELSE IF EXISTS (SELECT TOP 1 container_url FROM managed_backup.fn_backup_instance_config() WHERE container_url IS NOT NULL) 			BEGIN 				SET @is_configured = 1	 			END 			ELSE IF EXISTS (SELECT TOP 1 credential_name FROM smart_admin.fn_backup_db_config(NULL) WHERE credential_name IS NOT NULL) 			BEGIN 				SET @is_configured = 1	 			END 			ELSE IF EXISTS (SELECT TOP 1 credential_name FROM smart_admin.fn_backup_instance_config() WHERE credential_name IS NOT NULL) 			BEGIN 				SET @is_configured = 1	 			END 			 			IF (@is_configured = 1) 			BEGIN 				MERGE autoadmin_system_flags AS target 				USING (SELECT LOWER(N'SSMBackup2WAEverConfigured') as name) AS source 				ON source.name = target.name 				WHEN MATCHED THEN UPDATE SET target.value = N'true' 				WHEN NOT MATCHED THEN INSERT VALUES (N'SSMBackup2WAEverConfigured', N'true'); 			END 		END 	COMMIT TRANSACTION 	     SELECT name, 	value  	FROM autoadmin_system_flags END ",24,23,1,204,2,24
"(@_msparam_0 nvarchar(4000),@_msparam_1 nvarchar(4000),@_msparam_2 nvarchar(4000))SELECT udf.name AS [Name], udf.object_id AS [ID], udf.create_date AS [CreateDate], udf.modify_date AS [DateLastModified], ISNULL(sudf.name, N'') AS [Owner], CAST(case when udf.principal_id is null then 1 else 0 end AS bit) AS [IsSchemaOwned], SCHEMA_NAME(udf.schema_id) AS [Schema], CAST(  case      when udf.is_ms_shipped = 1 then 1     when (         select              major_id          from              sys.extended_properties          where              major_id = udf.object_id and              minor_id = 0 and              class = 1 and              name = N'microsoft_database_tools_support')          is not null then 1     else 0 end                        AS bit) AS [IsSystemObject], usrt.name AS [DataType], s1ret_param.name AS [DataTypeSchema], ISNULL(baset.name, N'') AS [SystemType], CAST(CASE WHEN baset.name IN (N'nchar', N'nvarchar') AND ret_param.max_length <> -1 THEN ret_param.max_length/2 ELSE ret_param.max_length END AS int) AS [Length], CAST(ret_param.precision AS int) AS [NumericPrecision], CAST(ret_param.scale AS int) AS [NumericScale], ISNULL(xscret_param.name, N'') AS [XmlSchemaNamespace], ISNULL(s2ret_param.name, N'') AS [XmlSchemaNamespaceSchema], ISNULL( (case ret_param.is_xml_document when 1 then 2 else 1 end), 0) AS [XmlDocumentConstraint], CASE WHEN usrt.is_table_type = 1 THEN N'structured' ELSE N'' END AS [UserType], CAST(ISNULL(OBJECTPROPERTYEX(udf.object_id,N'ExecIsAnsiNullsOn'),0) AS bit) AS [AnsiNullsStatus], CAST(ISNULL(OBJECTPROPERTYEX(udf.object_id, N'IsSchemaBound'),0) AS bit) AS [IsSchemaBound], CAST(CASE WHEN ISNULL(smudf.definition, ssmudf.definition) IS NULL THEN 1 ELSE 0 END AS bit) AS [IsEncrypted], case when amudf.object_id is null then N'' else asmbludf.name end AS [AssemblyName], case when amudf.object_id is null then N'' else amudf.assembly_class end AS [ClassName], case when amudf.object_id is null then N'' else amudf.assembly_method end AS [MethodName], CAST(case when amudf.object_id is null then CAST(smudf.null_on_null_input AS bit) else amudf.null_on_null_input end AS bit) AS [ReturnsNullOnNullInput], case when amudf.object_id is null then case isnull(smudf.execute_as_principal_id, -1) when -1 then 1 when -2 then 2 else 3 end else case isnull(amudf.execute_as_principal_id, -1) when -1 then 1 when -2 then 2 else 3 end end AS [ExecutionContext], case when amudf.object_id is null then ISNULL(user_name(smudf.execute_as_principal_id),N'') else ISNULL(user_name(amudf.execute_as_principal_id), N'') end AS [ExecutionContextPrincipal], CAST(OBJECTPROPERTYEX(udf.object_id, N'IsDeterministic') AS bit) AS [IsDeterministic], (case when 'FN' = udf.type then 1 when 'FS' = udf.type then 1 when 'IF' = udf.type then 3 when 'TF' = udf.type then 2 when 'FT' = udf.type then 2 else 0 end) AS [FunctionType], CASE WHEN udf.type IN ('FN','IF','TF') THEN 1 WHEN udf.type IN ('FS','FT') THEN 2 ELSE 1 END AS [ImplementationType], CAST(ISNULL(OBJECTPROPERTYEX(udf.object_id,N'ExecIsQuotedIdentOn'),0) AS bit) AS [QuotedIdentifierStatus], ret_param.name AS [TableVariableName], ISNULL(sm.uses_native_compilation,0) AS [IsNativelyCompiled], CAST(ISNULL(sm.inline_type,0) AS bit) AS [InlineType], CAST(ISNULL(sm.is_inlineable,0) AS bit) AS [IsInlineable], ISNULL(smudf.definition, ssmudf.definition) AS [Definition] FROM sys.all_objects AS udf LEFT OUTER JOIN sys.database_principals AS sudf ON sudf.principal_id = ISNULL(udf.principal_id, (OBJECTPROPERTY(udf.object_id, 'OwnerId'))) LEFT OUTER JOIN sys.all_parameters AS ret_param ON ret_param.object_id = udf.object_id and ret_param.is_output = @_msparam_0 LEFT OUTER JOIN sys.types AS usrt ON usrt.user_type_id = ret_param.user_type_id LEFT OUTER JOIN sys.schemas AS s1ret_param ON s1ret_param.schema_id = usrt.schema_id LEFT OUTER JOIN sys.types AS baset ON (baset.user_type_id = ret_param.system_type_id and baset.user_type_id = baset.system_type_id) or ((baset.system_type_id = ret_param.system_type_id) and (baset.user_type_id = ret_param.user_type_id) and (baset.is_user_defined = 0) and (baset.is_assembly_type = 1))  LEFT OUTER JOIN sys.xml_schema_collections AS xscret_param ON xscret_param.xml_collection_id = ret_param.xml_collection_id LEFT OUTER JOIN sys.schemas AS s2ret_param ON s2ret_param.schema_id = xscret_param.schema_id LEFT OUTER JOIN sys.sql_modules AS smudf ON smudf.object_id = udf.object_id LEFT OUTER JOIN sys.system_sql_modules AS ssmudf ON ssmudf.object_id = udf.object_id LEFT OUTER JOIN sys.assembly_modules AS amudf ON amudf.object_id = udf.object_id LEFT OUTER JOIN sys.assemblies AS asmbludf ON asmbludf.assembly_id = amudf.assembly_id LEFT OUTER JOIN sys.all_sql_modules AS sm ON sm.object_id = udf.object_id WHERE (udf.type in ('TF', 'FN', 'IF', 'FS', 'FT'))and(udf.name=@_msparam_1 and SCHEMA_NAME(udf.schema_id)=@_msparam_2)",22,22,0,116,0,22
"       SELECT COUNT_BIG(*) AS NumOfNodes FROM [sys].[dm_hadr_cluster_members] WHERE member_type = 0     ",22,20,2,0,0,2018
"(@_msparam_0 nvarchar(4000))SELECT SCHEMA_NAME(udf.schema_id) AS [Schema], udf.name AS [Name], udf.object_id AS [ID], (case when 'FN' = udf.type then 1 when 'FS' = udf.type then 1 when 'IF' = udf.type then 3 when 'TF' = udf.type then 2 when 'FT' = udf.type then 2 else 0 end) AS [FunctionType], CASE WHEN udf.type IN ('FN','IF','TF') THEN 1 WHEN udf.type IN ('FS','FT') THEN 2 ELSE 1 END AS [ImplementationType], CAST(  case      when udf.is_ms_shipped = 1 then 1     when (         select              major_id          from              sys.extended_properties          where              major_id = udf.object_id and              minor_id = 0 and              class = 1 and              name = N'microsoft_database_tools_support')          is not null then 1     else 0 end                        AS bit) AS [IsSystemObject], CAST(CASE WHEN ISNULL(smudf.definition, ssmudf.definition) IS NULL THEN 1 ELSE 0 END AS bit) AS [IsEncrypted], CAST(ISNULL(OBJECTPROPERTYEX(udf.object_id, N'IsSchemaBound'),0) AS bit) AS [IsSchemaBound], usrt.name AS [DataType] FROM sys.all_objects AS udf LEFT OUTER JOIN sys.sql_modules AS smudf ON smudf.object_id = udf.object_id LEFT OUTER JOIN sys.system_sql_modules AS ssmudf ON ssmudf.object_id = udf.object_id LEFT OUTER JOIN sys.all_parameters AS ret_param ON ret_param.object_id = udf.object_id and ret_param.is_output = @_msparam_0 LEFT OUTER JOIN sys.types AS usrt ON usrt.user_type_id = ret_param.user_type_id WHERE (udf.type in ('TF', 'FN', 'IF', 'FS', 'FT')) ORDER BY [Schema] ASC,[Name] ASC",21,21,0,4181,44,169
SELECT target_data 									FROM sys.dm_xe_session_targets xet WITH(nolock) 									JOIN sys.dm_xe_sessions xes WITH(nolock) 									ON xes.address = xet.event_session_address 									WHERE xes.name = 'telemetry_xevents' 									AND xet.target_name = 'ring_buffer',20,16,4,0,0,538911
"()begin try select top 10 rank() over(order by (total_worker_time+0.0)/execution_count desc,sql_handle,statement_start_offset ) as row_no ,       (rank() over(order by (total_worker_time+0.0)/execution_count desc,sql_handle,statement_start_offset ))%2 as l1 ,       creation_time ,       last_execution_time  ,       (total_worker_time+0.0)/1000 as total_worker_time ,       (total_worker_time+0.0)/(execution_count*1000) as [AvgCPUTime] ,       total_logical_reads as [LogicalReads] ,       total_logical_writes as [LogicalWrites] ,       execution_count ,       total_logical_reads+total_logical_writes as [AggIO] ,       (total_logical_reads+total_logical_writes)/(execution_count+0.0) as [AvgIO] ,       case when sql_handle IS NULL                 then ' '                 else ( substring(st.text,(qs.statement_start_offset+2)/2,       (case when qs.statement_end_offset = -1         then len(convert(nvarchar(MAX),st.text))*2      else qs.statement_end_offset    end - qs.statement_start_offset) /2  ) )         end as query_text  ,       db_name(st.dbid) as db_name ,       st.objectid as object_id from sys.dm_exec_query_stats  qs cross apply sys.dm_exec_sql_text(sql_handle) st where total_worker_time  > 0  order by [AvgCPUTime] desc end try begin catch select -100 as row_no ,       1 as l1, 1 as create_time,1 as last_execution_time,1 as total_worker_time,1 as AvgCPUTime,1 as LogicalReads,1 as LogicalWrites ,       ERROR_NUMBER() as execution_count ,       ERROR_SEVERITY() as AggIO ,       ERROR_STATE() as AvgIO ,       ERROR_MESSAGE() as query_text ,       0 as db_name ,       0 as object_name end catch",20,19,1,15308,698,40
"(@_msparam_0 nvarchar(4000))       select * into #tmpag_availability_groups from master.sys.availability_groups                 select group_id, replica_id, replica_server_name,create_date, modify_date, endpoint_url, read_only_routing_url, primary_role_allow_connections, secondary_role_allow_connections, availability_mode,failover_mode, session_timeout, backup_priority, owner_sid, seeding_mode into #tmpar_availability_replicas from master.sys.availability_replicas                select group_id, replica_id, role,operational_state,recovery_health,synchronization_health,connected_state, last_connect_error_number,last_connect_error_description, last_connect_error_timestamp into #tmpar_availability_replica_states from master.sys.dm_hadr_availability_replica_states              select * into #tmpar_ags from master.sys.dm_hadr_availability_group_states       select ar.group_id, ar.replica_id, ar.replica_server_name, ar.availability_mode, (case when UPPER(ags.primary_replica) = UPPER(ar.replica_server_name) then 1 else 0 end) as role, ars.synchronization_health into #tmpar_availabilty_mode from #tmpar_availability_replicas as ar       left join #tmpar_ags as ags on ags.group_id = ar.group_id       left join #tmpar_availability_replica_states as ars on ar.group_id = ars.group_id and ar.replica_id = ars.replica_id       select am1.replica_id, am1.role, (case when (am1.synchronization_health is null) then 3 else am1.synchronization_health end) as sync_state, (case when (am1.availability_mode is NULL) or (am3.availability_mode is NULL) then null when (am1.role = 1) then 1 when (am1.availability_mode = 0 or am3.availability_mode = 0) then 0 else 1 end) as effective_availability_mode       into #tmpar_replica_rollupstate from #tmpar_availabilty_mode as am1 left join (select group_id, role, availability_mode from #tmpar_availabilty_mode as am2 where am2.role = 1) as am3 on am1.group_id = am3.group_id       drop table #tmpar_availabilty_mode       drop table #tmpar_ags              select replica_id,join_state into #tmpar_availability_replica_cluster_states from master.sys.dm_hadr_availability_replica_cluster_states        SELECT AR.replica_server_name AS [Name], 'Server[@Name=' + quotename(CAST(         serverproperty(N'Servername')        AS sysname),'''') + ']' + '/AvailabilityGroup[@Name=' + quotename(AG.name,'''') + ']' + '/AvailabilityReplica[@Name=' + quotename(AR.replica_server_name,'''') + ']' AS [Urn], ISNULL(arstates.role, 3) AS [Role], ISNULL(AR.primary_role_allow_connections, 4) AS [ConnectionModeInPrimaryRole], ISNULL(AR.secondary_role_allow_connections, 3) AS [ConnectionModeInSecondaryRole], ISNULL(arstates.connected_state, 2) AS [ConnectionState], (case when arrollupstates.sync_state = 3 then 3 when (arrollupstates.effective_availability_mode = 1 or arrollupstates.role = 1) then arrollupstates.sync_state when arrollupstates.sync_state = 2 then 1 else 0 end) AS [RollupSynchronizationState], ISNULL(arcs.join_state, 99) AS [JoinState] FROM #tmpag_availability_groups AS AG INNER JOIN #tmpar_availability_replicas AS AR ON (AR.replica_server_name IS NOT NULL) AND (AR.group_id=AG.group_id) LEFT OUTER JOIN #tmpar_availability_replica_states AS arstates ON AR.replica_id = arstates.replica_id LEFT OUTER JOIN #tmpar_replica_rollupstate AS arrollupstates ON AR.replica_id = arrollupstates.replica_id LEFT OUTER JOIN #tmpar_availability_replica_cluster_states AS arcs ON AR.replica_id = arcs.replica_id WHERE (AG.name=@_msparam_0) ORDER BY [Name] ASC        DROP TABLE #tmpar_availability_replicas              DROP TABLE #tmpar_availability_replica_states              DROP TABLE #tmpar_replica_rollupstate              DROP TABLE #tmpar_availability_replica_cluster_states              drop table #tmpag_availability_groups       ",18,15,3,231,0,74
"       select COUNT_BIG(*) AS [NumReplicaPerAG]       from sys.dm_hadr_availability_replica_states where group_id in       (select group_id from sys.dm_hadr_availability_replica_states WITH(nolock) where is_local = 1 and role = 1) group by group_id     ",18,15,3,76,0,1672
"SELECT     DB_NAME (database_id) as [Database Name],     name as [Database File Name],     [Type] = CASE WHEN Type_Desc = 'ROWS' THEN 'Data File(s)'             WHEN Type_Desc = 'LOG'  THEN 'Log File(s)'             ELSE Type_Desc END,     size*8/1024 as 'Size (MB)',     physical_name as [Database_File_Location] FROM sys.master_files ORDER BY 1,3  IF OBJECT_ID('tempdb.dbo.#space') IS NOT NULL     DROP TABLE #space  CREATE TABLE #space (       database_id INT PRIMARY KEY     , data_used_size DECIMAL(18,2)     , log_used_size DECIMAL(18,2) )  DECLARE @SQL NVARCHAR(MAX)  SELECT @SQL = STUFF((     SELECT '     USE [' + d.name + ']     INSERT INTO #space (database_id, data_used_size, log_used_size)     SELECT           DB_ID()         , SUM(CASE WHEN [type] = 0 THEN space_used END)         , SUM(CASE WHEN [type] = 1 THEN space_used END)     FROM (         SELECT s.[type], space_used = SUM(FILEPROPERTY(s.name, ''SpaceUsed'') * 8. / 1024)         FROM sys.database_files s         GROUP BY s.[type]     ) t;'     FROM sys.databases d     WHERE d.[state] = 0     FOR XML PATH(''), TYPE).value('.', 'NVARCHAR(MAX)'), 1, 2, '')  EXEC sys.sp_executesql @SQL  SELECT       d.database_id     , d.name     , d.state_desc     , d.recovery_model_desc     , t.total_size     , t.data_size     , s.data_used_size     , t.log_size     , s.log_used_size     , bu.full_last_date     , bu.full_size     , bu.log_last_date     , bu.log_size FROM (     SELECT           database_id         , log_size = CAST(SUM(CASE WHEN [type] = 1 THEN size END) * 8. / 1024 AS DECIMAL(18,2))         , data_size = CAST(SUM(CASE WHEN [type] = 0 THEN size END) * 8. / 1024 AS DECIMAL(18,2))         , total_size = CAST(SUM(size) * 8. / 1024 AS DECIMAL(18,2))     FROM sys.master_files     GROUP BY database_id ) t JOIN sys.databases d ON d.database_id = t.database_id LEFT JOIN #space s ON d.database_id = s.database_id LEFT JOIN (     SELECT           database_name         , full_last_date = MAX(CASE WHEN [type] = 'D' THEN backup_finish_date END)         , full_size = MAX(CASE WHEN [type] = 'D' THEN backup_size END)         , log_last_date = MAX(CASE WHEN [type] = 'L' THEN backup_finish_date END)         , log_size = MAX(CASE WHEN [type] = 'L' THEN backup_size END)     FROM (         SELECT               s.database_name             , s.[type]             , s.backup_finish_date             , backup_size =                         CAST(CASE WHEN s.backup_size = s.compressed_backup_size                                     THEN s.backup_size                                     ELSE s.compressed_backup_size                         END / 1048576.0 AS DECIMAL(18,2))             , RowNum = ROW_NUMBER() OVER (PARTITION BY s.database_name, s.[type] ORDER BY s.backup_finish_date DESC)         FROM msdb.dbo.backupset s         WHERE s.[type] IN ('D', 'L')     ) f     WHERE f.RowNum = 1     GROUP BY f.database_name ) bu ON d.name = bu.database_name ORDER BY t.total_size DESC  SELECT      req.session_id     , req.total_elapsed_time AS duration_ms     , req.cpu_time AS cpu_time_ms     , req.total_elapsed_time - req.cpu_time AS wait_time     , req.logical_reads     , SUBSTRING (REPLACE (REPLACE (SUBSTRING (ST.text, (req.statement_start_offset/2) + 1,         ((CASE statement_end_offset            WHEN -1            THEN DATALENGTH(ST.text)              ELSE req.statement_end_offset          END - req.statement_start_offset)/2) + 1) , CHAR(10), ' '), CHAR(13), ' '),        1, 512)  AS statement_text   FROM sys.dm_exec_requests AS req     CROSS APPLY sys.dm_exec_sql_text(req.sql_handle) AS ST ORDER BY total_elapsed_time DESC;  SELECT top 100 t.text,      (qs.total_elapsed_time/1000) / qs.execution_count AS avg_elapsed_time,      (qs.total_worker_time/1000) / qs.execution_count AS avg_cpu_time,      ((qs.total_elapsed_time/1000) / qs.execution_count ) - ((qs.total_worker_time/1000) / qs.execution_count) AS avg_wait_time,      qs.total_logical_reads / qs.execution_count AS avg_logical_reads,      qs.total_logical_writes / qs.execution_count AS avg_writes,      (qs.total_elapsed_time/1000) AS cumulative_elapsed_time_all_executions FROM sys.dm_exec_query_stats qs      CROSS apply sys.Dm_exec_sql_text (sql_handle) t -- WHERE t.text like '<Your Query>%' -- Replace <Your Query> with your query or the beginning part of your query. The special chars like '[','_','%','^' in the query should be escaped. ORDER BY (qs.total_elapsed_time / qs.execution_count) DESC  --Deadlock sql check SELECT     session_id,     start_time,      [status],     command,     blocking_session_id,     wait_type,     wait_time,     open_transaction_count,     transaction_id,     total_elapsed_time,     Definition = CAST(text AS VARCHAR(MAX)) FROM     SYS.DM_EXEC_REQUESTS     CROSS APPLY sys.dm_exec_sql_text(sql_handle)  WHERE blocking_session_id != 0  SELECT sqlserver_start_time, (committed_kb/1024) AS Total_Server_Memory_MB, (committed_target_kb/1024)  AS Target_Server_Memory_MB FROM sys.dm_os_sys_info;",17,17,0,1182,0,17
"       select counter_name, cntr_value from sys.dm_os_performance_counters where object_name like '%External Scripts%'     ",16,16,0,0,0,1517
"       select counter_name, cntr_value from sys.dm_os_performance_counters where object_name like '%JSON Doc Stats%'     ",16,16,0,0,0,1512
"       SELECT database_id, database_guid,       CASE       WHEN db_name(database_id) LIKE '%WideWorldImportersDW%' THEN 'WideWorldImportersDW'       WHEN db_name(database_id) LIKE '%WideWorldImporters%' THEN 'WideWorldImporters'       WHEN db_name(database_id) LIKE '%AdventureWorks2016CTP3%' THEN 'AdventureWorks2016CTP3'       WHEN db_name(database_id) LIKE '%AdventureWorksDW2016CTP3%' THEN 'AdventureWorksDW2016CTP3'       WHEN db_name(database_id) LIKE '%AdventureWorks2014%' THEN 'AdventureWorks2014'       WHEN db_name(database_id) LIKE '%AdventureWorksDW2014%' THEN 'AdventureWorksDW2014'       WHEN db_name(database_id) LIKE '%AdventureWorks2012%' THEN 'AdventureWorks2012'       WHEN db_name(database_id) LIKE '%AdventureWorksDW2012%' THEN 'AdventureWorksDW2012'       WHEN db_name(database_id) LIKE '%AdventureWorks2008%' THEN 'AdventureWorks2008'       WHEN db_name(database_id) LIKE '%AdventureWorksDW2008%' THEN 'AdventureWorksDW2008'       WHEN db_name(database_id) LIKE '%AdventureWorksDW%' THEN 'AdventureWorksDW'       WHEN db_name(database_id) LIKE '%AdventureWorks%' THEN 'AdventureWorks'       WHEN db_name(database_id) LIKE '%ReportServerTempDB%' THEN 'ReportServerTempDB'       WHEN db_name(database_id) LIKE '%ReportServer%' THEN 'ReportServer'       WHEN db_name(database_id) LIKE '%WSS_Content%' THEN 'WSS_Content'       WHEN db_name(database_id) LIKE '%MDW%' THEN 'MDW'       WHEN db_name(database_id) LIKE '%MicrosoftDynamicsAX_baseline%' THEN 'MicrosoftDynamicsAX_baseline'       WHEN db_name(database_id) LIKE '%MicrosoftDynamicsAX%' THEN 'MicrosoftDynamicsAX'       WHEN db_name(database_id) = 'master' THEN 'master'       WHEN db_name(database_id) = 'msdb' THEN 'msdb'       WHEN db_name(database_id) = 'tempdb' THEN 'tempdb'       WHEN db_name(database_id) = 'model' THEN 'model'       WHEN db_name(database_id) LIKE '%SharePoint_Config%' THEN 'SharePoint_Config'       WHEN db_name(database_id) LIKE '%SharePoint_AdminContent%' THEN 'SharePoint_AdminContent'       WHEN db_name(database_id) LIKE '%AppManagement%' THEN 'AppManagement'       WHEN db_name(database_id) LIKE '%Bdc_Service_DB%' THEN 'Bdc_Service_DB'       WHEN db_name(database_id) LIKE '%Search_Service_Application_DB%' THEN 'Search_Service_Application_DB'       WHEN db_name(database_id) LIKE '%Search_Service_Application_AnalyticsReportingStoreDB%' THEN 'Search_Service_Application_AnalyticsReportingStoreDB'       WHEN db_name(database_id) LIKE '%Search_Service_Application_CrawlStoreDB%' THEN 'Search_Service_Application_CrawlStoreDB'       WHEN db_name(database_id) LIKE '%Search_Service_Application_LinkStoreDB%' THEN 'Search_Service_Application_LinkStoreDB'       WHEN db_name(database_id) LIKE '%Secure_Store_Service_DB%' THEN 'Secure_Store_Service_DB'       WHEN db_name(database_id) LIKE '%SharePoint_Logging%' THEN 'SharePoint_Logging'       WHEN db_name(database_id) LIKE '%SettingsServiceDB%' THEN 'SettingsServiceDB'       WHEN db_name(database_id) LIKE '%User Profile Service Application_ProfileDB%' THEN 'User Profile Service Application_ProfileDB'       WHEN db_name(database_id) LIKE '%User Profile Service Application_SyncDB%' THEN 'User Profile Service Application_SyncDB'       WHEN db_name(database_id) LIKE '%User Profile Service Application_SocialDB%' THEN 'User Profile Service Application_SocialDB'       WHEN db_name(database_id) LIKE '%WordAutomationServices%' THEN 'WordAutomationServices'       WHEN db_name(database_id) LIKE '%Managed Metadata Service Application_Metadata%' THEN 'Managed Metadata Service Application_Metadata'       WHEN db_name(database_id) LIKE '%SharePoint Translation Services%' THEN 'SharePoint Translation Services'       WHEN db_name(database_id) LIKE '%ProjectWebApp%' THEN 'ProjectWebApp'       WHEN db_name(database_id) LIKE '%DefaultPowerPivotServiceApplicationDB%' THEN 'DefaultPowerPivotServiceApplicationDB'       WHEN db_name(database_id) LIKE '%PerformancePoint Service%' THEN 'PerformancePoint Service'       WHEN db_name(database_id) LIKE '%SessionStateService%' THEN 'SessionStateService'       WHEN db_name(database_id) = 'SSISDB' THEN 'SSISDB'       WHEN db_name(database_id) = 'DQS_MAIN' THEN 'DQS_MAIN'       ELSE 'Other'       END AS default_database_class       FROM sys.database_recovery_status WITH(nolock)     ",16,8,8,17,0,1504
"         DECLARE @msticks bigint, @mstickstime datetime, @LastHour datetime                 SELECT @mstickstime = GETDATE(), @msticks = ms_ticks from sys.dm_os_sys_info                 SELECT @LastHour = DATEADD(HOUR, -1, @mstickstime);                  WITH Quartiles AS (                 SELECT DISTINCT                     CONVERT(VARCHAR(10), CAST(DATEADD (ms, -1 * (@msticks - [timestamp]),@mstickstime) AS DATE), 112) EventDate,                        CONVERT(VARCHAR(30), TIMEFROMPARTS(DATEPART(HOUR, DATEADD (ms, -1 * (@msticks - [timestamp]),@mstickstime)), 00,00,00,00), 114) AS [EventTime],                        PERCENTILE_DISC(0.5) WITHIN GROUP (ORDER BY record.value('(Record/SchedulerMonitorEvent/SystemHealth/ProcessUtilization)[1]', 'int')                            )                            OVER (PARTITION BY CONVERT(VARCHAR(10), CAST(DATEADD (ms, -1 * (@msticks - [timestamp]),@mstickstime) AS DATE), 112),                                   CONVERT(VARCHAR(30), TIMEFROMPARTS(DATEPART(HOUR, DATEADD (ms, -1 * (@msticks - [timestamp]),@mstickstime)), 00,00,00,00), 114)                            ) AS MedianSQLCPU                            ,                        PERCENTILE_CONT(0.75) WITHIN GROUP (ORDER BY record.value('(Record/SchedulerMonitorEvent/SystemHealth/ProcessUtilization)[1]', 'int')                            )                            OVER (PARTITION BY CONVERT(VARCHAR(10), CAST(DATEADD (ms, -1 * (@msticks - [timestamp]),@mstickstime) AS DATE), 112),                                   CONVERT(VARCHAR(30), TIMEFROMPARTS(DATEPART(HOUR, DATEADD (ms, -1 * (@msticks - [timestamp]),@mstickstime)), 00,00,00,00), 114)                            ) AS Q3SQLCPU                      ,                        PERCENTILE_CONT(0.25) WITHIN GROUP (ORDER BY record.value('(Record/SchedulerMonitorEvent/SystemHealth/ProcessUtilization)[1]', 'int')                            )                            OVER (PARTITION BY CONVERT(VARCHAR(10), CAST(DATEADD (ms, -1 * (@msticks - [timestamp]),@mstickstime) AS DATE), 112),                                   CONVERT(VARCHAR(30), TIMEFROMPARTS(DATEPART(HOUR, DATEADD (ms, -1 * (@msticks - [timestamp]),@mstickstime)), 00,00,00,00), 114)                            ) AS Q1SQLCPU                   FROM (                     SELECT timestamp, CONVERT (xml, record) AS 'record'                     FROM sys.dm_os_ring_buffers                     WHERE ring_buffer_type = 'RING_BUFFER_SCHEDULER_MONITOR'                       AND record LIKE '%<SystemHealth>%'                             ) AS t                      WHERE DATEPART(HOUR, DATEADD (ms, -1 * (@msticks - [timestamp]),@mstickstime)) = DATEPART(HOUR, @LastHour)                      AND CAST(DATEADD (ms, -1 * (@msticks - [timestamp]),@mstickstime) AS DATE) = CAST(@LastHour AS DATE)               ),               SimpleStats AS (                 SELECT                     CONVERT(VARCHAR(10), CAST(DATEADD (ms, -1 * (@msticks - [timestamp]),@mstickstime) AS DATE), 112) EventDate,                        CONVERT(VARCHAR(30), TIMEFROMPARTS(DATEPART(HOUR, DATEADD (ms, -1 * (@msticks - [timestamp]),@mstickstime)), 00,00,00,00), 114) AS [EventTime],                     MAX(record.value('(Record/SchedulerMonitorEvent/SystemHealth/ProcessUtilization)[1]', 'int')) AS [MaxSQLCPU],                        MIN(record.value('(Record/SchedulerMonitorEvent/SystemHealth/ProcessUtilization)[1]', 'int')) AS [MinSQLCPU],                        AVG(record.value('(Record/SchedulerMonitorEvent/SystemHealth/ProcessUtilization)[1]', 'int')) AS [AvgSQLCPU]                   FROM (                     SELECT timestamp, CONVERT (xml, record) AS 'record'                     FROM sys.dm_os_ring_buffers                     WHERE ring_buffer_type = 'RING_BUFFER_SCHEDULER_MONITOR'                       AND record LIKE '%<SystemHealth>%'                             ) AS t               WHERE DATEPART(HOUR, DATEADD (ms, -1 * (@msticks - [timestamp]),@mstickstime)) = DATEPART(HOUR, @LastHour)                      AND CAST(DATEADD (ms, -1 * (@msticks - [timestamp]),@mstickstime) AS DATE) = CAST(@LastHour AS DATE)               GROUP BY                      CONVERT(VARCHAR(10), CAST(DATEADD (ms, -1 * (@msticks - [timestamp]),@mstickstime) AS DATE), 112) ,                      CONVERT(VARCHAR(30), TIMEFROMPARTS(DATEPART(HOUR, DATEADD (ms, -1 * (@msticks - [timestamp]),@mstickstime)), 00,00,00,00), 114)               )               SELECT                      ss.EventDate AS EventDate,                      ss.EventTime AS EventTime,                      ss.MaxSQLCPU,                      ss.MinSQLCPU,                      ss.AvgSQLCPU,                      q.MedianSQLCPU,                      q.Q1SQLCPU,                      q.Q3SQLCPU               FROM SimpleStats ss                      INNER JOIN Quartiles q                            ON q.EventDate = ss.EventDate                            AND q.EventTime = ss.EventTime      ",16,16,0,781,0,36288
"       SELECT replica_id, group_id, is_local, role, operational_state, recovery_health, synchronization_health, connected_state, last_connect_error_number, last_connect_error_timestamp FROM sys.dm_hadr_availability_replica_states WITH(nolock)     ",16,13,3,66,0,1460
"SELECT     DB_NAME (database_id) as [Database Name],     name as [Database File Name],     [Type] = CASE WHEN Type_Desc = 'ROWS' THEN 'Data File(s)'             WHEN Type_Desc = 'LOG'  THEN 'Log File(s)'             ELSE Type_Desc END,     size*8/1024 as 'Size (MB)',     physical_name as [Database_File_Location] FROM sys.master_files ORDER BY 1,3  IF OBJECT_ID('tempdb.dbo.#space') IS NOT NULL     DROP TABLE #space  CREATE TABLE #space (       database_id INT PRIMARY KEY     , data_used_size DECIMAL(18,2)     , log_used_size DECIMAL(18,2) )  DECLARE @SQL NVARCHAR(MAX)  SELECT @SQL = STUFF((     SELECT '     USE [' + d.name + ']     INSERT INTO #space (database_id, data_used_size, log_used_size)     SELECT           DB_ID()         , SUM(CASE WHEN [type] = 0 THEN space_used END)         , SUM(CASE WHEN [type] = 1 THEN space_used END)     FROM (         SELECT s.[type], space_used = SUM(FILEPROPERTY(s.name, ''SpaceUsed'') * 8. / 1024)         FROM sys.database_files s         GROUP BY s.[type]     ) t;'     FROM sys.databases d     WHERE d.[state] = 0     FOR XML PATH(''), TYPE).value('.', 'NVARCHAR(MAX)'), 1, 2, '')  EXEC sys.sp_executesql @SQL  SELECT       d.database_id     , d.name     , d.state_desc     , d.recovery_model_desc     , t.total_size     , t.data_size     , s.data_used_size     , t.log_size     , s.log_used_size     , bu.full_last_date     , bu.full_size     , bu.log_last_date     , bu.log_size FROM (     SELECT           database_id         , log_size = CAST(SUM(CASE WHEN [type] = 1 THEN size END) * 8. / 1024 AS DECIMAL(18,2))         , data_size = CAST(SUM(CASE WHEN [type] = 0 THEN size END) * 8. / 1024 AS DECIMAL(18,2))         , total_size = CAST(SUM(size) * 8. / 1024 AS DECIMAL(18,2))     FROM sys.master_files     GROUP BY database_id ) t JOIN sys.databases d ON d.database_id = t.database_id LEFT JOIN #space s ON d.database_id = s.database_id LEFT JOIN (     SELECT           database_name         , full_last_date = MAX(CASE WHEN [type] = 'D' THEN backup_finish_date END)         , full_size = MAX(CASE WHEN [type] = 'D' THEN backup_size END)         , log_last_date = MAX(CASE WHEN [type] = 'L' THEN backup_finish_date END)         , log_size = MAX(CASE WHEN [type] = 'L' THEN backup_size END)     FROM (         SELECT               s.database_name             , s.[type]             , s.backup_finish_date             , backup_size =                         CAST(CASE WHEN s.backup_size = s.compressed_backup_size                                     THEN s.backup_size                                     ELSE s.compressed_backup_size                         END / 1048576.0 AS DECIMAL(18,2))             , RowNum = ROW_NUMBER() OVER (PARTITION BY s.database_name, s.[type] ORDER BY s.backup_finish_date DESC)         FROM msdb.dbo.backupset s         WHERE s.[type] IN ('D', 'L')     ) f     WHERE f.RowNum = 1     GROUP BY f.database_name ) bu ON d.name = bu.database_name ORDER BY t.total_size DESC  SELECT      req.session_id     , req.total_elapsed_time AS duration_ms     , req.cpu_time AS cpu_time_ms     , req.total_elapsed_time - req.cpu_time AS wait_time     , req.logical_reads     , SUBSTRING (REPLACE (REPLACE (SUBSTRING (ST.text, (req.statement_start_offset/2) + 1,         ((CASE statement_end_offset            WHEN -1            THEN DATALENGTH(ST.text)              ELSE req.statement_end_offset          END - req.statement_start_offset)/2) + 1) , CHAR(10), ' '), CHAR(13), ' '),        1, 512)  AS statement_text   FROM sys.dm_exec_requests AS req     CROSS APPLY sys.dm_exec_sql_text(req.sql_handle) AS ST ORDER BY total_elapsed_time DESC;  SELECT top 100 t.text,      (qs.total_elapsed_time/1000) / qs.execution_count AS avg_elapsed_time,      (qs.total_worker_time/1000) / qs.execution_count AS avg_cpu_time,      ((qs.total_elapsed_time/1000) / qs.execution_count ) - ((qs.total_worker_time/1000) / qs.execution_count) AS avg_wait_time,      qs.total_logical_reads / qs.execution_count AS avg_logical_reads,      qs.total_logical_writes / qs.execution_count AS avg_writes,      (qs.total_elapsed_time/1000) AS cumulative_elapsed_time_all_executions FROM sys.dm_exec_query_stats qs      CROSS apply sys.Dm_exec_sql_text (sql_handle) t -- WHERE t.text like '<Your Query>%' -- Replace <Your Query> with your query or the beginning part of your query. The special chars like '[','_','%','^' in the query should be escaped. ORDER BY (qs.total_elapsed_time / qs.execution_count) DESC  --Deadlock sql check SELECT     session_id,     start_time,      [status],     command,     blocking_session_id,     wait_type,     wait_time,     open_transaction_count,     transaction_id,     total_elapsed_time,     Definition = CAST(text AS VARCHAR(MAX)) FROM     SYS.DM_EXEC_REQUESTS     CROSS APPLY sys.dm_exec_sql_text(sql_handle)  WHERE blocking_session_id != 0  SELECT sqlserver_start_time, (committed_kb/1024) AS Total_Server_Memory_MB, (committed_target_kb/1024)  AS Target_Server_Memory_MB FROM sys.dm_os_sys_info; ",16,16,0,1047,0,16
"()                 begin try                 select  object_name                 ,       counter_name                 ,       convert(varchar(10),cntr_value) as cntr_value                 from sys.dm_os_performance_counters                 where ( (object_name like '%Manager%') and (counter_name = 'Memory Grants Pending' or counter_name='Memory Grants Outstanding' ))                 end try                 begin catch                 select top 0 0 as object_name, 0 as counter_name, 0 as cntr_value                 end catch               ",15,15,0,0,0,47
"       select       group_id,       replica_id,       availability_mode,       failover_mode,       primary_role_allow_connections,       secondary_role_allow_connections,       LEN(ISNULL(read_only_routing_url, '')) as read_only_routing_url_length,       seeding_mode,       session_timeout       from sys.availability_replicas WITH(nolock) where group_id in       (select group_id from sys.dm_hadr_availability_replica_states WITH(nolock) where is_local = 1 and role = 1)     ",15,12,3,98,0,93
"declare      @CPU_Usage_Percentage int,      @Total_SQL_Server_Memory_MB int   -- CPU WITH y AS (     SELECT               CONVERT(VARCHAR(5), 100 - ca.c.value('.', 'INT')) AS system_idle,         CONVERT(VARCHAR(30), rb.event_date) AS event_date,         CONVERT(VARCHAR(8000), rb.record) AS record     FROM (            SELECT              CONVERT(XML, dorb.record) AS record,             DATEADD(ms, ( ts.ms_ticks - dorb.timestamp ), GETDATE()) AS event_date         FROM   sys.dm_os_ring_buffers AS dorb             CROSS JOIN (                  SELECT                      dosi.ms_ticks                  FROM sys.dm_os_sys_info AS dosi ) AS ts                 WHERE   dorb.ring_buffer_type = N'RING_BUFFER_SCHEDULER_MONITOR'                         AND record LIKE '%%' ) AS rb             CROSS APPLY rb.record.nodes('/Record/SchedulerMonitorEvent/SystemHealth/SystemIdle') AS ca(c)         )     SELECT @CPU_Usage_Percentage = (select          TOP 1 y.system_idle     FROM y      ORDER BY y.event_date DESC)   -- memory select @Total_SQL_Server_Memory_MB = (select      cntr_value / 1024 from sys.dm_os_performance_counters pc where   [object_name] = 'SQLServer:Memory Manager'         and counter_name = 'Total Server Memory (KB)'                                                                                                         )   select      @CPU_Usage_Percentage           [CPU_Usage_Percentage],      @Total_SQL_Server_Memory_MB     [Total_SQL_Server_Memory_MB]; 	 WITH DB_CPU_Stats AS (SELECT pa.DatabaseID, DB_Name(pa.DatabaseID) AS [Database Name], SUM(qs.total_worker_time/1000) AS [CPU_Time_Ms]  FROM sys.dm_exec_query_stats AS qs WITH (NOLOCK)  CROSS APPLY (SELECT CONVERT(int, value) AS [DatabaseID]               FROM sys.dm_exec_plan_attributes(qs.plan_handle)               WHERE attribute = N'dbid') AS pa  GROUP BY DatabaseID) SELECT ROW_NUMBER() OVER(ORDER BY [CPU_Time_Ms] DESC) AS [CPU Rank],        [Database Name], [CPU_Time_Ms] AS [CPU Time (ms)],        CAST([CPU_Time_Ms] * 1.0 / SUM([CPU_Time_Ms]) OVER() * 100.0 AS DECIMAL(5, 2)) AS [CPU Percent] FROM DB_CPU_Stats WHERE DatabaseID <> 32767 -- ResourceDB ORDER BY [CPU Rank] OPTION (RECOMPILE);   DECLARE @total_buffer INT;  SELECT @total_buffer = cntr_value FROM sys.dm_os_performance_counters  WHERE RTRIM([object_name]) LIKE '%Buffer Manager' AND counter_name = 'Database Pages';  ;WITH src AS (   SELECT    database_id, db_buffer_pages = COUNT_BIG(*)   FROM sys.dm_os_buffer_descriptors   --WHERE database_id BETWEEN 5 AND 32766   GROUP BY database_id ) SELECT [db_name] = CASE [database_id] WHEN 32767  THEN 'Resource DB'  ELSE DB_NAME([database_id]) END, db_buffer_pages, db_buffer_MB = db_buffer_pages / 128, db_buffer_percent = CONVERT(DECIMAL(6,3),  db_buffer_pages * 100.0 / @total_buffer) FROM src ORDER BY db_buffer_MB DESC;  ",15,15,0,0,0,46
"(@_msparam_0 nvarchar(4000))       select * into #tmpag_availability_groups from master.sys.availability_groups                 select group_id, replica_id, replica_server_name,create_date, modify_date, endpoint_url, read_only_routing_url, primary_role_allow_connections, secondary_role_allow_connections, availability_mode,failover_mode, session_timeout, backup_priority, owner_sid, seeding_mode into #tmpar_availability_replicas from master.sys.availability_replicas                select group_id, replica_id, role,operational_state,recovery_health,synchronization_health,connected_state, last_connect_error_number,last_connect_error_description, last_connect_error_timestamp into #tmpar_availability_replica_states from master.sys.dm_hadr_availability_replica_states              select * into #tmpar_ags from master.sys.dm_hadr_availability_group_states       select ar.group_id, ar.replica_id, ar.replica_server_name, ar.availability_mode, (case when UPPER(ags.primary_replica) = UPPER(ar.replica_server_name) then 1 else 0 end) as role, ars.synchronization_health into #tmpar_availabilty_mode from #tmpar_availability_replicas as ar       left join #tmpar_ags as ags on ags.group_id = ar.group_id       left join #tmpar_availability_replica_states as ars on ar.group_id = ars.group_id and ar.replica_id = ars.replica_id       select am1.replica_id, am1.role, (case when (am1.synchronization_health is null) then 3 else am1.synchronization_health end) as sync_state, (case when (am1.availability_mode is NULL) or (am3.availability_mode is NULL) then null when (am1.role = 1) then 1 when (am1.availability_mode = 0 or am3.availability_mode = 0) then 0 else 1 end) as effective_availability_mode       into #tmpar_replica_rollupstate from #tmpar_availabilty_mode as am1 left join (select group_id, role, availability_mode from #tmpar_availabilty_mode as am2 where am2.role = 1) as am3 on am1.group_id = am3.group_id       drop table #tmpar_availabilty_mode       drop table #tmpar_ags              select replica_id,join_state into #tmpar_availability_replica_cluster_states from master.sys.dm_hadr_availability_replica_cluster_states        SELECT AR.replica_server_name AS [Name], 'Server[@Name=' + quotename(CAST(         serverproperty(N'Servername')        AS sysname),'''') + ']' + '/AvailabilityGroup[@Name=' + quotename(AG.name,'''') + ']' + '/AvailabilityReplica[@Name=' + quotename(AR.replica_server_name,'''') + ']' AS [Urn], ISNULL(arstates.role, 3) AS [Role], ISNULL(AR.primary_role_allow_connections, 4) AS [ConnectionModeInPrimaryRole], ISNULL(AR.secondary_role_allow_connections, 3) AS [ConnectionModeInSecondaryRole], ISNULL(arstates.connected_state, 2) AS [ConnectionState], (case when arrollupstates.sync_state = 3 then 3 when (arrollupstates.effective_availability_mode = 1 or arrollupstates.role = 1) then arrollupstates.sync_state when arrollupstates.sync_state = 2 then 1 else 0 end) AS [RollupSynchronizationState], ISNULL(arcs.join_state, 99) AS [JoinState] FROM #tmpag_availability_groups AS AG INNER JOIN #tmpar_availability_replicas AS AR ON (AR.replica_server_name IS NOT NULL) AND (AR.group_id=AG.group_id) LEFT OUTER JOIN #tmpar_availability_replica_states AS arstates ON AR.replica_id = arstates.replica_id LEFT OUTER JOIN #tmpar_replica_rollupstate AS arrollupstates ON AR.replica_id = arrollupstates.replica_id LEFT OUTER JOIN #tmpar_availability_replica_cluster_states AS arcs ON AR.replica_id = arcs.replica_id WHERE (AG.name=@_msparam_0) ORDER BY [Name] ASC        DROP TABLE #tmpar_availability_replicas              DROP TABLE #tmpar_availability_replica_states              DROP TABLE #tmpar_replica_rollupstate              DROP TABLE #tmpar_availability_replica_cluster_states              drop table #tmpag_availability_groups       ",14,12,2,172,0,59
"(@_msparam_0 nvarchar(4000))       select * into #tmpag_availability_groups from master.sys.availability_groups               select replica_id, group_id into #tmpardb_availability_replicas from master.sys.availability_replicas              select replica_id, group_database_id, database_name,is_database_joined,is_failover_ready,is_pending_secondary_suspend,recovery_lsn,truncation_lsn into #tmpardb_database_replica_cluster_states from master.sys.dm_hadr_database_replica_cluster_states              select replica_id, is_local into #tmpardb_availability_replica_states from master.sys.dm_hadr_availability_replica_states              select replica_id, group_database_id,synchronization_state, is_suspended into #tmpardb_database_replica_states from master.sys.dm_hadr_database_replica_states        SELECT dbcs.database_name AS [Name], 'Server[@Name=' + quotename(CAST(         serverproperty(N'Servername')        AS sysname),'''') + ']' + '/AvailabilityGroup[@Name=' + quotename(AG.name,'''') + ']' + '/AvailabilityDatabase[@Name=' + quotename(dbcs.database_name,'''') + ']' AS [Urn], ISNULL(dbrs.synchronization_state, 0) AS [SynchronizationState], ISNULL(dbrs.is_suspended, 0) AS [IsSuspended], ISNULL(dbcs.is_database_joined, 0) AS [IsJoined] FROM #tmpag_availability_groups AS AG INNER JOIN #tmpardb_availability_replicas AS AR ON AR.group_id=AG.group_id INNER JOIN #tmpardb_availability_replica_states AS arstates ON AR.replica_id = arstates.replica_id AND arstates.is_local = 1 INNER JOIN #tmpardb_database_replica_cluster_states AS dbcs ON arstates.replica_id = dbcs.replica_id LEFT OUTER JOIN #tmpardb_database_replica_states AS dbrs ON dbcs.replica_id = dbrs.replica_id AND dbcs.group_database_id = dbrs.group_database_id WHERE (AG.name=@_msparam_0) ORDER BY [Name] ASC        DROP TABLE #tmpardb_availability_replicas              DROP TABLE #tmpardb_database_replica_cluster_states              DROP TABLE #tmpardb_availability_replica_states              DROP TABLE #tmpardb_database_replica_states              drop table #tmpag_availability_groups       ",14,11,3,94,0,14
"declare      @CPU_Usage_Percentage int,      @Total_SQL_Server_Memory_MB int   -- CPU WITH y AS (     SELECT               CONVERT(VARCHAR(5), 100 - ca.c.value('.', 'INT')) AS system_idle,         CONVERT(VARCHAR(30), rb.event_date) AS event_date,         CONVERT(VARCHAR(8000), rb.record) AS record     FROM (            SELECT              CONVERT(XML, dorb.record) AS record,             DATEADD(ms, ( ts.ms_ticks - dorb.timestamp ), GETDATE()) AS event_date         FROM   sys.dm_os_ring_buffers AS dorb             CROSS JOIN (                  SELECT                      dosi.ms_ticks                  FROM sys.dm_os_sys_info AS dosi ) AS ts                 WHERE   dorb.ring_buffer_type = N'RING_BUFFER_SCHEDULER_MONITOR'                         AND record LIKE '%%' ) AS rb             CROSS APPLY rb.record.nodes('/Record/SchedulerMonitorEvent/SystemHealth/SystemIdle') AS ca(c)         )     SELECT @CPU_Usage_Percentage = (select          TOP 1 y.system_idle     FROM y      ORDER BY y.event_date DESC)   -- memory select @Total_SQL_Server_Memory_MB = (select      cntr_value / 1024 from sys.dm_os_performance_counters pc where   [object_name] = 'SQLServer:Memory Manager'         and counter_name = 'Total Server Memory (KB)'                                                                                                         )   select      @CPU_Usage_Percentage           [CPU_Usage_Percentage],      @Total_SQL_Server_Memory_MB     [Total_SQL_Server_Memory_MB]; 	 WITH DB_CPU_Stats AS (SELECT pa.DatabaseID, DB_Name(pa.DatabaseID) AS [Database Name], SUM(qs.total_worker_time/1000) AS [CPU_Time_Ms]  FROM sys.dm_exec_query_stats AS qs WITH (NOLOCK)  CROSS APPLY (SELECT CONVERT(int, value) AS [DatabaseID]               FROM sys.dm_exec_plan_attributes(qs.plan_handle)               WHERE attribute = N'dbid') AS pa  GROUP BY DatabaseID) SELECT ROW_NUMBER() OVER(ORDER BY [CPU_Time_Ms] DESC) AS [CPU Rank],        [Database Name], [CPU_Time_Ms] AS [CPU Time (ms)],        CAST([CPU_Time_Ms] * 1.0 / SUM([CPU_Time_Ms]) OVER() * 100.0 AS DECIMAL(5, 2)) AS [CPU Percent] FROM DB_CPU_Stats WHERE DatabaseID <> 32767 -- ResourceDB ORDER BY [CPU Rank] OPTION (RECOMPILE);   DECLARE @total_buffer INT;  SELECT @total_buffer = cntr_value FROM sys.dm_os_performance_counters  WHERE RTRIM([object_name]) LIKE '%Buffer Manager' AND counter_name = 'Database Pages';  ;WITH src AS (   SELECT    database_id, db_buffer_pages = COUNT_BIG(*)   FROM sys.dm_os_buffer_descriptors   --WHERE database_id BETWEEN 5 AND 32766   GROUP BY database_id ) SELECT [db_name] = CASE [database_id] WHEN 32767  THEN 'Resource DB'  ELSE DB_NAME([database_id]) END, db_buffer_pages, db_buffer_MB = db_buffer_pages / 128, db_buffer_percent = CONVERT(DECIMAL(6,3),  db_buffer_pages * 100.0 / @total_buffer) FROM src ORDER BY db_buffer_MB DESC;  ",13,13,0,0,0,41
" DECLARE @total_buffer INT;  SELECT @total_buffer = cntr_value FROM sys.dm_os_performance_counters  WHERE RTRIM([object_name]) LIKE '%Buffer Manager' AND counter_name = 'Database Pages';  ;WITH src AS (   SELECT    database_id, db_buffer_pages = COUNT_BIG(*)   FROM sys.dm_os_buffer_descriptors   --WHERE database_id BETWEEN 5 AND 32766   GROUP BY database_id ) SELECT [db_name] = CASE [database_id] WHEN 32767  THEN 'Resource DB'  ELSE DB_NAME([database_id]) END, db_buffer_pages, db_buffer_MB = db_buffer_pages / 128, db_buffer_percent = CONVERT(DECIMAL(6,3),  db_buffer_pages * 100.0 / @total_buffer) FROM src ORDER BY db_buffer_MB DESC;  ",13,13,0,0,0,41
"       select * into #tmpag_availability_groups from master.sys.availability_groups              select agstates.group_id, agstates.primary_replica into #tmpag_availability_group_states from master.sys.dm_hadr_availability_group_states as agstates              select group_id, replica_id, replica_metadata_id into #tmpag_availability_replicas from master.sys.availability_replicas       select replica_id, is_local, role into #tmpag_availability_replica_states from master.sys.dm_hadr_availability_replica_states                select TMIL.group_id, count(*) as is_managed_instance_link into #tmp_managed_instance_link from sys.availability_replicas AS TMIL where TMIL.endpoint_url LIKE '%Server=%' and (select count(*) from sys.availability_replicas as A1 where A1.group_id = TMIL.group_id) = 2 group by TMIL.group_id having count(*) = 1        SELECT AG.name AS [Name], 'Server[@Name=' + quotename(CAST(         serverproperty(N'Servername')        AS sysname),'''') + ']' + '/AvailabilityGroup[@Name=' + quotename(AG.name,'''') + ']' AS [Urn], ISNULL(agstates.primary_replica, '') AS [PrimaryReplicaServerName], ISNULL(arstates2.role, 3) AS [LocalReplicaRole], CAST(ISNULL(AG.is_distributed, 0) AS bit) AS [IsDistributedAvailabilityGroup], ISNULL(AG.cluster_type, 0) AS [ClusterType], CAST(ISNULL(MIL.is_managed_instance_link, 0) & ISNULL(AG.is_distributed, 0) AS bit) AS [IsManagedInstanceLink], CAST(ISNULL(AG.is_contained, 0) AS bit) AS [IsContained] FROM #tmpag_availability_groups AS AG LEFT OUTER JOIN #tmpag_availability_group_states as agstates ON AG.group_id = agstates.group_id INNER JOIN #tmpag_availability_replicas AS AR2 ON AG.group_id = AR2.group_id INNER JOIN #tmpag_availability_replica_states AS arstates2 ON AR2.replica_id = arstates2.replica_id AND arstates2.is_local = 1 LEFT OUTER JOIN #tmp_managed_instance_link AS MIL ON AG.group_id = MIL.group_id ORDER BY [Name] ASC        drop table #tmpag_availability_groups              drop table #tmpag_availability_group_states              drop table #tmpag_availability_replicas       drop table #tmpag_availability_replica_states              drop table #tmp_managed_instance_link      ",13,11,2,100,1,54
select ag.name from sys.availability_groups AS ag INNER JOIN  sys.dm_hadr_availability_replica_states AS ars ON ag.group_id = ars.group_id where ag.is_contained = 1 and ars.is_local = 1 and ars.role = 1,13,10,3,62,0,13
"       select       group_id,       automated_backup_preference AS [BackupPreference],       failure_condition_level,       health_check_timeout,       dtc_support,       db_failover,       is_distributed,       required_synchronized_secondaries_to_commit,       cluster_type,       sequence_number, 	  is_contained       from sys.availability_groups where group_id in       (select group_id from sys.dm_hadr_availability_replica_states WITH(nolock) where is_local = 1 and role = 1)     ",12,10,2,78,0,1150
"         declare @HkeyLocal nvarchar(18)         declare @ServicesRegPath nvarchar(34)         declare @SqlServiceRegPath sysname         declare @BrowserServiceRegPath sysname         declare @MSSqlServerRegPath nvarchar(31)         declare @InstanceNamesRegPath nvarchar(59)         declare @InstanceRegPath sysname         declare @SetupRegPath sysname         declare @NpRegPath sysname         declare @TcpRegPath sysname         declare @RegPathParams sysname         declare @FilestreamRegPath sysname          select @HkeyLocal=N'HKEY_LOCAL_MACHINE'          -- Instance-based paths         select @MSSqlServerRegPath=N'SOFTWARE\Microsoft\MSSQLServer'         select @InstanceRegPath=@MSSqlServerRegPath + N'\MSSQLServer'         select @FilestreamRegPath=@InstanceRegPath + N'\Filestream'         select @SetupRegPath=@MSSqlServerRegPath + N'\Setup'         select @RegPathParams=@InstanceRegPath+'\Parameters'          -- Services         select @ServicesRegPath=N'SYSTEM\CurrentControlSet\Services'         select @SqlServiceRegPath=@ServicesRegPath + N'\MSSQLSERVER'         select @BrowserServiceRegPath=@ServicesRegPath + N'\SQLBrowser'          -- InstanceId setting         select @InstanceNamesRegPath=N'SOFTWARE\Microsoft\Microsoft SQL Server\Instance Names\SQL'          -- Network settings         select @NpRegPath=@InstanceRegPath + N'\SuperSocketNetLib\Np'         select @TcpRegPath=@InstanceRegPath + N'\SuperSocketNetLib\Tcp'                  declare @SmoAuditLevel int         exec master.dbo.xp_instance_regread @HkeyLocal, @InstanceRegPath, N'AuditLevel', @SmoAuditLevel OUTPUT                  declare @NumErrorLogs int         exec master.dbo.xp_instance_regread @HkeyLocal, @InstanceRegPath, N'NumErrorLogs', @NumErrorLogs OUTPUT                  declare @SmoLoginMode int         exec master.dbo.xp_instance_regread @HkeyLocal, @InstanceRegPath, N'LoginMode', @SmoLoginMode OUTPUT                  declare @SmoMailProfile nvarchar(512)         exec master.dbo.xp_instance_regread @HkeyLocal, @InstanceRegPath, N'MailAccountName', @SmoMailProfile OUTPUT                  declare @BackupDirectory nvarchar(512)         if 1=isnull(cast(SERVERPROPERTY('IsLocalDB') as bit), 0)         select @BackupDirectory=cast(SERVERPROPERTY('instancedefaultdatapath') as nvarchar(512))         else         exec master.dbo.xp_instance_regread @HkeyLocal, @InstanceRegPath, N'BackupDirectory', @BackupDirectory OUTPUT                  declare @SmoPerfMonMode int         exec master.dbo.xp_instance_regread @HkeyLocal, @InstanceRegPath, N'Performance', @SmoPerfMonMode OUTPUT          if @SmoPerfMonMode is null         begin         set @SmoPerfMonMode = 1000         end                  declare @InstallSqlDataDir nvarchar(512)         exec master.dbo.xp_instance_regread @HkeyLocal, @SetupRegPath, N'SQLDataRoot', @InstallSqlDataDir OUTPUT                  declare @MasterPath nvarchar(512)         declare @LogPath nvarchar(512)         declare @ErrorLog nvarchar(512)         declare @ErrorLogPath nvarchar(512)         declare @Slash varchar = convert(varchar, serverproperty('PathSeparator'))         select @MasterPath=substring(physical_name, 1, len(physical_name) - charindex(@Slash, reverse(physical_name))) from master.sys.database_files where file_id = 1         select @LogPath=substring(physical_name, 1, len(physical_name) - charindex(@Slash, reverse(physical_name))) from master.sys.database_files where file_id = 2         select @ErrorLog=cast(SERVERPROPERTY(N'errorlogfilename') as nvarchar(512))         select @ErrorLogPath=IIF(@ErrorLog IS NULL, N'', substring(@ErrorLog, 1, len(@ErrorLog) - charindex(@Slash, reverse(@ErrorLog))))                  declare @SmoRoot nvarchar(512)         exec master.dbo.xp_instance_regread @HkeyLocal, @SetupRegPath, N'SQLPath', @SmoRoot OUTPUT                  declare @ServiceStartMode int         EXEC master.sys.xp_instance_regread @HkeyLocal, @SqlServiceRegPath, N'Start', @ServiceStartMode OUTPUT                  declare @ServiceAccount nvarchar(512)         EXEC master.sys.xp_instance_regread @HkeyLocal, @SqlServiceRegPath, N'ObjectName', @ServiceAccount OUTPUT                  declare @NamedPipesEnabled int         exec master.dbo.xp_instance_regread @HkeyLocal, @NpRegPath, N'Enabled', @NamedPipesEnabled OUTPUT                  declare @TcpEnabled int         EXEC master.sys.xp_instance_regread @HkeyLocal, @TcpRegPath, N'Enabled', @TcpEnabled OUTPUT                  declare @InstallSharedDirectory nvarchar(512)         EXEC master.sys.xp_instance_regread @HkeyLocal, @SetupRegPath, N'SQLPath', @InstallSharedDirectory OUTPUT                  declare @SqlGroup nvarchar(512)         exec master.dbo.xp_instance_regread @HkeyLocal, @SetupRegPath, N'SQLGroup', @SqlGroup OUTPUT                  declare @FilestreamLevel int         exec master.dbo.xp_instance_regread @HkeyLocal, @FilestreamRegPath, N'EnableLevel', @FilestreamLevel OUTPUT                  declare @FilestreamShareName nvarchar(512)         exec master.dbo.xp_instance_regread @HkeyLocal, @FilestreamRegPath, N'ShareName', @FilestreamShareName OUTPUT                  declare @cluster_name nvarchar(128)         declare @quorum_type tinyint         declare @quorum_state tinyint         BEGIN TRY         SELECT @cluster_name = cluster_name,         @quorum_type = quorum_type,         @quorum_state = quorum_state         FROM sys.dm_hadr_cluster         END TRY         BEGIN CATCH           IF(ERROR_NUMBER() NOT IN (297,300, 15562, 371))         BEGIN         THROW         END         END CATCH         SELECT @SmoAuditLevel AS [AuditLevel], ISNULL(@NumErrorLogs, -1) AS [NumberOfLogFiles], (case when @SmoLoginMode < 3 then @SmoLoginMode else 9 end) AS [LoginMode], ISNULL(@SmoMailProfile,N'') AS [MailProfile], @BackupDirectory AS [BackupDirectory], @SmoPerfMonMode AS [PerfMonMode], ISNULL(@InstallSqlDataDir,N'') AS [InstallDataDirectory], CAST(@@SERVICENAME AS sysname) AS [ServiceName], @ErrorLogPath AS [ErrorLogPath], @SmoRoot AS [RootDirectory], CAST(case when 'a' <> 'A' then 1 else 0 end AS bit) AS [IsCaseSensitive], @@MAX_PRECISION AS [MaxPrecision], CAST(FULLTEXTSERVICEPROPERTY('IsFullTextInstalled') AS bit) AS [IsFullTextInstalled], SERVERPROPERTY(N'ProductVersion') AS [VersionString], CAST(SERVERPROPERTY(N'Edition') AS sysname) AS [Edition], CAST(SERVERPROPERTY(N'ProductLevel') AS sysname) AS [ProductLevel], CAST(ISNULL(SERVERPROPERTY(N'ProductUpdateLevel'), N'') AS sysname) AS [ProductUpdateLevel], CAST(SERVERPROPERTY('IsSingleUser') AS bit) AS [IsSingleUser], CAST(SERVERPROPERTY('EngineEdition') AS int) AS [EngineEdition], convert(sysname, serverproperty(N'collation')) AS [Collation], CAST(ISNULL(SERVERPROPERTY('IsClustered'), 0) AS bit) AS [IsClustered], CAST(ISNULL(SERVERPROPERTY(N'MachineName'), N'') AS sysname) AS [NetName], ISNULL(SERVERPROPERTY(N'ComputerNamePhysicalNetBIOS'),N'') AS [ComputerNamePhysicalNetBIOS], ISNULL(@ServiceStartMode,2) AS [ServiceStartMode], @LogPath AS [MasterDBLogPath], @MasterPath AS [MasterDBPath], SERVERPROPERTY('instancedefaultdatapath') AS [DefaultFile], SERVERPROPERTY('instancedefaultlogpath') AS [DefaultLog], SERVERPROPERTY(N'ResourceVersion') AS [ResourceVersionString], SERVERPROPERTY(N'ResourceLastUpdateDateTime') AS [ResourceLastUpdateDateTime], SERVERPROPERTY(N'CollationID') AS [CollationID], SERVERPROPERTY(N'ComparisonStyle') AS [ComparisonStyle], SERVERPROPERTY(N'SqlCharSet') AS [SqlCharSet], SERVERPROPERTY(N'SqlCharSetName') AS [SqlCharSetName], SERVERPROPERTY(N'SqlSortOrder') AS [SqlSortOrder], SERVERPROPERTY(N'SqlSortOrderName') AS [SqlSortOrderName], SERVERPROPERTY(N'BuildClrVersion') AS [BuildClrVersionString], ISNULL(@ServiceAccount,N'') AS [ServiceAccount], CAST(@NamedPipesEnabled AS bit) AS [NamedPipesEnabled], CAST(@TcpEnabled AS bit) AS [TcpEnabled], ISNULL(@InstallSharedDirectory,N'') AS [InstallSharedDirectory], ISNULL(suser_sname(sid_binary(ISNULL(@SqlGroup,N''))),N'') AS [SqlDomainGroup], case when 1=msdb.dbo.fn_syspolicy_is_automation_enabled() and exists (select * from msdb.dbo.syspolicy_system_health_state  where target_query_expression_with_id like 'Server%' ) then 1 else 0 end AS [PolicyHealthState], @FilestreamLevel AS [FilestreamLevel], ISNULL(@FilestreamShareName,N'') AS [FilestreamShareName], -1 AS [TapeLoadWaitTime], CAST(SERVERPROPERTY(N'IsHadrEnabled') AS bit) AS [IsHadrEnabled], SERVERPROPERTY(N'HADRManagerStatus') AS [HadrManagerStatus], ISNULL(@cluster_name, '') AS [ClusterName], ISNULL(@quorum_type, 4) AS [ClusterQuorumType], ISNULL(@quorum_state, 3) AS [ClusterQuorumState], SUSER_SID(@ServiceAccount, 0) AS [ServiceAccountSid], CAST(SERVERPROPERTY('IsPolyBaseInstalled') AS bit) AS [IsPolyBaseInstalled], CAST(         serverproperty(N'Servername')        AS sysname) AS [Name], CAST(         ISNULL(serverproperty(N'instancename'),N'')        AS sysname) AS [InstanceName], CAST(0x0001 AS int) AS [Status], SERVERPROPERTY('PathSeparator') AS [PathSeparator], 0 AS [IsContainedAuthentication], CAST(null AS int) AS [ServerType]",12,11,1,0,0,96
"       SELECT quorum_type_desc FROM [sys].[dm_hadr_cluster]     ",11,11,0,0,0,1074
"CREATE   PROCEDURE sp_sqlagent_has_server_access   @login_name         sysname = NULL,   @job_id             uniqueidentifier = NULL, -- if this is not null, @login_name will be ignored!   @is_sysadmin_member INT     = NULL OUTPUT AS BEGIN   DECLARE @has_server_access BIT   DECLARE @is_sysadmin       BIT   DECLARE @actual_login_name sysname   -- Set only when login_name is actually found. It will be zero when @actual_login_name is (unknown).   DECLARE @login_found BIT   DECLARE @cachedate         DATETIME    SET NOCOUNT ON    SELECT @cachedate = NULL    -- remove expired entries from the cache   DELETE msdb.dbo.syscachedcredentials   WHERE  DATEDIFF(MINUTE, cachedate, GETDATE()) >= 29    -- query the cache   SELECT  @is_sysadmin = is_sysadmin_member,           @has_server_access = has_server_access,           @cachedate = cachedate   FROM    msdb.dbo.syscachedcredentials   WHERE   login_name = @login_name   AND     DATEDIFF(MINUTE, cachedate, GETDATE()) < 29    IF (@cachedate IS NOT NULL)   BEGIN     -- no output variable     IF (@is_sysadmin_member IS NULL)     BEGIN       -- Return result row       SELECT has_server_access = @has_server_access,              is_sysadmin       = @is_sysadmin,              actual_login_name = @login_name       RETURN     END     ELSE     BEGIN       SELECT @is_sysadmin_member = @is_sysadmin       RETURN     END   END -- select from cache    -- Set defaults   SELECT @has_server_access = 0   SELECT @is_sysadmin = 0   SELECT @actual_login_name = FORMATMESSAGE(14205)   SELECT @login_found = 0      -- If @job_id was set, get the current name associated with the job owner sid.   if (@job_id IS NOT NULL)   BEGIN 	SELECT @login_name = dbo.SQLAGENT_SUSER_SNAME(owner_sid) 	FROM msdb.dbo.sysjobs_view 	WHERE @job_id = job_id      -- If the job_id is invalid, return error     IF (@login_name IS NULL)     BEGIN       RETURN 1;     END    END   IF (@login_name IS NULL)   BEGIN     SELECT has_server_access = 1,            is_sysadmin       = IS_SRVROLEMEMBER(N'sysadmin'),            actual_login_name = SUSER_SNAME()     RETURN   END    IF (@login_name LIKE '%\%')   BEGIN     -- Handle the LocalSystem account ('NT AUTHORITY\SYSTEM') as a special case     IF (UPPER(@login_name collate SQL_Latin1_General_CP1_CS_AS) = N'NT AUTHORITY\SYSTEM')     BEGIN       IF (EXISTS (SELECT *                   FROM master.dbo.syslogins                   WHERE (UPPER(loginname collate SQL_Latin1_General_CP1_CS_AS) = N'NT AUTHORITY\SYSTEM')))       BEGIN         SELECT @has_server_access = hasaccess,                @is_sysadmin = sysadmin,                @actual_login_name = loginname         FROM master.dbo.syslogins         WHERE (UPPER(loginname collate SQL_Latin1_General_CP1_CS_AS) = N'NT AUTHORITY\SYSTEM')          SET @login_found = 1       END       ELSE       IF (EXISTS (SELECT *                   FROM master.dbo.syslogins                   WHERE (UPPER(loginname collate SQL_Latin1_General_CP1_CS_AS) = N'BUILTIN\ADMINISTRATORS')))       BEGIN         SELECT @has_server_access = hasaccess,                @is_sysadmin = sysadmin,                @actual_login_name = loginname         FROM master.dbo.syslogins         WHERE (UPPER(loginname collate SQL_Latin1_General_CP1_CS_AS) = N'BUILTIN\ADMINISTRATORS')          SET @login_found = 1       END     END     ELSE     BEGIN       -- Check if the NT login has been explicitly denied access       IF (EXISTS (SELECT *                   FROM master.dbo.syslogins                   WHERE (loginname = @login_name)                     AND (denylogin = 1)))       BEGIN         SELECT @has_server_access = 0,                @is_sysadmin = sysadmin,                @actual_login_name = loginname         FROM master.dbo.syslogins         WHERE (loginname = @login_name)          SET @login_found = 1       END       ELSE       BEGIN         -- declare table variable for storing results         DECLARE @xp_results TABLE         (         account_name      sysname      COLLATE database_default NOT NULL PRIMARY KEY,         type              NVARCHAR(10) COLLATE database_default NOT NULL,         privilege         NVARCHAR(10) COLLATE database_default NOT NULL,         mapped_login_name sysname      COLLATE database_default NOT NULL,         permission_path   sysname      COLLATE database_default NULL         )          -- Call xp_logininfo to determine server access         INSERT INTO @xp_results         EXECUTE master.dbo.xp_logininfo @login_name          IF (SELECT COUNT(*) FROM @xp_results) > 0         BEGIN           SET @has_server_access = 1           SET @login_found = 1         END          SELECT @actual_login_name = mapped_login_name,                @is_sysadmin = CASE UPPER(privilege collate SQL_Latin1_General_CP1_CS_AS)                                 WHEN 'ADMIN' THEN 1                                 ELSE 0                              END         FROM @xp_results       END     END     -- Only cache the NT logins to approximate the behavior of Sql Server and Windows (see bug 323287)     -- update the cache only if something is found     IF  (UPPER(@actual_login_name collate SQL_Latin1_General_CP1_CS_AS) <> '(UNKNOWN)')     BEGIN       -- Procedure starts its own transaction.       BEGIN TRANSACTION;        -- Modify database.       -- use a try catch login to prevent any error when trying       -- to insert/update syscachedcredentials table       -- no need to fail since the job owner has been validated       BEGIN TRY         IF EXISTS (SELECT * FROM msdb.dbo.syscachedcredentials WITH (TABLOCKX) WHERE login_name = @login_name)         BEGIN           UPDATE msdb.dbo.syscachedcredentials           SET    has_server_access = @has_server_access,                 is_sysadmin_member = @is_sysadmin,                 cachedate = GETDATE()           WHERE  login_name = @login_name         END         ELSE         BEGIN           INSERT INTO msdb.dbo.syscachedcredentials(login_name, has_server_access, is_sysadmin_member)           VALUES(@login_name, @has_server_access, @is_sysadmin)         END         END TRY         BEGIN CATCH             -- If an error occurred we want to ignore it         END CATCH          -- The procedure must commit the transaction it started.         COMMIT TRANSACTION;     END    END   ELSE   BEGIN     -- Standard login     IF (EXISTS (SELECT *                 FROM master.dbo.syslogins                 WHERE (loginname = @login_name)))     BEGIN       SELECT @has_server_access = hasaccess,              @is_sysadmin = sysadmin,              @actual_login_name = loginname       FROM master.dbo.syslogins       WHERE (loginname = @login_name)        SET @login_found = 1     END   END    IF (@is_sysadmin_member IS NULL)     -- Return result row     SELECT has_server_access = @has_server_access,            is_sysadmin       = @is_sysadmin,            actual_login_name = @actual_login_name,            login_found       = @login_found   ELSE     -- output variable only     SELECT @is_sysadmin_member = @is_sysadmin END ",11,10,1,140,0,25728
"       SELECT       ISNULL(sum(memory_allocated_for_table_kb+memory_allocated_for_indexes_kb) ,0) AS total_memory_allocated_for_user_data_kb, db_id() AS database_id       FROM sys.dm_db_xtp_table_memory_stats WITH(nolock)     ",10,5,5,19,0,974
"SELECT     DB_NAME (database_id) as [Database Name],     name as [Database File Name],     [Type] = CASE WHEN Type_Desc = 'ROWS' THEN 'Data File(s)'             WHEN Type_Desc = 'LOG'  THEN 'Log File(s)'             ELSE Type_Desc END,     size*8/1024 as 'Size (MB)',     physical_name as [Database_File_Location] FROM sys.master_files ORDER BY 1,3  IF OBJECT_ID('tempdb.dbo.#space') IS NOT NULL     DROP TABLE #space  CREATE TABLE #space (       database_id INT PRIMARY KEY     , data_used_size DECIMAL(18,2)     , log_used_size DECIMAL(18,2) )  DECLARE @SQL NVARCHAR(MAX)  SELECT @SQL = STUFF((     SELECT '     USE [' + d.name + ']     INSERT INTO #space (database_id, data_used_size, log_used_size)     SELECT           DB_ID()         , SUM(CASE WHEN [type] = 0 THEN space_used END)         , SUM(CASE WHEN [type] = 1 THEN space_used END)     FROM (         SELECT s.[type], space_used = SUM(FILEPROPERTY(s.name, ''SpaceUsed'') * 8. / 1024)         FROM sys.database_files s         GROUP BY s.[type]     ) t;'     FROM sys.databases d     WHERE d.[state] = 0     FOR XML PATH(''), TYPE).value('.', 'NVARCHAR(MAX)'), 1, 2, '')  EXEC sys.sp_executesql @SQL  SELECT       d.database_id     , d.name     , d.state_desc     , d.recovery_model_desc     , t.total_size     , t.data_size     , s.data_used_size     , t.log_size     , s.log_used_size     , bu.full_last_date     , bu.full_size     , bu.log_last_date     , bu.log_size FROM (     SELECT           database_id         , log_size = CAST(SUM(CASE WHEN [type] = 1 THEN size END) * 8. / 1024 AS DECIMAL(18,2))         , data_size = CAST(SUM(CASE WHEN [type] = 0 THEN size END) * 8. / 1024 AS DECIMAL(18,2))         , total_size = CAST(SUM(size) * 8. / 1024 AS DECIMAL(18,2))     FROM sys.master_files     GROUP BY database_id ) t JOIN sys.databases d ON d.database_id = t.database_id LEFT JOIN #space s ON d.database_id = s.database_id LEFT JOIN (     SELECT           database_name         , full_last_date = MAX(CASE WHEN [type] = 'D' THEN backup_finish_date END)         , full_size = MAX(CASE WHEN [type] = 'D' THEN backup_size END)         , log_last_date = MAX(CASE WHEN [type] = 'L' THEN backup_finish_date END)         , log_size = MAX(CASE WHEN [type] = 'L' THEN backup_size END)     FROM (         SELECT               s.database_name             , s.[type]             , s.backup_finish_date             , backup_size =                         CAST(CASE WHEN s.backup_size = s.compressed_backup_size                                     THEN s.backup_size                                     ELSE s.compressed_backup_size                         END / 1048576.0 AS DECIMAL(18,2))             , RowNum = ROW_NUMBER() OVER (PARTITION BY s.database_name, s.[type] ORDER BY s.backup_finish_date DESC)         FROM msdb.dbo.backupset s         WHERE s.[type] IN ('D', 'L')     ) f     WHERE f.RowNum = 1     GROUP BY f.database_name ) bu ON d.name = bu.database_name ORDER BY t.total_size DESC  SELECT      req.session_id     , req.total_elapsed_time AS duration_ms     , req.cpu_time AS cpu_time_ms     , req.total_elapsed_time - req.cpu_time AS wait_time     , req.logical_reads     , SUBSTRING (REPLACE (REPLACE (SUBSTRING (ST.text, (req.statement_start_offset/2) + 1,         ((CASE statement_end_offset            WHEN -1            THEN DATALENGTH(ST.text)              ELSE req.statement_end_offset          END - req.statement_start_offset)/2) + 1) , CHAR(10), ' '), CHAR(13), ' '),        1, 512)  AS statement_text   FROM sys.dm_exec_requests AS req     CROSS APPLY sys.dm_exec_sql_text(req.sql_handle) AS ST ORDER BY total_elapsed_time DESC;  SELECT top 100 t.text,      (qs.total_elapsed_time/1000) / qs.execution_count AS avg_elapsed_time,      (qs.total_worker_time/1000) / qs.execution_count AS avg_cpu_time,      ((qs.total_elapsed_time/1000) / qs.execution_count ) - ((qs.total_worker_time/1000) / qs.execution_count) AS avg_wait_time,      qs.total_logical_reads / qs.execution_count AS avg_logical_reads,      qs.total_logical_writes / qs.execution_count AS avg_writes,      (qs.total_elapsed_time/1000) AS cumulative_elapsed_time_all_executions FROM sys.dm_exec_query_stats qs      CROSS apply sys.Dm_exec_sql_text (sql_handle) t -- WHERE t.text like '<Your Query>%' -- Replace <Your Query> with your query or the beginning part of your query. The special chars like '[','_','%','^' in the query should be escaped. ORDER BY (qs.total_elapsed_time / qs.execution_count) DESC  --Deadlock sql check SELECT     session_id,     start_time,      [status],     command,     blocking_session_id,     wait_type,     wait_time,     open_transaction_count,     transaction_id,     total_elapsed_time,     Definition = CAST(text AS VARCHAR(MAX)) FROM     SYS.DM_EXEC_REQUESTS     CROSS APPLY sys.dm_exec_sql_text(sql_handle)  WHERE blocking_session_id != 0   ",10,10,0,777,0,10
" ------------------------------- xp_logininfo ----------------------------------  create procedure sys.xp_logininfo 	@acctname		sysname = null,				-- IN: NT login name 	@option			varchar(10) = null,			-- IN: 'all' | 'members' | null 	@privilege		varchar(10) = 'Not wanted' OUTPUT	-- OUT: 'admin' | 'user' | null as 	set nocount on  	declare @ret		int  	-- VALIDATE PARAMETERS -- 	if (@acctname is null AND (@option is not null OR (@privilege is null OR @privilege <> 'Not wanted'))) 		OR ((@option is null OR @option <> 'all') AND (@privilege is null OR @privilege <> 'Not wanted')) 		OR (@option is not null and @option not in ('all', 'members')) 	begin         raiserror(15600,-1,-1,'sys.xp_logininfo')         return 1 	end   	-- HANDLE case where NO @acctname GIVEN -- 	if (@acctname is null) 	begin 		select	'account name' = loginname, 				'type' = convert(varchar(8), case when isntuser = 1 then 'user' else 'group' end), 				'privilege' = convert(varchar(8), case when sysadmin = 1 then 'admin' else 'user' end), 				'mapped login name' = loginname, 				'permission path' = convert(sysname, null) 		from master..syslogins where isntname = 1 and hasaccess = 1 		order by 3, 1 		return @@error 	end  	-- HANDLE 'members' QUERY -- 	if (@option = 'members') 	begin 		declare @priv varchar(8) 		select @priv = case when sysadmin = 1 then 'admin' else 'user' end 			from master..syslogins where isntname = 1 and loginname = @acctname and hasaccess = 1 		if @priv is not null 			select	'account name' = domain+N'\'+name, 					'type' = convert(varchar(8), case when sidtype = 1 then 'user' else 'group' end), 					'privilege' = @priv, 					'mapped login name' = domain+N'\'+name, 					'permission path' = @acctname 			from OpenRowset(TABLE NETGROUPGETMEMBERS, @acctname) order by 3, 1 		else 			select	'account name' = convert(sysname, null), 					'type' = convert(varchar(8), null), 					'privilege' = @priv, 					'mapped login name' = convert(sysname, null), 					'permission path' = convert(sysname, null) 			where 0=1	-- empty result set 		return @@error 	end   	-- CREATE TEMP TABLE AND POPULATE WITH THE REQUIRED DATA -- 	CREATE TABLE #nt (name sysname collate catalog_default, sid varbinary(85), sidtype int) 	insert #nt select loginname, sid, isntgroup + 1 from master..syslogins 			where isntname = 1 and loginname = @acctname 	insert #nt select distinct domain+N'\'+name, sid, sidtype 			from OpenRowset(TABLE NETUSERGETGROUPS, @acctname) 	select @ret = @@error 	if @ret <> 0 		return @ret 	-- IF ANY DENY, THEN NO ACCESS -- 	if exists (select * from master..syslogins where sid in (select #nt.sid from #nt) and denylogin = 1) 		delete #nt   	-- HANDLE case where OUTPUT REQUESTED -- 	if (@privilege is null OR @privilege <> 'Not wanted') 	begin 		select @privilege = case max(sysadmin) 			when 1 then 'admin' 			when 0 then 'user' 			else NULL end 		from master..syslogins where isntname = 1 and hasaccess = 1 			AND sid in (select sid from #nt) 		return @@error 	end   	-- GET NT TYPE FOR NEXT OPTIONS -- 	declare @type varchar(8) 	select @type = case when get_sid('\U'+@acctname) is null then 'group' else 'user' end  	-- HANDLE 'all' QUERY -- 	if (@option = 'all') 	begin 		select	'account name' = @acctname, 				'type' = @type, 				'privilege' = convert(varchar(8), case when sysadmin = 1 then 'admin' else 'user' end), 				'mapped login name' = @acctname, 				'permission path' = case when l.loginname = @acctname then NULL else l.loginname end 		from master..syslogins l join #nt n on l.isntname = 1 and l.sid = n.sid 		where l.loginname = n.name and hasaccess = 1 		order by 3, 5 		return @@error 	end   	-- HANDLE DEFAULT QUERY -- 	select	TOP 1 			'account name' = @acctname, 			'type' = @type, 			'privilege' = convert(varchar(8), case when sysadmin = 1 then 'admin' else 'user' end), 			'mapped login name' = @acctname, 			'permission path' = case when l.loginname = @acctname then NULL else l.loginname end 	from master..syslogins l join #nt n on l.isntname = 1 and l.sid = n.sid 	where l.loginname = n.name and hasaccess = 1 	order by 3, 5 	return @@error ",10,9,1,11,0,22187
"       select * into #tmpag_availability_groups from master.sys.availability_groups              select agstates.group_id, agstates.primary_replica into #tmpag_availability_group_states from master.sys.dm_hadr_availability_group_states as agstates              select group_id, replica_id, replica_metadata_id into #tmpag_availability_replicas from master.sys.availability_replicas       select replica_id, is_local, role into #tmpag_availability_replica_states from master.sys.dm_hadr_availability_replica_states                select TMIL.group_id, count(*) as is_managed_instance_link into #tmp_managed_instance_link from sys.availability_replicas AS TMIL where TMIL.endpoint_url LIKE '%Server=%' and (select count(*) from sys.availability_replicas as A1 where A1.group_id = TMIL.group_id) = 2 group by TMIL.group_id having count(*) = 1        SELECT AG.name AS [Name], 'Server[@Name=' + quotename(CAST(         serverproperty(N'Servername')        AS sysname),'''') + ']' + '/AvailabilityGroup[@Name=' + quotename(AG.name,'''') + ']' AS [Urn], ISNULL(agstates.primary_replica, '') AS [PrimaryReplicaServerName], ISNULL(arstates2.role, 3) AS [LocalReplicaRole], CAST(ISNULL(AG.is_distributed, 0) AS bit) AS [IsDistributedAvailabilityGroup], ISNULL(AG.cluster_type, 0) AS [ClusterType], CAST(ISNULL(MIL.is_managed_instance_link, 0) & ISNULL(AG.is_distributed, 0) AS bit) AS [IsManagedInstanceLink], CAST(ISNULL(AG.is_contained, 0) AS bit) AS [IsContained] FROM #tmpag_availability_groups AS AG LEFT OUTER JOIN #tmpag_availability_group_states as agstates ON AG.group_id = agstates.group_id INNER JOIN #tmpag_availability_replicas AS AR2 ON AG.group_id = AR2.group_id INNER JOIN #tmpag_availability_replica_states AS arstates2 ON AR2.replica_id = arstates2.replica_id AND arstates2.is_local = 1 LEFT OUTER JOIN #tmp_managed_instance_link AS MIL ON AG.group_id = MIL.group_id ORDER BY [Name] ASC        drop table #tmpag_availability_groups              drop table #tmpag_availability_group_states              drop table #tmpag_availability_replicas       drop table #tmpag_availability_replica_states              drop table #tmp_managed_instance_link      ",9,8,1,174,1,38
"(@_msparam_0 nvarchar(4000))       select * into #tmpag_availability_groups from master.sys.availability_groups                 select group_id, replica_id, replica_server_name,create_date, modify_date, endpoint_url, read_only_routing_url, primary_role_allow_connections, secondary_role_allow_connections, availability_mode,failover_mode, session_timeout, backup_priority, owner_sid, seeding_mode into #tmpar_availability_replicas from master.sys.availability_replicas                select group_id, replica_id, role,operational_state,recovery_health,synchronization_health,connected_state, last_connect_error_number,last_connect_error_description, last_connect_error_timestamp into #tmpar_availability_replica_states from master.sys.dm_hadr_availability_replica_states              select * into #tmpar_ags from master.sys.dm_hadr_availability_group_states       select ar.group_id, ar.replica_id, ar.replica_server_name, ar.availability_mode, (case when UPPER(ags.primary_replica) = UPPER(ar.replica_server_name) then 1 else 0 end) as role, ars.synchronization_health into #tmpar_availabilty_mode from #tmpar_availability_replicas as ar       left join #tmpar_ags as ags on ags.group_id = ar.group_id       left join #tmpar_availability_replica_states as ars on ar.group_id = ars.group_id and ar.replica_id = ars.replica_id       select am1.replica_id, am1.role, (case when (am1.synchronization_health is null) then 3 else am1.synchronization_health end) as sync_state, (case when (am1.availability_mode is NULL) or (am3.availability_mode is NULL) then null when (am1.role = 1) then 1 when (am1.availability_mode = 0 or am3.availability_mode = 0) then 0 else 1 end) as effective_availability_mode       into #tmpar_replica_rollupstate from #tmpar_availabilty_mode as am1 left join (select group_id, role, availability_mode from #tmpar_availabilty_mode as am2 where am2.role = 1) as am3 on am1.group_id = am3.group_id       drop table #tmpar_availabilty_mode       drop table #tmpar_ags              select replica_id,join_state into #tmpar_availability_replica_cluster_states from master.sys.dm_hadr_availability_replica_cluster_states        SELECT AR.replica_server_name AS [Name], 'Server[@Name=' + quotename(CAST(         serverproperty(N'Servername')        AS sysname),'''') + ']' + '/AvailabilityGroup[@Name=' + quotename(AG.name,'''') + ']' + '/AvailabilityReplica[@Name=' + quotename(AR.replica_server_name,'''') + ']' AS [Urn], ISNULL(arstates.role, 3) AS [Role], ISNULL(AR.primary_role_allow_connections, 4) AS [ConnectionModeInPrimaryRole], ISNULL(AR.secondary_role_allow_connections, 3) AS [ConnectionModeInSecondaryRole], ISNULL(arstates.connected_state, 2) AS [ConnectionState], (case when arrollupstates.sync_state = 3 then 3 when (arrollupstates.effective_availability_mode = 1 or arrollupstates.role = 1) then arrollupstates.sync_state when arrollupstates.sync_state = 2 then 1 else 0 end) AS [RollupSynchronizationState], ISNULL(arcs.join_state, 99) AS [JoinState] FROM #tmpag_availability_groups AS AG INNER JOIN #tmpar_availability_replicas AS AR ON (AR.replica_server_name IS NOT NULL) AND (AR.group_id=AG.group_id) LEFT OUTER JOIN #tmpar_availability_replica_states AS arstates ON AR.replica_id = arstates.replica_id LEFT OUTER JOIN #tmpar_replica_rollupstate AS arrollupstates ON AR.replica_id = arrollupstates.replica_id LEFT OUTER JOIN #tmpar_availability_replica_cluster_states AS arcs ON AR.replica_id = arcs.replica_id WHERE (AG.name=@_msparam_0) ORDER BY [Name] ASC        DROP TABLE #tmpar_availability_replicas              DROP TABLE #tmpar_availability_replica_states              DROP TABLE #tmpar_replica_rollupstate              DROP TABLE #tmpar_availability_replica_cluster_states              drop table #tmpag_availability_groups       ",9,8,1,179,1,38
"(@_msparam_0 nvarchar(4000))       select * into #tmpag_availability_groups from master.sys.availability_groups        SELECT AGL.dns_name AS [Name], 'Server[@Name=' + quotename(CAST(         serverproperty(N'Servername')        AS sysname),'''') + ']' + '/AvailabilityGroup[@Name=' + quotename(AG.name,'''') + ']' + '/AvailabilityGroupListener[@Name=' + quotename(AGL.dns_name,'''') + ']' AS [Urn], ISNULL(AGL.port, -1) AS [PortNumber], AGL.is_conformant AS [IsConformant], ISNULL(AGL.ip_configuration_string_from_cluster, N'') AS [ClusterIPConfiguration] FROM #tmpag_availability_groups AS AG INNER JOIN master.sys.availability_group_listeners AS AGL ON AGL.group_id=AG.group_id WHERE (AG.name=@_msparam_0) ORDER BY [Name] ASC        drop table #tmpag_availability_groups       ",9,7,2,191,0,9
"(@_msparam_0 nvarchar(4000))       select * into #tmpag_availability_groups from master.sys.availability_groups               select replica_id, group_id into #tmpardb_availability_replicas from master.sys.availability_replicas              select replica_id, group_database_id, database_name,is_database_joined,is_failover_ready,is_pending_secondary_suspend,recovery_lsn,truncation_lsn into #tmpardb_database_replica_cluster_states from master.sys.dm_hadr_database_replica_cluster_states              select replica_id, is_local into #tmpardb_availability_replica_states from master.sys.dm_hadr_availability_replica_states              select replica_id, group_database_id,synchronization_state, is_suspended into #tmpardb_database_replica_states from master.sys.dm_hadr_database_replica_states        SELECT dbcs.database_name AS [Name], 'Server[@Name=' + quotename(CAST(         serverproperty(N'Servername')        AS sysname),'''') + ']' + '/AvailabilityGroup[@Name=' + quotename(AG.name,'''') + ']' + '/AvailabilityDatabase[@Name=' + quotename(dbcs.database_name,'''') + ']' AS [Urn], ISNULL(dbrs.synchronization_state, 0) AS [SynchronizationState], ISNULL(dbrs.is_suspended, 0) AS [IsSuspended], ISNULL(dbcs.is_database_joined, 0) AS [IsJoined] FROM #tmpag_availability_groups AS AG INNER JOIN #tmpardb_availability_replicas AS AR ON AR.group_id=AG.group_id INNER JOIN #tmpardb_availability_replica_states AS arstates ON AR.replica_id = arstates.replica_id AND arstates.is_local = 1 INNER JOIN #tmpardb_database_replica_cluster_states AS dbcs ON arstates.replica_id = dbcs.replica_id LEFT OUTER JOIN #tmpardb_database_replica_states AS dbrs ON dbcs.replica_id = dbrs.replica_id AND dbcs.group_database_id = dbrs.group_database_id WHERE (AG.name=@_msparam_0) ORDER BY [Name] ASC        DROP TABLE #tmpardb_availability_replicas              DROP TABLE #tmpardb_database_replica_cluster_states              DROP TABLE #tmpardb_availability_replica_states              DROP TABLE #tmpardb_database_replica_states              drop table #tmpag_availability_groups       ",9,7,2,192,0,9
"()           select           (select count(*) from sys.traces) as running_traces,           (select count(*) from sys.databases) as number_of_databases,           (select count(*) from sys.dm_db_missing_index_group_stats) as missing_index_count,           (select waiting_tasks_count from sys.dm_os_wait_stats where wait_type = N'SQLCLR_QUANTUM_PUNISHMENT') as clr_quantum_waits,           (select count(*) from sys.dm_os_ring_buffers where ring_buffer_type = N'RING_BUFFER_SCHEDULER_MONITOR' and record like N'%NonYieldSchedBegin%') as non_yield_count,           (select cpu_count from sys.dm_os_sys_info) as number_of_cpus,           (select scheduler_count from sys.dm_os_sys_info) as number_of_schedulers,           (select COUNT(*) from sys.dm_xe_sessions) as number_of_xevent_sessions",9,9,0,44,0,9
"(@_msparam_0 nvarchar(4000))SELECT SCHEMA_NAME(v.schema_id) AS [Schema], v.name AS [Name], v.object_id AS [ID] FROM sys.all_views AS v WHERE (v.type = @_msparam_0) ORDER BY [Schema] ASC,[Name] ASC",8,6,2,72,0,44
"       select count(*) as AgsWithDtcSupportOn       from sys.availability_groups WITH(nolock) where dtc_support = 1 and group_id in       (select group_id from sys.dm_hadr_availability_replica_states WITH(nolock) where is_local = 1 and role = 1)     ",8,7,1,40,0,782
"       select COUNT_BIG(*) as [NumAGinServer] from sys.availability_groups WITH(nolock)     ",8,6,2,40,0,737
" 			create table #tmp_sp_help_category 			(category_id int null, category_type tinyint null, name nvarchar(128) null) 			insert into #tmp_sp_help_category exec msdb.dbo.sp_help_category 		   SELECT sv.name AS [Name], 'Server[@Name=' + quotename(CAST(         serverproperty(N'Servername')        AS sysname),'''') + ']' + '/JobServer' + '/Job[@Name=' + quotename(sv.name,'''') + ' and @CategoryID=' + quotename(sv.category_id,'''') + ']' AS [Urn], CAST(sv.enabled AS bit) AS [IsEnabled], null AS [CurrentRunStatus], tshc.category_type AS [CategoryType], sv.category_id AS [CategoryID], CAST(sv.job_id AS nvarchar(100)) AS [job_id] FROM msdb.dbo.sysjobs_view AS sv INNER JOIN #tmp_sp_help_category AS tshc ON sv.category_id = tshc.category_id ORDER BY [Name] ASC  drop table #tmp_sp_help_category 		 ",7,6,1,205,2,7
"CREATE   PROCEDURE sp_sqlagent_refresh_job   @job_id      UNIQUEIDENTIFIER = NULL,   @server_name sysname          = NULL -- This parameter allows a TSX to use this SP when updating a job AS BEGIN   DECLARE @server_id INT    SET NOCOUNT ON    IF (@server_name IS NULL) OR (UPPER(@server_name collate SQL_Latin1_General_CP1_CS_AS) = '(LOCAL)')     SELECT @server_name = CONVERT(sysname, SERVERPROPERTY('ServerName'))    SELECT @server_name = UPPER(@server_name)    SELECT @server_id = server_id   FROM msdb.dbo.systargetservers_view   WHERE (UPPER(server_name) = ISNULL(@server_name, UPPER(CONVERT(sysname, SERVERPROPERTY('ServerName')))))    SELECT @server_id = ISNULL(@server_id, 0)    SELECT sjv.job_id,          sjv.name COLLATE SQL_Latin1_General_CP1_CI_AS,          sjv.enabled,          sjv.start_step_id,          owner = dbo.SQLAGENT_SUSER_SNAME(sjv.owner_sid),          sjv.notify_level_eventlog,          sjv.notify_level_email,          sjv.notify_level_netsend,          sjv.notify_level_page,          sjv.notify_email_operator_id,          sjv.notify_netsend_operator_id,          sjv.notify_page_operator_id,          sjv.delete_level,          has_step = (SELECT COUNT(*)                      FROM msdb.dbo.sysjobsteps sjst                      WHERE (sjst.job_id = sjv.job_id)),          sjv.version_number,          last_run_date = ISNULL(sjs.last_run_date, 0),          last_run_time = ISNULL(sjs.last_run_time, 0),          sjv.originating_server,          sjv.description COLLATE SQL_Latin1_General_CP1_CI_AS,          agent_account = CASE sjv.owner_sid               WHEN 0xFFFFFFFF THEN 1               ELSE                 0          END, 		 0 AS is_system   FROM msdb.dbo.sysjobservers sjs,        msdb.dbo.sysjobs_view  sjv   WHERE ((@job_id IS NULL) OR (@job_id = sjv.job_id))     AND (sjv.job_id = sjs.job_id)     AND (sjs.server_id = @server_id)   UNION   SELECT 	job_id, 	name COLLATE SQL_Latin1_General_CP1_CI_AS, 	enabled, 	start_step_id, 	dbo.SQLAGENT_SUSER_SNAME(0x01) AS [owner], 	notify_level_eventlog, 	0 AS notify_level_email,          -- notify_level_email 	0 AS notify_level_netsend,        -- notify_level_netsend 	0 AS notify_level_page,           -- notify_level_page 	0 AS notify_email_operator_id,    -- notify_email_operator_id 	0 AS notify_netsend_operator_id,  -- notify_netsend_operator_id 	0 AS notify_page_operator_id,     -- notify_page_operator_id 	delete_level, 	has_step = (SELECT COUNT(*)                      FROM sys.fn_sqlagent_jobsteps(j.job_id, NULL) js                      ), 	0 AS version_number,				-- version_number 	0 AS last_run_date, 	0 AS last_run_time, 	@server_name AS originating_server, 	description COLLATE SQL_Latin1_General_CP1_CI_AS, 	0 AS agent_account, 	1 AS is_system   FROM sys.fn_sqlagent_jobs(NULL) j   WHERE ((@job_id IS NULL) OR (@job_id = j.job_id))    RETURN(@@error) -- 0 means success END ",7,6,1,238,0,7
"           create table #SVer(ID int,  Name  sysname, Internal_Value int, Value nvarchar(512))           insert #SVer exec master.dbo.xp_msver           insert #SVer select t.*           from sys.dm_os_host_info           CROSS APPLY (           VALUES           (1001, 'host_platform', 0, host_platform),           (1002, 'host_distribution', 0, host_distribution),           (1003, 'host_release', 0, host_release),           (1004, 'host_service_pack_level', 0, host_service_pack_level),           (1005, 'host_sku', host_sku, ''),           (1006, 'HardwareGeneration', '', ''),           (1007, 'ServiceTier', '', ''),           (1008, 'ReservedStorageSizeMB', '0', '0'),           (1009, 'UsedStorageSizeMB', '0', '0')           ) t(id, [name], internal_value, [value])            -- Managed Instance-specific properties           if (SERVERPROPERTY('EngineEdition') = 8)           begin             DECLARE @gen4memoryPerCoreMB float = 7168.0             DECLARE @gen5memoryPerCoreMB float = 5223.0             DECLARE @physicalMemory float             DECLARE @virtual_core_count int             DECLARE @reservedStorageSize bigint             DECLARE @usedStorageSize decimal(18,2)             DECLARE @hwGeneration nvarchar(128)             DECLARE @serviceTier nvarchar(128)              SET @physicalMemory = (SELECT TOP 1 [virtual_core_count] *               (                 CASE WHEN [hardware_generation] = 'Gen4' THEN @gen4memoryPerCoreMB                 WHEN [hardware_generation] = 'Gen5' THEN @gen5memoryPerCoreMB                 ELSE 0 END                )                FROM master.sys.server_resource_stats                 ORDER BY start_time DESC)                    IF (@physicalMemory <> 0)              BEGIN               UPDATE #SVer SET [Internal_Value] =  @physicalMemory WHERE Name = N'PhysicalMemory'               UPDATE #SVer SET [Value] = CONCAT( @physicalMemory, ' (',  @physicalMemory * 1024, ')') WHERE Name = N'PhysicalMemory'             END              UPDATE #SVer SET [Internal_Value] = (SELECT TOP 1 [virtual_core_count] FROM master.sys.server_resource_stats ORDER BY start_time desc) WHERE Name = N'ProcessorCount'             UPDATE #SVer SET [Value] = [Internal_Value] WHERE Name = N'ProcessorCount'              SELECT TOP 1               @hwGeneration = [hardware_generation],               @serviceTier =[sku],               @virtual_core_count = [virtual_core_count],               @reservedStorageSize = [reserved_storage_mb],               @usedStorageSize = [storage_space_used_mb]             FROM master.sys.server_resource_stats             ORDER BY [start_time] DESC              UPDATE #SVer SET [Value] = @hwGeneration WHERE Name = N'HardwareGeneration'             UPDATE #SVer SET [Value] = @serviceTier WHERE Name = N'ServiceTier'             UPDATE #SVer SET [Value] = @reservedStorageSize WHERE Name = N'ReservedStorageSizeMB'             UPDATE #SVer SET [Value] = @usedStorageSize WHERE Name = N'UsedStorageSizeMB'           end          SELECT CAST(         serverproperty(N'Servername')        AS sysname) AS [Server_Name], 'Server[@Name=' + quotename(CAST(         serverproperty(N'Servername')        AS sysname),'''') + ']' AS [Server_Urn], CAST(null AS int) AS [Server_ServerType], CAST(0x0001 AS int) AS [Server_Status], 0 AS [Server_IsContainedAuthentication], (@@microsoftversion / 0x1000000) & 0xff AS [VersionMajor], (@@microsoftversion / 0x10000) & 0xff AS [VersionMinor], @@microsoftversion & 0xffff AS [BuildNumber], CAST(SERVERPROPERTY('IsSingleUser') AS bit) AS [IsSingleUser], CAST(SERVERPROPERTY(N'Edition') AS sysname) AS [Edition], CAST(SERVERPROPERTY('EngineEdition') AS int) AS [EngineEdition], CAST(ISNULL(SERVERPROPERTY(N'IsXTPSupported'), 0) AS bit) AS [IsXTPSupported], SERVERPROPERTY(N'ProductVersion') AS [VersionString], ( select Value from #SVer where Name =N'host_platform') AS [HostPlatform], CAST(FULLTEXTSERVICEPROPERTY('IsFullTextInstalled') AS bit) AS [IsFullTextInstalled] ORDER BY [Server_Name] ASC          drop table #SVer        ",7,2,5,78,1,74
"(@_msparam_0 nvarchar(4000),@_msparam_1 nvarchar(4000),@_msparam_2 nvarchar(4000),@_msparam_3 nvarchar(4000),@_msparam_4 nvarchar(4000)) create table #tmp_sp_help_jobstep (step_id int null, step_name nvarchar(128) null, subsystem nvarchar(128) collate Latin1_General_CI_AS null, command nvarchar(max) null, flags int null, cmdexec_success_code int null, on_success_action tinyint null, on_success_step_id int null, on_fail_action tinyint null, on_fail_step_id int null, server nvarchar(128) null, database_name sysname null, database_user_name sysname null, retry_attempts int null, retry_interval int null, os_run_priority int null, output_file_name nvarchar(300) null, last_run_outcome int null, last_run_duration int null, last_run_retries int null, last_run_date int null, last_run_time int null, proxy_id int null, job_id uniqueidentifier null)  declare @job_id uniqueidentifier declare crs cursor local fast_forward for ( SELECT sv.job_id AS [JobID] FROM msdb.dbo.sysjobs_view AS sv WHERE (sv.name=@_msparam_0 and sv.category_id=@_msparam_1) )  open crs  fetch crs into @job_id while @@fetch_status >= 0  begin  	insert into #tmp_sp_help_jobstep(step_id, step_name, subsystem, command, flags, cmdexec_success_code, on_success_action, on_success_step_id, on_fail_action, on_fail_step_id, server, database_name, database_user_name, retry_attempts, retry_interval, os_run_priority, output_file_name, last_run_outcome, last_run_duration, last_run_retries, last_run_date, last_run_time, proxy_id)  		exec msdb.dbo.sp_help_jobstep @job_id = @job_id 	update #tmp_sp_help_jobstep set job_id = @job_id where job_id is null 	fetch crs into @job_id end  close crs deallocate crs   create table #tmp_sp_help_proxy (proxy_id int null, name nvarchar(300) null, credential_identity nvarchar(300) null, enabled tinyint null, description nvarchar(max) null, user_sid binary(200) null, credential_id int null, credential_identity_exists int null) insert into #tmp_sp_help_proxy(proxy_id, name, credential_identity, enabled, description, user_sid, credential_id, credential_identity_exists) 		exec msdb.dbo.sp_help_proxy 		   SELECT tshj.step_name AS [Name], tshj.step_id AS [ID], CASE LOWER(tshj.subsystem) when 'tsql' THEN 1 WHEN 'activescripting' THEN 2 WHEN 'cmdexec' THEN 3  WHEN 'snapshot' THEN 4 WHEN 'logreader' THEN 5 WHEN 'distribution' THEN 6  WHEN 'merge' THEN 7 WHEN 'queuereader' THEN 8 WHEN 'analysisquery' THEN 9  WHEN 'analysiscommand' THEN 10 WHEN 'dts' THEN 11 WHEN 'ssis' THEN 11 WHEN 'powershell' THEN 12 ELSE 0 END AS [SubSystem], ISNULL(tshj.command,N'') AS [Command], tshj.cmdexec_success_code AS [CommandExecutionSuccessCode], tshj.on_success_action AS [OnSuccessAction], tshj.on_success_step_id AS [OnSuccessStep], tshj.on_fail_action AS [OnFailAction], tshj.on_fail_step_id AS [OnFailStep], ISNULL(tshj.server,N'') AS [Server], ISNULL(tshj.database_name,N'') AS [DatabaseName], ISNULL(tshj.database_user_name,N'') AS [DatabaseUserName], tshj.retry_attempts AS [RetryAttempts], tshj.retry_interval AS [RetryInterval], tshj.os_run_priority AS [OSRunPriority], ISNULL(tshj.output_file_name,N'') AS [OutputFileName], tshj.last_run_outcome AS [LastRunOutcome], tshj.last_run_duration AS [LastRunDuration], tshj.last_run_retries AS [LastRunRetries], null AS [LastRunDate], tshj.flags AS [JobStepFlags], ISNULL(sp.name,N'') AS [ProxyName], tshj.last_run_date AS [LastRunDateInt], tshj.last_run_time AS [LastRunTimeInt] FROM msdb.dbo.sysjobs_view AS sv INNER JOIN #tmp_sp_help_jobstep AS tshj ON tshj.job_id=sv.job_id LEFT OUTER JOIN #tmp_sp_help_proxy AS sp ON sp.proxy_id = tshj.proxy_id WHERE (tshj.step_name=@_msparam_2)and((sv.name=@_msparam_3 and sv.category_id=@_msparam_4))  drop table #tmp_sp_help_jobstep 		   drop table #tmp_sp_help_proxy 		 ",7,6,1,349,0,14
"(@_msparam_0 nvarchar(4000))SELECT SCHEMA_NAME(v.schema_id) AS [Schema], v.name AS [Name], v.object_id AS [ID] FROM sys.all_views AS v WHERE (v.type = @_msparam_0) ORDER BY [Schema] ASC,[Name] ASC",6,5,1,44,0,6
"(@_msparam_0 nvarchar(4000),@_msparam_1 nvarchar(4000),@_msparam_2 nvarchar(4000),@_msparam_3 nvarchar(4000)) create table #tmp_sp_help_jobschedule (schedule_id int null, schedule_name nvarchar(128) null, enabled int null, freq_type int null, freq_interval int null, freq_subday_type int null, freq_subday_interval int null, freq_relative_interval int null, freq_recurrence_factor int null, active_start_date int null, active_end_date int null, active_start_time int null, active_end_time int null, date_created datetime null, schedule_description nvarchar(4000) null, next_run_date int null, next_run_time int null, schedule_uid uniqueidentifier null,  job_count int null, job_id uniqueidentifier null) declare @job_id sysname declare crs cursor local fast_forward for ( SELECT sv.job_id AS [JobID] FROM msdb.dbo.sysjobs_view AS sv WHERE (sv.name=@_msparam_0 and sv.category_id=@_msparam_1) )  open crs  fetch crs into @job_id while @@fetch_status >= 0  begin  	insert into #tmp_sp_help_jobschedule (schedule_id, schedule_name, enabled, freq_type, freq_interval, freq_subday_type, freq_subday_interval, freq_relative_interval, freq_recurrence_factor, active_start_date, active_end_date, active_start_time, active_end_time, date_created, schedule_description, next_run_date, next_run_time, schedule_uid, job_count)  		exec msdb.dbo.sp_help_jobschedule @job_id = @job_id 	update #tmp_sp_help_jobschedule set job_id = @job_id where job_id is null 	fetch crs into @job_id end  close crs deallocate crs   SELECT tshj.schedule_name AS [Name], tshj.schedule_id AS [ID] FROM msdb.dbo.sysjobs_view AS sv INNER JOIN #tmp_sp_help_jobschedule AS tshj ON tshj.job_id=sv.job_id WHERE (sv.name=@_msparam_2 and sv.category_id=@_msparam_3) ORDER BY [Name] ASC              drop table #tmp_sp_help_jobschedule          ",6,6,0,272,4,13
"declare      @CPU_Usage_Percentage int,      @Total_SQL_Server_Memory_MB int   -- CPU WITH y AS (     SELECT               CONVERT(VARCHAR(5), 100 - ca.c.value('.', 'INT')) AS system_idle,         CONVERT(VARCHAR(30), rb.event_date) AS event_date,         CONVERT(VARCHAR(8000), rb.record) AS record     FROM (            SELECT              CONVERT(XML, dorb.record) AS record,             DATEADD(ms, ( ts.ms_ticks - dorb.timestamp ), GETDATE()) AS event_date         FROM   sys.dm_os_ring_buffers AS dorb             CROSS JOIN (                  SELECT                      dosi.ms_ticks                  FROM sys.dm_os_sys_info AS dosi ) AS ts                 WHERE   dorb.ring_buffer_type = N'RING_BUFFER_SCHEDULER_MONITOR'                         AND record LIKE '%%' ) AS rb             CROSS APPLY rb.record.nodes('/Record/SchedulerMonitorEvent/SystemHealth/SystemIdle') AS ca(c)         )     SELECT @CPU_Usage_Percentage = (select          TOP 1 y.system_idle     FROM y      ORDER BY y.event_date DESC)   -- memory select @Total_SQL_Server_Memory_MB = (select      cntr_value / 1024 from sys.dm_os_performance_counters pc where   [object_name] = 'SQLServer:Memory Manager'         and counter_name = 'Total Server Memory (KB)'                                                                                                         )   select      @CPU_Usage_Percentage           [CPU_Usage_Percentage],      @Total_SQL_Server_Memory_MB     [Total_SQL_Server_Memory_MB]; 	 WITH DB_CPU_Stats AS (SELECT pa.DatabaseID, DB_Name(pa.DatabaseID) AS [Database Name], SUM(qs.total_worker_time/1000) AS [CPU_Time_Ms]  FROM sys.dm_exec_query_stats AS qs WITH (NOLOCK)  CROSS APPLY (SELECT CONVERT(int, value) AS [DatabaseID]               FROM sys.dm_exec_plan_attributes(qs.plan_handle)               WHERE attribute = N'dbid') AS pa  GROUP BY DatabaseID) SELECT ROW_NUMBER() OVER(ORDER BY [CPU_Time_Ms] DESC) AS [CPU Rank],        [Database Name], [CPU_Time_Ms] AS [CPU Time (ms)],        CAST([CPU_Time_Ms] * 1.0 / SUM([CPU_Time_Ms]) OVER() * 100.0 AS DECIMAL(5, 2)) AS [CPU Percent] FROM DB_CPU_Stats WHERE DatabaseID <> 32767 -- ResourceDB ORDER BY [CPU Rank] OPTION (RECOMPILE);   DECLARE @total_buffer INT;  SELECT @total_buffer = cntr_value FROM sys.dm_os_performance_counters  WHERE RTRIM([object_name]) LIKE '%Buffer Manager' AND counter_name = 'Database Pages';  ;WITH src AS (   SELECT    database_id, db_buffer_pages = COUNT_BIG(*)   FROM sys.dm_os_buffer_descriptors   --WHERE database_id BETWEEN 5 AND 32766   GROUP BY database_id ) SELECT [db_name] = CASE [database_id] WHEN 32767  THEN 'Resource DB'  ELSE DB_NAME([database_id]) END, db_buffer_pages, db_buffer_MB = db_buffer_pages / 128, db_buffer_percent = CONVERT(DECIMAL(6,3),  db_buffer_pages * 100.0 / @total_buffer) FROM src ORDER BY db_buffer_MB DESC;  ",6,6,0,16,0,6
"(@_msparam_0 nvarchar(4000))       select * into #tmpag_availability_groups from master.sys.availability_groups                 select group_id, replica_id, replica_server_name,create_date, modify_date, endpoint_url, read_only_routing_url, primary_role_allow_connections, secondary_role_allow_connections, availability_mode,failover_mode, session_timeout, backup_priority, owner_sid, seeding_mode into #tmpar_availability_replicas from master.sys.availability_replicas                select group_id, replica_id, role,operational_state,recovery_health,synchronization_health,connected_state, last_connect_error_number,last_connect_error_description, last_connect_error_timestamp into #tmpar_availability_replica_states from master.sys.dm_hadr_availability_replica_states              select * into #tmpar_ags from master.sys.dm_hadr_availability_group_states       select ar.group_id, ar.replica_id, ar.replica_server_name, ar.availability_mode, (case when UPPER(ags.primary_replica) = UPPER(ar.replica_server_name) then 1 else 0 end) as role, ars.synchronization_health into #tmpar_availabilty_mode from #tmpar_availability_replicas as ar       left join #tmpar_ags as ags on ags.group_id = ar.group_id       left join #tmpar_availability_replica_states as ars on ar.group_id = ars.group_id and ar.replica_id = ars.replica_id       select am1.replica_id, am1.role, (case when (am1.synchronization_health is null) then 3 else am1.synchronization_health end) as sync_state, (case when (am1.availability_mode is NULL) or (am3.availability_mode is NULL) then null when (am1.role = 1) then 1 when (am1.availability_mode = 0 or am3.availability_mode = 0) then 0 else 1 end) as effective_availability_mode       into #tmpar_replica_rollupstate from #tmpar_availabilty_mode as am1 left join (select group_id, role, availability_mode from #tmpar_availabilty_mode as am2 where am2.role = 1) as am3 on am1.group_id = am3.group_id       drop table #tmpar_availabilty_mode       drop table #tmpar_ags              select replica_id,join_state into #tmpar_availability_replica_cluster_states from master.sys.dm_hadr_availability_replica_cluster_states        SELECT AR.replica_server_name AS [Name], 'Server[@Name=' + quotename(CAST(         serverproperty(N'Servername')        AS sysname),'''') + ']' + '/AvailabilityGroup[@Name=' + quotename(AG.name,'''') + ']' + '/AvailabilityReplica[@Name=' + quotename(AR.replica_server_name,'''') + ']' AS [Urn], ISNULL(arstates.role, 3) AS [Role], ISNULL(AR.primary_role_allow_connections, 4) AS [ConnectionModeInPrimaryRole], ISNULL(AR.secondary_role_allow_connections, 3) AS [ConnectionModeInSecondaryRole], ISNULL(arstates.connected_state, 2) AS [ConnectionState], (case when arrollupstates.sync_state = 3 then 3 when (arrollupstates.effective_availability_mode = 1 or arrollupstates.role = 1) then arrollupstates.sync_state when arrollupstates.sync_state = 2 then 1 else 0 end) AS [RollupSynchronizationState], ISNULL(arcs.join_state, 99) AS [JoinState] FROM #tmpag_availability_groups AS AG INNER JOIN #tmpar_availability_replicas AS AR ON (AR.replica_server_name IS NOT NULL) AND (AR.group_id=AG.group_id) LEFT OUTER JOIN #tmpar_availability_replica_states AS arstates ON AR.replica_id = arstates.replica_id LEFT OUTER JOIN #tmpar_replica_rollupstate AS arrollupstates ON AR.replica_id = arrollupstates.replica_id LEFT OUTER JOIN #tmpar_availability_replica_cluster_states AS arcs ON AR.replica_id = arcs.replica_id WHERE (AG.name=@_msparam_0) ORDER BY [Name] ASC        DROP TABLE #tmpar_availability_replicas              DROP TABLE #tmpar_availability_replica_states              DROP TABLE #tmpar_replica_rollupstate              DROP TABLE #tmpar_availability_replica_cluster_states              drop table #tmpag_availability_groups       ",6,5,1,141,0,6
"()                 begin try                 declare @table1 table(                 objecttype varchar (100) collate database_default                 ,       buffers bigint                 );                  insert @table1                 exec('dbcc memorystatus with tableresults')                  select 0 as row_no                 ,       objecttype                 ,       buffers as value                 ,       1 as state,      1 as msg                 from @table1                 where objecttype in ('Stolen','Free','Cached','Dirty','Kept','I/O','Latched','Other' )                 end try                 begin catch                 select -100 as row_no                 ,       ERROR_NUMBER() as objecttype                 ,       ERROR_SEVERITY() as value                 ,       ERROR_STATE() as state                 ,       ERROR_MESSAGE() as msg                 end catch               ",6,6,0,3783,11,19
"       select * into #tmpag_availability_groups from master.sys.availability_groups              select agstates.group_id, agstates.primary_replica into #tmpag_availability_group_states from master.sys.dm_hadr_availability_group_states as agstates              select group_id, replica_id, replica_metadata_id into #tmpag_availability_replicas from master.sys.availability_replicas       select replica_id, is_local, role into #tmpag_availability_replica_states from master.sys.dm_hadr_availability_replica_states                select TMIL.group_id, count(*) as is_managed_instance_link into #tmp_managed_instance_link from sys.availability_replicas AS TMIL where TMIL.endpoint_url LIKE '%Server=%' and (select count(*) from sys.availability_replicas as A1 where A1.group_id = TMIL.group_id) = 2 group by TMIL.group_id having count(*) = 1        SELECT AG.name AS [Name], 'Server[@Name=' + quotename(CAST(         serverproperty(N'Servername')        AS sysname),'''') + ']' + '/AvailabilityGroup[@Name=' + quotename(AG.name,'''') + ']' AS [Urn], ISNULL(agstates.primary_replica, '') AS [PrimaryReplicaServerName], ISNULL(arstates2.role, 3) AS [LocalReplicaRole], CAST(ISNULL(AG.is_distributed, 0) AS bit) AS [IsDistributedAvailabilityGroup], ISNULL(AG.cluster_type, 0) AS [ClusterType], CAST(ISNULL(MIL.is_managed_instance_link, 0) & ISNULL(AG.is_distributed, 0) AS bit) AS [IsManagedInstanceLink], CAST(ISNULL(AG.is_contained, 0) AS bit) AS [IsContained] FROM #tmpag_availability_groups AS AG LEFT OUTER JOIN #tmpag_availability_group_states as agstates ON AG.group_id = agstates.group_id INNER JOIN #tmpag_availability_replicas AS AR2 ON AG.group_id = AR2.group_id INNER JOIN #tmpag_availability_replica_states AS arstates2 ON AR2.replica_id = arstates2.replica_id AND arstates2.is_local = 1 LEFT OUTER JOIN #tmp_managed_instance_link AS MIL ON AG.group_id = MIL.group_id ORDER BY [Name] ASC        drop table #tmpag_availability_groups              drop table #tmpag_availability_group_states              drop table #tmpag_availability_replicas       drop table #tmpag_availability_replica_states              drop table #tmp_managed_instance_link      ",6,5,1,67,2,6
"       select COUNT_BIG(*) AS [NumDBperAG] from sys.dm_hadr_database_replica_states where group_id in       (select group_id from sys.dm_hadr_availability_replica_states WITH(nolock) where is_local = 1 and role = 1) and is_local = 1 group by group_id     ",5,4,1,66,0,533
"       SELECT top 1000       group_id, replica_id, group_database_id,group_database_id, is_local, is_primary_replica, synchronization_state, is_commit_participant, synchronization_health, database_state, is_suspended       FROM sys.dm_hadr_database_replica_states WITH(nolock)       where group_id in (select group_id from sys.dm_hadr_availability_replica_states WITH(nolock) where is_local = 1 and role = 1)     ",5,4,1,66,0,530
"(@_msparam_0 nvarchar(4000))       select * into #tmpag_availability_groups from master.sys.availability_groups               select replica_id, group_id into #tmpardb_availability_replicas from master.sys.availability_replicas              select replica_id, group_database_id, database_name,is_database_joined,is_failover_ready,is_pending_secondary_suspend,recovery_lsn,truncation_lsn into #tmpardb_database_replica_cluster_states from master.sys.dm_hadr_database_replica_cluster_states              select replica_id, is_local into #tmpardb_availability_replica_states from master.sys.dm_hadr_availability_replica_states              select replica_id, group_database_id,synchronization_state, is_suspended into #tmpardb_database_replica_states from master.sys.dm_hadr_database_replica_states        SELECT dbcs.database_name AS [Name], 'Server[@Name=' + quotename(CAST(         serverproperty(N'Servername')        AS sysname),'''') + ']' + '/AvailabilityGroup[@Name=' + quotename(AG.name,'''') + ']' + '/AvailabilityDatabase[@Name=' + quotename(dbcs.database_name,'''') + ']' AS [Urn], ISNULL(dbrs.synchronization_state, 0) AS [SynchronizationState], ISNULL(dbrs.is_suspended, 0) AS [IsSuspended], ISNULL(dbcs.is_database_joined, 0) AS [IsJoined] FROM #tmpag_availability_groups AS AG INNER JOIN #tmpardb_availability_replicas AS AR ON AR.group_id=AG.group_id INNER JOIN #tmpardb_availability_replica_states AS arstates ON AR.replica_id = arstates.replica_id AND arstates.is_local = 1 INNER JOIN #tmpardb_database_replica_cluster_states AS dbcs ON arstates.replica_id = dbcs.replica_id LEFT OUTER JOIN #tmpardb_database_replica_states AS dbrs ON dbcs.replica_id = dbrs.replica_id AND dbcs.group_database_id = dbrs.group_database_id WHERE (AG.name=@_msparam_0) ORDER BY [Name] ASC        DROP TABLE #tmpardb_availability_replicas              DROP TABLE #tmpardb_database_replica_cluster_states              DROP TABLE #tmpardb_availability_replica_states              DROP TABLE #tmpardb_database_replica_states              drop table #tmpag_availability_groups       ",5,5,0,63,0,5
"       select       case       when (listener_id IS NOT NULL) then 1       else 0       end AS [listener_used]       from sys.availability_group_listeners WITH(nolock) where group_id in       (select group_id from sys.dm_hadr_availability_replica_states WITH(nolock) where is_local = 1 and role = 1)     ",5,4,1,38,0,520
"       select group_id, listener_id, LEN(ISNULL(dns_name,'')) AS dns_length, is_conformant, is_distributed_network_name       from sys.availability_group_listeners WITH(nolock)       where group_id in (select group_id from sys.dm_hadr_availability_replica_states WITH(nolock) where is_local = 1 and role = 1)     ",5,4,1,38,0,519
"       select * into #tmpag_availability_groups from master.sys.availability_groups              select agstates.group_id, agstates.primary_replica into #tmpag_availability_group_states from master.sys.dm_hadr_availability_group_states as agstates              select group_id, replica_id, replica_metadata_id into #tmpag_availability_replicas from master.sys.availability_replicas       select replica_id, is_local, role into #tmpag_availability_replica_states from master.sys.dm_hadr_availability_replica_states                select TMIL.group_id, count(*) as is_managed_instance_link into #tmp_managed_instance_link from sys.availability_replicas AS TMIL where TMIL.endpoint_url LIKE '%Server=%' and (select count(*) from sys.availability_replicas as A1 where A1.group_id = TMIL.group_id) = 2 group by TMIL.group_id having count(*) = 1        SELECT AG.name AS [Name], 'Server[@Name=' + quotename(CAST(         serverproperty(N'Servername')        AS sysname),'''') + ']' + '/AvailabilityGroup[@Name=' + quotename(AG.name,'''') + ']' AS [Urn], ISNULL(agstates.primary_replica, '') AS [PrimaryReplicaServerName], ISNULL(arstates2.role, 3) AS [LocalReplicaRole], CAST(ISNULL(AG.is_distributed, 0) AS bit) AS [IsDistributedAvailabilityGroup], ISNULL(AG.cluster_type, 0) AS [ClusterType], CAST(ISNULL(MIL.is_managed_instance_link, 0) & ISNULL(AG.is_distributed, 0) AS bit) AS [IsManagedInstanceLink], CAST(ISNULL(AG.is_contained, 0) AS bit) AS [IsContained] FROM #tmpag_availability_groups AS AG LEFT OUTER JOIN #tmpag_availability_group_states as agstates ON AG.group_id = agstates.group_id INNER JOIN #tmpag_availability_replicas AS AR2 ON AG.group_id = AR2.group_id INNER JOIN #tmpag_availability_replica_states AS arstates2 ON AR2.replica_id = arstates2.replica_id AND arstates2.is_local = 1 LEFT OUTER JOIN #tmp_managed_instance_link AS MIL ON AG.group_id = MIL.group_id ORDER BY [Name] ASC        drop table #tmpag_availability_groups              drop table #tmpag_availability_group_states              drop table #tmpag_availability_replicas       drop table #tmpag_availability_replica_states              drop table #tmp_managed_instance_link      ",5,4,1,40,0,5
"       SELECT       ISNULL(SUM(memory_used_by_table_kb),0) AS total_memory_used_by_tables_kb,       ISNULL(SUM(memory_used_by_indexes_kb),0) AS total_memory_used_by_indexes_kb, db_id() AS database_id       FROM sys.dm_db_xtp_table_memory_stats WITH(nolock)     ",5,2,3,18,0,493
"SELECT u.name AS [Name], u.principal_id AS [ID], ISNULL(ak.name,N'') AS [AsymmetricKey], ISNULL(cert.name,N'') AS [Certificate],          CASE         WHEN N'C' = u.type THEN 1         WHEN N'K' = u.type THEN 2         WHEN N'S' = u.type AND SUSER_SNAME(u.sid) is null AND u.authentication_type != 2 THEN 3         WHEN N'E' = u.type or N'X' = u.type THEN 4         ELSE 0 END        AS [UserType] FROM sys.database_principals AS u LEFT OUTER JOIN sys.asymmetric_keys AS ak ON ak.sid = u.sid LEFT OUTER JOIN sys.certificates AS cert ON cert.sid = u.sid WHERE (u.type in ('U', 'S', 'G', 'C', 'K' ,'E', 'X')) ORDER BY [Name] ASC",5,5,0,131,0,27
"       select * into #tmpag_availability_groups from master.sys.availability_groups              select agstates.group_id, agstates.primary_replica into #tmpag_availability_group_states from master.sys.dm_hadr_availability_group_states as agstates              select group_id, replica_id, replica_metadata_id into #tmpag_availability_replicas from master.sys.availability_replicas       select replica_id, is_local, role into #tmpag_availability_replica_states from master.sys.dm_hadr_availability_replica_states                select TMIL.group_id, count(*) as is_managed_instance_link into #tmp_managed_instance_link from sys.availability_replicas AS TMIL where TMIL.endpoint_url LIKE '%Server=%' and (select count(*) from sys.availability_replicas as A1 where A1.group_id = TMIL.group_id) = 2 group by TMIL.group_id having count(*) = 1        SELECT AG.name AS [Name], 'Server[@Name=' + quotename(CAST(         serverproperty(N'Servername')        AS sysname),'''') + ']' + '/AvailabilityGroup[@Name=' + quotename(AG.name,'''') + ']' AS [Urn], ISNULL(agstates.primary_replica, '') AS [PrimaryReplicaServerName], ISNULL(arstates2.role, 3) AS [LocalReplicaRole], CAST(ISNULL(AG.is_distributed, 0) AS bit) AS [IsDistributedAvailabilityGroup], ISNULL(AG.cluster_type, 0) AS [ClusterType], CAST(ISNULL(MIL.is_managed_instance_link, 0) & ISNULL(AG.is_distributed, 0) AS bit) AS [IsManagedInstanceLink], CAST(ISNULL(AG.is_contained, 0) AS bit) AS [IsContained] FROM #tmpag_availability_groups AS AG LEFT OUTER JOIN #tmpag_availability_group_states as agstates ON AG.group_id = agstates.group_id INNER JOIN #tmpag_availability_replicas AS AR2 ON AG.group_id = AR2.group_id INNER JOIN #tmpag_availability_replica_states AS arstates2 ON AR2.replica_id = arstates2.replica_id AND arstates2.is_local = 1 LEFT OUTER JOIN #tmp_managed_instance_link AS MIL ON AG.group_id = MIL.group_id ORDER BY [Name] ASC        drop table #tmpag_availability_groups              drop table #tmpag_availability_group_states              drop table #tmpag_availability_replicas       drop table #tmpag_availability_replica_states              drop table #tmp_managed_instance_link      ",5,4,1,91,1,21
select COUNT_BIG(*) AS ReadOnlyRoutingRuleCount from sys.availability_read_only_routing_lists WITH(nolock),5,4,1,0,0,485
"       SELECT       ISNULL(sum(allocated_bytes)/1024,0) AS total_memory_allocated_for_system_kb       FROM sys.dm_xtp_system_memory_consumers WITH(nolock)     ",5,2,3,0,0,478
"SELECT SCHEMA_NAME(xproc.schema_id) AS [Schema], xproc.name AS [Name], xproc.object_id AS [ID], CAST(                 xproc.is_ms_shipped             AS bit) AS [IsSystemObject] FROM sys.all_objects AS xproc WHERE (xproc.type='X') ORDER BY [Schema] ASC,[Name] ASC",5,4,1,66,0,25
"       select count_big(*) AS [XTPAlwaysOnAG],       isnull(sum(ar.availability_mode),0) AS [XTPAlwaysOnAGSync], db_id() AS database_id       from sys.databases d WITH (NOLOCK)       join sys.availability_databases_cluster adb WITH (NOLOCK)       on d.group_database_id=adb.group_database_id       join sys.availability_replicas ar  WITH (NOLOCK)       on d.replica_id=ar.replica_id       where database_id=db_id() and exists (select * from sys.data_spaces  WITH (NOLOCK) where type='FX')     ",4,4,0,4,0,4
"(@_msparam_0 nvarchar(4000),@_msparam_1 nvarchar(4000),@_msparam_2 nvarchar(4000),@_msparam_3 nvarchar(4000),@_msparam_4 nvarchar(4000),@_msparam_5 nvarchar(4000),@_msparam_6 nvarchar(4000),@_msparam_7 nvarchar(4000),@_msparam_8 nvarchar(4000))SELECT tbl.name AS [Name], SCHEMA_NAME(tbl.schema_id) AS [Schema], 'Server[@Name=' + quotename(CAST(         serverproperty(N'Servername')        AS sysname),'''') + ']' + '/Database[@Name=' + quotename(db_name(),'''') + ']' + '/Table[@Name=' + quotename(tbl.name,'''') + ' and @Schema=' + quotename(SCHEMA_NAME(tbl.schema_id),'''') + ']' AS [Urn], tbl.create_date AS [CreateDate], CAST(tbl.is_memory_optimized AS bit) AS [IsMemoryOptimized], CAST(CASE idx.type WHEN 5 THEN 1 ELSE 0 END AS bit) AS [HasClusteredColumnStoreIndex], CAST(tbl.is_remote_data_archive_enabled AS bit) AS [RemoteDataArchiveEnabled], tbl.temporal_type AS [TemporalType], CAST(ISNULL(tbl.ledger_type, 0) AS int) AS [LedgerType], CAST(CASE WHEN 'PS'=dsidx.type THEN 1 ELSE 0 END AS bit) AS [IsPartitioned], CAST(         ISNULL((SELECT distinct 1 from sys.all_columns         WHERE object_id = tbl.object_id         AND is_sparse = 1), 0)        AS bit) AS [HasSparseColumn], CAST(tbl.is_node AS bit) AS [IsNode], CAST(tbl.is_edge AS bit) AS [IsEdge], CAST(ISNULL((select top 1 1 from sys.indexes ind where ind.object_id = tbl.object_id and ind.type > 1 and ind.is_hypothetical = 0 ), 0) AS bit) AS [HasNonClusteredIndex], CAST(CASE idx.index_id WHEN 1 THEN 1 ELSE 0 END AS bit) AS [HasClusteredIndex], CAST(case idx.index_id when 1 then case when (idx.is_primary_key + 2*idx.is_unique_constraint = 1) then 1 else 0 end else 0 end AS bit) AS [HasPrimaryClusteredIndex], CAST(ISNULL((select top 1 1 from sys.indexes ind where ind.object_id = tbl.object_id and ind.type = 3 and ind.is_hypothetical = 0 ), 0) AS bit) AS [HasXmlIndex], CAST(ISNULL((select top 1 1 from sys.all_columns as clmns join sys.types as usrt on usrt.user_type_id = clmns.user_type_id where clmns.object_id = tbl.object_id and usrt.name = N'xml'), 0) AS bit) AS [HasXmlData], CAST(ISNULL((select top 1 1 from sys.all_columns as clmns join sys.types as usrt on usrt.user_type_id = clmns.user_type_id where clmns.object_id = tbl.object_id and usrt.name in (N'geometry', N'geography')), 0) AS bit) AS [HasSpatialData], CAST(ISNULL((select top 1 1 from sys.indexes ind where ind.object_id = tbl.object_id and ind.type = 6 and ind.is_hypothetical = 0 ), 0) AS bit) AS [HasNonClusteredColumnStoreIndex] FROM sys.tables AS tbl INNER JOIN sys.indexes AS idx ON          idx.object_id = tbl.object_id and (idx.index_id < @_msparam_0  or (tbl.is_memory_optimized = 1 and idx.index_id = (select min(index_id) from sys.indexes where object_id = tbl.object_id)))        LEFT OUTER JOIN sys.data_spaces AS dsidx ON dsidx.data_space_id = idx.data_space_id WHERE (CAST(  case      when tbl.is_ms_shipped = 1 then 1     when (         select              major_id          from              sys.extended_properties          where              major_id = tbl.object_id and              minor_id = 0 and              class = 1 and              name = N'microsoft_database_tools_support')          is not null then 1     else 0 end                        AS bit)=@_msparam_1 and tbl.is_filetable=@_msparam_2 and CAST(tbl.is_memory_optimized AS bit)=@_msparam_3 and tbl.temporal_type=@_msparam_4 and CAST(tbl.is_external AS bit)=@_msparam_5 and CAST(tbl.is_node AS bit)=@_msparam_6 and CAST(tbl.is_edge AS bit)=@_msparam_7 and CAST(ISNULL(tbl.ledger_type, 0) AS int)=@_msparam_8)",4,4,0,70,0,4
"       SELECT db_id() AS database_id, o.[type] as ModuleType, COUNT_BIG(*) as ModuleCount       FROM sys.objects AS o WITH(nolock)       WHERE o.type in ('AF', 'F', 'FN', 'FS', 'FT', 'IF', 'P', 'PC', 'TA', 'TF', 'TR', 'X', 'C', 'D', 'PG', 'SN', 'SO', 'SQ', 'TT', 'UQ', 'V')       GROUP BY o.[type]     ",4,4,0,40,0,418
"SELECT SCHEMA_NAME(tbl.schema_id) AS [Schema], tbl.name AS [Name], tbl.object_id AS [ID] FROM sys.tables AS tbl ORDER BY [Schema] ASC,[Name] ASC",4,4,0,111,0,22
"()                 begin try                 declare @dbsize bigint                 declare @logsize bigint                 declare @database_size_mb float                 declare @unallocated_space_mb float                 declare @reserved_mb float                 declare @data_mb float                 declare @log_size_mb float                 declare @index_mb float                 declare @unused_mb float                 declare @reservedpages bigint                 declare @pages bigint                 declare @usedpages bigint                  select @dbsize = sum(convert(bigint,case when status & 64 = 0 then size else 0 end))                 ,@logsize = sum(convert(bigint,case when status & 64 != 0 then size else 0 end))                 from dbo.sysfiles                  select @reservedpages = sum(a.total_pages)                 ,@usedpages = sum(a.used_pages)                 ,@pages = sum(CASE                 WHEN it.internal_type IN (202,204) THEN 0                 WHEN a.type != 1 THEN a.used_pages                 WHEN p.index_id < 2 THEN a.data_pages                 ELSE 0                 END)                 from sys.partitions p                 join sys.allocation_units a on p.partition_id = a.container_id                 left join sys.internal_tables it on p.object_id = it.object_id                  select @database_size_mb = (convert(dec (19,2),@dbsize) + convert(dec(19,2),@logsize)) * 8192 / 1048576.0                 select @unallocated_space_mb =(case                 when @dbsize >= @reservedpages then (convert (dec (19,2),@dbsize) - convert (dec (19,2),@reservedpages)) * 8192 / 1048576.0                 else 0                 end)                  select  @reserved_mb = @reservedpages * 8192 / 1048576.0                 select  @data_mb = @pages * 8192 / 1048576.0                 select  @log_size_mb = convert(dec(19,2),@logsize) * 8192 / 1048576.0                 select  @index_mb = (@usedpages - @pages) * 8192 / 1048576.0                 select  @unused_mb = (@reservedpages - @usedpages) * 8192 / 1048576.0                  select                 @database_size_mb as 'database_size_mb'                 ,       @reserved_mb as 'reserved_mb'                 ,       @unallocated_space_mb as 'unallocated_space_mb'                 ,       (@reserved_mb + @unallocated_space_mb) as 'data_size'                 ,       @log_size_mb as 'transaction_log_size'                 ,       cast(@unallocated_space_mb*100.0/(@reserved_mb + @unallocated_space_mb) as decimal(10,2))as  'unallocated'                 ,       cast(@reserved_mb*100/(@reserved_mb + @unallocated_space_mb) as decimal(10,2))as 'reserved'                 ,       cast(@data_mb*100/(@reserved_mb + @unallocated_space_mb) as decimal(10,2))as 'data'                 ,       cast(@index_mb*100/(@reserved_mb + @unallocated_space_mb) as decimal(10,2)) as 'index_1'                 ,       cast(@unused_mb*100/(@reserved_mb + @unallocated_space_mb) as decimal(10,2))as 'unused';                  end try                 begin catch                 select                 1 as database_size_mb                 ,       ERROR_NUMBER() as reserved_mb                 ,       ERROR_SEVERITY() as unallocated_space_mb                 ,       ERROR_STATE() as data_size                 ,       1 as transaction_log_size                 ,       ERROR_MESSAGE() as unallocated                 ,       -100 as reserved                 ,       1 as data                 ,       1 as index_1                 ,       1 as unused                 end catch               ",4,4,0,2828,0,13
"       --In the following query, the certificate certificate key length, and the certificate encryption type for TDE are collected.       SELECT key_length, pvt_key_encryption_type, COUNT_BIG(*) AS cert_count FROM sys.certificates WITH(nolock) GROUP BY key_length, pvt_key_encryption_type     ",4,3,1,19,0,396
"(@_msparam_0 nvarchar(4000),@_msparam_1 nvarchar(4000),@_msparam_2 nvarchar(4000),@_msparam_3 nvarchar(4000),@_msparam_4 nvarchar(4000),@_msparam_5 nvarchar(4000))SELECT tbl.name AS [Name], SCHEMA_NAME(tbl.schema_id) AS [Schema], 'Server[@Name=' + quotename(CAST(         serverproperty(N'Servername')        AS sysname),'''') + ']' + '/Database[@Name=' + quotename(db_name(),'''') + ']' + '/Table[@Name=' + quotename(tbl.name,'''') + ' and @Schema=' + quotename(SCHEMA_NAME(tbl.schema_id),'''') + ']' AS [Urn], tbl.create_date AS [CreateDate], CAST(tbl.is_memory_optimized AS bit) AS [IsMemoryOptimized], case when (tbl.durability=1) then 0 else 1 end AS [Durability], CAST(ISNULL(historyTable.object_id, 0) AS int) AS [HistoryTableID], CAST(ISNULL(historyTable.name, N'') AS sysname) AS [HistoryTableName], CAST(ISNULL(SCHEMA_NAME(historyTable.schema_id), N'') AS sysname) AS [HistoryTableSchema], tbl.temporal_type AS [TemporalType], CAST(tbl.is_remote_data_archive_enabled AS bit) AS [RemoteDataArchiveEnabled], CAST(ISNULL((select top 1 1 from sys.indexes ind where ind.object_id = tbl.object_id and ind.type > 1 and ind.is_hypothetical = 0 ), 0) AS bit) AS [HasNonClusteredIndex], CAST(CASE idx.index_id WHEN 1 THEN 1 ELSE 0 END AS bit) AS [HasClusteredIndex], CAST(case idx.index_id when 1 then case when (idx.is_primary_key + 2*idx.is_unique_constraint = 1) then 1 else 0 end else 0 end AS bit) AS [HasPrimaryClusteredIndex], CAST(ISNULL((select top 1 1 from sys.indexes ind where ind.object_id = tbl.object_id and ind.type = 3 and ind.is_hypothetical = 0 ), 0) AS bit) AS [HasXmlIndex], CAST(ISNULL((select top 1 1 from sys.all_columns as clmns join sys.types as usrt on usrt.user_type_id = clmns.user_type_id where clmns.object_id = tbl.object_id and usrt.name = N'xml'), 0) AS bit) AS [HasXmlData], CAST(ISNULL((select top 1 1 from sys.all_columns as clmns join sys.types as usrt on usrt.user_type_id = clmns.user_type_id where clmns.object_id = tbl.object_id and usrt.name in (N'geometry', N'geography')), 0) AS bit) AS [HasSpatialData], CAST(ISNULL((select top 1 1 from sys.indexes ind where ind.object_id = tbl.object_id and ind.type = 6 and ind.is_hypothetical = 0 ), 0) AS bit) AS [HasNonClusteredColumnStoreIndex] FROM sys.tables AS tbl LEFT OUTER JOIN sys.tables as historyTable ON historyTable.object_id = tbl.history_table_id INNER JOIN sys.indexes AS idx ON          idx.object_id = tbl.object_id and (idx.index_id < @_msparam_0  or (tbl.is_memory_optimized = 1 and idx.index_id = (select min(index_id) from sys.indexes where object_id = tbl.object_id)))        WHERE (CAST(  case      when tbl.is_ms_shipped = 1 then 1     when (         select              major_id          from              sys.extended_properties          where              major_id = tbl.object_id and              minor_id = 0 and              class = 1 and              name = N'microsoft_database_tools_support')          is not null then 1     else 0 end                        AS bit)=@_msparam_1 and tbl.is_filetable=@_msparam_2 and CAST(tbl.is_memory_optimized AS bit)=@_msparam_3 and tbl.temporal_type=@_msparam_4 and CAST(tbl.is_external AS bit)=@_msparam_5)",4,4,0,80,0,4
"SELECT SCHEMA_NAME(s.schema_id) AS [Schema], s.name AS [Name], s.object_id AS [ID], N'' AS [BaseDatabase], N'' AS [BaseObject], N'' AS [BaseSchema], N'' AS [BaseServer],  			CASE OBJECTPROPERTYEX(s.object_id,'BaseType')  				WHEN N'U' THEN 1  				WHEN N'V' THEN 2  				WHEN N'P' THEN 3  				WHEN N'FN' THEN 4  				WHEN N'TF' THEN 5  				WHEN N'IF' THEN 6  				WHEN N'X' THEN 7  				WHEN N'RF' THEN 8  				WHEN N'PC' THEN 9  				WHEN N'FS' THEN 10  				WHEN N'FT' THEN 11  				WHEN N'AF' THEN 12 ELSE 0 END 		 AS [BaseType], s.base_object_name AS [BaseObjectName] FROM sys.synonyms AS s ORDER BY [Schema] ASC,[Name] ASC",4,4,0,405,0,20
"(@_msparam_0 nvarchar(4000),@_msparam_1 nvarchar(4000),@_msparam_2 nvarchar(4000),@_msparam_3 nvarchar(4000)) create table #tmp_sp_help_jobserver (server_id int null, server_name sysname null, enlist_date datetime null, last_poll_date datetime null, last_run_date int null, last_run_time int null, last_run_duration int null, last_run_outcome tinyint null, last_outcome_message nvarchar(4000) null, job_id uniqueidentifier null)  declare @job_id uniqueidentifier declare crs cursor local fast_forward for ( SELECT sv.job_id AS [JobID] FROM msdb.dbo.sysjobs_view AS sv WHERE (sv.name=@_msparam_0 and sv.category_id=@_msparam_1) ) open crs fetch crs into @job_id while @@fetch_status >= 0 begin insert into #tmp_sp_help_jobserver(server_id, server_name, enlist_date, last_poll_date, last_run_date, last_run_time, last_run_duration, last_run_outcome, last_outcome_message) 		exec msdb.dbo.sp_help_jobserver @job_id = @job_id, @show_last_run_details = 1 	update #tmp_sp_help_jobserver set job_id = @job_id where job_id is null 	fetch crs into @job_id end close crs deallocate crs   SELECT tshj.server_name AS [ServerName], tshj.server_id AS [ID], tshj.enlist_date AS [EnlistDate], tshj.last_poll_date AS [LastPollDate], null AS [LastRunDate], tshj.last_run_duration AS [LastRunDuration], tshj.last_run_outcome AS [LastRunOutcome], tshj.last_outcome_message AS [LastOutcomeMessage], tshj.last_run_date AS [LastRunDateInt], tshj.last_run_time AS [LastRunTimeInt] FROM msdb.dbo.sysjobs_view AS sv INNER JOIN #tmp_sp_help_jobserver AS tshj ON tshj.job_id=sv.job_id WHERE (sv.name=@_msparam_2 and sv.category_id=@_msparam_3)  drop table #tmp_sp_help_jobserver 		 ",4,3,1,62,0,8
"(@_msparam_0 nvarchar(4000),@_msparam_1 nvarchar(4000),@_msparam_2 nvarchar(4000),@_msparam_3 nvarchar(4000))SELECT tbl.name AS [Name], SCHEMA_NAME(tbl.schema_id) AS [Schema], 'Server[@Name=' + quotename(CAST(         serverproperty(N'Servername')        AS sysname),'''') + ']' + '/Database[@Name=' + quotename(db_name(),'''') + ']' + '/Table[@Name=' + quotename(tbl.name,'''') + ' and @Schema=' + quotename(SCHEMA_NAME(tbl.schema_id),'''') + ']' AS [Urn], tbl.create_date AS [CreateDate], CAST(tbl.is_memory_optimized AS bit) AS [IsMemoryOptimized], CAST(CASE idx.type WHEN 5 THEN 1 ELSE 0 END AS bit) AS [HasClusteredColumnStoreIndex], CAST(ISNULL(tbl.ledger_type, 0) AS int) AS [LedgerType], CAST(ISNULL(tbl.is_dropped_ledger_table, 0) AS bit) AS [IsDroppedLedgerTable], CAST(CASE WHEN 'PS'=dsidx.type THEN 1 ELSE 0 END AS bit) AS [IsPartitioned], CAST(         ISNULL((SELECT distinct 1 from sys.all_columns         WHERE object_id = tbl.object_id         AND is_sparse = 1), 0)        AS bit) AS [HasSparseColumn], CAST(ISNULL((select top 1 1 from sys.indexes ind where ind.object_id = tbl.object_id and ind.type > 1 and ind.is_hypothetical = 0 ), 0) AS bit) AS [HasNonClusteredIndex], CAST(CASE idx.index_id WHEN 1 THEN 1 ELSE 0 END AS bit) AS [HasClusteredIndex], CAST(case idx.index_id when 1 then case when (idx.is_primary_key + 2*idx.is_unique_constraint = 1) then 1 else 0 end else 0 end AS bit) AS [HasPrimaryClusteredIndex], CAST(ISNULL((select top 1 1 from sys.indexes ind where ind.object_id = tbl.object_id and ind.type = 3 and ind.is_hypothetical = 0 ), 0) AS bit) AS [HasXmlIndex], CAST(ISNULL((select top 1 1 from sys.all_columns as clmns join sys.types as usrt on usrt.user_type_id = clmns.user_type_id where clmns.object_id = tbl.object_id and usrt.name = N'xml'), 0) AS bit) AS [HasXmlData], CAST(ISNULL((select top 1 1 from sys.all_columns as clmns join sys.types as usrt on usrt.user_type_id = clmns.user_type_id where clmns.object_id = tbl.object_id and usrt.name in (N'geometry', N'geography')), 0) AS bit) AS [HasSpatialData], CAST(ISNULL((select top 1 1 from sys.indexes ind where ind.object_id = tbl.object_id and ind.type = 6 and ind.is_hypothetical = 0 ), 0) AS bit) AS [HasNonClusteredColumnStoreIndex] FROM sys.tables AS tbl INNER JOIN sys.indexes AS idx ON          idx.object_id = tbl.object_id and (idx.index_id < @_msparam_0  or (tbl.is_memory_optimized = 1 and idx.index_id = (select min(index_id) from sys.indexes where object_id = tbl.object_id)))        LEFT OUTER JOIN sys.data_spaces AS dsidx ON dsidx.data_space_id = idx.data_space_id WHERE (CAST(  case      when tbl.is_ms_shipped = 1 then 1     when (         select              major_id          from              sys.extended_properties          where              major_id = tbl.object_id and              minor_id = 0 and              class = 1 and              name = N'microsoft_database_tools_support')          is not null then 1     else 0 end                        AS bit)=@_msparam_1 and CAST(ISNULL(tbl.ledger_type, 0) AS int)=@_msparam_2 and CAST(ISNULL(tbl.is_dropped_ledger_table, 0) AS bit)=@_msparam_3)",3,3,0,48,0,3
"SELECT SCHEMA_NAME(xproc.schema_id) AS [Schema], xproc.name AS [Name], xproc.object_id AS [ID], CAST(                 xproc.is_ms_shipped             AS bit) AS [IsSystemObject] FROM sys.all_objects AS xproc WHERE (xproc.type='X') ORDER BY [Schema] ASC,[Name] ASC",3,2,1,42,0,30
"(@_msparam_0 nvarchar(4000),@_msparam_1 nvarchar(4000),@_msparam_2 nvarchar(4000),@_msparam_3 nvarchar(4000))SELECT tbl.name AS [Name], SCHEMA_NAME(tbl.schema_id) AS [Schema], 'Server[@Name=' + quotename(CAST(         serverproperty(N'Servername')        AS sysname),'''') + ']' + '/Database[@Name=' + quotename(db_name(),'''') + ']' + '/Table[@Name=' + quotename(tbl.name,'''') + ' and @Schema=' + quotename(SCHEMA_NAME(tbl.schema_id),'''') + ']' AS [Urn], tbl.create_date AS [CreateDate], CAST(tbl.is_memory_optimized AS bit) AS [IsMemoryOptimized], CAST(CASE idx.type WHEN 5 THEN 1 ELSE 0 END AS bit) AS [HasClusteredColumnStoreIndex], CAST(ISNULL(historyTable.object_id, 0) AS int) AS [HistoryTableID], CAST(ISNULL(historyTable.name, N'') AS sysname) AS [HistoryTableName], CAST(ISNULL(SCHEMA_NAME(historyTable.schema_id), N'') AS sysname) AS [HistoryTableSchema], tbl.temporal_type AS [TemporalType], CAST(ISNULL(tbl.ledger_type, 0) AS int) AS [LedgerType], CAST(ISNULL(tbl.is_dropped_ledger_table, 0) AS bit) AS [IsDroppedLedgerTable], CAST(CASE WHEN 'PS'=dsidx.type THEN 1 ELSE 0 END AS bit) AS [IsPartitioned], CAST(         ISNULL((SELECT distinct 1 from sys.all_columns         WHERE object_id = tbl.object_id         AND is_sparse = 1), 0)        AS bit) AS [HasSparseColumn], CAST(ISNULL((select top 1 1 from sys.indexes ind where ind.object_id = tbl.object_id and ind.type > 1 and ind.is_hypothetical = 0 ), 0) AS bit) AS [HasNonClusteredIndex], CAST(CASE idx.index_id WHEN 1 THEN 1 ELSE 0 END AS bit) AS [HasClusteredIndex], CAST(case idx.index_id when 1 then case when (idx.is_primary_key + 2*idx.is_unique_constraint = 1) then 1 else 0 end else 0 end AS bit) AS [HasPrimaryClusteredIndex], CAST(ISNULL((select top 1 1 from sys.indexes ind where ind.object_id = tbl.object_id and ind.type = 3 and ind.is_hypothetical = 0 ), 0) AS bit) AS [HasXmlIndex], CAST(ISNULL((select top 1 1 from sys.all_columns as clmns join sys.types as usrt on usrt.user_type_id = clmns.user_type_id where clmns.object_id = tbl.object_id and usrt.name = N'xml'), 0) AS bit) AS [HasXmlData], CAST(ISNULL((select top 1 1 from sys.all_columns as clmns join sys.types as usrt on usrt.user_type_id = clmns.user_type_id where clmns.object_id = tbl.object_id and usrt.name in (N'geometry', N'geography')), 0) AS bit) AS [HasSpatialData], CAST(ISNULL((select top 1 1 from sys.indexes ind where ind.object_id = tbl.object_id and ind.type = 6 and ind.is_hypothetical = 0 ), 0) AS bit) AS [HasNonClusteredColumnStoreIndex] FROM sys.tables AS tbl INNER JOIN sys.indexes AS idx ON          idx.object_id = tbl.object_id and (idx.index_id < @_msparam_0  or (tbl.is_memory_optimized = 1 and idx.index_id = (select min(index_id) from sys.indexes where object_id = tbl.object_id)))        LEFT OUTER JOIN sys.tables as historyTable ON historyTable.object_id = tbl.history_table_id LEFT OUTER JOIN sys.data_spaces AS dsidx ON dsidx.data_space_id = idx.data_space_id WHERE (CAST(  case      when tbl.is_ms_shipped = 1 then 1     when (         select              major_id          from              sys.extended_properties          where              major_id = tbl.object_id and              minor_id = 0 and              class = 1 and              name = N'microsoft_database_tools_support')          is not null then 1     else 0 end                        AS bit)=@_msparam_1 and CAST(ISNULL(tbl.ledger_type, 0) AS int)=@_msparam_2 and CAST(ISNULL(tbl.is_dropped_ledger_table, 0) AS bit)=@_msparam_3)",3,3,0,48,0,3
