"(@P0 int,@P1 date,@P2 date,@P3 nvarchar(4000))select TOP(@P0) inspection0_.id as id1_147_, inspection0_.actual_date as actual_d2_147_, inspection0_.audit_procedure_name as audit_pr3_147_, inspection0_.audit_work_id as audit_wo4_147_, inspection0_.auditee_org_id as auditee_5_147_, inspection0_.auditee_org_name as auditee_6_147_, inspection0_.auditee_org_postcode as auditee_7_147_, inspection0_.comment as comment8_147_, inspection0_.compare as compare9_147_, inspection0_.inspection_date as inspect10_147_, inspection0_.name as name11_147_, inspection0_.post_area_name as post_ar12_147_, inspection0_.schedual_date as schedua13_147_, inspection0_.seq as seq14_147_, inspection0_.seq_name as seq_nam15_147_, inspection0_.user_name as user_na16_147_ from v_inspection_compare_report inspection0_ where inspection0_.inspection_date>=@P1 and inspection0_.inspection_date<=@P2 and (inspection0_.compare like @P3)",893000,876716,16284,188006879,1325,893000
"(@P0 nvarchar(4000),@P1 int,@P2 int)WITH query AS (SELECT inner_query.*, ROW_NUMBER() OVER (ORDER BY CURRENT_TIMESTAMP) as __hibernate_row_nr__ FROM ( select inspection0_.id as id1_147_, inspection0_.actual_date as actual_d2_147_, inspection0_.audit_procedure_name as audit_pr3_147_, inspection0_.audit_work_id as audit_wo4_147_, inspection0_.auditee_org_id as auditee_5_147_, inspection0_.auditee_org_name as auditee_6_147_, inspection0_.auditee_org_postcode as auditee_7_147_, inspection0_.comment as comment8_147_, inspection0_.compare as compare9_147_, inspection0_.inspection_date as inspect10_147_, inspection0_.name as name11_147_, inspection0_.post_area_name as post_ar12_147_, inspection0_.schedual_date as schedua13_147_, inspection0_.seq as seq14_147_, inspection0_.seq_name as seq_nam15_147_, inspection0_.user_name as user_na16_147_ from v_inspection_compare_report inspection0_ where inspection0_.compare like @P0 ) inner_query ) SELECT id1_147_, actual_d2_147_, audit_pr3_147_, audit_wo4_147_, auditee_5_147_, auditee_6_147_, auditee_7_147_, comment8_147_, compare9_147_, inspect10_147_, name11_147_, post_ar12_147_, schedua13_147_, seq14_147_, seq_nam15_147_, user_na16_147_ FROM query WHERE __hibernate_row_nr__ >= @P1 AND __hibernate_row_nr__ < @P2",864982,864956,26,192266282,1252,864982
"(@P0 nvarchar(4000),@P1 nvarchar(4000),@P2 nvarchar(4000),@P3 nvarchar(4000),@P4 bit,@P5 nvarchar(4000),@P6 int,@P7 nvarchar(4000),@P8 bit,@P9 int)select distinct inspection0_.id as id1_152_, inspection0_.annual_plan_detail_id as annual_36_152_, inspection0_.annual_plan_draft_id as annual_p2_152_, inspection0_.annual_plan_draft_name as annual_p3_152_, inspection0_.annual_plan_id as annual_p4_152_, inspection0_.audit_plan_info_org_id as audit_p37_152_, inspection0_.audit_procedure_code as audit_pr5_152_, inspection0_.audit_procedure_id as audit_pr6_152_, inspection0_.audit_procedure_name as audit_pr7_152_, inspection0_.audit_procedure_years as audit_pr8_152_, inspection0_.audit_task_status as audit_ta9_152_, inspection0_.audit_work_status as audit_w10_152_, inspection0_.audited_date_set_report as audited11_152_, inspection0_.auditee_org_id as auditee38_152_, inspection0_.auditee_org_name as auditee12_152_, inspection0_.auditee_org_postcode as auditee13_152_, inspection0_.auditee_org_type as auditee14_152_, inspection0_.feedback_status as feedbac15_152_, inspection0_.inspection_date as inspect16_152_, inspection0_.inspection_evaluate_date as inspect17_152_, inspection0_.inspection_evaluate_status as inspect18_152_, inspection0_.inspection_report_id as inspect39_152_, inspection0_.inspection_report_status as inspect19_152_, inspection0_.is_show_leader as is_show20_152_, inspection0_.last_updated_date as last_up21_152_, inspection0_.last_updated_date_feedback_solution as last_up22_152_, inspection0_.last_updated_date_inspection_tracking as last_up23_152_, inspection0_.lat as lat24_152_, inspection0_.lng as lng25_152_, inspection0_.manager_user_id as manager26_152_, inspection0_.priority_suggestion_color as priorit27_152_, inspection0_.priority_suggestion_name as priorit28_152_, inspection0_.priority_suggestion_seq as priorit29_152_, inspection0_.send_email_replied_date as send_em30_152_, inspection0_.send_email_status as send_em31_152_, inspection0_.strategic_plan_id as strateg32_152_, inspection0_.strategic_plan_item_id as strateg33_152_, inspection0_.strategic_plan_item_total_effort as strateg34_152_, inspection0_.strategic_plan_name as strateg35_152_ from v_inspection_report inspection0_ inner join audit_plan_info_org auditplani1_ on inspection0_.audit_plan_info_org_id=auditplani1_.id inner join audit_work auditwork2_ on auditplani1_.id=auditwork2_.audit_plan_info_org_id inner join audit_work_auditor auditworka3_ on auditwork2_.id=auditworka3_.audit_work_id cross join inspection_report inspection4_ cross join audit_work auditwork8_ cross join audit_work auditwork11_ where inspection0_.inspection_report_id=inspection4_.id and auditplani1_.id=auditwork8_.audit_plan_info_org_id and inspection4_.audit_work_id=auditwork11_.id and (inspection4_.inspection_report_status in (@P0 , @P1 , @P2) or inspection4_.inspection_report_status=@P3 and (inspection4_.send_manager_date is not null)) and auditwork8_.is_show_leader=@P4 and (auditworka3_.position_name=@P5 and auditworka3_.user_id=@P6 or inspection0_.manager_user_id=924 or inspection0_.auditee_org_id in (select distinct auditeeorg9_.id from v_auditee_org_flat_tree auditeeorg9_ where auditeeorg9_.auditee_type=@P7 and (auditeeorg9_.parent_id in (1568) or auditeeorg9_.id in (1568)))) and auditwork11_.is_show_leader=@P8 order by inspection0_.last_updated_date desc offset 0 rows fetch next @P9 rows only",594354,1423629,-829275,2815047079,164,4160482
"(@P0 nvarchar(4000),@P1 nvarchar(4000),@P2 nvarchar(4000),@P3 nvarchar(4000),@P4 bit,@P5 nvarchar(4000),@P6 int,@P7 nvarchar(4000),@P8 bit,@P9 int)select distinct inspection0_.id as id1_152_, inspection0_.annual_plan_detail_id as annual_36_152_, inspection0_.annual_plan_draft_id as annual_p2_152_, inspection0_.annual_plan_draft_name as annual_p3_152_, inspection0_.annual_plan_id as annual_p4_152_, inspection0_.audit_plan_info_org_id as audit_p37_152_, inspection0_.audit_procedure_code as audit_pr5_152_, inspection0_.audit_procedure_id as audit_pr6_152_, inspection0_.audit_procedure_name as audit_pr7_152_, inspection0_.audit_procedure_years as audit_pr8_152_, inspection0_.audit_task_status as audit_ta9_152_, inspection0_.audit_work_status as audit_w10_152_, inspection0_.audited_date_set_report as audited11_152_, inspection0_.auditee_org_id as auditee38_152_, inspection0_.auditee_org_name as auditee12_152_, inspection0_.auditee_org_postcode as auditee13_152_, inspection0_.auditee_org_type as auditee14_152_, inspection0_.feedback_status as feedbac15_152_, inspection0_.inspection_date as inspect16_152_, inspection0_.inspection_evaluate_date as inspect17_152_, inspection0_.inspection_evaluate_status as inspect18_152_, inspection0_.inspection_report_id as inspect39_152_, inspection0_.inspection_report_status as inspect19_152_, inspection0_.is_show_leader as is_show20_152_, inspection0_.last_updated_date as last_up21_152_, inspection0_.last_updated_date_feedback_solution as last_up22_152_, inspection0_.last_updated_date_inspection_tracking as last_up23_152_, inspection0_.lat as lat24_152_, inspection0_.lng as lng25_152_, inspection0_.manager_user_id as manager26_152_, inspection0_.priority_suggestion_color as priorit27_152_, inspection0_.priority_suggestion_name as priorit28_152_, inspection0_.priority_suggestion_seq as priorit29_152_, inspection0_.send_email_replied_date as send_em30_152_, inspection0_.send_email_status as send_em31_152_, inspection0_.strategic_plan_id as strateg32_152_, inspection0_.strategic_plan_item_id as strateg33_152_, inspection0_.strategic_plan_item_total_effort as strateg34_152_, inspection0_.strategic_plan_name as strateg35_152_ from v_inspection_report inspection0_ inner join audit_plan_info_org auditplani1_ on inspection0_.audit_plan_info_org_id=auditplani1_.id inner join audit_work auditwork2_ on auditplani1_.id=auditwork2_.audit_plan_info_org_id inner join audit_work_auditor auditworka3_ on auditwork2_.id=auditworka3_.audit_work_id cross join inspection_report inspection4_ cross join audit_work auditwork8_ cross join audit_work auditwork11_ where inspection0_.inspection_report_id=inspection4_.id and auditplani1_.id=auditwork8_.audit_plan_info_org_id and inspection4_.audit_work_id=auditwork11_.id and (inspection4_.inspection_report_status in (@P0 , @P1 , @P2) or inspection4_.inspection_report_status=@P3 and (inspection4_.send_manager_date is not null)) and auditwork8_.is_show_leader=@P4 and (auditworka3_.position_name=@P5 and auditworka3_.user_id=@P6 or inspection0_.manager_user_id=180 or inspection0_.auditee_org_id in (select distinct auditeeorg9_.id from v_auditee_org_flat_tree auditeeorg9_ where auditeeorg9_.auditee_type=@P7 and (auditeeorg9_.parent_id in (null) or auditeeorg9_.id in (null)))) and auditwork11_.is_show_leader=@P8 order by inspection0_.last_updated_date desc offset 0 rows fetch next @P9 rows only",516109,515594,515,1130102204,0,516109
"(@P0 nvarchar(4000),@P1 nvarchar(4000),@P2 nvarchar(4000),@P3 nvarchar(4000),@P4 bit,@P5 nvarchar(4000),@P6 int,@P7 nvarchar(4000),@P8 bit,@P9 int)select distinct inspection0_.id as id1_152_, inspection0_.annual_plan_detail_id as annual_36_152_, inspection0_.annual_plan_draft_id as annual_p2_152_, inspection0_.annual_plan_draft_name as annual_p3_152_, inspection0_.annual_plan_id as annual_p4_152_, inspection0_.audit_plan_info_org_id as audit_p37_152_, inspection0_.audit_procedure_code as audit_pr5_152_, inspection0_.audit_procedure_id as audit_pr6_152_, inspection0_.audit_procedure_name as audit_pr7_152_, inspection0_.audit_procedure_years as audit_pr8_152_, inspection0_.audit_task_status as audit_ta9_152_, inspection0_.audit_work_status as audit_w10_152_, inspection0_.audited_date_set_report as audited11_152_, inspection0_.auditee_org_id as auditee38_152_, inspection0_.auditee_org_name as auditee12_152_, inspection0_.auditee_org_postcode as auditee13_152_, inspection0_.auditee_org_type as auditee14_152_, inspection0_.feedback_status as feedbac15_152_, inspection0_.inspection_date as inspect16_152_, inspection0_.inspection_evaluate_date as inspect17_152_, inspection0_.inspection_evaluate_status as inspect18_152_, inspection0_.inspection_report_id as inspect39_152_, inspection0_.inspection_report_status as inspect19_152_, inspection0_.is_show_leader as is_show20_152_, inspection0_.last_updated_date as last_up21_152_, inspection0_.last_updated_date_feedback_solution as last_up22_152_, inspection0_.last_updated_date_inspection_tracking as last_up23_152_, inspection0_.lat as lat24_152_, inspection0_.lng as lng25_152_, inspection0_.manager_user_id as manager26_152_, inspection0_.priority_suggestion_color as priorit27_152_, inspection0_.priority_suggestion_name as priorit28_152_, inspection0_.priority_suggestion_seq as priorit29_152_, inspection0_.send_email_replied_date as send_em30_152_, inspection0_.send_email_status as send_em31_152_, inspection0_.strategic_plan_id as strateg32_152_, inspection0_.strategic_plan_item_id as strateg33_152_, inspection0_.strategic_plan_item_total_effort as strateg34_152_, inspection0_.strategic_plan_name as strateg35_152_ from v_inspection_report inspection0_ inner join audit_plan_info_org auditplani1_ on inspection0_.audit_plan_info_org_id=auditplani1_.id inner join audit_work auditwork2_ on auditplani1_.id=auditwork2_.audit_plan_info_org_id inner join audit_work_auditor auditworka3_ on auditwork2_.id=auditworka3_.audit_work_id cross join inspection_report inspection4_ cross join audit_work auditwork8_ cross join audit_work auditwork11_ where inspection0_.inspection_report_id=inspection4_.id and auditplani1_.id=auditwork8_.audit_plan_info_org_id and inspection4_.audit_work_id=auditwork11_.id and (inspection4_.inspection_report_status in (@P0 , @P1 , @P2) or inspection4_.inspection_report_status=@P3 and (inspection4_.send_manager_date is not null)) and auditwork8_.is_show_leader=@P4 and (auditworka3_.position_name=@P5 and auditworka3_.user_id=@P6 or inspection0_.manager_user_id=869 or inspection0_.auditee_org_id in (select distinct auditeeorg9_.id from v_auditee_org_flat_tree auditeeorg9_ where auditeeorg9_.auditee_type=@P7 and (auditeeorg9_.parent_id in (1332 , 1673) or auditeeorg9_.id in (1332 , 1673)))) and auditwork11_.is_show_leader=@P8 order by inspection0_.last_updated_date desc offset 0 rows fetch next @P9 rows only",502029,2093487,-1591458,2809069158,131,502029
"(@P0 nvarchar(4000),@P1 nvarchar(4000),@P2 nvarchar(4000),@P3 nvarchar(4000),@P4 bit,@P5 nvarchar(4000),@P6 int,@P7 nvarchar(4000),@P8 bit,@P9 int)select distinct inspection0_.id as id1_152_, inspection0_.annual_plan_detail_id as annual_36_152_, inspection0_.annual_plan_draft_id as annual_p2_152_, inspection0_.annual_plan_draft_name as annual_p3_152_, inspection0_.annual_plan_id as annual_p4_152_, inspection0_.audit_plan_info_org_id as audit_p37_152_, inspection0_.audit_procedure_code as audit_pr5_152_, inspection0_.audit_procedure_id as audit_pr6_152_, inspection0_.audit_procedure_name as audit_pr7_152_, inspection0_.audit_procedure_years as audit_pr8_152_, inspection0_.audit_task_status as audit_ta9_152_, inspection0_.audit_work_status as audit_w10_152_, inspection0_.audited_date_set_report as audited11_152_, inspection0_.auditee_org_id as auditee38_152_, inspection0_.auditee_org_name as auditee12_152_, inspection0_.auditee_org_postcode as auditee13_152_, inspection0_.auditee_org_type as auditee14_152_, inspection0_.feedback_status as feedbac15_152_, inspection0_.inspection_date as inspect16_152_, inspection0_.inspection_evaluate_date as inspect17_152_, inspection0_.inspection_evaluate_status as inspect18_152_, inspection0_.inspection_report_id as inspect39_152_, inspection0_.inspection_report_status as inspect19_152_, inspection0_.is_show_leader as is_show20_152_, inspection0_.last_updated_date as last_up21_152_, inspection0_.last_updated_date_feedback_solution as last_up22_152_, inspection0_.last_updated_date_inspection_tracking as last_up23_152_, inspection0_.lat as lat24_152_, inspection0_.lng as lng25_152_, inspection0_.manager_user_id as manager26_152_, inspection0_.priority_suggestion_color as priorit27_152_, inspection0_.priority_suggestion_name as priorit28_152_, inspection0_.priority_suggestion_seq as priorit29_152_, inspection0_.send_email_replied_date as send_em30_152_, inspection0_.send_email_status as send_em31_152_, inspection0_.strategic_plan_id as strateg32_152_, inspection0_.strategic_plan_item_id as strateg33_152_, inspection0_.strategic_plan_item_total_effort as strateg34_152_, inspection0_.strategic_plan_name as strateg35_152_ from v_inspection_report inspection0_ inner join audit_plan_info_org auditplani1_ on inspection0_.audit_plan_info_org_id=auditplani1_.id inner join audit_work auditwork2_ on auditplani1_.id=auditwork2_.audit_plan_info_org_id inner join audit_work_auditor auditworka3_ on auditwork2_.id=auditworka3_.audit_work_id cross join inspection_report inspection4_ cross join audit_work auditwork8_ cross join audit_work auditwork11_ where inspection0_.inspection_report_id=inspection4_.id and auditplani1_.id=auditwork8_.audit_plan_info_org_id and inspection4_.audit_work_id=auditwork11_.id and (inspection4_.inspection_report_status in (@P0 , @P1 , @P2) or inspection4_.inspection_report_status=@P3 and (inspection4_.send_manager_date is not null)) and auditwork8_.is_show_leader=@P4 and (auditworka3_.position_name=@P5 and auditworka3_.user_id=@P6 or inspection0_.manager_user_id=143 or inspection0_.auditee_org_id in (select distinct auditeeorg9_.id from v_auditee_org_flat_tree auditeeorg9_ where auditeeorg9_.auditee_type=@P7 and (auditeeorg9_.parent_id in (null) or auditeeorg9_.id in (null)))) and auditwork11_.is_show_leader=@P8 order by inspection0_.last_updated_date desc offset 0 rows fetch next @P9 rows only",480115,478255,1860,1059049122,16,960230
"(@P0 nvarchar(4000),@P1 nvarchar(4000),@P2 nvarchar(4000),@P3 nvarchar(4000),@P4 bit,@P5 nvarchar(4000),@P6 int,@P7 nvarchar(4000),@P8 bit,@P9 int)select distinct inspection0_.id as id1_152_, inspection0_.annual_plan_detail_id as annual_36_152_, inspection0_.annual_plan_draft_id as annual_p2_152_, inspection0_.annual_plan_draft_name as annual_p3_152_, inspection0_.annual_plan_id as annual_p4_152_, inspection0_.audit_plan_info_org_id as audit_p37_152_, inspection0_.audit_procedure_code as audit_pr5_152_, inspection0_.audit_procedure_id as audit_pr6_152_, inspection0_.audit_procedure_name as audit_pr7_152_, inspection0_.audit_procedure_years as audit_pr8_152_, inspection0_.audit_task_status as audit_ta9_152_, inspection0_.audit_work_status as audit_w10_152_, inspection0_.audited_date_set_report as audited11_152_, inspection0_.auditee_org_id as auditee38_152_, inspection0_.auditee_org_name as auditee12_152_, inspection0_.auditee_org_postcode as auditee13_152_, inspection0_.auditee_org_type as auditee14_152_, inspection0_.feedback_status as feedbac15_152_, inspection0_.inspection_date as inspect16_152_, inspection0_.inspection_evaluate_date as inspect17_152_, inspection0_.inspection_evaluate_status as inspect18_152_, inspection0_.inspection_report_id as inspect39_152_, inspection0_.inspection_report_status as inspect19_152_, inspection0_.is_show_leader as is_show20_152_, inspection0_.last_updated_date as last_up21_152_, inspection0_.last_updated_date_feedback_solution as last_up22_152_, inspection0_.last_updated_date_inspection_tracking as last_up23_152_, inspection0_.lat as lat24_152_, inspection0_.lng as lng25_152_, inspection0_.manager_user_id as manager26_152_, inspection0_.priority_suggestion_color as priorit27_152_, inspection0_.priority_suggestion_name as priorit28_152_, inspection0_.priority_suggestion_seq as priorit29_152_, inspection0_.send_email_replied_date as send_em30_152_, inspection0_.send_email_status as send_em31_152_, inspection0_.strategic_plan_id as strateg32_152_, inspection0_.strategic_plan_item_id as strateg33_152_, inspection0_.strategic_plan_item_total_effort as strateg34_152_, inspection0_.strategic_plan_name as strateg35_152_ from v_inspection_report inspection0_ inner join audit_plan_info_org auditplani1_ on inspection0_.audit_plan_info_org_id=auditplani1_.id inner join audit_work auditwork2_ on auditplani1_.id=auditwork2_.audit_plan_info_org_id inner join audit_work_auditor auditworka3_ on auditwork2_.id=auditworka3_.audit_work_id cross join inspection_report inspection4_ cross join audit_work auditwork8_ cross join audit_work auditwork11_ where inspection0_.inspection_report_id=inspection4_.id and auditplani1_.id=auditwork8_.audit_plan_info_org_id and inspection4_.audit_work_id=auditwork11_.id and (inspection4_.inspection_report_status in (@P0 , @P1 , @P2) or inspection4_.inspection_report_status=@P3 and (inspection4_.send_manager_date is not null)) and auditwork8_.is_show_leader=@P4 and (auditworka3_.position_name=@P5 and auditworka3_.user_id=@P6 or inspection0_.manager_user_id=1348 or inspection0_.auditee_org_id in (select distinct auditeeorg9_.id from v_auditee_org_flat_tree auditeeorg9_ where auditeeorg9_.auditee_type=@P7 and (auditeeorg9_.parent_id in (1595 , 1657) or auditeeorg9_.id in (1595 , 1657)))) and auditwork11_.is_show_leader=@P8 order by inspection0_.last_updated_date desc offset 0 rows fetch next @P9 rows only",477299,1522841,-1045542,2808962215,147,477299
"(@P0 nvarchar(4000),@P1 nvarchar(4000),@P2 nvarchar(4000),@P3 nvarchar(4000),@P4 bit,@P5 nvarchar(4000),@P6 int,@P7 nvarchar(4000),@P8 bit,@P9 int)select distinct inspection0_.id as id1_152_, inspection0_.annual_plan_detail_id as annual_36_152_, inspection0_.annual_plan_draft_id as annual_p2_152_, inspection0_.annual_plan_draft_name as annual_p3_152_, inspection0_.annual_plan_id as annual_p4_152_, inspection0_.audit_plan_info_org_id as audit_p37_152_, inspection0_.audit_procedure_code as audit_pr5_152_, inspection0_.audit_procedure_id as audit_pr6_152_, inspection0_.audit_procedure_name as audit_pr7_152_, inspection0_.audit_procedure_years as audit_pr8_152_, inspection0_.audit_task_status as audit_ta9_152_, inspection0_.audit_work_status as audit_w10_152_, inspection0_.audited_date_set_report as audited11_152_, inspection0_.auditee_org_id as auditee38_152_, inspection0_.auditee_org_name as auditee12_152_, inspection0_.auditee_org_postcode as auditee13_152_, inspection0_.auditee_org_type as auditee14_152_, inspection0_.feedback_status as feedbac15_152_, inspection0_.inspection_date as inspect16_152_, inspection0_.inspection_evaluate_date as inspect17_152_, inspection0_.inspection_evaluate_status as inspect18_152_, inspection0_.inspection_report_id as inspect39_152_, inspection0_.inspection_report_status as inspect19_152_, inspection0_.is_show_leader as is_show20_152_, inspection0_.last_updated_date as last_up21_152_, inspection0_.last_updated_date_feedback_solution as last_up22_152_, inspection0_.last_updated_date_inspection_tracking as last_up23_152_, inspection0_.lat as lat24_152_, inspection0_.lng as lng25_152_, inspection0_.manager_user_id as manager26_152_, inspection0_.priority_suggestion_color as priorit27_152_, inspection0_.priority_suggestion_name as priorit28_152_, inspection0_.priority_suggestion_seq as priorit29_152_, inspection0_.send_email_replied_date as send_em30_152_, inspection0_.send_email_status as send_em31_152_, inspection0_.strategic_plan_id as strateg32_152_, inspection0_.strategic_plan_item_id as strateg33_152_, inspection0_.strategic_plan_item_total_effort as strateg34_152_, inspection0_.strategic_plan_name as strateg35_152_ from v_inspection_report inspection0_ inner join audit_plan_info_org auditplani1_ on inspection0_.audit_plan_info_org_id=auditplani1_.id inner join audit_work auditwork2_ on auditplani1_.id=auditwork2_.audit_plan_info_org_id inner join audit_work_auditor auditworka3_ on auditwork2_.id=auditworka3_.audit_work_id cross join inspection_report inspection4_ cross join audit_work auditwork8_ cross join audit_work auditwork11_ where inspection0_.inspection_report_id=inspection4_.id and auditplani1_.id=auditwork8_.audit_plan_info_org_id and inspection4_.audit_work_id=auditwork11_.id and (inspection4_.inspection_report_status in (@P0 , @P1 , @P2) or inspection4_.inspection_report_status=@P3 and (inspection4_.send_manager_date is not null)) and auditwork8_.is_show_leader=@P4 and (auditworka3_.position_name=@P5 and auditworka3_.user_id=@P6 or inspection0_.manager_user_id=703 or inspection0_.auditee_org_id in (select distinct auditeeorg9_.id from v_auditee_org_flat_tree auditeeorg9_ where auditeeorg9_.auditee_type=@P7 and (auditeeorg9_.parent_id in (1444 , 1564 , 1583 , 1612) or auditeeorg9_.id in (1444 , 1564 , 1583 , 1612)))) and auditwork11_.is_show_leader=@P8 order by inspection0_.last_updated_date desc offset 0 rows fetch next @P9 rows only",448791,1448212,-999421,2801141188,189,2243959
"(@P0 nvarchar(4000),@P1 nvarchar(4000),@P2 nvarchar(4000),@P3 nvarchar(4000),@P4 bit,@P5 nvarchar(4000),@P6 int,@P7 nvarchar(4000),@P8 bit,@P9 int)select distinct inspection0_.id as id1_152_, inspection0_.annual_plan_detail_id as annual_36_152_, inspection0_.annual_plan_draft_id as annual_p2_152_, inspection0_.annual_plan_draft_name as annual_p3_152_, inspection0_.annual_plan_id as annual_p4_152_, inspection0_.audit_plan_info_org_id as audit_p37_152_, inspection0_.audit_procedure_code as audit_pr5_152_, inspection0_.audit_procedure_id as audit_pr6_152_, inspection0_.audit_procedure_name as audit_pr7_152_, inspection0_.audit_procedure_years as audit_pr8_152_, inspection0_.audit_task_status as audit_ta9_152_, inspection0_.audit_work_status as audit_w10_152_, inspection0_.audited_date_set_report as audited11_152_, inspection0_.auditee_org_id as auditee38_152_, inspection0_.auditee_org_name as auditee12_152_, inspection0_.auditee_org_postcode as auditee13_152_, inspection0_.auditee_org_type as auditee14_152_, inspection0_.feedback_status as feedbac15_152_, inspection0_.inspection_date as inspect16_152_, inspection0_.inspection_evaluate_date as inspect17_152_, inspection0_.inspection_evaluate_status as inspect18_152_, inspection0_.inspection_report_id as inspect39_152_, inspection0_.inspection_report_status as inspect19_152_, inspection0_.is_show_leader as is_show20_152_, inspection0_.last_updated_date as last_up21_152_, inspection0_.last_updated_date_feedback_solution as last_up22_152_, inspection0_.last_updated_date_inspection_tracking as last_up23_152_, inspection0_.lat as lat24_152_, inspection0_.lng as lng25_152_, inspection0_.manager_user_id as manager26_152_, inspection0_.priority_suggestion_color as priorit27_152_, inspection0_.priority_suggestion_name as priorit28_152_, inspection0_.priority_suggestion_seq as priorit29_152_, inspection0_.send_email_replied_date as send_em30_152_, inspection0_.send_email_status as send_em31_152_, inspection0_.strategic_plan_id as strateg32_152_, inspection0_.strategic_plan_item_id as strateg33_152_, inspection0_.strategic_plan_item_total_effort as strateg34_152_, inspection0_.strategic_plan_name as strateg35_152_ from v_inspection_report inspection0_ inner join audit_plan_info_org auditplani1_ on inspection0_.audit_plan_info_org_id=auditplani1_.id inner join audit_work auditwork2_ on auditplani1_.id=auditwork2_.audit_plan_info_org_id inner join audit_work_auditor auditworka3_ on auditwork2_.id=auditworka3_.audit_work_id cross join inspection_report inspection4_ cross join audit_work auditwork8_ cross join audit_work auditwork11_ where inspection0_.inspection_report_id=inspection4_.id and auditplani1_.id=auditwork8_.audit_plan_info_org_id and inspection4_.audit_work_id=auditwork11_.id and (inspection4_.inspection_report_status in (@P0 , @P1 , @P2) or inspection4_.inspection_report_status=@P3 and (inspection4_.send_manager_date is not null)) and auditwork8_.is_show_leader=@P4 and (auditworka3_.position_name=@P5 and auditworka3_.user_id=@P6 or inspection0_.manager_user_id=173 or inspection0_.auditee_org_id in (select distinct auditeeorg9_.id from v_auditee_org_flat_tree auditeeorg9_ where auditeeorg9_.auditee_type=@P7 and (auditeeorg9_.parent_id in (80) or auditeeorg9_.id in (80)))) and auditwork11_.is_show_leader=@P8 order by inspection0_.last_updated_date desc offset 0 rows fetch next @P9 rows only",438662,1452021,-1013359,2809168005,184,2631975
"(@P0 nvarchar(4000),@P1 nvarchar(4000),@P2 nvarchar(4000),@P3 nvarchar(4000),@P4 bit,@P5 nvarchar(4000),@P6 int,@P7 nvarchar(4000),@P8 bit,@P9 int)select distinct inspection0_.id as id1_152_, inspection0_.annual_plan_detail_id as annual_36_152_, inspection0_.annual_plan_draft_id as annual_p2_152_, inspection0_.annual_plan_draft_name as annual_p3_152_, inspection0_.annual_plan_id as annual_p4_152_, inspection0_.audit_plan_info_org_id as audit_p37_152_, inspection0_.audit_procedure_code as audit_pr5_152_, inspection0_.audit_procedure_id as audit_pr6_152_, inspection0_.audit_procedure_name as audit_pr7_152_, inspection0_.audit_procedure_years as audit_pr8_152_, inspection0_.audit_task_status as audit_ta9_152_, inspection0_.audit_work_status as audit_w10_152_, inspection0_.audited_date_set_report as audited11_152_, inspection0_.auditee_org_id as auditee38_152_, inspection0_.auditee_org_name as auditee12_152_, inspection0_.auditee_org_postcode as auditee13_152_, inspection0_.auditee_org_type as auditee14_152_, inspection0_.feedback_status as feedbac15_152_, inspection0_.inspection_date as inspect16_152_, inspection0_.inspection_evaluate_date as inspect17_152_, inspection0_.inspection_evaluate_status as inspect18_152_, inspection0_.inspection_report_id as inspect39_152_, inspection0_.inspection_report_status as inspect19_152_, inspection0_.is_show_leader as is_show20_152_, inspection0_.last_updated_date as last_up21_152_, inspection0_.last_updated_date_feedback_solution as last_up22_152_, inspection0_.last_updated_date_inspection_tracking as last_up23_152_, inspection0_.lat as lat24_152_, inspection0_.lng as lng25_152_, inspection0_.manager_user_id as manager26_152_, inspection0_.priority_suggestion_color as priorit27_152_, inspection0_.priority_suggestion_name as priorit28_152_, inspection0_.priority_suggestion_seq as priorit29_152_, inspection0_.send_email_replied_date as send_em30_152_, inspection0_.send_email_status as send_em31_152_, inspection0_.strategic_plan_id as strateg32_152_, inspection0_.strategic_plan_item_id as strateg33_152_, inspection0_.strategic_plan_item_total_effort as strateg34_152_, inspection0_.strategic_plan_name as strateg35_152_ from v_inspection_report inspection0_ inner join audit_plan_info_org auditplani1_ on inspection0_.audit_plan_info_org_id=auditplani1_.id inner join audit_work auditwork2_ on auditplani1_.id=auditwork2_.audit_plan_info_org_id inner join audit_work_auditor auditworka3_ on auditwork2_.id=auditworka3_.audit_work_id cross join inspection_report inspection4_ cross join audit_work auditwork8_ cross join audit_work auditwork11_ where inspection0_.inspection_report_id=inspection4_.id and auditplani1_.id=auditwork8_.audit_plan_info_org_id and inspection4_.audit_work_id=auditwork11_.id and (inspection4_.inspection_report_status in (@P0 , @P1 , @P2) or inspection4_.inspection_report_status=@P3 and (inspection4_.send_manager_date is not null)) and auditwork8_.is_show_leader=@P4 and (auditworka3_.position_name=@P5 and auditworka3_.user_id=@P6 or inspection0_.manager_user_id=1653 or inspection0_.auditee_org_id in (select distinct auditeeorg9_.id from v_auditee_org_flat_tree auditeeorg9_ where auditeeorg9_.auditee_type=@P7 and (auditeeorg9_.parent_id in (1576) or auditeeorg9_.id in (1576)))) and auditwork11_.is_show_leader=@P8 order by inspection0_.last_updated_date desc offset 0 rows fetch next @P9 rows only",395187,1403632,-1008445,2764688951,140,1185561
"(@P0 nvarchar(4000),@P1 nvarchar(4000),@P2 nvarchar(4000),@P3 nvarchar(4000),@P4 bit,@P5 nvarchar(4000),@P6 int,@P7 nvarchar(4000),@P8 bit,@P9 int)select distinct inspection0_.id as id1_152_, inspection0_.annual_plan_detail_id as annual_36_152_, inspection0_.annual_plan_draft_id as annual_p2_152_, inspection0_.annual_plan_draft_name as annual_p3_152_, inspection0_.annual_plan_id as annual_p4_152_, inspection0_.audit_plan_info_org_id as audit_p37_152_, inspection0_.audit_procedure_code as audit_pr5_152_, inspection0_.audit_procedure_id as audit_pr6_152_, inspection0_.audit_procedure_name as audit_pr7_152_, inspection0_.audit_procedure_years as audit_pr8_152_, inspection0_.audit_task_status as audit_ta9_152_, inspection0_.audit_work_status as audit_w10_152_, inspection0_.audited_date_set_report as audited11_152_, inspection0_.auditee_org_id as auditee38_152_, inspection0_.auditee_org_name as auditee12_152_, inspection0_.auditee_org_postcode as auditee13_152_, inspection0_.auditee_org_type as auditee14_152_, inspection0_.feedback_status as feedbac15_152_, inspection0_.inspection_date as inspect16_152_, inspection0_.inspection_evaluate_date as inspect17_152_, inspection0_.inspection_evaluate_status as inspect18_152_, inspection0_.inspection_report_id as inspect39_152_, inspection0_.inspection_report_status as inspect19_152_, inspection0_.is_show_leader as is_show20_152_, inspection0_.last_updated_date as last_up21_152_, inspection0_.last_updated_date_feedback_solution as last_up22_152_, inspection0_.last_updated_date_inspection_tracking as last_up23_152_, inspection0_.lat as lat24_152_, inspection0_.lng as lng25_152_, inspection0_.manager_user_id as manager26_152_, inspection0_.priority_suggestion_color as priorit27_152_, inspection0_.priority_suggestion_name as priorit28_152_, inspection0_.priority_suggestion_seq as priorit29_152_, inspection0_.send_email_replied_date as send_em30_152_, inspection0_.send_email_status as send_em31_152_, inspection0_.strategic_plan_id as strateg32_152_, inspection0_.strategic_plan_item_id as strateg33_152_, inspection0_.strategic_plan_item_total_effort as strateg34_152_, inspection0_.strategic_plan_name as strateg35_152_ from v_inspection_report inspection0_ inner join audit_plan_info_org auditplani1_ on inspection0_.audit_plan_info_org_id=auditplani1_.id inner join audit_work auditwork2_ on auditplani1_.id=auditwork2_.audit_plan_info_org_id inner join audit_work_auditor auditworka3_ on auditwork2_.id=auditworka3_.audit_work_id cross join inspection_report inspection4_ cross join audit_work auditwork8_ cross join audit_work auditwork11_ where inspection0_.inspection_report_id=inspection4_.id and auditplani1_.id=auditwork8_.audit_plan_info_org_id and inspection4_.audit_work_id=auditwork11_.id and (inspection4_.inspection_report_status in (@P0 , @P1 , @P2) or inspection4_.inspection_report_status=@P3 and (inspection4_.send_manager_date is not null)) and auditwork8_.is_show_leader=@P4 and (auditworka3_.position_name=@P5 and auditworka3_.user_id=@P6 or inspection0_.manager_user_id=1076 or inspection0_.auditee_org_id in (select distinct auditeeorg9_.id from v_auditee_org_flat_tree auditeeorg9_ where auditeeorg9_.auditee_type=@P7 and (auditeeorg9_.parent_id in (10081) or auditeeorg9_.id in (10081)))) and auditwork11_.is_show_leader=@P8 order by inspection0_.last_updated_date desc offset 0 rows fetch next @P9 rows only",383510,1413330,-1029820,2692334438,140,383510
"(@P0 nvarchar(4000),@P1 nvarchar(4000),@P2 nvarchar(4000),@P3 nvarchar(4000),@P4 bit,@P5 nvarchar(4000),@P6 int,@P7 nvarchar(4000),@P8 bit,@P9 int)select distinct inspection0_.id as id1_152_, inspection0_.annual_plan_detail_id as annual_36_152_, inspection0_.annual_plan_draft_id as annual_p2_152_, inspection0_.annual_plan_draft_name as annual_p3_152_, inspection0_.annual_plan_id as annual_p4_152_, inspection0_.audit_plan_info_org_id as audit_p37_152_, inspection0_.audit_procedure_code as audit_pr5_152_, inspection0_.audit_procedure_id as audit_pr6_152_, inspection0_.audit_procedure_name as audit_pr7_152_, inspection0_.audit_procedure_years as audit_pr8_152_, inspection0_.audit_task_status as audit_ta9_152_, inspection0_.audit_work_status as audit_w10_152_, inspection0_.audited_date_set_report as audited11_152_, inspection0_.auditee_org_id as auditee38_152_, inspection0_.auditee_org_name as auditee12_152_, inspection0_.auditee_org_postcode as auditee13_152_, inspection0_.auditee_org_type as auditee14_152_, inspection0_.feedback_status as feedbac15_152_, inspection0_.inspection_date as inspect16_152_, inspection0_.inspection_evaluate_date as inspect17_152_, inspection0_.inspection_evaluate_status as inspect18_152_, inspection0_.inspection_report_id as inspect39_152_, inspection0_.inspection_report_status as inspect19_152_, inspection0_.is_show_leader as is_show20_152_, inspection0_.last_updated_date as last_up21_152_, inspection0_.last_updated_date_feedback_solution as last_up22_152_, inspection0_.last_updated_date_inspection_tracking as last_up23_152_, inspection0_.lat as lat24_152_, inspection0_.lng as lng25_152_, inspection0_.manager_user_id as manager26_152_, inspection0_.priority_suggestion_color as priorit27_152_, inspection0_.priority_suggestion_name as priorit28_152_, inspection0_.priority_suggestion_seq as priorit29_152_, inspection0_.send_email_replied_date as send_em30_152_, inspection0_.send_email_status as send_em31_152_, inspection0_.strategic_plan_id as strateg32_152_, inspection0_.strategic_plan_item_id as strateg33_152_, inspection0_.strategic_plan_item_total_effort as strateg34_152_, inspection0_.strategic_plan_name as strateg35_152_ from v_inspection_report inspection0_ inner join audit_plan_info_org auditplani1_ on inspection0_.audit_plan_info_org_id=auditplani1_.id inner join audit_work auditwork2_ on auditplani1_.id=auditwork2_.audit_plan_info_org_id inner join audit_work_auditor auditworka3_ on auditwork2_.id=auditworka3_.audit_work_id cross join inspection_report inspection4_ cross join audit_work auditwork8_ cross join audit_work auditwork11_ where inspection0_.inspection_report_id=inspection4_.id and auditplani1_.id=auditwork8_.audit_plan_info_org_id and inspection4_.audit_work_id=auditwork11_.id and (inspection4_.inspection_report_status in (@P0 , @P1 , @P2) or inspection4_.inspection_report_status=@P3 and (inspection4_.send_manager_date is not null)) and auditwork8_.is_show_leader=@P4 and (auditworka3_.position_name=@P5 and auditworka3_.user_id=@P6 or inspection0_.manager_user_id=468 or inspection0_.auditee_org_id in (select distinct auditeeorg9_.id from v_auditee_org_flat_tree auditeeorg9_ where auditeeorg9_.auditee_type=@P7 and (auditeeorg9_.parent_id in (1422) or auditeeorg9_.id in (1422)))) and auditwork11_.is_show_leader=@P8 order by inspection0_.last_updated_date desc offset 0 rows fetch next @P9 rows only",381612,1377593,-995981,2804913490,157,5342581
"(@P0 nvarchar(4000),@P1 nvarchar(4000),@P2 nvarchar(4000),@P3 nvarchar(4000),@P4 bit,@P5 nvarchar(4000),@P6 int,@P7 nvarchar(4000),@P8 bit,@P9 int)select distinct inspection0_.id as id1_152_, inspection0_.annual_plan_detail_id as annual_36_152_, inspection0_.annual_plan_draft_id as annual_p2_152_, inspection0_.annual_plan_draft_name as annual_p3_152_, inspection0_.annual_plan_id as annual_p4_152_, inspection0_.audit_plan_info_org_id as audit_p37_152_, inspection0_.audit_procedure_code as audit_pr5_152_, inspection0_.audit_procedure_id as audit_pr6_152_, inspection0_.audit_procedure_name as audit_pr7_152_, inspection0_.audit_procedure_years as audit_pr8_152_, inspection0_.audit_task_status as audit_ta9_152_, inspection0_.audit_work_status as audit_w10_152_, inspection0_.audited_date_set_report as audited11_152_, inspection0_.auditee_org_id as auditee38_152_, inspection0_.auditee_org_name as auditee12_152_, inspection0_.auditee_org_postcode as auditee13_152_, inspection0_.auditee_org_type as auditee14_152_, inspection0_.feedback_status as feedbac15_152_, inspection0_.inspection_date as inspect16_152_, inspection0_.inspection_evaluate_date as inspect17_152_, inspection0_.inspection_evaluate_status as inspect18_152_, inspection0_.inspection_report_id as inspect39_152_, inspection0_.inspection_report_status as inspect19_152_, inspection0_.is_show_leader as is_show20_152_, inspection0_.last_updated_date as last_up21_152_, inspection0_.last_updated_date_feedback_solution as last_up22_152_, inspection0_.last_updated_date_inspection_tracking as last_up23_152_, inspection0_.lat as lat24_152_, inspection0_.lng as lng25_152_, inspection0_.manager_user_id as manager26_152_, inspection0_.priority_suggestion_color as priorit27_152_, inspection0_.priority_suggestion_name as priorit28_152_, inspection0_.priority_suggestion_seq as priorit29_152_, inspection0_.send_email_replied_date as send_em30_152_, inspection0_.send_email_status as send_em31_152_, inspection0_.strategic_plan_id as strateg32_152_, inspection0_.strategic_plan_item_id as strateg33_152_, inspection0_.strategic_plan_item_total_effort as strateg34_152_, inspection0_.strategic_plan_name as strateg35_152_ from v_inspection_report inspection0_ inner join audit_plan_info_org auditplani1_ on inspection0_.audit_plan_info_org_id=auditplani1_.id inner join audit_work auditwork2_ on auditplani1_.id=auditwork2_.audit_plan_info_org_id inner join audit_work_auditor auditworka3_ on auditwork2_.id=auditworka3_.audit_work_id cross join inspection_report inspection4_ cross join audit_work auditwork8_ cross join audit_work auditwork11_ where inspection0_.inspection_report_id=inspection4_.id and auditplani1_.id=auditwork8_.audit_plan_info_org_id and inspection4_.audit_work_id=auditwork11_.id and (inspection4_.inspection_report_status in (@P0 , @P1 , @P2) or inspection4_.inspection_report_status=@P3 and (inspection4_.send_manager_date is not null)) and auditwork8_.is_show_leader=@P4 and (auditworka3_.position_name=@P5 and auditworka3_.user_id=@P6 or inspection0_.manager_user_id=363 or inspection0_.auditee_org_id in (select distinct auditeeorg9_.id from v_auditee_org_flat_tree auditeeorg9_ where auditeeorg9_.auditee_type=@P7 and (auditeeorg9_.parent_id in (109) or auditeeorg9_.id in (109)))) and auditwork11_.is_show_leader=@P8 order by inspection0_.last_updated_date desc offset 0 rows fetch next @P9 rows only",377809,1467759,-1089950,2809173119,156,1889048
"(@P0 nvarchar(4000),@P1 nvarchar(4000),@P2 nvarchar(4000),@P3 nvarchar(4000),@P4 bit,@P5 nvarchar(4000),@P6 int,@P7 nvarchar(4000),@P8 bit,@P9 int)select distinct inspection0_.id as id1_152_, inspection0_.annual_plan_detail_id as annual_36_152_, inspection0_.annual_plan_draft_id as annual_p2_152_, inspection0_.annual_plan_draft_name as annual_p3_152_, inspection0_.annual_plan_id as annual_p4_152_, inspection0_.audit_plan_info_org_id as audit_p37_152_, inspection0_.audit_procedure_code as audit_pr5_152_, inspection0_.audit_procedure_id as audit_pr6_152_, inspection0_.audit_procedure_name as audit_pr7_152_, inspection0_.audit_procedure_years as audit_pr8_152_, inspection0_.audit_task_status as audit_ta9_152_, inspection0_.audit_work_status as audit_w10_152_, inspection0_.audited_date_set_report as audited11_152_, inspection0_.auditee_org_id as auditee38_152_, inspection0_.auditee_org_name as auditee12_152_, inspection0_.auditee_org_postcode as auditee13_152_, inspection0_.auditee_org_type as auditee14_152_, inspection0_.feedback_status as feedbac15_152_, inspection0_.inspection_date as inspect16_152_, inspection0_.inspection_evaluate_date as inspect17_152_, inspection0_.inspection_evaluate_status as inspect18_152_, inspection0_.inspection_report_id as inspect39_152_, inspection0_.inspection_report_status as inspect19_152_, inspection0_.is_show_leader as is_show20_152_, inspection0_.last_updated_date as last_up21_152_, inspection0_.last_updated_date_feedback_solution as last_up22_152_, inspection0_.last_updated_date_inspection_tracking as last_up23_152_, inspection0_.lat as lat24_152_, inspection0_.lng as lng25_152_, inspection0_.manager_user_id as manager26_152_, inspection0_.priority_suggestion_color as priorit27_152_, inspection0_.priority_suggestion_name as priorit28_152_, inspection0_.priority_suggestion_seq as priorit29_152_, inspection0_.send_email_replied_date as send_em30_152_, inspection0_.send_email_status as send_em31_152_, inspection0_.strategic_plan_id as strateg32_152_, inspection0_.strategic_plan_item_id as strateg33_152_, inspection0_.strategic_plan_item_total_effort as strateg34_152_, inspection0_.strategic_plan_name as strateg35_152_ from v_inspection_report inspection0_ inner join audit_plan_info_org auditplani1_ on inspection0_.audit_plan_info_org_id=auditplani1_.id inner join audit_work auditwork2_ on auditplani1_.id=auditwork2_.audit_plan_info_org_id inner join audit_work_auditor auditworka3_ on auditwork2_.id=auditworka3_.audit_work_id cross join inspection_report inspection4_ cross join audit_work auditwork8_ cross join audit_work auditwork11_ where inspection0_.inspection_report_id=inspection4_.id and auditplani1_.id=auditwork8_.audit_plan_info_org_id and inspection4_.audit_work_id=auditwork11_.id and (inspection4_.inspection_report_status in (@P0 , @P1 , @P2) or inspection4_.inspection_report_status=@P3 and (inspection4_.send_manager_date is not null)) and auditwork8_.is_show_leader=@P4 and (auditworka3_.position_name=@P5 and auditworka3_.user_id=@P6 or inspection0_.manager_user_id=2295 or inspection0_.auditee_org_id in (select distinct auditeeorg9_.id from v_auditee_org_flat_tree auditeeorg9_ where auditeeorg9_.auditee_type=@P7 and (auditeeorg9_.parent_id in (28 , 29 , 41 , 60 , 80) or auditeeorg9_.id in (28 , 29 , 41 , 60 , 80)))) and auditwork11_.is_show_leader=@P8 order by inspection0_.last_updated_date desc offset 0 rows fetch next @P9 rows only",374563,1414764,-1040201,2809170258,149,374563
"(@P0 nvarchar(4000),@P1 nvarchar(4000),@P2 nvarchar(4000),@P3 nvarchar(4000),@P4 bit,@P5 nvarchar(4000),@P6 int,@P7 nvarchar(4000),@P8 bit,@P9 int)select distinct inspection0_.id as id1_152_, inspection0_.annual_plan_detail_id as annual_36_152_, inspection0_.annual_plan_draft_id as annual_p2_152_, inspection0_.annual_plan_draft_name as annual_p3_152_, inspection0_.annual_plan_id as annual_p4_152_, inspection0_.audit_plan_info_org_id as audit_p37_152_, inspection0_.audit_procedure_code as audit_pr5_152_, inspection0_.audit_procedure_id as audit_pr6_152_, inspection0_.audit_procedure_name as audit_pr7_152_, inspection0_.audit_procedure_years as audit_pr8_152_, inspection0_.audit_task_status as audit_ta9_152_, inspection0_.audit_work_status as audit_w10_152_, inspection0_.audited_date_set_report as audited11_152_, inspection0_.auditee_org_id as auditee38_152_, inspection0_.auditee_org_name as auditee12_152_, inspection0_.auditee_org_postcode as auditee13_152_, inspection0_.auditee_org_type as auditee14_152_, inspection0_.feedback_status as feedbac15_152_, inspection0_.inspection_date as inspect16_152_, inspection0_.inspection_evaluate_date as inspect17_152_, inspection0_.inspection_evaluate_status as inspect18_152_, inspection0_.inspection_report_id as inspect39_152_, inspection0_.inspection_report_status as inspect19_152_, inspection0_.is_show_leader as is_show20_152_, inspection0_.last_updated_date as last_up21_152_, inspection0_.last_updated_date_feedback_solution as last_up22_152_, inspection0_.last_updated_date_inspection_tracking as last_up23_152_, inspection0_.lat as lat24_152_, inspection0_.lng as lng25_152_, inspection0_.manager_user_id as manager26_152_, inspection0_.priority_suggestion_color as priorit27_152_, inspection0_.priority_suggestion_name as priorit28_152_, inspection0_.priority_suggestion_seq as priorit29_152_, inspection0_.send_email_replied_date as send_em30_152_, inspection0_.send_email_status as send_em31_152_, inspection0_.strategic_plan_id as strateg32_152_, inspection0_.strategic_plan_item_id as strateg33_152_, inspection0_.strategic_plan_item_total_effort as strateg34_152_, inspection0_.strategic_plan_name as strateg35_152_ from v_inspection_report inspection0_ inner join audit_plan_info_org auditplani1_ on inspection0_.audit_plan_info_org_id=auditplani1_.id inner join audit_work auditwork2_ on auditplani1_.id=auditwork2_.audit_plan_info_org_id inner join audit_work_auditor auditworka3_ on auditwork2_.id=auditworka3_.audit_work_id cross join inspection_report inspection4_ cross join audit_work auditwork8_ cross join audit_work auditwork11_ where inspection0_.inspection_report_id=inspection4_.id and auditplani1_.id=auditwork8_.audit_plan_info_org_id and inspection4_.audit_work_id=auditwork11_.id and (inspection4_.inspection_report_status in (@P0 , @P1 , @P2) or inspection4_.inspection_report_status=@P3 and (inspection4_.send_manager_date is not null)) and auditwork8_.is_show_leader=@P4 and (auditworka3_.position_name=@P5 and auditworka3_.user_id=@P6 or inspection0_.manager_user_id=168 or inspection0_.auditee_org_id in (select distinct auditeeorg9_.id from v_auditee_org_flat_tree auditeeorg9_ where auditeeorg9_.auditee_type=@P7 and (auditeeorg9_.parent_id in (51) or auditeeorg9_.id in (51)))) and auditwork11_.is_show_leader=@P8 order by inspection0_.last_updated_date desc offset 0 rows fetch next @P9 rows only",353112,1345051,-991939,2809401453,134,353112
"(@P0 nvarchar(4000),@P1 nvarchar(4000),@P2 nvarchar(4000),@P3 nvarchar(4000),@P4 bit,@P5 nvarchar(4000),@P6 int,@P7 nvarchar(4000),@P8 bit,@P9 int)select distinct inspection0_.id as id1_152_, inspection0_.annual_plan_detail_id as annual_36_152_, inspection0_.annual_plan_draft_id as annual_p2_152_, inspection0_.annual_plan_draft_name as annual_p3_152_, inspection0_.annual_plan_id as annual_p4_152_, inspection0_.audit_plan_info_org_id as audit_p37_152_, inspection0_.audit_procedure_code as audit_pr5_152_, inspection0_.audit_procedure_id as audit_pr6_152_, inspection0_.audit_procedure_name as audit_pr7_152_, inspection0_.audit_procedure_years as audit_pr8_152_, inspection0_.audit_task_status as audit_ta9_152_, inspection0_.audit_work_status as audit_w10_152_, inspection0_.audited_date_set_report as audited11_152_, inspection0_.auditee_org_id as auditee38_152_, inspection0_.auditee_org_name as auditee12_152_, inspection0_.auditee_org_postcode as auditee13_152_, inspection0_.auditee_org_type as auditee14_152_, inspection0_.feedback_status as feedbac15_152_, inspection0_.inspection_date as inspect16_152_, inspection0_.inspection_evaluate_date as inspect17_152_, inspection0_.inspection_evaluate_status as inspect18_152_, inspection0_.inspection_report_id as inspect39_152_, inspection0_.inspection_report_status as inspect19_152_, inspection0_.is_show_leader as is_show20_152_, inspection0_.last_updated_date as last_up21_152_, inspection0_.last_updated_date_feedback_solution as last_up22_152_, inspection0_.last_updated_date_inspection_tracking as last_up23_152_, inspection0_.lat as lat24_152_, inspection0_.lng as lng25_152_, inspection0_.manager_user_id as manager26_152_, inspection0_.priority_suggestion_color as priorit27_152_, inspection0_.priority_suggestion_name as priorit28_152_, inspection0_.priority_suggestion_seq as priorit29_152_, inspection0_.send_email_replied_date as send_em30_152_, inspection0_.send_email_status as send_em31_152_, inspection0_.strategic_plan_id as strateg32_152_, inspection0_.strategic_plan_item_id as strateg33_152_, inspection0_.strategic_plan_item_total_effort as strateg34_152_, inspection0_.strategic_plan_name as strateg35_152_ from v_inspection_report inspection0_ inner join audit_plan_info_org auditplani1_ on inspection0_.audit_plan_info_org_id=auditplani1_.id inner join audit_work auditwork2_ on auditplani1_.id=auditwork2_.audit_plan_info_org_id inner join audit_work_auditor auditworka3_ on auditwork2_.id=auditworka3_.audit_work_id cross join inspection_report inspection4_ cross join audit_work auditwork8_ cross join audit_work auditwork11_ where inspection0_.inspection_report_id=inspection4_.id and auditplani1_.id=auditwork8_.audit_plan_info_org_id and inspection4_.audit_work_id=auditwork11_.id and (inspection4_.inspection_report_status in (@P0 , @P1 , @P2) or inspection4_.inspection_report_status=@P3 and (inspection4_.send_manager_date is not null)) and auditwork8_.is_show_leader=@P4 and (auditworka3_.position_name=@P5 and auditworka3_.user_id=@P6 or inspection0_.manager_user_id=291 or inspection0_.auditee_org_id in (select distinct auditeeorg9_.id from v_auditee_org_flat_tree auditeeorg9_ where auditeeorg9_.auditee_type=@P7 and (auditeeorg9_.parent_id in (1431 , 1658 , 1749 , 1750) or auditeeorg9_.id in (1431 , 1658 , 1749 , 1750)))) and auditwork11_.is_show_leader=@P8 order by inspection0_.last_updated_date desc offset 0 rows fetch next @P9 rows only",346268,1370641,-1024373,2809080486,140,1038804
"(@P0 nvarchar(4000),@P1 nvarchar(4000),@P2 nvarchar(4000),@P3 nvarchar(4000),@P4 bit,@P5 nvarchar(4000),@P6 int,@P7 nvarchar(4000),@P8 bit,@P9 int)select distinct inspection0_.id as id1_152_, inspection0_.annual_plan_detail_id as annual_36_152_, inspection0_.annual_plan_draft_id as annual_p2_152_, inspection0_.annual_plan_draft_name as annual_p3_152_, inspection0_.annual_plan_id as annual_p4_152_, inspection0_.audit_plan_info_org_id as audit_p37_152_, inspection0_.audit_procedure_code as audit_pr5_152_, inspection0_.audit_procedure_id as audit_pr6_152_, inspection0_.audit_procedure_name as audit_pr7_152_, inspection0_.audit_procedure_years as audit_pr8_152_, inspection0_.audit_task_status as audit_ta9_152_, inspection0_.audit_work_status as audit_w10_152_, inspection0_.audited_date_set_report as audited11_152_, inspection0_.auditee_org_id as auditee38_152_, inspection0_.auditee_org_name as auditee12_152_, inspection0_.auditee_org_postcode as auditee13_152_, inspection0_.auditee_org_type as auditee14_152_, inspection0_.feedback_status as feedbac15_152_, inspection0_.inspection_date as inspect16_152_, inspection0_.inspection_evaluate_date as inspect17_152_, inspection0_.inspection_evaluate_status as inspect18_152_, inspection0_.inspection_report_id as inspect39_152_, inspection0_.inspection_report_status as inspect19_152_, inspection0_.is_show_leader as is_show20_152_, inspection0_.last_updated_date as last_up21_152_, inspection0_.last_updated_date_feedback_solution as last_up22_152_, inspection0_.last_updated_date_inspection_tracking as last_up23_152_, inspection0_.lat as lat24_152_, inspection0_.lng as lng25_152_, inspection0_.manager_user_id as manager26_152_, inspection0_.priority_suggestion_color as priorit27_152_, inspection0_.priority_suggestion_name as priorit28_152_, inspection0_.priority_suggestion_seq as priorit29_152_, inspection0_.send_email_replied_date as send_em30_152_, inspection0_.send_email_status as send_em31_152_, inspection0_.strategic_plan_id as strateg32_152_, inspection0_.strategic_plan_item_id as strateg33_152_, inspection0_.strategic_plan_item_total_effort as strateg34_152_, inspection0_.strategic_plan_name as strateg35_152_ from v_inspection_report inspection0_ inner join audit_plan_info_org auditplani1_ on inspection0_.audit_plan_info_org_id=auditplani1_.id inner join audit_work auditwork2_ on auditplani1_.id=auditwork2_.audit_plan_info_org_id inner join audit_work_auditor auditworka3_ on auditwork2_.id=auditworka3_.audit_work_id cross join inspection_report inspection4_ cross join audit_work auditwork8_ cross join audit_work auditwork11_ where inspection0_.inspection_report_id=inspection4_.id and auditplani1_.id=auditwork8_.audit_plan_info_org_id and inspection4_.audit_work_id=auditwork11_.id and (inspection4_.inspection_report_status in (@P0 , @P1 , @P2) or inspection4_.inspection_report_status=@P3 and (inspection4_.send_manager_date is not null)) and auditwork8_.is_show_leader=@P4 and (auditworka3_.position_name=@P5 and auditworka3_.user_id=@P6 or inspection0_.manager_user_id=1589 or inspection0_.auditee_org_id in (select distinct auditeeorg9_.id from v_auditee_org_flat_tree auditeeorg9_ where auditeeorg9_.auditee_type=@P7 and (auditeeorg9_.parent_id in (1336 , 1426 , 1438) or auditeeorg9_.id in (1336 , 1426 , 1438)))) and auditwork11_.is_show_leader=@P8 order by inspection0_.last_updated_date desc offset 0 rows fetch next @P9 rows only",342886,1473393,-1130507,2695919794,186,1714430
"(@P0 nvarchar(4000),@P1 nvarchar(4000),@P2 nvarchar(4000),@P3 nvarchar(4000),@P4 bit,@P5 nvarchar(4000),@P6 int,@P7 nvarchar(4000),@P8 bit,@P9 int)select distinct inspection0_.id as id1_152_, inspection0_.annual_plan_detail_id as annual_36_152_, inspection0_.annual_plan_draft_id as annual_p2_152_, inspection0_.annual_plan_draft_name as annual_p3_152_, inspection0_.annual_plan_id as annual_p4_152_, inspection0_.audit_plan_info_org_id as audit_p37_152_, inspection0_.audit_procedure_code as audit_pr5_152_, inspection0_.audit_procedure_id as audit_pr6_152_, inspection0_.audit_procedure_name as audit_pr7_152_, inspection0_.audit_procedure_years as audit_pr8_152_, inspection0_.audit_task_status as audit_ta9_152_, inspection0_.audit_work_status as audit_w10_152_, inspection0_.audited_date_set_report as audited11_152_, inspection0_.auditee_org_id as auditee38_152_, inspection0_.auditee_org_name as auditee12_152_, inspection0_.auditee_org_postcode as auditee13_152_, inspection0_.auditee_org_type as auditee14_152_, inspection0_.feedback_status as feedbac15_152_, inspection0_.inspection_date as inspect16_152_, inspection0_.inspection_evaluate_date as inspect17_152_, inspection0_.inspection_evaluate_status as inspect18_152_, inspection0_.inspection_report_id as inspect39_152_, inspection0_.inspection_report_status as inspect19_152_, inspection0_.is_show_leader as is_show20_152_, inspection0_.last_updated_date as last_up21_152_, inspection0_.last_updated_date_feedback_solution as last_up22_152_, inspection0_.last_updated_date_inspection_tracking as last_up23_152_, inspection0_.lat as lat24_152_, inspection0_.lng as lng25_152_, inspection0_.manager_user_id as manager26_152_, inspection0_.priority_suggestion_color as priorit27_152_, inspection0_.priority_suggestion_name as priorit28_152_, inspection0_.priority_suggestion_seq as priorit29_152_, inspection0_.send_email_replied_date as send_em30_152_, inspection0_.send_email_status as send_em31_152_, inspection0_.strategic_plan_id as strateg32_152_, inspection0_.strategic_plan_item_id as strateg33_152_, inspection0_.strategic_plan_item_total_effort as strateg34_152_, inspection0_.strategic_plan_name as strateg35_152_ from v_inspection_report inspection0_ inner join audit_plan_info_org auditplani1_ on inspection0_.audit_plan_info_org_id=auditplani1_.id inner join audit_work auditwork2_ on auditplani1_.id=auditwork2_.audit_plan_info_org_id inner join audit_work_auditor auditworka3_ on auditwork2_.id=auditworka3_.audit_work_id cross join inspection_report inspection4_ cross join audit_work auditwork8_ cross join audit_work auditwork11_ where inspection0_.inspection_report_id=inspection4_.id and auditplani1_.id=auditwork8_.audit_plan_info_org_id and inspection4_.audit_work_id=auditwork11_.id and (inspection4_.inspection_report_status in (@P0 , @P1 , @P2) or inspection4_.inspection_report_status=@P3 and (inspection4_.send_manager_date is not null)) and auditwork8_.is_show_leader=@P4 and (auditworka3_.position_name=@P5 and auditworka3_.user_id=@P6 or inspection0_.manager_user_id=199 or inspection0_.auditee_org_id in (select distinct auditeeorg9_.id from v_auditee_org_flat_tree auditeeorg9_ where auditeeorg9_.auditee_type=@P7 and (auditeeorg9_.parent_id in (29) or auditeeorg9_.id in (29)))) and auditwork11_.is_show_leader=@P8 order by inspection0_.last_updated_date desc offset 0 rows fetch next @P9 rows only",324386,1283416,-959030,2594165960,133,324386
"(@P0 nvarchar(4000),@P1 nvarchar(4000),@P2 nvarchar(4000),@P3 nvarchar(4000),@P4 bit,@P5 nvarchar(4000),@P6 int,@P7 nvarchar(4000),@P8 bit,@P9 int)select distinct inspection0_.id as id1_152_, inspection0_.annual_plan_detail_id as annual_36_152_, inspection0_.annual_plan_draft_id as annual_p2_152_, inspection0_.annual_plan_draft_name as annual_p3_152_, inspection0_.annual_plan_id as annual_p4_152_, inspection0_.audit_plan_info_org_id as audit_p37_152_, inspection0_.audit_procedure_code as audit_pr5_152_, inspection0_.audit_procedure_id as audit_pr6_152_, inspection0_.audit_procedure_name as audit_pr7_152_, inspection0_.audit_procedure_years as audit_pr8_152_, inspection0_.audit_task_status as audit_ta9_152_, inspection0_.audit_work_status as audit_w10_152_, inspection0_.audited_date_set_report as audited11_152_, inspection0_.auditee_org_id as auditee38_152_, inspection0_.auditee_org_name as auditee12_152_, inspection0_.auditee_org_postcode as auditee13_152_, inspection0_.auditee_org_type as auditee14_152_, inspection0_.feedback_status as feedbac15_152_, inspection0_.inspection_date as inspect16_152_, inspection0_.inspection_evaluate_date as inspect17_152_, inspection0_.inspection_evaluate_status as inspect18_152_, inspection0_.inspection_report_id as inspect39_152_, inspection0_.inspection_report_status as inspect19_152_, inspection0_.is_show_leader as is_show20_152_, inspection0_.last_updated_date as last_up21_152_, inspection0_.last_updated_date_feedback_solution as last_up22_152_, inspection0_.last_updated_date_inspection_tracking as last_up23_152_, inspection0_.lat as lat24_152_, inspection0_.lng as lng25_152_, inspection0_.manager_user_id as manager26_152_, inspection0_.priority_suggestion_color as priorit27_152_, inspection0_.priority_suggestion_name as priorit28_152_, inspection0_.priority_suggestion_seq as priorit29_152_, inspection0_.send_email_replied_date as send_em30_152_, inspection0_.send_email_status as send_em31_152_, inspection0_.strategic_plan_id as strateg32_152_, inspection0_.strategic_plan_item_id as strateg33_152_, inspection0_.strategic_plan_item_total_effort as strateg34_152_, inspection0_.strategic_plan_name as strateg35_152_ from v_inspection_report inspection0_ inner join audit_plan_info_org auditplani1_ on inspection0_.audit_plan_info_org_id=auditplani1_.id inner join audit_work auditwork2_ on auditplani1_.id=auditwork2_.audit_plan_info_org_id inner join audit_work_auditor auditworka3_ on auditwork2_.id=auditworka3_.audit_work_id cross join inspection_report inspection4_ cross join audit_work auditwork8_ cross join audit_work auditwork11_ where inspection0_.inspection_report_id=inspection4_.id and auditplani1_.id=auditwork8_.audit_plan_info_org_id and inspection4_.audit_work_id=auditwork11_.id and (inspection4_.inspection_report_status in (@P0 , @P1 , @P2) or inspection4_.inspection_report_status=@P3 and (inspection4_.send_manager_date is not null)) and auditwork8_.is_show_leader=@P4 and (auditworka3_.position_name=@P5 and auditworka3_.user_id=@P6 or inspection0_.manager_user_id=208 or inspection0_.auditee_org_id in (select distinct auditeeorg9_.id from v_auditee_org_flat_tree auditeeorg9_ where auditeeorg9_.auditee_type=@P7 and (auditeeorg9_.parent_id in (60) or auditeeorg9_.id in (60)))) and auditwork11_.is_show_leader=@P8 order by inspection0_.last_updated_date desc offset 0 rows fetch next @P9 rows only",322347,1422905,-1100558,2809165905,155,644695
"(@P0 nvarchar(4000),@P1 nvarchar(4000),@P2 nvarchar(4000),@P3 nvarchar(4000),@P4 bit,@P5 nvarchar(4000),@P6 int,@P7 nvarchar(4000),@P8 bit,@P9 int)select distinct inspection0_.id as id1_152_, inspection0_.annual_plan_detail_id as annual_36_152_, inspection0_.annual_plan_draft_id as annual_p2_152_, inspection0_.annual_plan_draft_name as annual_p3_152_, inspection0_.annual_plan_id as annual_p4_152_, inspection0_.audit_plan_info_org_id as audit_p37_152_, inspection0_.audit_procedure_code as audit_pr5_152_, inspection0_.audit_procedure_id as audit_pr6_152_, inspection0_.audit_procedure_name as audit_pr7_152_, inspection0_.audit_procedure_years as audit_pr8_152_, inspection0_.audit_task_status as audit_ta9_152_, inspection0_.audit_work_status as audit_w10_152_, inspection0_.audited_date_set_report as audited11_152_, inspection0_.auditee_org_id as auditee38_152_, inspection0_.auditee_org_name as auditee12_152_, inspection0_.auditee_org_postcode as auditee13_152_, inspection0_.auditee_org_type as auditee14_152_, inspection0_.feedback_status as feedbac15_152_, inspection0_.inspection_date as inspect16_152_, inspection0_.inspection_evaluate_date as inspect17_152_, inspection0_.inspection_evaluate_status as inspect18_152_, inspection0_.inspection_report_id as inspect39_152_, inspection0_.inspection_report_status as inspect19_152_, inspection0_.is_show_leader as is_show20_152_, inspection0_.last_updated_date as last_up21_152_, inspection0_.last_updated_date_feedback_solution as last_up22_152_, inspection0_.last_updated_date_inspection_tracking as last_up23_152_, inspection0_.lat as lat24_152_, inspection0_.lng as lng25_152_, inspection0_.manager_user_id as manager26_152_, inspection0_.priority_suggestion_color as priorit27_152_, inspection0_.priority_suggestion_name as priorit28_152_, inspection0_.priority_suggestion_seq as priorit29_152_, inspection0_.send_email_replied_date as send_em30_152_, inspection0_.send_email_status as send_em31_152_, inspection0_.strategic_plan_id as strateg32_152_, inspection0_.strategic_plan_item_id as strateg33_152_, inspection0_.strategic_plan_item_total_effort as strateg34_152_, inspection0_.strategic_plan_name as strateg35_152_ from v_inspection_report inspection0_ inner join audit_plan_info_org auditplani1_ on inspection0_.audit_plan_info_org_id=auditplani1_.id inner join audit_work auditwork2_ on auditplani1_.id=auditwork2_.audit_plan_info_org_id inner join audit_work_auditor auditworka3_ on auditwork2_.id=auditworka3_.audit_work_id cross join inspection_report inspection4_ cross join audit_work auditwork8_ cross join audit_work auditwork11_ where inspection0_.inspection_report_id=inspection4_.id and auditplani1_.id=auditwork8_.audit_plan_info_org_id and inspection4_.audit_work_id=auditwork11_.id and (inspection4_.inspection_report_status in (@P0 , @P1 , @P2) or inspection4_.inspection_report_status=@P3 and (inspection4_.send_manager_date is not null)) and auditwork8_.is_show_leader=@P4 and (auditworka3_.position_name=@P5 and auditworka3_.user_id=@P6 or inspection0_.manager_user_id=165 or inspection0_.auditee_org_id in (select distinct auditeeorg9_.id from v_auditee_org_flat_tree auditeeorg9_ where auditeeorg9_.auditee_type=@P7 and (auditeeorg9_.parent_id in (73) or auditeeorg9_.id in (73)))) and auditwork11_.is_show_leader=@P8 order by inspection0_.last_updated_date desc offset 0 rows fetch next @P9 rows only",321875,1422802,-1100927,2809173038,137,965627
"(@P0 nvarchar(4000),@P1 nvarchar(4000),@P2 nvarchar(4000),@P3 nvarchar(4000),@P4 bit,@P5 nvarchar(4000),@P6 int,@P7 nvarchar(4000),@P8 bit,@P9 int)select distinct inspection0_.id as id1_152_, inspection0_.annual_plan_detail_id as annual_36_152_, inspection0_.annual_plan_draft_id as annual_p2_152_, inspection0_.annual_plan_draft_name as annual_p3_152_, inspection0_.annual_plan_id as annual_p4_152_, inspection0_.audit_plan_info_org_id as audit_p37_152_, inspection0_.audit_procedure_code as audit_pr5_152_, inspection0_.audit_procedure_id as audit_pr6_152_, inspection0_.audit_procedure_name as audit_pr7_152_, inspection0_.audit_procedure_years as audit_pr8_152_, inspection0_.audit_task_status as audit_ta9_152_, inspection0_.audit_work_status as audit_w10_152_, inspection0_.audited_date_set_report as audited11_152_, inspection0_.auditee_org_id as auditee38_152_, inspection0_.auditee_org_name as auditee12_152_, inspection0_.auditee_org_postcode as auditee13_152_, inspection0_.auditee_org_type as auditee14_152_, inspection0_.feedback_status as feedbac15_152_, inspection0_.inspection_date as inspect16_152_, inspection0_.inspection_evaluate_date as inspect17_152_, inspection0_.inspection_evaluate_status as inspect18_152_, inspection0_.inspection_report_id as inspect39_152_, inspection0_.inspection_report_status as inspect19_152_, inspection0_.is_show_leader as is_show20_152_, inspection0_.last_updated_date as last_up21_152_, inspection0_.last_updated_date_feedback_solution as last_up22_152_, inspection0_.last_updated_date_inspection_tracking as last_up23_152_, inspection0_.lat as lat24_152_, inspection0_.lng as lng25_152_, inspection0_.manager_user_id as manager26_152_, inspection0_.priority_suggestion_color as priorit27_152_, inspection0_.priority_suggestion_name as priorit28_152_, inspection0_.priority_suggestion_seq as priorit29_152_, inspection0_.send_email_replied_date as send_em30_152_, inspection0_.send_email_status as send_em31_152_, inspection0_.strategic_plan_id as strateg32_152_, inspection0_.strategic_plan_item_id as strateg33_152_, inspection0_.strategic_plan_item_total_effort as strateg34_152_, inspection0_.strategic_plan_name as strateg35_152_ from v_inspection_report inspection0_ inner join audit_plan_info_org auditplani1_ on inspection0_.audit_plan_info_org_id=auditplani1_.id inner join audit_work auditwork2_ on auditplani1_.id=auditwork2_.audit_plan_info_org_id inner join audit_work_auditor auditworka3_ on auditwork2_.id=auditworka3_.audit_work_id cross join inspection_report inspection4_ cross join audit_work auditwork8_ cross join audit_work auditwork11_ where inspection0_.inspection_report_id=inspection4_.id and auditplani1_.id=auditwork8_.audit_plan_info_org_id and inspection4_.audit_work_id=auditwork11_.id and (inspection4_.inspection_report_status in (@P0 , @P1 , @P2) or inspection4_.inspection_report_status=@P3 and (inspection4_.send_manager_date is not null)) and auditwork8_.is_show_leader=@P4 and (auditworka3_.position_name=@P5 and auditworka3_.user_id=@P6 or inspection0_.manager_user_id=535 or inspection0_.auditee_org_id in (select distinct auditeeorg9_.id from v_auditee_org_flat_tree auditeeorg9_ where auditeeorg9_.auditee_type=@P7 and (auditeeorg9_.parent_id in (1642 , 1656 , 1754) or auditeeorg9_.id in (1642 , 1656 , 1754)))) and auditwork11_.is_show_leader=@P8 order by inspection0_.last_updated_date desc offset 0 rows fetch next @P9 rows only",317305,1290829,-973524,2578450630,132,317305
"(@P0 nvarchar(4000),@P1 nvarchar(4000),@P2 nvarchar(4000),@P3 nvarchar(4000),@P4 bit,@P5 nvarchar(4000),@P6 int,@P7 nvarchar(4000),@P8 bit,@P9 int)select distinct inspection0_.id as id1_152_, inspection0_.annual_plan_detail_id as annual_36_152_, inspection0_.annual_plan_draft_id as annual_p2_152_, inspection0_.annual_plan_draft_name as annual_p3_152_, inspection0_.annual_plan_id as annual_p4_152_, inspection0_.audit_plan_info_org_id as audit_p37_152_, inspection0_.audit_procedure_code as audit_pr5_152_, inspection0_.audit_procedure_id as audit_pr6_152_, inspection0_.audit_procedure_name as audit_pr7_152_, inspection0_.audit_procedure_years as audit_pr8_152_, inspection0_.audit_task_status as audit_ta9_152_, inspection0_.audit_work_status as audit_w10_152_, inspection0_.audited_date_set_report as audited11_152_, inspection0_.auditee_org_id as auditee38_152_, inspection0_.auditee_org_name as auditee12_152_, inspection0_.auditee_org_postcode as auditee13_152_, inspection0_.auditee_org_type as auditee14_152_, inspection0_.feedback_status as feedbac15_152_, inspection0_.inspection_date as inspect16_152_, inspection0_.inspection_evaluate_date as inspect17_152_, inspection0_.inspection_evaluate_status as inspect18_152_, inspection0_.inspection_report_id as inspect39_152_, inspection0_.inspection_report_status as inspect19_152_, inspection0_.is_show_leader as is_show20_152_, inspection0_.last_updated_date as last_up21_152_, inspection0_.last_updated_date_feedback_solution as last_up22_152_, inspection0_.last_updated_date_inspection_tracking as last_up23_152_, inspection0_.lat as lat24_152_, inspection0_.lng as lng25_152_, inspection0_.manager_user_id as manager26_152_, inspection0_.priority_suggestion_color as priorit27_152_, inspection0_.priority_suggestion_name as priorit28_152_, inspection0_.priority_suggestion_seq as priorit29_152_, inspection0_.send_email_replied_date as send_em30_152_, inspection0_.send_email_status as send_em31_152_, inspection0_.strategic_plan_id as strateg32_152_, inspection0_.strategic_plan_item_id as strateg33_152_, inspection0_.strategic_plan_item_total_effort as strateg34_152_, inspection0_.strategic_plan_name as strateg35_152_ from v_inspection_report inspection0_ inner join audit_plan_info_org auditplani1_ on inspection0_.audit_plan_info_org_id=auditplani1_.id inner join audit_work auditwork2_ on auditplani1_.id=auditwork2_.audit_plan_info_org_id inner join audit_work_auditor auditworka3_ on auditwork2_.id=auditworka3_.audit_work_id cross join inspection_report inspection4_ cross join audit_work auditwork8_ cross join audit_work auditwork11_ where inspection0_.inspection_report_id=inspection4_.id and auditplani1_.id=auditwork8_.audit_plan_info_org_id and inspection4_.audit_work_id=auditwork11_.id and (inspection4_.inspection_report_status in (@P0 , @P1 , @P2) or inspection4_.inspection_report_status=@P3 and (inspection4_.send_manager_date is not null)) and auditwork8_.is_show_leader=@P4 and (auditworka3_.position_name=@P5 and auditworka3_.user_id=@P6 or inspection0_.manager_user_id=328 or inspection0_.auditee_org_id in (select distinct auditeeorg9_.id from v_auditee_org_flat_tree auditeeorg9_ where auditeeorg9_.auditee_type=@P7 and (auditeeorg9_.parent_id in (42) or auditeeorg9_.id in (42)))) and auditwork11_.is_show_leader=@P8 order by inspection0_.last_updated_date desc offset 0 rows fetch next @P9 rows only",312772,1228997,-916225,2809033515,145,312772
"(@P0 nvarchar(4000),@P1 nvarchar(4000),@P2 nvarchar(4000),@P3 nvarchar(4000),@P4 bit,@P5 nvarchar(4000),@P6 int,@P7 nvarchar(4000),@P8 bit,@P9 int)select distinct inspection0_.id as id1_152_, inspection0_.annual_plan_detail_id as annual_36_152_, inspection0_.annual_plan_draft_id as annual_p2_152_, inspection0_.annual_plan_draft_name as annual_p3_152_, inspection0_.annual_plan_id as annual_p4_152_, inspection0_.audit_plan_info_org_id as audit_p37_152_, inspection0_.audit_procedure_code as audit_pr5_152_, inspection0_.audit_procedure_id as audit_pr6_152_, inspection0_.audit_procedure_name as audit_pr7_152_, inspection0_.audit_procedure_years as audit_pr8_152_, inspection0_.audit_task_status as audit_ta9_152_, inspection0_.audit_work_status as audit_w10_152_, inspection0_.audited_date_set_report as audited11_152_, inspection0_.auditee_org_id as auditee38_152_, inspection0_.auditee_org_name as auditee12_152_, inspection0_.auditee_org_postcode as auditee13_152_, inspection0_.auditee_org_type as auditee14_152_, inspection0_.feedback_status as feedbac15_152_, inspection0_.inspection_date as inspect16_152_, inspection0_.inspection_evaluate_date as inspect17_152_, inspection0_.inspection_evaluate_status as inspect18_152_, inspection0_.inspection_report_id as inspect39_152_, inspection0_.inspection_report_status as inspect19_152_, inspection0_.is_show_leader as is_show20_152_, inspection0_.last_updated_date as last_up21_152_, inspection0_.last_updated_date_feedback_solution as last_up22_152_, inspection0_.last_updated_date_inspection_tracking as last_up23_152_, inspection0_.lat as lat24_152_, inspection0_.lng as lng25_152_, inspection0_.manager_user_id as manager26_152_, inspection0_.priority_suggestion_color as priorit27_152_, inspection0_.priority_suggestion_name as priorit28_152_, inspection0_.priority_suggestion_seq as priorit29_152_, inspection0_.send_email_replied_date as send_em30_152_, inspection0_.send_email_status as send_em31_152_, inspection0_.strategic_plan_id as strateg32_152_, inspection0_.strategic_plan_item_id as strateg33_152_, inspection0_.strategic_plan_item_total_effort as strateg34_152_, inspection0_.strategic_plan_name as strateg35_152_ from v_inspection_report inspection0_ inner join audit_plan_info_org auditplani1_ on inspection0_.audit_plan_info_org_id=auditplani1_.id inner join audit_work auditwork2_ on auditplani1_.id=auditwork2_.audit_plan_info_org_id inner join audit_work_auditor auditworka3_ on auditwork2_.id=auditworka3_.audit_work_id cross join inspection_report inspection4_ cross join audit_work auditwork8_ cross join audit_work auditwork11_ where inspection0_.inspection_report_id=inspection4_.id and auditplani1_.id=auditwork8_.audit_plan_info_org_id and inspection4_.audit_work_id=auditwork11_.id and (inspection4_.inspection_report_status in (@P0 , @P1 , @P2) or inspection4_.inspection_report_status=@P3 and (inspection4_.send_manager_date is not null)) and auditwork8_.is_show_leader=@P4 and (auditworka3_.position_name=@P5 and auditworka3_.user_id=@P6 or inspection0_.manager_user_id=1286 or inspection0_.auditee_org_id in (select distinct auditeeorg9_.id from v_auditee_org_flat_tree auditeeorg9_ where auditeeorg9_.auditee_type=@P7 and (auditeeorg9_.parent_id in (1579) or auditeeorg9_.id in (1579)))) and auditwork11_.is_show_leader=@P8 order by inspection0_.last_updated_date desc offset 0 rows fetch next @P9 rows only",312129,1293920,-981791,2764635204,131,312129
"(@P0 nvarchar(4000),@P1 nvarchar(4000),@P2 nvarchar(4000),@P3 nvarchar(4000),@P4 bit,@P5 nvarchar(4000),@P6 int,@P7 nvarchar(4000),@P8 bit,@P9 int)select distinct inspection0_.id as id1_152_, inspection0_.annual_plan_detail_id as annual_36_152_, inspection0_.annual_plan_draft_id as annual_p2_152_, inspection0_.annual_plan_draft_name as annual_p3_152_, inspection0_.annual_plan_id as annual_p4_152_, inspection0_.audit_plan_info_org_id as audit_p37_152_, inspection0_.audit_procedure_code as audit_pr5_152_, inspection0_.audit_procedure_id as audit_pr6_152_, inspection0_.audit_procedure_name as audit_pr7_152_, inspection0_.audit_procedure_years as audit_pr8_152_, inspection0_.audit_task_status as audit_ta9_152_, inspection0_.audit_work_status as audit_w10_152_, inspection0_.audited_date_set_report as audited11_152_, inspection0_.auditee_org_id as auditee38_152_, inspection0_.auditee_org_name as auditee12_152_, inspection0_.auditee_org_postcode as auditee13_152_, inspection0_.auditee_org_type as auditee14_152_, inspection0_.feedback_status as feedbac15_152_, inspection0_.inspection_date as inspect16_152_, inspection0_.inspection_evaluate_date as inspect17_152_, inspection0_.inspection_evaluate_status as inspect18_152_, inspection0_.inspection_report_id as inspect39_152_, inspection0_.inspection_report_status as inspect19_152_, inspection0_.is_show_leader as is_show20_152_, inspection0_.last_updated_date as last_up21_152_, inspection0_.last_updated_date_feedback_solution as last_up22_152_, inspection0_.last_updated_date_inspection_tracking as last_up23_152_, inspection0_.lat as lat24_152_, inspection0_.lng as lng25_152_, inspection0_.manager_user_id as manager26_152_, inspection0_.priority_suggestion_color as priorit27_152_, inspection0_.priority_suggestion_name as priorit28_152_, inspection0_.priority_suggestion_seq as priorit29_152_, inspection0_.send_email_replied_date as send_em30_152_, inspection0_.send_email_status as send_em31_152_, inspection0_.strategic_plan_id as strateg32_152_, inspection0_.strategic_plan_item_id as strateg33_152_, inspection0_.strategic_plan_item_total_effort as strateg34_152_, inspection0_.strategic_plan_name as strateg35_152_ from v_inspection_report inspection0_ inner join audit_plan_info_org auditplani1_ on inspection0_.audit_plan_info_org_id=auditplani1_.id inner join audit_work auditwork2_ on auditplani1_.id=auditwork2_.audit_plan_info_org_id inner join audit_work_auditor auditworka3_ on auditwork2_.id=auditworka3_.audit_work_id cross join inspection_report inspection4_ cross join audit_work auditwork8_ cross join audit_work auditwork11_ where inspection0_.inspection_report_id=inspection4_.id and auditplani1_.id=auditwork8_.audit_plan_info_org_id and inspection4_.audit_work_id=auditwork11_.id and (inspection4_.inspection_report_status in (@P0 , @P1 , @P2) or inspection4_.inspection_report_status=@P3 and (inspection4_.send_manager_date is not null)) and auditwork8_.is_show_leader=@P4 and (auditworka3_.position_name=@P5 and auditworka3_.user_id=@P6 or inspection0_.manager_user_id=1656 or inspection0_.auditee_org_id in (select distinct auditeeorg9_.id from v_auditee_org_flat_tree auditeeorg9_ where auditeeorg9_.auditee_type=@P7 and (auditeeorg9_.parent_id in (1726 , 1746) or auditeeorg9_.id in (1726 , 1746)))) and auditwork11_.is_show_leader=@P8 order by inspection0_.last_updated_date desc offset 0 rows fetch next @P9 rows only",308080,1343304,-1035224,2764638478,140,308080
"(@P0 nvarchar(4000),@P1 nvarchar(4000),@P2 nvarchar(4000),@P3 nvarchar(4000),@P4 bit,@P5 nvarchar(4000),@P6 int,@P7 nvarchar(4000),@P8 bit,@P9 int)select distinct inspection0_.id as id1_152_, inspection0_.annual_plan_detail_id as annual_36_152_, inspection0_.annual_plan_draft_id as annual_p2_152_, inspection0_.annual_plan_draft_name as annual_p3_152_, inspection0_.annual_plan_id as annual_p4_152_, inspection0_.audit_plan_info_org_id as audit_p37_152_, inspection0_.audit_procedure_code as audit_pr5_152_, inspection0_.audit_procedure_id as audit_pr6_152_, inspection0_.audit_procedure_name as audit_pr7_152_, inspection0_.audit_procedure_years as audit_pr8_152_, inspection0_.audit_task_status as audit_ta9_152_, inspection0_.audit_work_status as audit_w10_152_, inspection0_.audited_date_set_report as audited11_152_, inspection0_.auditee_org_id as auditee38_152_, inspection0_.auditee_org_name as auditee12_152_, inspection0_.auditee_org_postcode as auditee13_152_, inspection0_.auditee_org_type as auditee14_152_, inspection0_.feedback_status as feedbac15_152_, inspection0_.inspection_date as inspect16_152_, inspection0_.inspection_evaluate_date as inspect17_152_, inspection0_.inspection_evaluate_status as inspect18_152_, inspection0_.inspection_report_id as inspect39_152_, inspection0_.inspection_report_status as inspect19_152_, inspection0_.is_show_leader as is_show20_152_, inspection0_.last_updated_date as last_up21_152_, inspection0_.last_updated_date_feedback_solution as last_up22_152_, inspection0_.last_updated_date_inspection_tracking as last_up23_152_, inspection0_.lat as lat24_152_, inspection0_.lng as lng25_152_, inspection0_.manager_user_id as manager26_152_, inspection0_.priority_suggestion_color as priorit27_152_, inspection0_.priority_suggestion_name as priorit28_152_, inspection0_.priority_suggestion_seq as priorit29_152_, inspection0_.send_email_replied_date as send_em30_152_, inspection0_.send_email_status as send_em31_152_, inspection0_.strategic_plan_id as strateg32_152_, inspection0_.strategic_plan_item_id as strateg33_152_, inspection0_.strategic_plan_item_total_effort as strateg34_152_, inspection0_.strategic_plan_name as strateg35_152_ from v_inspection_report inspection0_ inner join audit_plan_info_org auditplani1_ on inspection0_.audit_plan_info_org_id=auditplani1_.id inner join audit_work auditwork2_ on auditplani1_.id=auditwork2_.audit_plan_info_org_id inner join audit_work_auditor auditworka3_ on auditwork2_.id=auditworka3_.audit_work_id cross join inspection_report inspection4_ cross join audit_work auditwork8_ cross join audit_work auditwork11_ where inspection0_.inspection_report_id=inspection4_.id and auditplani1_.id=auditwork8_.audit_plan_info_org_id and inspection4_.audit_work_id=auditwork11_.id and (inspection4_.inspection_report_status in (@P0 , @P1 , @P2) or inspection4_.inspection_report_status=@P3 and (inspection4_.send_manager_date is not null)) and auditwork8_.is_show_leader=@P4 and (auditworka3_.position_name=@P5 and auditworka3_.user_id=@P6 or inspection0_.manager_user_id=929 or inspection0_.auditee_org_id in (select distinct auditeeorg9_.id from v_auditee_org_flat_tree auditeeorg9_ where auditeeorg9_.auditee_type=@P7 and (auditeeorg9_.parent_id in (1727) or auditeeorg9_.id in (1727)))) and auditwork11_.is_show_leader=@P8 order by inspection0_.last_updated_date desc offset 0 rows fetch next @P9 rows only",303724,1309581,-1005857,2807070483,144,303724
"(@P0 nvarchar(4000),@P1 nvarchar(4000),@P2 nvarchar(4000),@P3 nvarchar(4000),@P4 bit,@P5 nvarchar(4000),@P6 int,@P7 nvarchar(4000),@P8 bit,@P9 int)select distinct inspection0_.id as id1_152_, inspection0_.annual_plan_detail_id as annual_36_152_, inspection0_.annual_plan_draft_id as annual_p2_152_, inspection0_.annual_plan_draft_name as annual_p3_152_, inspection0_.annual_plan_id as annual_p4_152_, inspection0_.audit_plan_info_org_id as audit_p37_152_, inspection0_.audit_procedure_code as audit_pr5_152_, inspection0_.audit_procedure_id as audit_pr6_152_, inspection0_.audit_procedure_name as audit_pr7_152_, inspection0_.audit_procedure_years as audit_pr8_152_, inspection0_.audit_task_status as audit_ta9_152_, inspection0_.audit_work_status as audit_w10_152_, inspection0_.audited_date_set_report as audited11_152_, inspection0_.auditee_org_id as auditee38_152_, inspection0_.auditee_org_name as auditee12_152_, inspection0_.auditee_org_postcode as auditee13_152_, inspection0_.auditee_org_type as auditee14_152_, inspection0_.feedback_status as feedbac15_152_, inspection0_.inspection_date as inspect16_152_, inspection0_.inspection_evaluate_date as inspect17_152_, inspection0_.inspection_evaluate_status as inspect18_152_, inspection0_.inspection_report_id as inspect39_152_, inspection0_.inspection_report_status as inspect19_152_, inspection0_.is_show_leader as is_show20_152_, inspection0_.last_updated_date as last_up21_152_, inspection0_.last_updated_date_feedback_solution as last_up22_152_, inspection0_.last_updated_date_inspection_tracking as last_up23_152_, inspection0_.lat as lat24_152_, inspection0_.lng as lng25_152_, inspection0_.manager_user_id as manager26_152_, inspection0_.priority_suggestion_color as priorit27_152_, inspection0_.priority_suggestion_name as priorit28_152_, inspection0_.priority_suggestion_seq as priorit29_152_, inspection0_.send_email_replied_date as send_em30_152_, inspection0_.send_email_status as send_em31_152_, inspection0_.strategic_plan_id as strateg32_152_, inspection0_.strategic_plan_item_id as strateg33_152_, inspection0_.strategic_plan_item_total_effort as strateg34_152_, inspection0_.strategic_plan_name as strateg35_152_ from v_inspection_report inspection0_ inner join audit_plan_info_org auditplani1_ on inspection0_.audit_plan_info_org_id=auditplani1_.id inner join audit_work auditwork2_ on auditplani1_.id=auditwork2_.audit_plan_info_org_id inner join audit_work_auditor auditworka3_ on auditwork2_.id=auditworka3_.audit_work_id cross join inspection_report inspection4_ cross join audit_work auditwork8_ cross join audit_work auditwork11_ where inspection0_.inspection_report_id=inspection4_.id and auditplani1_.id=auditwork8_.audit_plan_info_org_id and inspection4_.audit_work_id=auditwork11_.id and (inspection4_.inspection_report_status in (@P0 , @P1 , @P2) or inspection4_.inspection_report_status=@P3 and (inspection4_.send_manager_date is not null)) and auditwork8_.is_show_leader=@P4 and (auditworka3_.position_name=@P5 and auditworka3_.user_id=@P6 or inspection0_.manager_user_id=362 or inspection0_.auditee_org_id in (select distinct auditeeorg9_.id from v_auditee_org_flat_tree auditeeorg9_ where auditeeorg9_.auditee_type=@P7 and (auditeeorg9_.parent_id in (130) or auditeeorg9_.id in (130)))) and auditwork11_.is_show_leader=@P8 order by inspection0_.last_updated_date desc offset 0 rows fetch next @P9 rows only",302059,1387822,-1085763,2809127201,154,1208238
"(@P0 nvarchar(4000),@P1 nvarchar(4000),@P2 nvarchar(4000),@P3 nvarchar(4000),@P4 bit,@P5 nvarchar(4000),@P6 int,@P7 nvarchar(4000),@P8 bit,@P9 int)select distinct inspection0_.id as id1_152_, inspection0_.annual_plan_detail_id as annual_36_152_, inspection0_.annual_plan_draft_id as annual_p2_152_, inspection0_.annual_plan_draft_name as annual_p3_152_, inspection0_.annual_plan_id as annual_p4_152_, inspection0_.audit_plan_info_org_id as audit_p37_152_, inspection0_.audit_procedure_code as audit_pr5_152_, inspection0_.audit_procedure_id as audit_pr6_152_, inspection0_.audit_procedure_name as audit_pr7_152_, inspection0_.audit_procedure_years as audit_pr8_152_, inspection0_.audit_task_status as audit_ta9_152_, inspection0_.audit_work_status as audit_w10_152_, inspection0_.audited_date_set_report as audited11_152_, inspection0_.auditee_org_id as auditee38_152_, inspection0_.auditee_org_name as auditee12_152_, inspection0_.auditee_org_postcode as auditee13_152_, inspection0_.auditee_org_type as auditee14_152_, inspection0_.feedback_status as feedbac15_152_, inspection0_.inspection_date as inspect16_152_, inspection0_.inspection_evaluate_date as inspect17_152_, inspection0_.inspection_evaluate_status as inspect18_152_, inspection0_.inspection_report_id as inspect39_152_, inspection0_.inspection_report_status as inspect19_152_, inspection0_.is_show_leader as is_show20_152_, inspection0_.last_updated_date as last_up21_152_, inspection0_.last_updated_date_feedback_solution as last_up22_152_, inspection0_.last_updated_date_inspection_tracking as last_up23_152_, inspection0_.lat as lat24_152_, inspection0_.lng as lng25_152_, inspection0_.manager_user_id as manager26_152_, inspection0_.priority_suggestion_color as priorit27_152_, inspection0_.priority_suggestion_name as priorit28_152_, inspection0_.priority_suggestion_seq as priorit29_152_, inspection0_.send_email_replied_date as send_em30_152_, inspection0_.send_email_status as send_em31_152_, inspection0_.strategic_plan_id as strateg32_152_, inspection0_.strategic_plan_item_id as strateg33_152_, inspection0_.strategic_plan_item_total_effort as strateg34_152_, inspection0_.strategic_plan_name as strateg35_152_ from v_inspection_report inspection0_ inner join audit_plan_info_org auditplani1_ on inspection0_.audit_plan_info_org_id=auditplani1_.id inner join audit_work auditwork2_ on auditplani1_.id=auditwork2_.audit_plan_info_org_id inner join audit_work_auditor auditworka3_ on auditwork2_.id=auditworka3_.audit_work_id cross join inspection_report inspection4_ cross join audit_work auditwork8_ cross join audit_work auditwork11_ where inspection0_.inspection_report_id=inspection4_.id and auditplani1_.id=auditwork8_.audit_plan_info_org_id and inspection4_.audit_work_id=auditwork11_.id and (inspection4_.inspection_report_status in (@P0 , @P1 , @P2) or inspection4_.inspection_report_status=@P3 and (inspection4_.send_manager_date is not null)) and auditwork8_.is_show_leader=@P4 and (auditworka3_.position_name=@P5 and auditworka3_.user_id=@P6 or inspection0_.manager_user_id=2300 or inspection0_.auditee_org_id in (select distinct auditeeorg9_.id from v_auditee_org_flat_tree auditeeorg9_ where auditeeorg9_.auditee_type=@P7 and (auditeeorg9_.parent_id in (1 , 2 , 3 , 5 , 6 , 10099) or auditeeorg9_.id in (1 , 2 , 3 , 5 , 6 , 10099)))) and auditwork11_.is_show_leader=@P8 order by inspection0_.last_updated_date desc offset 0 rows fetch next @P9 rows only",301626,1148493,-846867,2593993163,138,301626
"(@P0 nvarchar(4000),@P1 nvarchar(4000),@P2 nvarchar(4000),@P3 nvarchar(4000),@P4 bit,@P5 nvarchar(4000),@P6 int,@P7 nvarchar(4000),@P8 bit,@P9 int)select distinct inspection0_.id as id1_152_, inspection0_.annual_plan_detail_id as annual_36_152_, inspection0_.annual_plan_draft_id as annual_p2_152_, inspection0_.annual_plan_draft_name as annual_p3_152_, inspection0_.annual_plan_id as annual_p4_152_, inspection0_.audit_plan_info_org_id as audit_p37_152_, inspection0_.audit_procedure_code as audit_pr5_152_, inspection0_.audit_procedure_id as audit_pr6_152_, inspection0_.audit_procedure_name as audit_pr7_152_, inspection0_.audit_procedure_years as audit_pr8_152_, inspection0_.audit_task_status as audit_ta9_152_, inspection0_.audit_work_status as audit_w10_152_, inspection0_.audited_date_set_report as audited11_152_, inspection0_.auditee_org_id as auditee38_152_, inspection0_.auditee_org_name as auditee12_152_, inspection0_.auditee_org_postcode as auditee13_152_, inspection0_.auditee_org_type as auditee14_152_, inspection0_.feedback_status as feedbac15_152_, inspection0_.inspection_date as inspect16_152_, inspection0_.inspection_evaluate_date as inspect17_152_, inspection0_.inspection_evaluate_status as inspect18_152_, inspection0_.inspection_report_id as inspect39_152_, inspection0_.inspection_report_status as inspect19_152_, inspection0_.is_show_leader as is_show20_152_, inspection0_.last_updated_date as last_up21_152_, inspection0_.last_updated_date_feedback_solution as last_up22_152_, inspection0_.last_updated_date_inspection_tracking as last_up23_152_, inspection0_.lat as lat24_152_, inspection0_.lng as lng25_152_, inspection0_.manager_user_id as manager26_152_, inspection0_.priority_suggestion_color as priorit27_152_, inspection0_.priority_suggestion_name as priorit28_152_, inspection0_.priority_suggestion_seq as priorit29_152_, inspection0_.send_email_replied_date as send_em30_152_, inspection0_.send_email_status as send_em31_152_, inspection0_.strategic_plan_id as strateg32_152_, inspection0_.strategic_plan_item_id as strateg33_152_, inspection0_.strategic_plan_item_total_effort as strateg34_152_, inspection0_.strategic_plan_name as strateg35_152_ from v_inspection_report inspection0_ inner join audit_plan_info_org auditplani1_ on inspection0_.audit_plan_info_org_id=auditplani1_.id inner join audit_work auditwork2_ on auditplani1_.id=auditwork2_.audit_plan_info_org_id inner join audit_work_auditor auditworka3_ on auditwork2_.id=auditworka3_.audit_work_id cross join inspection_report inspection4_ cross join audit_work auditwork8_ cross join audit_work auditwork11_ where inspection0_.inspection_report_id=inspection4_.id and auditplani1_.id=auditwork8_.audit_plan_info_org_id and inspection4_.audit_work_id=auditwork11_.id and (inspection4_.inspection_report_status in (@P0 , @P1 , @P2) or inspection4_.inspection_report_status=@P3 and (inspection4_.send_manager_date is not null)) and auditwork8_.is_show_leader=@P4 and (auditworka3_.position_name=@P5 and auditworka3_.user_id=@P6 or inspection0_.manager_user_id=190 or inspection0_.auditee_org_id in (select distinct auditeeorg9_.id from v_auditee_org_flat_tree auditeeorg9_ where auditeeorg9_.auditee_type=@P7 and (auditeeorg9_.parent_id in (71) or auditeeorg9_.id in (71)))) and auditwork11_.is_show_leader=@P8 order by inspection0_.last_updated_date desc offset 0 rows fetch next @P9 rows only",300385,1226943,-926558,2809171888,132,300385
"(@P0 nvarchar(4000),@P1 nvarchar(4000),@P2 nvarchar(4000),@P3 nvarchar(4000),@P4 bit,@P5 nvarchar(4000),@P6 int,@P7 nvarchar(4000),@P8 bit,@P9 int)select distinct inspection0_.id as id1_152_, inspection0_.annual_plan_detail_id as annual_36_152_, inspection0_.annual_plan_draft_id as annual_p2_152_, inspection0_.annual_plan_draft_name as annual_p3_152_, inspection0_.annual_plan_id as annual_p4_152_, inspection0_.audit_plan_info_org_id as audit_p37_152_, inspection0_.audit_procedure_code as audit_pr5_152_, inspection0_.audit_procedure_id as audit_pr6_152_, inspection0_.audit_procedure_name as audit_pr7_152_, inspection0_.audit_procedure_years as audit_pr8_152_, inspection0_.audit_task_status as audit_ta9_152_, inspection0_.audit_work_status as audit_w10_152_, inspection0_.audited_date_set_report as audited11_152_, inspection0_.auditee_org_id as auditee38_152_, inspection0_.auditee_org_name as auditee12_152_, inspection0_.auditee_org_postcode as auditee13_152_, inspection0_.auditee_org_type as auditee14_152_, inspection0_.feedback_status as feedbac15_152_, inspection0_.inspection_date as inspect16_152_, inspection0_.inspection_evaluate_date as inspect17_152_, inspection0_.inspection_evaluate_status as inspect18_152_, inspection0_.inspection_report_id as inspect39_152_, inspection0_.inspection_report_status as inspect19_152_, inspection0_.is_show_leader as is_show20_152_, inspection0_.last_updated_date as last_up21_152_, inspection0_.last_updated_date_feedback_solution as last_up22_152_, inspection0_.last_updated_date_inspection_tracking as last_up23_152_, inspection0_.lat as lat24_152_, inspection0_.lng as lng25_152_, inspection0_.manager_user_id as manager26_152_, inspection0_.priority_suggestion_color as priorit27_152_, inspection0_.priority_suggestion_name as priorit28_152_, inspection0_.priority_suggestion_seq as priorit29_152_, inspection0_.send_email_replied_date as send_em30_152_, inspection0_.send_email_status as send_em31_152_, inspection0_.strategic_plan_id as strateg32_152_, inspection0_.strategic_plan_item_id as strateg33_152_, inspection0_.strategic_plan_item_total_effort as strateg34_152_, inspection0_.strategic_plan_name as strateg35_152_ from v_inspection_report inspection0_ inner join audit_plan_info_org auditplani1_ on inspection0_.audit_plan_info_org_id=auditplani1_.id inner join audit_work auditwork2_ on auditplani1_.id=auditwork2_.audit_plan_info_org_id inner join audit_work_auditor auditworka3_ on auditwork2_.id=auditworka3_.audit_work_id cross join inspection_report inspection4_ cross join audit_work auditwork8_ cross join audit_work auditwork11_ where inspection0_.inspection_report_id=inspection4_.id and auditplani1_.id=auditwork8_.audit_plan_info_org_id and inspection4_.audit_work_id=auditwork11_.id and (inspection4_.inspection_report_status in (@P0 , @P1 , @P2) or inspection4_.inspection_report_status=@P3 and (inspection4_.send_manager_date is not null)) and auditwork8_.is_show_leader=@P4 and (auditworka3_.position_name=@P5 and auditworka3_.user_id=@P6 or inspection0_.manager_user_id=1069 or inspection0_.auditee_org_id in (select distinct auditeeorg9_.id from v_auditee_org_flat_tree auditeeorg9_ where auditeeorg9_.auditee_type=@P7 and (auditeeorg9_.parent_id in (1454 , 10082) or auditeeorg9_.id in (1454 , 10082)))) and auditwork11_.is_show_leader=@P8 order by inspection0_.last_updated_date desc offset 0 rows fetch next @P9 rows only",296200,1239072,-942872,2504002330,143,1184800
"(@P0 nvarchar(4000),@P1 nvarchar(4000),@P2 nvarchar(4000),@P3 nvarchar(4000),@P4 bit,@P5 nvarchar(4000),@P6 int,@P7 nvarchar(4000),@P8 bit,@P9 int)select distinct inspection0_.id as id1_152_, inspection0_.annual_plan_detail_id as annual_36_152_, inspection0_.annual_plan_draft_id as annual_p2_152_, inspection0_.annual_plan_draft_name as annual_p3_152_, inspection0_.annual_plan_id as annual_p4_152_, inspection0_.audit_plan_info_org_id as audit_p37_152_, inspection0_.audit_procedure_code as audit_pr5_152_, inspection0_.audit_procedure_id as audit_pr6_152_, inspection0_.audit_procedure_name as audit_pr7_152_, inspection0_.audit_procedure_years as audit_pr8_152_, inspection0_.audit_task_status as audit_ta9_152_, inspection0_.audit_work_status as audit_w10_152_, inspection0_.audited_date_set_report as audited11_152_, inspection0_.auditee_org_id as auditee38_152_, inspection0_.auditee_org_name as auditee12_152_, inspection0_.auditee_org_postcode as auditee13_152_, inspection0_.auditee_org_type as auditee14_152_, inspection0_.feedback_status as feedbac15_152_, inspection0_.inspection_date as inspect16_152_, inspection0_.inspection_evaluate_date as inspect17_152_, inspection0_.inspection_evaluate_status as inspect18_152_, inspection0_.inspection_report_id as inspect39_152_, inspection0_.inspection_report_status as inspect19_152_, inspection0_.is_show_leader as is_show20_152_, inspection0_.last_updated_date as last_up21_152_, inspection0_.last_updated_date_feedback_solution as last_up22_152_, inspection0_.last_updated_date_inspection_tracking as last_up23_152_, inspection0_.lat as lat24_152_, inspection0_.lng as lng25_152_, inspection0_.manager_user_id as manager26_152_, inspection0_.priority_suggestion_color as priorit27_152_, inspection0_.priority_suggestion_name as priorit28_152_, inspection0_.priority_suggestion_seq as priorit29_152_, inspection0_.send_email_replied_date as send_em30_152_, inspection0_.send_email_status as send_em31_152_, inspection0_.strategic_plan_id as strateg32_152_, inspection0_.strategic_plan_item_id as strateg33_152_, inspection0_.strategic_plan_item_total_effort as strateg34_152_, inspection0_.strategic_plan_name as strateg35_152_ from v_inspection_report inspection0_ inner join audit_plan_info_org auditplani1_ on inspection0_.audit_plan_info_org_id=auditplani1_.id inner join audit_work auditwork2_ on auditplani1_.id=auditwork2_.audit_plan_info_org_id inner join audit_work_auditor auditworka3_ on auditwork2_.id=auditworka3_.audit_work_id cross join inspection_report inspection4_ cross join audit_work auditwork8_ cross join audit_work auditwork11_ where inspection0_.inspection_report_id=inspection4_.id and auditplani1_.id=auditwork8_.audit_plan_info_org_id and inspection4_.audit_work_id=auditwork11_.id and (inspection4_.inspection_report_status in (@P0 , @P1 , @P2) or inspection4_.inspection_report_status=@P3 and (inspection4_.send_manager_date is not null)) and auditwork8_.is_show_leader=@P4 and (auditworka3_.position_name=@P5 and auditworka3_.user_id=@P6 or inspection0_.manager_user_id=2291 or inspection0_.auditee_org_id in (select distinct auditeeorg9_.id from v_auditee_org_flat_tree auditeeorg9_ where auditeeorg9_.auditee_type=@P7 and (auditeeorg9_.parent_id in (1 , 2 , 3 , 5 , 6 , 10099) or auditeeorg9_.id in (1 , 2 , 3 , 5 , 6 , 10099)))) and auditwork11_.is_show_leader=@P8 order by inspection0_.last_updated_date desc offset 0 rows fetch next @P9 rows only",295263,1373896,-1078633,2809125838,227,295263
"(@P0 nvarchar(4000),@P1 nvarchar(4000),@P2 nvarchar(4000),@P3 nvarchar(4000),@P4 bit,@P5 nvarchar(4000),@P6 int,@P7 nvarchar(4000),@P8 bit,@P9 int)select distinct inspection0_.id as id1_152_, inspection0_.annual_plan_detail_id as annual_36_152_, inspection0_.annual_plan_draft_id as annual_p2_152_, inspection0_.annual_plan_draft_name as annual_p3_152_, inspection0_.annual_plan_id as annual_p4_152_, inspection0_.audit_plan_info_org_id as audit_p37_152_, inspection0_.audit_procedure_code as audit_pr5_152_, inspection0_.audit_procedure_id as audit_pr6_152_, inspection0_.audit_procedure_name as audit_pr7_152_, inspection0_.audit_procedure_years as audit_pr8_152_, inspection0_.audit_task_status as audit_ta9_152_, inspection0_.audit_work_status as audit_w10_152_, inspection0_.audited_date_set_report as audited11_152_, inspection0_.auditee_org_id as auditee38_152_, inspection0_.auditee_org_name as auditee12_152_, inspection0_.auditee_org_postcode as auditee13_152_, inspection0_.auditee_org_type as auditee14_152_, inspection0_.feedback_status as feedbac15_152_, inspection0_.inspection_date as inspect16_152_, inspection0_.inspection_evaluate_date as inspect17_152_, inspection0_.inspection_evaluate_status as inspect18_152_, inspection0_.inspection_report_id as inspect39_152_, inspection0_.inspection_report_status as inspect19_152_, inspection0_.is_show_leader as is_show20_152_, inspection0_.last_updated_date as last_up21_152_, inspection0_.last_updated_date_feedback_solution as last_up22_152_, inspection0_.last_updated_date_inspection_tracking as last_up23_152_, inspection0_.lat as lat24_152_, inspection0_.lng as lng25_152_, inspection0_.manager_user_id as manager26_152_, inspection0_.priority_suggestion_color as priorit27_152_, inspection0_.priority_suggestion_name as priorit28_152_, inspection0_.priority_suggestion_seq as priorit29_152_, inspection0_.send_email_replied_date as send_em30_152_, inspection0_.send_email_status as send_em31_152_, inspection0_.strategic_plan_id as strateg32_152_, inspection0_.strategic_plan_item_id as strateg33_152_, inspection0_.strategic_plan_item_total_effort as strateg34_152_, inspection0_.strategic_plan_name as strateg35_152_ from v_inspection_report inspection0_ inner join audit_plan_info_org auditplani1_ on inspection0_.audit_plan_info_org_id=auditplani1_.id inner join audit_work auditwork2_ on auditplani1_.id=auditwork2_.audit_plan_info_org_id inner join audit_work_auditor auditworka3_ on auditwork2_.id=auditworka3_.audit_work_id cross join inspection_report inspection4_ cross join audit_work auditwork8_ cross join audit_work auditwork11_ where inspection0_.inspection_report_id=inspection4_.id and auditplani1_.id=auditwork8_.audit_plan_info_org_id and inspection4_.audit_work_id=auditwork11_.id and (inspection4_.inspection_report_status in (@P0 , @P1 , @P2) or inspection4_.inspection_report_status=@P3 and (inspection4_.send_manager_date is not null)) and auditwork8_.is_show_leader=@P4 and (auditworka3_.position_name=@P5 and auditworka3_.user_id=@P6 or inspection0_.manager_user_id=326 or inspection0_.auditee_org_id in (select distinct auditeeorg9_.id from v_auditee_org_flat_tree auditeeorg9_ where auditeeorg9_.auditee_type=@P7 and (auditeeorg9_.parent_id in (60) or auditeeorg9_.id in (60)))) and auditwork11_.is_show_leader=@P8 order by inspection0_.last_updated_date desc offset 0 rows fetch next @P9 rows only",293862,1263197,-969335,2809401732,154,293862
"(@P0 nvarchar(4000),@P1 nvarchar(4000),@P2 nvarchar(4000),@P3 nvarchar(4000),@P4 bit,@P5 nvarchar(4000),@P6 int,@P7 nvarchar(4000),@P8 bit,@P9 int)select distinct inspection0_.id as id1_152_, inspection0_.annual_plan_detail_id as annual_36_152_, inspection0_.annual_plan_draft_id as annual_p2_152_, inspection0_.annual_plan_draft_name as annual_p3_152_, inspection0_.annual_plan_id as annual_p4_152_, inspection0_.audit_plan_info_org_id as audit_p37_152_, inspection0_.audit_procedure_code as audit_pr5_152_, inspection0_.audit_procedure_id as audit_pr6_152_, inspection0_.audit_procedure_name as audit_pr7_152_, inspection0_.audit_procedure_years as audit_pr8_152_, inspection0_.audit_task_status as audit_ta9_152_, inspection0_.audit_work_status as audit_w10_152_, inspection0_.audited_date_set_report as audited11_152_, inspection0_.auditee_org_id as auditee38_152_, inspection0_.auditee_org_name as auditee12_152_, inspection0_.auditee_org_postcode as auditee13_152_, inspection0_.auditee_org_type as auditee14_152_, inspection0_.feedback_status as feedbac15_152_, inspection0_.inspection_date as inspect16_152_, inspection0_.inspection_evaluate_date as inspect17_152_, inspection0_.inspection_evaluate_status as inspect18_152_, inspection0_.inspection_report_id as inspect39_152_, inspection0_.inspection_report_status as inspect19_152_, inspection0_.is_show_leader as is_show20_152_, inspection0_.last_updated_date as last_up21_152_, inspection0_.last_updated_date_feedback_solution as last_up22_152_, inspection0_.last_updated_date_inspection_tracking as last_up23_152_, inspection0_.lat as lat24_152_, inspection0_.lng as lng25_152_, inspection0_.manager_user_id as manager26_152_, inspection0_.priority_suggestion_color as priorit27_152_, inspection0_.priority_suggestion_name as priorit28_152_, inspection0_.priority_suggestion_seq as priorit29_152_, inspection0_.send_email_replied_date as send_em30_152_, inspection0_.send_email_status as send_em31_152_, inspection0_.strategic_plan_id as strateg32_152_, inspection0_.strategic_plan_item_id as strateg33_152_, inspection0_.strategic_plan_item_total_effort as strateg34_152_, inspection0_.strategic_plan_name as strateg35_152_ from v_inspection_report inspection0_ inner join audit_plan_info_org auditplani1_ on inspection0_.audit_plan_info_org_id=auditplani1_.id inner join audit_work auditwork2_ on auditplani1_.id=auditwork2_.audit_plan_info_org_id inner join audit_work_auditor auditworka3_ on auditwork2_.id=auditworka3_.audit_work_id cross join inspection_report inspection4_ cross join audit_work auditwork8_ cross join audit_work auditwork11_ where inspection0_.inspection_report_id=inspection4_.id and auditplani1_.id=auditwork8_.audit_plan_info_org_id and inspection4_.audit_work_id=auditwork11_.id and (inspection4_.inspection_report_status in (@P0 , @P1 , @P2) or inspection4_.inspection_report_status=@P3 and (inspection4_.send_manager_date is not null)) and auditwork8_.is_show_leader=@P4 and (auditworka3_.position_name=@P5 and auditworka3_.user_id=@P6 or inspection0_.manager_user_id=331 or inspection0_.auditee_org_id in (select distinct auditeeorg9_.id from v_auditee_org_flat_tree auditeeorg9_ where auditeeorg9_.auditee_type=@P7 and (auditeeorg9_.parent_id in (72) or auditeeorg9_.id in (72)))) and auditwork11_.is_show_leader=@P8 order by inspection0_.last_updated_date desc offset 0 rows fetch next @P9 rows only",291426,1273761,-982335,2772142922,143,582852
"(@P0 nvarchar(4000),@P1 nvarchar(4000),@P2 nvarchar(4000),@P3 nvarchar(4000),@P4 bit,@P5 nvarchar(4000),@P6 int,@P7 nvarchar(4000),@P8 bit,@P9 int)select distinct inspection0_.id as id1_152_, inspection0_.annual_plan_detail_id as annual_36_152_, inspection0_.annual_plan_draft_id as annual_p2_152_, inspection0_.annual_plan_draft_name as annual_p3_152_, inspection0_.annual_plan_id as annual_p4_152_, inspection0_.audit_plan_info_org_id as audit_p37_152_, inspection0_.audit_procedure_code as audit_pr5_152_, inspection0_.audit_procedure_id as audit_pr6_152_, inspection0_.audit_procedure_name as audit_pr7_152_, inspection0_.audit_procedure_years as audit_pr8_152_, inspection0_.audit_task_status as audit_ta9_152_, inspection0_.audit_work_status as audit_w10_152_, inspection0_.audited_date_set_report as audited11_152_, inspection0_.auditee_org_id as auditee38_152_, inspection0_.auditee_org_name as auditee12_152_, inspection0_.auditee_org_postcode as auditee13_152_, inspection0_.auditee_org_type as auditee14_152_, inspection0_.feedback_status as feedbac15_152_, inspection0_.inspection_date as inspect16_152_, inspection0_.inspection_evaluate_date as inspect17_152_, inspection0_.inspection_evaluate_status as inspect18_152_, inspection0_.inspection_report_id as inspect39_152_, inspection0_.inspection_report_status as inspect19_152_, inspection0_.is_show_leader as is_show20_152_, inspection0_.last_updated_date as last_up21_152_, inspection0_.last_updated_date_feedback_solution as last_up22_152_, inspection0_.last_updated_date_inspection_tracking as last_up23_152_, inspection0_.lat as lat24_152_, inspection0_.lng as lng25_152_, inspection0_.manager_user_id as manager26_152_, inspection0_.priority_suggestion_color as priorit27_152_, inspection0_.priority_suggestion_name as priorit28_152_, inspection0_.priority_suggestion_seq as priorit29_152_, inspection0_.send_email_replied_date as send_em30_152_, inspection0_.send_email_status as send_em31_152_, inspection0_.strategic_plan_id as strateg32_152_, inspection0_.strategic_plan_item_id as strateg33_152_, inspection0_.strategic_plan_item_total_effort as strateg34_152_, inspection0_.strategic_plan_name as strateg35_152_ from v_inspection_report inspection0_ inner join audit_plan_info_org auditplani1_ on inspection0_.audit_plan_info_org_id=auditplani1_.id inner join audit_work auditwork2_ on auditplani1_.id=auditwork2_.audit_plan_info_org_id inner join audit_work_auditor auditworka3_ on auditwork2_.id=auditworka3_.audit_work_id cross join inspection_report inspection4_ cross join audit_work auditwork8_ cross join audit_work auditwork11_ where inspection0_.inspection_report_id=inspection4_.id and auditplani1_.id=auditwork8_.audit_plan_info_org_id and inspection4_.audit_work_id=auditwork11_.id and (inspection4_.inspection_report_status in (@P0 , @P1 , @P2) or inspection4_.inspection_report_status=@P3 and (inspection4_.send_manager_date is not null)) and auditwork8_.is_show_leader=@P4 and (auditworka3_.position_name=@P5 and auditworka3_.user_id=@P6 or inspection0_.manager_user_id=297 or inspection0_.auditee_org_id in (select distinct auditeeorg9_.id from v_auditee_org_flat_tree auditeeorg9_ where auditeeorg9_.auditee_type=@P7 and (auditeeorg9_.parent_id in (1417) or auditeeorg9_.id in (1417)))) and auditwork11_.is_show_leader=@P8 order by inspection0_.last_updated_date desc offset 0 rows fetch next @P9 rows only",287850,1121275,-833425,2562931732,139,575700
"(@P0 nvarchar(4000),@P1 nvarchar(4000),@P2 nvarchar(4000),@P3 nvarchar(4000),@P4 bit,@P5 nvarchar(4000),@P6 int,@P7 nvarchar(4000),@P8 bit,@P9 int)select distinct inspection0_.id as id1_152_, inspection0_.annual_plan_detail_id as annual_36_152_, inspection0_.annual_plan_draft_id as annual_p2_152_, inspection0_.annual_plan_draft_name as annual_p3_152_, inspection0_.annual_plan_id as annual_p4_152_, inspection0_.audit_plan_info_org_id as audit_p37_152_, inspection0_.audit_procedure_code as audit_pr5_152_, inspection0_.audit_procedure_id as audit_pr6_152_, inspection0_.audit_procedure_name as audit_pr7_152_, inspection0_.audit_procedure_years as audit_pr8_152_, inspection0_.audit_task_status as audit_ta9_152_, inspection0_.audit_work_status as audit_w10_152_, inspection0_.audited_date_set_report as audited11_152_, inspection0_.auditee_org_id as auditee38_152_, inspection0_.auditee_org_name as auditee12_152_, inspection0_.auditee_org_postcode as auditee13_152_, inspection0_.auditee_org_type as auditee14_152_, inspection0_.feedback_status as feedbac15_152_, inspection0_.inspection_date as inspect16_152_, inspection0_.inspection_evaluate_date as inspect17_152_, inspection0_.inspection_evaluate_status as inspect18_152_, inspection0_.inspection_report_id as inspect39_152_, inspection0_.inspection_report_status as inspect19_152_, inspection0_.is_show_leader as is_show20_152_, inspection0_.last_updated_date as last_up21_152_, inspection0_.last_updated_date_feedback_solution as last_up22_152_, inspection0_.last_updated_date_inspection_tracking as last_up23_152_, inspection0_.lat as lat24_152_, inspection0_.lng as lng25_152_, inspection0_.manager_user_id as manager26_152_, inspection0_.priority_suggestion_color as priorit27_152_, inspection0_.priority_suggestion_name as priorit28_152_, inspection0_.priority_suggestion_seq as priorit29_152_, inspection0_.send_email_replied_date as send_em30_152_, inspection0_.send_email_status as send_em31_152_, inspection0_.strategic_plan_id as strateg32_152_, inspection0_.strategic_plan_item_id as strateg33_152_, inspection0_.strategic_plan_item_total_effort as strateg34_152_, inspection0_.strategic_plan_name as strateg35_152_ from v_inspection_report inspection0_ inner join audit_plan_info_org auditplani1_ on inspection0_.audit_plan_info_org_id=auditplani1_.id inner join audit_work auditwork2_ on auditplani1_.id=auditwork2_.audit_plan_info_org_id inner join audit_work_auditor auditworka3_ on auditwork2_.id=auditworka3_.audit_work_id cross join inspection_report inspection4_ cross join audit_work auditwork8_ cross join audit_work auditwork11_ where inspection0_.inspection_report_id=inspection4_.id and auditplani1_.id=auditwork8_.audit_plan_info_org_id and inspection4_.audit_work_id=auditwork11_.id and (inspection4_.inspection_report_status in (@P0 , @P1 , @P2) or inspection4_.inspection_report_status=@P3 and (inspection4_.send_manager_date is not null)) and auditwork8_.is_show_leader=@P4 and (auditworka3_.position_name=@P5 and auditworka3_.user_id=@P6 or inspection0_.manager_user_id=1496 or inspection0_.auditee_org_id in (select distinct auditeeorg9_.id from v_auditee_org_flat_tree auditeeorg9_ where auditeeorg9_.auditee_type=@P7 and (auditeeorg9_.parent_id in (10020) or auditeeorg9_.id in (10020)))) and auditwork11_.is_show_leader=@P8 order by inspection0_.last_updated_date desc offset 0 rows fetch next @P9 rows only",287218,1178958,-891740,2570829029,167,861655
"(@P0 nvarchar(4000),@P1 nvarchar(4000),@P2 nvarchar(4000),@P3 nvarchar(4000),@P4 bit,@P5 nvarchar(4000),@P6 int,@P7 nvarchar(4000),@P8 bit,@P9 int)select distinct inspection0_.id as id1_152_, inspection0_.annual_plan_detail_id as annual_36_152_, inspection0_.annual_plan_draft_id as annual_p2_152_, inspection0_.annual_plan_draft_name as annual_p3_152_, inspection0_.annual_plan_id as annual_p4_152_, inspection0_.audit_plan_info_org_id as audit_p37_152_, inspection0_.audit_procedure_code as audit_pr5_152_, inspection0_.audit_procedure_id as audit_pr6_152_, inspection0_.audit_procedure_name as audit_pr7_152_, inspection0_.audit_procedure_years as audit_pr8_152_, inspection0_.audit_task_status as audit_ta9_152_, inspection0_.audit_work_status as audit_w10_152_, inspection0_.audited_date_set_report as audited11_152_, inspection0_.auditee_org_id as auditee38_152_, inspection0_.auditee_org_name as auditee12_152_, inspection0_.auditee_org_postcode as auditee13_152_, inspection0_.auditee_org_type as auditee14_152_, inspection0_.feedback_status as feedbac15_152_, inspection0_.inspection_date as inspect16_152_, inspection0_.inspection_evaluate_date as inspect17_152_, inspection0_.inspection_evaluate_status as inspect18_152_, inspection0_.inspection_report_id as inspect39_152_, inspection0_.inspection_report_status as inspect19_152_, inspection0_.is_show_leader as is_show20_152_, inspection0_.last_updated_date as last_up21_152_, inspection0_.last_updated_date_feedback_solution as last_up22_152_, inspection0_.last_updated_date_inspection_tracking as last_up23_152_, inspection0_.lat as lat24_152_, inspection0_.lng as lng25_152_, inspection0_.manager_user_id as manager26_152_, inspection0_.priority_suggestion_color as priorit27_152_, inspection0_.priority_suggestion_name as priorit28_152_, inspection0_.priority_suggestion_seq as priorit29_152_, inspection0_.send_email_replied_date as send_em30_152_, inspection0_.send_email_status as send_em31_152_, inspection0_.strategic_plan_id as strateg32_152_, inspection0_.strategic_plan_item_id as strateg33_152_, inspection0_.strategic_plan_item_total_effort as strateg34_152_, inspection0_.strategic_plan_name as strateg35_152_ from v_inspection_report inspection0_ inner join audit_plan_info_org auditplani1_ on inspection0_.audit_plan_info_org_id=auditplani1_.id inner join audit_work auditwork2_ on auditplani1_.id=auditwork2_.audit_plan_info_org_id inner join audit_work_auditor auditworka3_ on auditwork2_.id=auditworka3_.audit_work_id cross join inspection_report inspection4_ cross join audit_work auditwork8_ cross join audit_work auditwork11_ where inspection0_.inspection_report_id=inspection4_.id and auditplani1_.id=auditwork8_.audit_plan_info_org_id and inspection4_.audit_work_id=auditwork11_.id and (inspection4_.inspection_report_status in (@P0 , @P1 , @P2) or inspection4_.inspection_report_status=@P3 and (inspection4_.send_manager_date is not null)) and auditwork8_.is_show_leader=@P4 and (auditworka3_.position_name=@P5 and auditworka3_.user_id=@P6 or inspection0_.manager_user_id=855 or inspection0_.auditee_org_id in (select distinct auditeeorg9_.id from v_auditee_org_flat_tree auditeeorg9_ where auditeeorg9_.auditee_type=@P7 and (auditeeorg9_.parent_id in (1755) or auditeeorg9_.id in (1755)))) and auditwork11_.is_show_leader=@P8 order by inspection0_.last_updated_date desc offset 0 rows fetch next @P9 rows only",286361,1216126,-929765,2598039971,207,572722
"(@P0 nvarchar(4000),@P1 nvarchar(4000),@P2 nvarchar(4000),@P3 nvarchar(4000),@P4 bit,@P5 nvarchar(4000),@P6 int,@P7 nvarchar(4000),@P8 bit,@P9 int)select distinct inspection0_.id as id1_152_, inspection0_.annual_plan_detail_id as annual_36_152_, inspection0_.annual_plan_draft_id as annual_p2_152_, inspection0_.annual_plan_draft_name as annual_p3_152_, inspection0_.annual_plan_id as annual_p4_152_, inspection0_.audit_plan_info_org_id as audit_p37_152_, inspection0_.audit_procedure_code as audit_pr5_152_, inspection0_.audit_procedure_id as audit_pr6_152_, inspection0_.audit_procedure_name as audit_pr7_152_, inspection0_.audit_procedure_years as audit_pr8_152_, inspection0_.audit_task_status as audit_ta9_152_, inspection0_.audit_work_status as audit_w10_152_, inspection0_.audited_date_set_report as audited11_152_, inspection0_.auditee_org_id as auditee38_152_, inspection0_.auditee_org_name as auditee12_152_, inspection0_.auditee_org_postcode as auditee13_152_, inspection0_.auditee_org_type as auditee14_152_, inspection0_.feedback_status as feedbac15_152_, inspection0_.inspection_date as inspect16_152_, inspection0_.inspection_evaluate_date as inspect17_152_, inspection0_.inspection_evaluate_status as inspect18_152_, inspection0_.inspection_report_id as inspect39_152_, inspection0_.inspection_report_status as inspect19_152_, inspection0_.is_show_leader as is_show20_152_, inspection0_.last_updated_date as last_up21_152_, inspection0_.last_updated_date_feedback_solution as last_up22_152_, inspection0_.last_updated_date_inspection_tracking as last_up23_152_, inspection0_.lat as lat24_152_, inspection0_.lng as lng25_152_, inspection0_.manager_user_id as manager26_152_, inspection0_.priority_suggestion_color as priorit27_152_, inspection0_.priority_suggestion_name as priorit28_152_, inspection0_.priority_suggestion_seq as priorit29_152_, inspection0_.send_email_replied_date as send_em30_152_, inspection0_.send_email_status as send_em31_152_, inspection0_.strategic_plan_id as strateg32_152_, inspection0_.strategic_plan_item_id as strateg33_152_, inspection0_.strategic_plan_item_total_effort as strateg34_152_, inspection0_.strategic_plan_name as strateg35_152_ from v_inspection_report inspection0_ inner join audit_plan_info_org auditplani1_ on inspection0_.audit_plan_info_org_id=auditplani1_.id inner join audit_work auditwork2_ on auditplani1_.id=auditwork2_.audit_plan_info_org_id inner join audit_work_auditor auditworka3_ on auditwork2_.id=auditworka3_.audit_work_id cross join inspection_report inspection4_ cross join audit_work auditwork8_ cross join audit_work auditwork11_ where inspection0_.inspection_report_id=inspection4_.id and auditplani1_.id=auditwork8_.audit_plan_info_org_id and inspection4_.audit_work_id=auditwork11_.id and (inspection4_.inspection_report_status in (@P0 , @P1 , @P2) or inspection4_.inspection_report_status=@P3 and (inspection4_.send_manager_date is not null)) and auditwork8_.is_show_leader=@P4 and (auditworka3_.position_name=@P5 and auditworka3_.user_id=@P6 or inspection0_.manager_user_id=508 or inspection0_.auditee_org_id in (select distinct auditeeorg9_.id from v_auditee_org_flat_tree auditeeorg9_ where auditeeorg9_.auditee_type=@P7 and (auditeeorg9_.parent_id in (1670) or auditeeorg9_.id in (1670)))) and auditwork11_.is_show_leader=@P8 order by inspection0_.last_updated_date desc offset 0 rows fetch next @P9 rows only",285621,1255863,-970242,2801137205,138,285621
"(@P0 nvarchar(4000),@P1 nvarchar(4000),@P2 nvarchar(4000),@P3 nvarchar(4000),@P4 bit,@P5 nvarchar(4000),@P6 int,@P7 nvarchar(4000),@P8 bit,@P9 int)select distinct inspection0_.id as id1_152_, inspection0_.annual_plan_detail_id as annual_36_152_, inspection0_.annual_plan_draft_id as annual_p2_152_, inspection0_.annual_plan_draft_name as annual_p3_152_, inspection0_.annual_plan_id as annual_p4_152_, inspection0_.audit_plan_info_org_id as audit_p37_152_, inspection0_.audit_procedure_code as audit_pr5_152_, inspection0_.audit_procedure_id as audit_pr6_152_, inspection0_.audit_procedure_name as audit_pr7_152_, inspection0_.audit_procedure_years as audit_pr8_152_, inspection0_.audit_task_status as audit_ta9_152_, inspection0_.audit_work_status as audit_w10_152_, inspection0_.audited_date_set_report as audited11_152_, inspection0_.auditee_org_id as auditee38_152_, inspection0_.auditee_org_name as auditee12_152_, inspection0_.auditee_org_postcode as auditee13_152_, inspection0_.auditee_org_type as auditee14_152_, inspection0_.feedback_status as feedbac15_152_, inspection0_.inspection_date as inspect16_152_, inspection0_.inspection_evaluate_date as inspect17_152_, inspection0_.inspection_evaluate_status as inspect18_152_, inspection0_.inspection_report_id as inspect39_152_, inspection0_.inspection_report_status as inspect19_152_, inspection0_.is_show_leader as is_show20_152_, inspection0_.last_updated_date as last_up21_152_, inspection0_.last_updated_date_feedback_solution as last_up22_152_, inspection0_.last_updated_date_inspection_tracking as last_up23_152_, inspection0_.lat as lat24_152_, inspection0_.lng as lng25_152_, inspection0_.manager_user_id as manager26_152_, inspection0_.priority_suggestion_color as priorit27_152_, inspection0_.priority_suggestion_name as priorit28_152_, inspection0_.priority_suggestion_seq as priorit29_152_, inspection0_.send_email_replied_date as send_em30_152_, inspection0_.send_email_status as send_em31_152_, inspection0_.strategic_plan_id as strateg32_152_, inspection0_.strategic_plan_item_id as strateg33_152_, inspection0_.strategic_plan_item_total_effort as strateg34_152_, inspection0_.strategic_plan_name as strateg35_152_ from v_inspection_report inspection0_ inner join audit_plan_info_org auditplani1_ on inspection0_.audit_plan_info_org_id=auditplani1_.id inner join audit_work auditwork2_ on auditplani1_.id=auditwork2_.audit_plan_info_org_id inner join audit_work_auditor auditworka3_ on auditwork2_.id=auditworka3_.audit_work_id cross join inspection_report inspection4_ cross join audit_work auditwork8_ cross join audit_work auditwork11_ where inspection0_.inspection_report_id=inspection4_.id and auditplani1_.id=auditwork8_.audit_plan_info_org_id and inspection4_.audit_work_id=auditwork11_.id and (inspection4_.inspection_report_status in (@P0 , @P1 , @P2) or inspection4_.inspection_report_status=@P3 and (inspection4_.send_manager_date is not null)) and auditwork8_.is_show_leader=@P4 and (auditworka3_.position_name=@P5 and auditworka3_.user_id=@P6 or inspection0_.manager_user_id=319 or inspection0_.auditee_org_id in (select distinct auditeeorg9_.id from v_auditee_org_flat_tree auditeeorg9_ where auditeeorg9_.auditee_type=@P7 and (auditeeorg9_.parent_id in (41) or auditeeorg9_.id in (41)))) and auditwork11_.is_show_leader=@P8 order by inspection0_.last_updated_date desc offset 0 rows fetch next @P9 rows only",280169,1264078,-983909,2747004409,151,280169
"(@P0 nvarchar(4000),@P1 nvarchar(4000),@P2 nvarchar(4000),@P3 nvarchar(4000),@P4 bit,@P5 nvarchar(4000),@P6 int,@P7 nvarchar(4000),@P8 bit,@P9 int)select distinct inspection0_.id as id1_152_, inspection0_.annual_plan_detail_id as annual_36_152_, inspection0_.annual_plan_draft_id as annual_p2_152_, inspection0_.annual_plan_draft_name as annual_p3_152_, inspection0_.annual_plan_id as annual_p4_152_, inspection0_.audit_plan_info_org_id as audit_p37_152_, inspection0_.audit_procedure_code as audit_pr5_152_, inspection0_.audit_procedure_id as audit_pr6_152_, inspection0_.audit_procedure_name as audit_pr7_152_, inspection0_.audit_procedure_years as audit_pr8_152_, inspection0_.audit_task_status as audit_ta9_152_, inspection0_.audit_work_status as audit_w10_152_, inspection0_.audited_date_set_report as audited11_152_, inspection0_.auditee_org_id as auditee38_152_, inspection0_.auditee_org_name as auditee12_152_, inspection0_.auditee_org_postcode as auditee13_152_, inspection0_.auditee_org_type as auditee14_152_, inspection0_.feedback_status as feedbac15_152_, inspection0_.inspection_date as inspect16_152_, inspection0_.inspection_evaluate_date as inspect17_152_, inspection0_.inspection_evaluate_status as inspect18_152_, inspection0_.inspection_report_id as inspect39_152_, inspection0_.inspection_report_status as inspect19_152_, inspection0_.is_show_leader as is_show20_152_, inspection0_.last_updated_date as last_up21_152_, inspection0_.last_updated_date_feedback_solution as last_up22_152_, inspection0_.last_updated_date_inspection_tracking as last_up23_152_, inspection0_.lat as lat24_152_, inspection0_.lng as lng25_152_, inspection0_.manager_user_id as manager26_152_, inspection0_.priority_suggestion_color as priorit27_152_, inspection0_.priority_suggestion_name as priorit28_152_, inspection0_.priority_suggestion_seq as priorit29_152_, inspection0_.send_email_replied_date as send_em30_152_, inspection0_.send_email_status as send_em31_152_, inspection0_.strategic_plan_id as strateg32_152_, inspection0_.strategic_plan_item_id as strateg33_152_, inspection0_.strategic_plan_item_total_effort as strateg34_152_, inspection0_.strategic_plan_name as strateg35_152_ from v_inspection_report inspection0_ inner join audit_plan_info_org auditplani1_ on inspection0_.audit_plan_info_org_id=auditplani1_.id inner join audit_work auditwork2_ on auditplani1_.id=auditwork2_.audit_plan_info_org_id inner join audit_work_auditor auditworka3_ on auditwork2_.id=auditworka3_.audit_work_id cross join inspection_report inspection4_ cross join audit_work auditwork8_ cross join audit_work auditwork11_ where inspection0_.inspection_report_id=inspection4_.id and auditplani1_.id=auditwork8_.audit_plan_info_org_id and inspection4_.audit_work_id=auditwork11_.id and (inspection4_.inspection_report_status in (@P0 , @P1 , @P2) or inspection4_.inspection_report_status=@P3 and (inspection4_.send_manager_date is not null)) and auditwork8_.is_show_leader=@P4 and (auditworka3_.position_name=@P5 and auditworka3_.user_id=@P6 or inspection0_.manager_user_id=169 or inspection0_.auditee_org_id in (select distinct auditeeorg9_.id from v_auditee_org_flat_tree auditeeorg9_ where auditeeorg9_.auditee_type=@P7 and (auditeeorg9_.parent_id in (42) or auditeeorg9_.id in (42)))) and auditwork11_.is_show_leader=@P8 order by inspection0_.last_updated_date desc offset 0 rows fetch next @P9 rows only",278082,1241375,-963293,2811302896,158,834248
"(@P0 nvarchar(4000),@P1 nvarchar(4000),@P2 nvarchar(4000),@P3 nvarchar(4000),@P4 bit,@P5 nvarchar(4000),@P6 int,@P7 nvarchar(4000),@P8 bit,@P9 int)select distinct inspection0_.id as id1_152_, inspection0_.annual_plan_detail_id as annual_36_152_, inspection0_.annual_plan_draft_id as annual_p2_152_, inspection0_.annual_plan_draft_name as annual_p3_152_, inspection0_.annual_plan_id as annual_p4_152_, inspection0_.audit_plan_info_org_id as audit_p37_152_, inspection0_.audit_procedure_code as audit_pr5_152_, inspection0_.audit_procedure_id as audit_pr6_152_, inspection0_.audit_procedure_name as audit_pr7_152_, inspection0_.audit_procedure_years as audit_pr8_152_, inspection0_.audit_task_status as audit_ta9_152_, inspection0_.audit_work_status as audit_w10_152_, inspection0_.audited_date_set_report as audited11_152_, inspection0_.auditee_org_id as auditee38_152_, inspection0_.auditee_org_name as auditee12_152_, inspection0_.auditee_org_postcode as auditee13_152_, inspection0_.auditee_org_type as auditee14_152_, inspection0_.feedback_status as feedbac15_152_, inspection0_.inspection_date as inspect16_152_, inspection0_.inspection_evaluate_date as inspect17_152_, inspection0_.inspection_evaluate_status as inspect18_152_, inspection0_.inspection_report_id as inspect39_152_, inspection0_.inspection_report_status as inspect19_152_, inspection0_.is_show_leader as is_show20_152_, inspection0_.last_updated_date as last_up21_152_, inspection0_.last_updated_date_feedback_solution as last_up22_152_, inspection0_.last_updated_date_inspection_tracking as last_up23_152_, inspection0_.lat as lat24_152_, inspection0_.lng as lng25_152_, inspection0_.manager_user_id as manager26_152_, inspection0_.priority_suggestion_color as priorit27_152_, inspection0_.priority_suggestion_name as priorit28_152_, inspection0_.priority_suggestion_seq as priorit29_152_, inspection0_.send_email_replied_date as send_em30_152_, inspection0_.send_email_status as send_em31_152_, inspection0_.strategic_plan_id as strateg32_152_, inspection0_.strategic_plan_item_id as strateg33_152_, inspection0_.strategic_plan_item_total_effort as strateg34_152_, inspection0_.strategic_plan_name as strateg35_152_ from v_inspection_report inspection0_ inner join audit_plan_info_org auditplani1_ on inspection0_.audit_plan_info_org_id=auditplani1_.id inner join audit_work auditwork2_ on auditplani1_.id=auditwork2_.audit_plan_info_org_id inner join audit_work_auditor auditworka3_ on auditwork2_.id=auditworka3_.audit_work_id cross join inspection_report inspection4_ cross join audit_work auditwork8_ cross join audit_work auditwork11_ where inspection0_.inspection_report_id=inspection4_.id and auditplani1_.id=auditwork8_.audit_plan_info_org_id and inspection4_.audit_work_id=auditwork11_.id and (inspection4_.inspection_report_status in (@P0 , @P1 , @P2) or inspection4_.inspection_report_status=@P3 and (inspection4_.send_manager_date is not null)) and auditwork8_.is_show_leader=@P4 and (auditworka3_.position_name=@P5 and auditworka3_.user_id=@P6 or inspection0_.manager_user_id=597 or inspection0_.auditee_org_id in (select distinct auditeeorg9_.id from v_auditee_org_flat_tree auditeeorg9_ where auditeeorg9_.auditee_type=@P7 and (auditeeorg9_.parent_id in (1442 , 1559 , 1578) or auditeeorg9_.id in (1442 , 1559 , 1578)))) and auditwork11_.is_show_leader=@P8 order by inspection0_.last_updated_date desc offset 0 rows fetch next @P9 rows only",276761,1236140,-959379,2527364057,136,553522
"(@P0 nvarchar(4000),@P1 nvarchar(4000),@P2 nvarchar(4000),@P3 nvarchar(4000),@P4 bit,@P5 nvarchar(4000),@P6 int,@P7 nvarchar(4000),@P8 bit,@P9 int)select distinct inspection0_.id as id1_152_, inspection0_.annual_plan_detail_id as annual_36_152_, inspection0_.annual_plan_draft_id as annual_p2_152_, inspection0_.annual_plan_draft_name as annual_p3_152_, inspection0_.annual_plan_id as annual_p4_152_, inspection0_.audit_plan_info_org_id as audit_p37_152_, inspection0_.audit_procedure_code as audit_pr5_152_, inspection0_.audit_procedure_id as audit_pr6_152_, inspection0_.audit_procedure_name as audit_pr7_152_, inspection0_.audit_procedure_years as audit_pr8_152_, inspection0_.audit_task_status as audit_ta9_152_, inspection0_.audit_work_status as audit_w10_152_, inspection0_.audited_date_set_report as audited11_152_, inspection0_.auditee_org_id as auditee38_152_, inspection0_.auditee_org_name as auditee12_152_, inspection0_.auditee_org_postcode as auditee13_152_, inspection0_.auditee_org_type as auditee14_152_, inspection0_.feedback_status as feedbac15_152_, inspection0_.inspection_date as inspect16_152_, inspection0_.inspection_evaluate_date as inspect17_152_, inspection0_.inspection_evaluate_status as inspect18_152_, inspection0_.inspection_report_id as inspect39_152_, inspection0_.inspection_report_status as inspect19_152_, inspection0_.is_show_leader as is_show20_152_, inspection0_.last_updated_date as last_up21_152_, inspection0_.last_updated_date_feedback_solution as last_up22_152_, inspection0_.last_updated_date_inspection_tracking as last_up23_152_, inspection0_.lat as lat24_152_, inspection0_.lng as lng25_152_, inspection0_.manager_user_id as manager26_152_, inspection0_.priority_suggestion_color as priorit27_152_, inspection0_.priority_suggestion_name as priorit28_152_, inspection0_.priority_suggestion_seq as priorit29_152_, inspection0_.send_email_replied_date as send_em30_152_, inspection0_.send_email_status as send_em31_152_, inspection0_.strategic_plan_id as strateg32_152_, inspection0_.strategic_plan_item_id as strateg33_152_, inspection0_.strategic_plan_item_total_effort as strateg34_152_, inspection0_.strategic_plan_name as strateg35_152_ from v_inspection_report inspection0_ inner join audit_plan_info_org auditplani1_ on inspection0_.audit_plan_info_org_id=auditplani1_.id inner join audit_work auditwork2_ on auditplani1_.id=auditwork2_.audit_plan_info_org_id inner join audit_work_auditor auditworka3_ on auditwork2_.id=auditworka3_.audit_work_id cross join inspection_report inspection4_ cross join audit_work auditwork8_ cross join audit_work auditwork11_ where inspection0_.inspection_report_id=inspection4_.id and auditplani1_.id=auditwork8_.audit_plan_info_org_id and inspection4_.audit_work_id=auditwork11_.id and (inspection4_.inspection_report_status in (@P0 , @P1 , @P2) or inspection4_.inspection_report_status=@P3 and (inspection4_.send_manager_date is not null)) and auditwork8_.is_show_leader=@P4 and (auditworka3_.position_name=@P5 and auditworka3_.user_id=@P6 or inspection0_.manager_user_id=164 or inspection0_.auditee_org_id in (select distinct auditeeorg9_.id from v_auditee_org_flat_tree auditeeorg9_ where auditeeorg9_.auditee_type=@P7 and (auditeeorg9_.parent_id in (24) or auditeeorg9_.id in (24)))) and auditwork11_.is_show_leader=@P8 order by inspection0_.last_updated_date desc offset 0 rows fetch next @P9 rows only",275323,1301448,-1026125,2838054157,133,275323
"(@P0 nvarchar(4000),@P1 nvarchar(4000),@P2 nvarchar(4000),@P3 nvarchar(4000),@P4 bit,@P5 nvarchar(4000),@P6 int,@P7 nvarchar(4000),@P8 bit,@P9 int)select distinct inspection0_.id as id1_152_, inspection0_.annual_plan_detail_id as annual_36_152_, inspection0_.annual_plan_draft_id as annual_p2_152_, inspection0_.annual_plan_draft_name as annual_p3_152_, inspection0_.annual_plan_id as annual_p4_152_, inspection0_.audit_plan_info_org_id as audit_p37_152_, inspection0_.audit_procedure_code as audit_pr5_152_, inspection0_.audit_procedure_id as audit_pr6_152_, inspection0_.audit_procedure_name as audit_pr7_152_, inspection0_.audit_procedure_years as audit_pr8_152_, inspection0_.audit_task_status as audit_ta9_152_, inspection0_.audit_work_status as audit_w10_152_, inspection0_.audited_date_set_report as audited11_152_, inspection0_.auditee_org_id as auditee38_152_, inspection0_.auditee_org_name as auditee12_152_, inspection0_.auditee_org_postcode as auditee13_152_, inspection0_.auditee_org_type as auditee14_152_, inspection0_.feedback_status as feedbac15_152_, inspection0_.inspection_date as inspect16_152_, inspection0_.inspection_evaluate_date as inspect17_152_, inspection0_.inspection_evaluate_status as inspect18_152_, inspection0_.inspection_report_id as inspect39_152_, inspection0_.inspection_report_status as inspect19_152_, inspection0_.is_show_leader as is_show20_152_, inspection0_.last_updated_date as last_up21_152_, inspection0_.last_updated_date_feedback_solution as last_up22_152_, inspection0_.last_updated_date_inspection_tracking as last_up23_152_, inspection0_.lat as lat24_152_, inspection0_.lng as lng25_152_, inspection0_.manager_user_id as manager26_152_, inspection0_.priority_suggestion_color as priorit27_152_, inspection0_.priority_suggestion_name as priorit28_152_, inspection0_.priority_suggestion_seq as priorit29_152_, inspection0_.send_email_replied_date as send_em30_152_, inspection0_.send_email_status as send_em31_152_, inspection0_.strategic_plan_id as strateg32_152_, inspection0_.strategic_plan_item_id as strateg33_152_, inspection0_.strategic_plan_item_total_effort as strateg34_152_, inspection0_.strategic_plan_name as strateg35_152_ from v_inspection_report inspection0_ inner join audit_plan_info_org auditplani1_ on inspection0_.audit_plan_info_org_id=auditplani1_.id inner join audit_work auditwork2_ on auditplani1_.id=auditwork2_.audit_plan_info_org_id inner join audit_work_auditor auditworka3_ on auditwork2_.id=auditworka3_.audit_work_id cross join inspection_report inspection4_ cross join audit_work auditwork8_ cross join audit_work auditwork11_ where inspection0_.inspection_report_id=inspection4_.id and auditplani1_.id=auditwork8_.audit_plan_info_org_id and inspection4_.audit_work_id=auditwork11_.id and (inspection4_.inspection_report_status in (@P0 , @P1 , @P2) or inspection4_.inspection_report_status=@P3 and (inspection4_.send_manager_date is not null)) and auditwork8_.is_show_leader=@P4 and (auditworka3_.position_name=@P5 and auditworka3_.user_id=@P6 or inspection0_.manager_user_id=1361 or inspection0_.auditee_org_id in (select distinct auditeeorg9_.id from v_auditee_org_flat_tree auditeeorg9_ where auditeeorg9_.auditee_type=@P7 and (auditeeorg9_.parent_id in (1341) or auditeeorg9_.id in (1341)))) and auditwork11_.is_show_leader=@P8 order by inspection0_.last_updated_date desc offset 0 rows fetch next @P9 rows only",273950,1247886,-973936,2809127854,143,273950
"(@P0 nvarchar(4000),@P1 nvarchar(4000),@P2 nvarchar(4000),@P3 nvarchar(4000),@P4 bit,@P5 nvarchar(4000),@P6 int,@P7 nvarchar(4000),@P8 bit,@P9 int)select distinct inspection0_.id as id1_152_, inspection0_.annual_plan_detail_id as annual_36_152_, inspection0_.annual_plan_draft_id as annual_p2_152_, inspection0_.annual_plan_draft_name as annual_p3_152_, inspection0_.annual_plan_id as annual_p4_152_, inspection0_.audit_plan_info_org_id as audit_p37_152_, inspection0_.audit_procedure_code as audit_pr5_152_, inspection0_.audit_procedure_id as audit_pr6_152_, inspection0_.audit_procedure_name as audit_pr7_152_, inspection0_.audit_procedure_years as audit_pr8_152_, inspection0_.audit_task_status as audit_ta9_152_, inspection0_.audit_work_status as audit_w10_152_, inspection0_.audited_date_set_report as audited11_152_, inspection0_.auditee_org_id as auditee38_152_, inspection0_.auditee_org_name as auditee12_152_, inspection0_.auditee_org_postcode as auditee13_152_, inspection0_.auditee_org_type as auditee14_152_, inspection0_.feedback_status as feedbac15_152_, inspection0_.inspection_date as inspect16_152_, inspection0_.inspection_evaluate_date as inspect17_152_, inspection0_.inspection_evaluate_status as inspect18_152_, inspection0_.inspection_report_id as inspect39_152_, inspection0_.inspection_report_status as inspect19_152_, inspection0_.is_show_leader as is_show20_152_, inspection0_.last_updated_date as last_up21_152_, inspection0_.last_updated_date_feedback_solution as last_up22_152_, inspection0_.last_updated_date_inspection_tracking as last_up23_152_, inspection0_.lat as lat24_152_, inspection0_.lng as lng25_152_, inspection0_.manager_user_id as manager26_152_, inspection0_.priority_suggestion_color as priorit27_152_, inspection0_.priority_suggestion_name as priorit28_152_, inspection0_.priority_suggestion_seq as priorit29_152_, inspection0_.send_email_replied_date as send_em30_152_, inspection0_.send_email_status as send_em31_152_, inspection0_.strategic_plan_id as strateg32_152_, inspection0_.strategic_plan_item_id as strateg33_152_, inspection0_.strategic_plan_item_total_effort as strateg34_152_, inspection0_.strategic_plan_name as strateg35_152_ from v_inspection_report inspection0_ inner join audit_plan_info_org auditplani1_ on inspection0_.audit_plan_info_org_id=auditplani1_.id inner join audit_work auditwork2_ on auditplani1_.id=auditwork2_.audit_plan_info_org_id inner join audit_work_auditor auditworka3_ on auditwork2_.id=auditworka3_.audit_work_id cross join inspection_report inspection4_ cross join audit_work auditwork8_ cross join audit_work auditwork11_ where inspection0_.inspection_report_id=inspection4_.id and auditplani1_.id=auditwork8_.audit_plan_info_org_id and inspection4_.audit_work_id=auditwork11_.id and (inspection4_.inspection_report_status in (@P0 , @P1 , @P2) or inspection4_.inspection_report_status=@P3 and (inspection4_.send_manager_date is not null)) and auditwork8_.is_show_leader=@P4 and (auditworka3_.position_name=@P5 and auditworka3_.user_id=@P6 or inspection0_.manager_user_id=392 or inspection0_.auditee_org_id in (select distinct auditeeorg9_.id from v_auditee_org_flat_tree auditeeorg9_ where auditeeorg9_.auditee_type=@P7 and (auditeeorg9_.parent_id in (240) or auditeeorg9_.id in (240)))) and auditwork11_.is_show_leader=@P8 order by inspection0_.last_updated_date desc offset 0 rows fetch next @P9 rows only",273332,1145271,-871939,2597979640,146,273332
"(@P0 nvarchar(4000),@P1 nvarchar(4000),@P2 nvarchar(4000),@P3 nvarchar(4000),@P4 bit,@P5 nvarchar(4000),@P6 int,@P7 nvarchar(4000),@P8 bit,@P9 int)select distinct inspection0_.id as id1_152_, inspection0_.annual_plan_detail_id as annual_36_152_, inspection0_.annual_plan_draft_id as annual_p2_152_, inspection0_.annual_plan_draft_name as annual_p3_152_, inspection0_.annual_plan_id as annual_p4_152_, inspection0_.audit_plan_info_org_id as audit_p37_152_, inspection0_.audit_procedure_code as audit_pr5_152_, inspection0_.audit_procedure_id as audit_pr6_152_, inspection0_.audit_procedure_name as audit_pr7_152_, inspection0_.audit_procedure_years as audit_pr8_152_, inspection0_.audit_task_status as audit_ta9_152_, inspection0_.audit_work_status as audit_w10_152_, inspection0_.audited_date_set_report as audited11_152_, inspection0_.auditee_org_id as auditee38_152_, inspection0_.auditee_org_name as auditee12_152_, inspection0_.auditee_org_postcode as auditee13_152_, inspection0_.auditee_org_type as auditee14_152_, inspection0_.feedback_status as feedbac15_152_, inspection0_.inspection_date as inspect16_152_, inspection0_.inspection_evaluate_date as inspect17_152_, inspection0_.inspection_evaluate_status as inspect18_152_, inspection0_.inspection_report_id as inspect39_152_, inspection0_.inspection_report_status as inspect19_152_, inspection0_.is_show_leader as is_show20_152_, inspection0_.last_updated_date as last_up21_152_, inspection0_.last_updated_date_feedback_solution as last_up22_152_, inspection0_.last_updated_date_inspection_tracking as last_up23_152_, inspection0_.lat as lat24_152_, inspection0_.lng as lng25_152_, inspection0_.manager_user_id as manager26_152_, inspection0_.priority_suggestion_color as priorit27_152_, inspection0_.priority_suggestion_name as priorit28_152_, inspection0_.priority_suggestion_seq as priorit29_152_, inspection0_.send_email_replied_date as send_em30_152_, inspection0_.send_email_status as send_em31_152_, inspection0_.strategic_plan_id as strateg32_152_, inspection0_.strategic_plan_item_id as strateg33_152_, inspection0_.strategic_plan_item_total_effort as strateg34_152_, inspection0_.strategic_plan_name as strateg35_152_ from v_inspection_report inspection0_ inner join audit_plan_info_org auditplani1_ on inspection0_.audit_plan_info_org_id=auditplani1_.id inner join audit_work auditwork2_ on auditplani1_.id=auditwork2_.audit_plan_info_org_id inner join audit_work_auditor auditworka3_ on auditwork2_.id=auditworka3_.audit_work_id cross join inspection_report inspection4_ cross join audit_work auditwork8_ cross join audit_work auditwork11_ where inspection0_.inspection_report_id=inspection4_.id and auditplani1_.id=auditwork8_.audit_plan_info_org_id and inspection4_.audit_work_id=auditwork11_.id and (inspection4_.inspection_report_status in (@P0 , @P1 , @P2) or inspection4_.inspection_report_status=@P3 and (inspection4_.send_manager_date is not null)) and auditwork8_.is_show_leader=@P4 and (auditworka3_.position_name=@P5 and auditworka3_.user_id=@P6 or inspection0_.manager_user_id=850 or inspection0_.auditee_org_id in (select distinct auditeeorg9_.id from v_auditee_org_flat_tree auditeeorg9_ where auditeeorg9_.auditee_type=@P7 and (auditeeorg9_.parent_id in (1465) or auditeeorg9_.id in (1465)))) and auditwork11_.is_show_leader=@P8 order by inspection0_.last_updated_date desc offset 0 rows fetch next @P9 rows only",262797,1176101,-913304,2559876523,131,262797
"(@P0 nvarchar(4000),@P1 nvarchar(4000),@P2 nvarchar(4000),@P3 nvarchar(4000),@P4 bit,@P5 nvarchar(4000),@P6 int,@P7 nvarchar(4000),@P8 bit,@P9 int)select distinct inspection0_.id as id1_152_, inspection0_.annual_plan_detail_id as annual_36_152_, inspection0_.annual_plan_draft_id as annual_p2_152_, inspection0_.annual_plan_draft_name as annual_p3_152_, inspection0_.annual_plan_id as annual_p4_152_, inspection0_.audit_plan_info_org_id as audit_p37_152_, inspection0_.audit_procedure_code as audit_pr5_152_, inspection0_.audit_procedure_id as audit_pr6_152_, inspection0_.audit_procedure_name as audit_pr7_152_, inspection0_.audit_procedure_years as audit_pr8_152_, inspection0_.audit_task_status as audit_ta9_152_, inspection0_.audit_work_status as audit_w10_152_, inspection0_.audited_date_set_report as audited11_152_, inspection0_.auditee_org_id as auditee38_152_, inspection0_.auditee_org_name as auditee12_152_, inspection0_.auditee_org_postcode as auditee13_152_, inspection0_.auditee_org_type as auditee14_152_, inspection0_.feedback_status as feedbac15_152_, inspection0_.inspection_date as inspect16_152_, inspection0_.inspection_evaluate_date as inspect17_152_, inspection0_.inspection_evaluate_status as inspect18_152_, inspection0_.inspection_report_id as inspect39_152_, inspection0_.inspection_report_status as inspect19_152_, inspection0_.is_show_leader as is_show20_152_, inspection0_.last_updated_date as last_up21_152_, inspection0_.last_updated_date_feedback_solution as last_up22_152_, inspection0_.last_updated_date_inspection_tracking as last_up23_152_, inspection0_.lat as lat24_152_, inspection0_.lng as lng25_152_, inspection0_.manager_user_id as manager26_152_, inspection0_.priority_suggestion_color as priorit27_152_, inspection0_.priority_suggestion_name as priorit28_152_, inspection0_.priority_suggestion_seq as priorit29_152_, inspection0_.send_email_replied_date as send_em30_152_, inspection0_.send_email_status as send_em31_152_, inspection0_.strategic_plan_id as strateg32_152_, inspection0_.strategic_plan_item_id as strateg33_152_, inspection0_.strategic_plan_item_total_effort as strateg34_152_, inspection0_.strategic_plan_name as strateg35_152_ from v_inspection_report inspection0_ inner join audit_plan_info_org auditplani1_ on inspection0_.audit_plan_info_org_id=auditplani1_.id inner join audit_work auditwork2_ on auditplani1_.id=auditwork2_.audit_plan_info_org_id inner join audit_work_auditor auditworka3_ on auditwork2_.id=auditworka3_.audit_work_id cross join inspection_report inspection4_ cross join audit_work auditwork8_ cross join audit_work auditwork11_ where inspection0_.inspection_report_id=inspection4_.id and auditplani1_.id=auditwork8_.audit_plan_info_org_id and inspection4_.audit_work_id=auditwork11_.id and (inspection4_.inspection_report_status in (@P0 , @P1 , @P2) or inspection4_.inspection_report_status=@P3 and (inspection4_.send_manager_date is not null)) and auditwork8_.is_show_leader=@P4 and (auditworka3_.position_name=@P5 and auditworka3_.user_id=@P6 or inspection0_.manager_user_id=296 or inspection0_.auditee_org_id in (select distinct auditeeorg9_.id from v_auditee_org_flat_tree auditeeorg9_ where auditeeorg9_.auditee_type=@P7 and (auditeeorg9_.parent_id in (1418 , 1560 , 1580 , 1621 , 1678 , 1720 , 1721 , 1740) or auditeeorg9_.id in (1418 , 1560 , 1580 , 1621 , 1678 , 1720 , 1721 , 1740)))) and auditwork11_.is_show_leader=@P8 order by inspection0_.last_updated_date desc offset 0 rows fetch next @P9 rows only",262763,1153903,-891140,2570794158,132,262763
"(@P0 nvarchar(4000),@P1 nvarchar(4000),@P2 nvarchar(4000),@P3 nvarchar(4000),@P4 bit,@P5 nvarchar(4000),@P6 int,@P7 nvarchar(4000),@P8 bit,@P9 int)select distinct inspection0_.id as id1_152_, inspection0_.annual_plan_detail_id as annual_36_152_, inspection0_.annual_plan_draft_id as annual_p2_152_, inspection0_.annual_plan_draft_name as annual_p3_152_, inspection0_.annual_plan_id as annual_p4_152_, inspection0_.audit_plan_info_org_id as audit_p37_152_, inspection0_.audit_procedure_code as audit_pr5_152_, inspection0_.audit_procedure_id as audit_pr6_152_, inspection0_.audit_procedure_name as audit_pr7_152_, inspection0_.audit_procedure_years as audit_pr8_152_, inspection0_.audit_task_status as audit_ta9_152_, inspection0_.audit_work_status as audit_w10_152_, inspection0_.audited_date_set_report as audited11_152_, inspection0_.auditee_org_id as auditee38_152_, inspection0_.auditee_org_name as auditee12_152_, inspection0_.auditee_org_postcode as auditee13_152_, inspection0_.auditee_org_type as auditee14_152_, inspection0_.feedback_status as feedbac15_152_, inspection0_.inspection_date as inspect16_152_, inspection0_.inspection_evaluate_date as inspect17_152_, inspection0_.inspection_evaluate_status as inspect18_152_, inspection0_.inspection_report_id as inspect39_152_, inspection0_.inspection_report_status as inspect19_152_, inspection0_.is_show_leader as is_show20_152_, inspection0_.last_updated_date as last_up21_152_, inspection0_.last_updated_date_feedback_solution as last_up22_152_, inspection0_.last_updated_date_inspection_tracking as last_up23_152_, inspection0_.lat as lat24_152_, inspection0_.lng as lng25_152_, inspection0_.manager_user_id as manager26_152_, inspection0_.priority_suggestion_color as priorit27_152_, inspection0_.priority_suggestion_name as priorit28_152_, inspection0_.priority_suggestion_seq as priorit29_152_, inspection0_.send_email_replied_date as send_em30_152_, inspection0_.send_email_status as send_em31_152_, inspection0_.strategic_plan_id as strateg32_152_, inspection0_.strategic_plan_item_id as strateg33_152_, inspection0_.strategic_plan_item_total_effort as strateg34_152_, inspection0_.strategic_plan_name as strateg35_152_ from v_inspection_report inspection0_ inner join audit_plan_info_org auditplani1_ on inspection0_.audit_plan_info_org_id=auditplani1_.id inner join audit_work auditwork2_ on auditplani1_.id=auditwork2_.audit_plan_info_org_id inner join audit_work_auditor auditworka3_ on auditwork2_.id=auditworka3_.audit_work_id cross join inspection_report inspection4_ cross join audit_work auditwork8_ cross join audit_work auditwork11_ where inspection0_.inspection_report_id=inspection4_.id and auditplani1_.id=auditwork8_.audit_plan_info_org_id and inspection4_.audit_work_id=auditwork11_.id and (inspection4_.inspection_report_status in (@P0 , @P1 , @P2) or inspection4_.inspection_report_status=@P3 and (inspection4_.send_manager_date is not null)) and auditwork8_.is_show_leader=@P4 and (auditworka3_.position_name=@P5 and auditworka3_.user_id=@P6 or inspection0_.manager_user_id=2294 or inspection0_.auditee_org_id in (select distinct auditeeorg9_.id from v_auditee_org_flat_tree auditeeorg9_ where auditeeorg9_.auditee_type=@P7 and (auditeeorg9_.parent_id in (24 , 39 , 40 , 42 , 51) or auditeeorg9_.id in (24 , 39 , 40 , 42 , 51)))) and auditwork11_.is_show_leader=@P8 order by inspection0_.last_updated_date desc offset 0 rows fetch next @P9 rows only",257751,1177409,-919658,2594194448,128,257751
"(@P0 nvarchar(4000),@P1 nvarchar(4000),@P2 nvarchar(4000),@P3 nvarchar(4000),@P4 bit,@P5 nvarchar(4000),@P6 int,@P7 nvarchar(4000),@P8 bit,@P9 int)select distinct inspection0_.id as id1_152_, inspection0_.annual_plan_detail_id as annual_36_152_, inspection0_.annual_plan_draft_id as annual_p2_152_, inspection0_.annual_plan_draft_name as annual_p3_152_, inspection0_.annual_plan_id as annual_p4_152_, inspection0_.audit_plan_info_org_id as audit_p37_152_, inspection0_.audit_procedure_code as audit_pr5_152_, inspection0_.audit_procedure_id as audit_pr6_152_, inspection0_.audit_procedure_name as audit_pr7_152_, inspection0_.audit_procedure_years as audit_pr8_152_, inspection0_.audit_task_status as audit_ta9_152_, inspection0_.audit_work_status as audit_w10_152_, inspection0_.audited_date_set_report as audited11_152_, inspection0_.auditee_org_id as auditee38_152_, inspection0_.auditee_org_name as auditee12_152_, inspection0_.auditee_org_postcode as auditee13_152_, inspection0_.auditee_org_type as auditee14_152_, inspection0_.feedback_status as feedbac15_152_, inspection0_.inspection_date as inspect16_152_, inspection0_.inspection_evaluate_date as inspect17_152_, inspection0_.inspection_evaluate_status as inspect18_152_, inspection0_.inspection_report_id as inspect39_152_, inspection0_.inspection_report_status as inspect19_152_, inspection0_.is_show_leader as is_show20_152_, inspection0_.last_updated_date as last_up21_152_, inspection0_.last_updated_date_feedback_solution as last_up22_152_, inspection0_.last_updated_date_inspection_tracking as last_up23_152_, inspection0_.lat as lat24_152_, inspection0_.lng as lng25_152_, inspection0_.manager_user_id as manager26_152_, inspection0_.priority_suggestion_color as priorit27_152_, inspection0_.priority_suggestion_name as priorit28_152_, inspection0_.priority_suggestion_seq as priorit29_152_, inspection0_.send_email_replied_date as send_em30_152_, inspection0_.send_email_status as send_em31_152_, inspection0_.strategic_plan_id as strateg32_152_, inspection0_.strategic_plan_item_id as strateg33_152_, inspection0_.strategic_plan_item_total_effort as strateg34_152_, inspection0_.strategic_plan_name as strateg35_152_ from v_inspection_report inspection0_ inner join audit_plan_info_org auditplani1_ on inspection0_.audit_plan_info_org_id=auditplani1_.id inner join audit_work auditwork2_ on auditplani1_.id=auditwork2_.audit_plan_info_org_id inner join audit_work_auditor auditworka3_ on auditwork2_.id=auditworka3_.audit_work_id cross join inspection_report inspection4_ cross join audit_work auditwork8_ cross join audit_work auditwork11_ where inspection0_.inspection_report_id=inspection4_.id and auditplani1_.id=auditwork8_.audit_plan_info_org_id and inspection4_.audit_work_id=auditwork11_.id and (inspection4_.inspection_report_status in (@P0 , @P1 , @P2) or inspection4_.inspection_report_status=@P3 and (inspection4_.send_manager_date is not null)) and auditwork8_.is_show_leader=@P4 and (auditworka3_.position_name=@P5 and auditworka3_.user_id=@P6 or inspection0_.manager_user_id=647 or inspection0_.auditee_org_id in (select distinct auditeeorg9_.id from v_auditee_org_flat_tree auditeeorg9_ where auditeeorg9_.auditee_type=@P7 and (auditeeorg9_.parent_id in (1674) or auditeeorg9_.id in (1674)))) and auditwork11_.is_show_leader=@P8 order by inspection0_.last_updated_date desc offset 0 rows fetch next @P9 rows only",255546,1230167,-974621,2588693603,135,255546
"(@P0 nvarchar(4000),@P1 nvarchar(4000),@P2 nvarchar(4000),@P3 nvarchar(4000),@P4 bit,@P5 nvarchar(4000),@P6 int,@P7 nvarchar(4000),@P8 bit,@P9 int)select distinct inspection0_.id as id1_152_, inspection0_.annual_plan_detail_id as annual_36_152_, inspection0_.annual_plan_draft_id as annual_p2_152_, inspection0_.annual_plan_draft_name as annual_p3_152_, inspection0_.annual_plan_id as annual_p4_152_, inspection0_.audit_plan_info_org_id as audit_p37_152_, inspection0_.audit_procedure_code as audit_pr5_152_, inspection0_.audit_procedure_id as audit_pr6_152_, inspection0_.audit_procedure_name as audit_pr7_152_, inspection0_.audit_procedure_years as audit_pr8_152_, inspection0_.audit_task_status as audit_ta9_152_, inspection0_.audit_work_status as audit_w10_152_, inspection0_.audited_date_set_report as audited11_152_, inspection0_.auditee_org_id as auditee38_152_, inspection0_.auditee_org_name as auditee12_152_, inspection0_.auditee_org_postcode as auditee13_152_, inspection0_.auditee_org_type as auditee14_152_, inspection0_.feedback_status as feedbac15_152_, inspection0_.inspection_date as inspect16_152_, inspection0_.inspection_evaluate_date as inspect17_152_, inspection0_.inspection_evaluate_status as inspect18_152_, inspection0_.inspection_report_id as inspect39_152_, inspection0_.inspection_report_status as inspect19_152_, inspection0_.is_show_leader as is_show20_152_, inspection0_.last_updated_date as last_up21_152_, inspection0_.last_updated_date_feedback_solution as last_up22_152_, inspection0_.last_updated_date_inspection_tracking as last_up23_152_, inspection0_.lat as lat24_152_, inspection0_.lng as lng25_152_, inspection0_.manager_user_id as manager26_152_, inspection0_.priority_suggestion_color as priorit27_152_, inspection0_.priority_suggestion_name as priorit28_152_, inspection0_.priority_suggestion_seq as priorit29_152_, inspection0_.send_email_replied_date as send_em30_152_, inspection0_.send_email_status as send_em31_152_, inspection0_.strategic_plan_id as strateg32_152_, inspection0_.strategic_plan_item_id as strateg33_152_, inspection0_.strategic_plan_item_total_effort as strateg34_152_, inspection0_.strategic_plan_name as strateg35_152_ from v_inspection_report inspection0_ inner join audit_plan_info_org auditplani1_ on inspection0_.audit_plan_info_org_id=auditplani1_.id inner join audit_work auditwork2_ on auditplani1_.id=auditwork2_.audit_plan_info_org_id inner join audit_work_auditor auditworka3_ on auditwork2_.id=auditworka3_.audit_work_id cross join inspection_report inspection4_ cross join audit_work auditwork8_ cross join audit_work auditwork11_ where inspection0_.inspection_report_id=inspection4_.id and auditplani1_.id=auditwork8_.audit_plan_info_org_id and inspection4_.audit_work_id=auditwork11_.id and (inspection4_.inspection_report_status in (@P0 , @P1 , @P2) or inspection4_.inspection_report_status=@P3 and (inspection4_.send_manager_date is not null)) and auditwork8_.is_show_leader=@P4 and (auditworka3_.position_name=@P5 and auditworka3_.user_id=@P6 or inspection0_.manager_user_id=1427 or inspection0_.auditee_org_id in (select distinct auditeeorg9_.id from v_auditee_org_flat_tree auditeeorg9_ where auditeeorg9_.auditee_type=@P7 and (auditeeorg9_.parent_id in (1646) or auditeeorg9_.id in (1646)))) and auditwork11_.is_show_leader=@P8 order by inspection0_.last_updated_date desc offset 0 rows fetch next @P9 rows only",251403,1179202,-927799,2610899762,202,251403
"(@P0 nvarchar(4000),@P1 nvarchar(4000),@P2 nvarchar(4000),@P3 nvarchar(4000),@P4 bit,@P5 nvarchar(4000),@P6 int,@P7 nvarchar(4000),@P8 bit,@P9 int)select distinct inspection0_.id as id1_152_, inspection0_.annual_plan_detail_id as annual_36_152_, inspection0_.annual_plan_draft_id as annual_p2_152_, inspection0_.annual_plan_draft_name as annual_p3_152_, inspection0_.annual_plan_id as annual_p4_152_, inspection0_.audit_plan_info_org_id as audit_p37_152_, inspection0_.audit_procedure_code as audit_pr5_152_, inspection0_.audit_procedure_id as audit_pr6_152_, inspection0_.audit_procedure_name as audit_pr7_152_, inspection0_.audit_procedure_years as audit_pr8_152_, inspection0_.audit_task_status as audit_ta9_152_, inspection0_.audit_work_status as audit_w10_152_, inspection0_.audited_date_set_report as audited11_152_, inspection0_.auditee_org_id as auditee38_152_, inspection0_.auditee_org_name as auditee12_152_, inspection0_.auditee_org_postcode as auditee13_152_, inspection0_.auditee_org_type as auditee14_152_, inspection0_.feedback_status as feedbac15_152_, inspection0_.inspection_date as inspect16_152_, inspection0_.inspection_evaluate_date as inspect17_152_, inspection0_.inspection_evaluate_status as inspect18_152_, inspection0_.inspection_report_id as inspect39_152_, inspection0_.inspection_report_status as inspect19_152_, inspection0_.is_show_leader as is_show20_152_, inspection0_.last_updated_date as last_up21_152_, inspection0_.last_updated_date_feedback_solution as last_up22_152_, inspection0_.last_updated_date_inspection_tracking as last_up23_152_, inspection0_.lat as lat24_152_, inspection0_.lng as lng25_152_, inspection0_.manager_user_id as manager26_152_, inspection0_.priority_suggestion_color as priorit27_152_, inspection0_.priority_suggestion_name as priorit28_152_, inspection0_.priority_suggestion_seq as priorit29_152_, inspection0_.send_email_replied_date as send_em30_152_, inspection0_.send_email_status as send_em31_152_, inspection0_.strategic_plan_id as strateg32_152_, inspection0_.strategic_plan_item_id as strateg33_152_, inspection0_.strategic_plan_item_total_effort as strateg34_152_, inspection0_.strategic_plan_name as strateg35_152_ from v_inspection_report inspection0_ inner join audit_plan_info_org auditplani1_ on inspection0_.audit_plan_info_org_id=auditplani1_.id inner join audit_work auditwork2_ on auditplani1_.id=auditwork2_.audit_plan_info_org_id inner join audit_work_auditor auditworka3_ on auditwork2_.id=auditworka3_.audit_work_id cross join inspection_report inspection4_ cross join audit_work auditwork8_ cross join audit_work auditwork11_ where inspection0_.inspection_report_id=inspection4_.id and auditplani1_.id=auditwork8_.audit_plan_info_org_id and inspection4_.audit_work_id=auditwork11_.id and (inspection4_.inspection_report_status in (@P0 , @P1 , @P2) or inspection4_.inspection_report_status=@P3 and (inspection4_.send_manager_date is not null)) and auditwork8_.is_show_leader=@P4 and (auditworka3_.position_name=@P5 and auditworka3_.user_id=@P6 or inspection0_.manager_user_id=1576 or inspection0_.auditee_org_id in (select distinct auditeeorg9_.id from v_auditee_org_flat_tree auditeeorg9_ where auditeeorg9_.auditee_type=@P7 and (auditeeorg9_.parent_id in (1633 , 1652 , 1734) or auditeeorg9_.id in (1633 , 1652 , 1734)))) and auditwork11_.is_show_leader=@P8 order by inspection0_.last_updated_date desc offset 0 rows fetch next @P9 rows only",250797,1136354,-885557,2558680016,131,250797
"(@P0 date,@P1 nvarchar(4000),@P2 nvarchar(4000),@P3 nvarchar(4000),@P4 nvarchar(4000),@P5 bit,@P6 nvarchar(4000),@P7 int,@P8 nvarchar(4000),@P9 bit,@P10 int)select distinct inspection0_.id as id1_152_, inspection0_.annual_plan_detail_id as annual_36_152_, inspection0_.annual_plan_draft_id as annual_p2_152_, inspection0_.annual_plan_draft_name as annual_p3_152_, inspection0_.annual_plan_id as annual_p4_152_, inspection0_.audit_plan_info_org_id as audit_p37_152_, inspection0_.audit_procedure_code as audit_pr5_152_, inspection0_.audit_procedure_id as audit_pr6_152_, inspection0_.audit_procedure_name as audit_pr7_152_, inspection0_.audit_procedure_years as audit_pr8_152_, inspection0_.audit_task_status as audit_ta9_152_, inspection0_.audit_work_status as audit_w10_152_, inspection0_.audited_date_set_report as audited11_152_, inspection0_.auditee_org_id as auditee38_152_, inspection0_.auditee_org_name as auditee12_152_, inspection0_.auditee_org_postcode as auditee13_152_, inspection0_.auditee_org_type as auditee14_152_, inspection0_.feedback_status as feedbac15_152_, inspection0_.inspection_date as inspect16_152_, inspection0_.inspection_evaluate_date as inspect17_152_, inspection0_.inspection_evaluate_status as inspect18_152_, inspection0_.inspection_report_id as inspect39_152_, inspection0_.inspection_report_status as inspect19_152_, inspection0_.is_show_leader as is_show20_152_, inspection0_.last_updated_date as last_up21_152_, inspection0_.last_updated_date_feedback_solution as last_up22_152_, inspection0_.last_updated_date_inspection_tracking as last_up23_152_, inspection0_.lat as lat24_152_, inspection0_.lng as lng25_152_, inspection0_.manager_user_id as manager26_152_, inspection0_.priority_suggestion_color as priorit27_152_, inspection0_.priority_suggestion_name as priorit28_152_, inspection0_.priority_suggestion_seq as priorit29_152_, inspection0_.send_email_replied_date as send_em30_152_, inspection0_.send_email_status as send_em31_152_, inspection0_.strategic_plan_id as strateg32_152_, inspection0_.strategic_plan_item_id as strateg33_152_, inspection0_.strategic_plan_item_total_effort as strateg34_152_, inspection0_.strategic_plan_name as strateg35_152_ from v_inspection_report inspection0_ inner join audit_plan_info_org auditplani1_ on inspection0_.audit_plan_info_org_id=auditplani1_.id inner join audit_work auditwork2_ on auditplani1_.id=auditwork2_.audit_plan_info_org_id inner join audit_work_auditor auditworka3_ on auditwork2_.id=auditworka3_.audit_work_id cross join audit_work auditwork5_ cross join inspection_report inspection6_ cross join audit_work auditwork13_ where auditplani1_.id=auditwork5_.audit_plan_info_org_id and inspection0_.inspection_report_id=inspection6_.id and inspection6_.audit_work_id=auditwork13_.id and auditwork5_.inspection_date<=@P0 and (inspection6_.inspection_report_status in (@P1 , @P2 , @P3) or inspection6_.inspection_report_status=@P4 and (inspection6_.send_manager_date is not null)) and auditwork5_.is_show_leader=@P5 and (auditworka3_.position_name=@P6 and auditworka3_.user_id=@P7 or inspection0_.manager_user_id=156 or inspection0_.auditee_org_id in (select distinct auditeeorg11_.id from v_auditee_org_flat_tree auditeeorg11_ where auditeeorg11_.auditee_type=@P8 and (auditeeorg11_.parent_id in (81) or auditeeorg11_.id in (81)))) and auditwork13_.is_show_leader=@P9 order by inspection0_.last_updated_date desc offset 0 rows fetch next @P10 rows only",249202,1233536,-984334,2592372682,142,249202
"(@P0 nvarchar(4000),@P1 nvarchar(4000),@P2 nvarchar(4000),@P3 nvarchar(4000),@P4 bit,@P5 nvarchar(4000),@P6 int,@P7 nvarchar(4000),@P8 bit,@P9 int)select distinct inspection0_.id as id1_152_, inspection0_.annual_plan_detail_id as annual_36_152_, inspection0_.annual_plan_draft_id as annual_p2_152_, inspection0_.annual_plan_draft_name as annual_p3_152_, inspection0_.annual_plan_id as annual_p4_152_, inspection0_.audit_plan_info_org_id as audit_p37_152_, inspection0_.audit_procedure_code as audit_pr5_152_, inspection0_.audit_procedure_id as audit_pr6_152_, inspection0_.audit_procedure_name as audit_pr7_152_, inspection0_.audit_procedure_years as audit_pr8_152_, inspection0_.audit_task_status as audit_ta9_152_, inspection0_.audit_work_status as audit_w10_152_, inspection0_.audited_date_set_report as audited11_152_, inspection0_.auditee_org_id as auditee38_152_, inspection0_.auditee_org_name as auditee12_152_, inspection0_.auditee_org_postcode as auditee13_152_, inspection0_.auditee_org_type as auditee14_152_, inspection0_.feedback_status as feedbac15_152_, inspection0_.inspection_date as inspect16_152_, inspection0_.inspection_evaluate_date as inspect17_152_, inspection0_.inspection_evaluate_status as inspect18_152_, inspection0_.inspection_report_id as inspect39_152_, inspection0_.inspection_report_status as inspect19_152_, inspection0_.is_show_leader as is_show20_152_, inspection0_.last_updated_date as last_up21_152_, inspection0_.last_updated_date_feedback_solution as last_up22_152_, inspection0_.last_updated_date_inspection_tracking as last_up23_152_, inspection0_.lat as lat24_152_, inspection0_.lng as lng25_152_, inspection0_.manager_user_id as manager26_152_, inspection0_.priority_suggestion_color as priorit27_152_, inspection0_.priority_suggestion_name as priorit28_152_, inspection0_.priority_suggestion_seq as priorit29_152_, inspection0_.send_email_replied_date as send_em30_152_, inspection0_.send_email_status as send_em31_152_, inspection0_.strategic_plan_id as strateg32_152_, inspection0_.strategic_plan_item_id as strateg33_152_, inspection0_.strategic_plan_item_total_effort as strateg34_152_, inspection0_.strategic_plan_name as strateg35_152_ from v_inspection_report inspection0_ inner join audit_plan_info_org auditplani1_ on inspection0_.audit_plan_info_org_id=auditplani1_.id inner join audit_work auditwork2_ on auditplani1_.id=auditwork2_.audit_plan_info_org_id inner join audit_work_auditor auditworka3_ on auditwork2_.id=auditworka3_.audit_work_id cross join inspection_report inspection4_ cross join audit_work auditwork8_ cross join audit_work auditwork11_ where inspection0_.inspection_report_id=inspection4_.id and auditplani1_.id=auditwork8_.audit_plan_info_org_id and inspection4_.audit_work_id=auditwork11_.id and (inspection4_.inspection_report_status in (@P0 , @P1 , @P2) or inspection4_.inspection_report_status=@P3 and (inspection4_.send_manager_date is not null)) and auditwork8_.is_show_leader=@P4 and (auditworka3_.position_name=@P5 and auditworka3_.user_id=@P6 or inspection0_.manager_user_id=1387 or inspection0_.auditee_org_id in (select distinct auditeeorg9_.id from v_auditee_org_flat_tree auditeeorg9_ where auditeeorg9_.auditee_type=@P7 and (auditeeorg9_.parent_id in (1430) or auditeeorg9_.id in (1430)))) and auditwork11_.is_show_leader=@P8 order by inspection0_.last_updated_date desc offset 0 rows fetch next @P9 rows only",241206,1113666,-872460,2556867126,137,241206
"(@P0 nvarchar(4000),@P1 nvarchar(4000),@P2 nvarchar(4000),@P3 nvarchar(4000),@P4 bit,@P5 nvarchar(4000),@P6 int,@P7 nvarchar(4000),@P8 bit,@P9 int)select distinct inspection0_.id as id1_152_, inspection0_.annual_plan_detail_id as annual_36_152_, inspection0_.annual_plan_draft_id as annual_p2_152_, inspection0_.annual_plan_draft_name as annual_p3_152_, inspection0_.annual_plan_id as annual_p4_152_, inspection0_.audit_plan_info_org_id as audit_p37_152_, inspection0_.audit_procedure_code as audit_pr5_152_, inspection0_.audit_procedure_id as audit_pr6_152_, inspection0_.audit_procedure_name as audit_pr7_152_, inspection0_.audit_procedure_years as audit_pr8_152_, inspection0_.audit_task_status as audit_ta9_152_, inspection0_.audit_work_status as audit_w10_152_, inspection0_.audited_date_set_report as audited11_152_, inspection0_.auditee_org_id as auditee38_152_, inspection0_.auditee_org_name as auditee12_152_, inspection0_.auditee_org_postcode as auditee13_152_, inspection0_.auditee_org_type as auditee14_152_, inspection0_.feedback_status as feedbac15_152_, inspection0_.inspection_date as inspect16_152_, inspection0_.inspection_evaluate_date as inspect17_152_, inspection0_.inspection_evaluate_status as inspect18_152_, inspection0_.inspection_report_id as inspect39_152_, inspection0_.inspection_report_status as inspect19_152_, inspection0_.is_show_leader as is_show20_152_, inspection0_.last_updated_date as last_up21_152_, inspection0_.last_updated_date_feedback_solution as last_up22_152_, inspection0_.last_updated_date_inspection_tracking as last_up23_152_, inspection0_.lat as lat24_152_, inspection0_.lng as lng25_152_, inspection0_.manager_user_id as manager26_152_, inspection0_.priority_suggestion_color as priorit27_152_, inspection0_.priority_suggestion_name as priorit28_152_, inspection0_.priority_suggestion_seq as priorit29_152_, inspection0_.send_email_replied_date as send_em30_152_, inspection0_.send_email_status as send_em31_152_, inspection0_.strategic_plan_id as strateg32_152_, inspection0_.strategic_plan_item_id as strateg33_152_, inspection0_.strategic_plan_item_total_effort as strateg34_152_, inspection0_.strategic_plan_name as strateg35_152_ from v_inspection_report inspection0_ inner join audit_plan_info_org auditplani1_ on inspection0_.audit_plan_info_org_id=auditplani1_.id inner join audit_work auditwork2_ on auditplani1_.id=auditwork2_.audit_plan_info_org_id inner join audit_work_auditor auditworka3_ on auditwork2_.id=auditworka3_.audit_work_id cross join inspection_report inspection4_ cross join audit_work auditwork8_ cross join audit_work auditwork11_ where inspection0_.inspection_report_id=inspection4_.id and auditplani1_.id=auditwork8_.audit_plan_info_org_id and inspection4_.audit_work_id=auditwork11_.id and (inspection4_.inspection_report_status in (@P0 , @P1 , @P2) or inspection4_.inspection_report_status=@P3 and (inspection4_.send_manager_date is not null)) and auditwork8_.is_show_leader=@P4 and (auditworka3_.position_name=@P5 and auditworka3_.user_id=@P6 or inspection0_.manager_user_id=1285 or inspection0_.auditee_org_id in (select distinct auditeeorg9_.id from v_auditee_org_flat_tree auditeeorg9_ where auditeeorg9_.auditee_type=@P7 and (auditeeorg9_.parent_id in (60) or auditeeorg9_.id in (60)))) and auditwork11_.is_show_leader=@P8 order by inspection0_.last_updated_date desc offset 0 rows fetch next @P9 rows only",239936,1118316,-878380,2610899726,138,239936
"(@P0 nvarchar(4000),@P1 nvarchar(4000),@P2 nvarchar(4000),@P3 nvarchar(4000),@P4 nvarchar(4000),@P5 nvarchar(4000),@P6 nvarchar(4000),@P7 nvarchar(4000),@P8 bit,@P9 int)select inspection0_.id as id1_152_, inspection0_.annual_plan_detail_id as annual_36_152_, inspection0_.annual_plan_draft_id as annual_p2_152_, inspection0_.annual_plan_draft_name as annual_p3_152_, inspection0_.annual_plan_id as annual_p4_152_, inspection0_.audit_plan_info_org_id as audit_p37_152_, inspection0_.audit_procedure_code as audit_pr5_152_, inspection0_.audit_procedure_id as audit_pr6_152_, inspection0_.audit_procedure_name as audit_pr7_152_, inspection0_.audit_procedure_years as audit_pr8_152_, inspection0_.audit_task_status as audit_ta9_152_, inspection0_.audit_work_status as audit_w10_152_, inspection0_.audited_date_set_report as audited11_152_, inspection0_.auditee_org_id as auditee38_152_, inspection0_.auditee_org_name as auditee12_152_, inspection0_.auditee_org_postcode as auditee13_152_, inspection0_.auditee_org_type as auditee14_152_, inspection0_.feedback_status as feedbac15_152_, inspection0_.inspection_date as inspect16_152_, inspection0_.inspection_evaluate_date as inspect17_152_, inspection0_.inspection_evaluate_status as inspect18_152_, inspection0_.inspection_report_id as inspect39_152_, inspection0_.inspection_report_status as inspect19_152_, inspection0_.is_show_leader as is_show20_152_, inspection0_.last_updated_date as last_up21_152_, inspection0_.last_updated_date_feedback_solution as last_up22_152_, inspection0_.last_updated_date_inspection_tracking as last_up23_152_, inspection0_.lat as lat24_152_, inspection0_.lng as lng25_152_, inspection0_.manager_user_id as manager26_152_, inspection0_.priority_suggestion_color as priorit27_152_, inspection0_.priority_suggestion_name as priorit28_152_, inspection0_.priority_suggestion_seq as priorit29_152_, inspection0_.send_email_replied_date as send_em30_152_, inspection0_.send_email_status as send_em31_152_, inspection0_.strategic_plan_id as strateg32_152_, inspection0_.strategic_plan_item_id as strateg33_152_, inspection0_.strategic_plan_item_total_effort as strateg34_152_, inspection0_.strategic_plan_name as strateg35_152_ from v_inspection_report inspection0_ cross join inspection_report inspection1_ cross join audit_plan_info_org auditplani2_ cross join audit_work auditwork3_ where inspection0_.inspection_report_id=inspection1_.id and inspection0_.audit_plan_info_org_id=auditplani2_.id and auditplani2_.id=auditwork3_.audit_plan_info_org_id and (inspection1_.feedback_status in (@P0 , @P1 , @P2 , @P3 , @P4 , @P5 , @P6 , @P7)) and auditwork3_.is_show_leader=@P8 order by inspection0_.last_updated_date desc, inspection0_.last_updated_date_feedback_solution desc offset 0 rows fetch next @P9 rows only",225140,1793589,-1568449,2802019375,19,450280
"(@P0 nvarchar(4000),@P1 nvarchar(4000),@P2 nvarchar(4000),@P3 nvarchar(4000),@P4 nvarchar(4000),@P5 nvarchar(4000),@P6 nvarchar(4000),@P7 nvarchar(4000),@P8 nvarchar(4000),@P9 bit,@P10 nvarchar(4000),@P11 bit,@P12 int)select distinct inspection0_.id as id1_152_, inspection0_.annual_plan_detail_id as annual_36_152_, inspection0_.annual_plan_draft_id as annual_p2_152_, inspection0_.annual_plan_draft_name as annual_p3_152_, inspection0_.annual_plan_id as annual_p4_152_, inspection0_.audit_plan_info_org_id as audit_p37_152_, inspection0_.audit_procedure_code as audit_pr5_152_, inspection0_.audit_procedure_id as audit_pr6_152_, inspection0_.audit_procedure_name as audit_pr7_152_, inspection0_.audit_procedure_years as audit_pr8_152_, inspection0_.audit_task_status as audit_ta9_152_, inspection0_.audit_work_status as audit_w10_152_, inspection0_.audited_date_set_report as audited11_152_, inspection0_.auditee_org_id as auditee38_152_, inspection0_.auditee_org_name as auditee12_152_, inspection0_.auditee_org_postcode as auditee13_152_, inspection0_.auditee_org_type as auditee14_152_, inspection0_.feedback_status as feedbac15_152_, inspection0_.inspection_date as inspect16_152_, inspection0_.inspection_evaluate_date as inspect17_152_, inspection0_.inspection_evaluate_status as inspect18_152_, inspection0_.inspection_report_id as inspect39_152_, inspection0_.inspection_report_status as inspect19_152_, inspection0_.is_show_leader as is_show20_152_, inspection0_.last_updated_date as last_up21_152_, inspection0_.last_updated_date_feedback_solution as last_up22_152_, inspection0_.last_updated_date_inspection_tracking as last_up23_152_, inspection0_.lat as lat24_152_, inspection0_.lng as lng25_152_, inspection0_.manager_user_id as manager26_152_, inspection0_.priority_suggestion_color as priorit27_152_, inspection0_.priority_suggestion_name as priorit28_152_, inspection0_.priority_suggestion_seq as priorit29_152_, inspection0_.send_email_replied_date as send_em30_152_, inspection0_.send_email_status as send_em31_152_, inspection0_.strategic_plan_id as strateg32_152_, inspection0_.strategic_plan_item_id as strateg33_152_, inspection0_.strategic_plan_item_total_effort as strateg34_152_, inspection0_.strategic_plan_name as strateg35_152_ from v_inspection_report inspection0_ cross join inspection_report inspection1_ cross join audit_plan_info_org auditplani2_ cross join audit_work auditwork3_ cross join audit_work auditwork6_ where inspection0_.inspection_report_id=inspection1_.id and inspection0_.audit_plan_info_org_id=auditplani2_.id and auditplani2_.id=auditwork3_.audit_plan_info_org_id and inspection1_.audit_work_id=auditwork6_.id and (inspection1_.feedback_status in (@P0 , @P1 , @P2 , @P3 , @P4 , @P5 , @P6 , @P7 , @P8)) and auditwork3_.is_show_leader=@P9 and (inspection0_.manager_user_id=2291 or inspection0_.auditee_org_id in (select distinct auditeeorg4_.id from v_auditee_org_flat_tree auditeeorg4_ where auditeeorg4_.auditee_type=@P10 and (auditeeorg4_.parent_id in (1 , 2 , 3 , 5 , 6 , 10099) or auditeeorg4_.id in (1 , 2 , 3 , 5 , 6 , 10099)))) and auditwork6_.is_show_leader=@P11 order by inspection0_.last_updated_date desc, inspection0_.last_updated_date_feedback_solution desc offset 0 rows fetch next @P12 rows only",204912,1584109,-1379197,2784189283,150,409825
"(@P0 nvarchar(4000),@P1 nvarchar(4000),@P2 nvarchar(4000),@P3 nvarchar(4000),@P4 nvarchar(4000),@P5 nvarchar(4000),@P6 nvarchar(4000),@P7 int)select inspection0_.id as id1_152_, inspection0_.annual_plan_detail_id as annual_36_152_, inspection0_.annual_plan_draft_id as annual_p2_152_, inspection0_.annual_plan_draft_name as annual_p3_152_, inspection0_.annual_plan_id as annual_p4_152_, inspection0_.audit_plan_info_org_id as audit_p37_152_, inspection0_.audit_procedure_code as audit_pr5_152_, inspection0_.audit_procedure_id as audit_pr6_152_, inspection0_.audit_procedure_name as audit_pr7_152_, inspection0_.audit_procedure_years as audit_pr8_152_, inspection0_.audit_task_status as audit_ta9_152_, inspection0_.audit_work_status as audit_w10_152_, inspection0_.audited_date_set_report as audited11_152_, inspection0_.auditee_org_id as auditee38_152_, inspection0_.auditee_org_name as auditee12_152_, inspection0_.auditee_org_postcode as auditee13_152_, inspection0_.auditee_org_type as auditee14_152_, inspection0_.feedback_status as feedbac15_152_, inspection0_.inspection_date as inspect16_152_, inspection0_.inspection_evaluate_date as inspect17_152_, inspection0_.inspection_evaluate_status as inspect18_152_, inspection0_.inspection_report_id as inspect39_152_, inspection0_.inspection_report_status as inspect19_152_, inspection0_.is_show_leader as is_show20_152_, inspection0_.last_updated_date as last_up21_152_, inspection0_.last_updated_date_feedback_solution as last_up22_152_, inspection0_.last_updated_date_inspection_tracking as last_up23_152_, inspection0_.lat as lat24_152_, inspection0_.lng as lng25_152_, inspection0_.manager_user_id as manager26_152_, inspection0_.priority_suggestion_color as priorit27_152_, inspection0_.priority_suggestion_name as priorit28_152_, inspection0_.priority_suggestion_seq as priorit29_152_, inspection0_.send_email_replied_date as send_em30_152_, inspection0_.send_email_status as send_em31_152_, inspection0_.strategic_plan_id as strateg32_152_, inspection0_.strategic_plan_item_id as strateg33_152_, inspection0_.strategic_plan_item_total_effort as strateg34_152_, inspection0_.strategic_plan_name as strateg35_152_ from v_inspection_report inspection0_ cross join inspection_report inspection1_ where inspection0_.inspection_report_id=inspection1_.id and (inspection1_.feedback_status in (@P0 , @P1 , @P2 , @P3 , @P4 , @P5 , @P6)) order by inspection0_.last_updated_date_feedback_solution desc offset 0 rows fetch next @P7 rows only",197429,1577128,-1379699,2802285241,58,197429
"(@P0 nvarchar(4000),@P1 nvarchar(4000),@P2 nvarchar(4000),@P3 nvarchar(4000),@P4 nvarchar(4000),@P5 nvarchar(4000),@P6 nvarchar(4000),@P7 nvarchar(4000),@P8 nvarchar(4000),@P9 bit,@P10 int)select inspection0_.id as id1_152_, inspection0_.annual_plan_detail_id as annual_36_152_, inspection0_.annual_plan_draft_id as annual_p2_152_, inspection0_.annual_plan_draft_name as annual_p3_152_, inspection0_.annual_plan_id as annual_p4_152_, inspection0_.audit_plan_info_org_id as audit_p37_152_, inspection0_.audit_procedure_code as audit_pr5_152_, inspection0_.audit_procedure_id as audit_pr6_152_, inspection0_.audit_procedure_name as audit_pr7_152_, inspection0_.audit_procedure_years as audit_pr8_152_, inspection0_.audit_task_status as audit_ta9_152_, inspection0_.audit_work_status as audit_w10_152_, inspection0_.audited_date_set_report as audited11_152_, inspection0_.auditee_org_id as auditee38_152_, inspection0_.auditee_org_name as auditee12_152_, inspection0_.auditee_org_postcode as auditee13_152_, inspection0_.auditee_org_type as auditee14_152_, inspection0_.feedback_status as feedbac15_152_, inspection0_.inspection_date as inspect16_152_, inspection0_.inspection_evaluate_date as inspect17_152_, inspection0_.inspection_evaluate_status as inspect18_152_, inspection0_.inspection_report_id as inspect39_152_, inspection0_.inspection_report_status as inspect19_152_, inspection0_.is_show_leader as is_show20_152_, inspection0_.last_updated_date as last_up21_152_, inspection0_.last_updated_date_feedback_solution as last_up22_152_, inspection0_.last_updated_date_inspection_tracking as last_up23_152_, inspection0_.lat as lat24_152_, inspection0_.lng as lng25_152_, inspection0_.manager_user_id as manager26_152_, inspection0_.priority_suggestion_color as priorit27_152_, inspection0_.priority_suggestion_name as priorit28_152_, inspection0_.priority_suggestion_seq as priorit29_152_, inspection0_.send_email_replied_date as send_em30_152_, inspection0_.send_email_status as send_em31_152_, inspection0_.strategic_plan_id as strateg32_152_, inspection0_.strategic_plan_item_id as strateg33_152_, inspection0_.strategic_plan_item_total_effort as strateg34_152_, inspection0_.strategic_plan_name as strateg35_152_ from v_inspection_report inspection0_ cross join inspection_report inspection1_ cross join audit_plan_info_org auditplani2_ cross join audit_work auditwork3_ where inspection0_.inspection_report_id=inspection1_.id and inspection0_.audit_plan_info_org_id=auditplani2_.id and auditplani2_.id=auditwork3_.audit_plan_info_org_id and (inspection1_.feedback_status in (@P0 , @P1 , @P2 , @P3 , @P4 , @P5 , @P6 , @P7 , @P8)) and auditwork3_.is_show_leader=@P9 order by inspection0_.last_updated_date desc, inspection0_.last_updated_date_feedback_solution desc offset 0 rows fetch next @P10 rows only",182155,1406825,-1224670,2807375871,15,910779
"(@P0 nvarchar(4000),@P1 int)select inspection0_.id as id1_152_, inspection0_.annual_plan_detail_id as annual_36_152_, inspection0_.annual_plan_draft_id as annual_p2_152_, inspection0_.annual_plan_draft_name as annual_p3_152_, inspection0_.annual_plan_id as annual_p4_152_, inspection0_.audit_plan_info_org_id as audit_p37_152_, inspection0_.audit_procedure_code as audit_pr5_152_, inspection0_.audit_procedure_id as audit_pr6_152_, inspection0_.audit_procedure_name as audit_pr7_152_, inspection0_.audit_procedure_years as audit_pr8_152_, inspection0_.audit_task_status as audit_ta9_152_, inspection0_.audit_work_status as audit_w10_152_, inspection0_.audited_date_set_report as audited11_152_, inspection0_.auditee_org_id as auditee38_152_, inspection0_.auditee_org_name as auditee12_152_, inspection0_.auditee_org_postcode as auditee13_152_, inspection0_.auditee_org_type as auditee14_152_, inspection0_.feedback_status as feedbac15_152_, inspection0_.inspection_date as inspect16_152_, inspection0_.inspection_evaluate_date as inspect17_152_, inspection0_.inspection_evaluate_status as inspect18_152_, inspection0_.inspection_report_id as inspect39_152_, inspection0_.inspection_report_status as inspect19_152_, inspection0_.is_show_leader as is_show20_152_, inspection0_.last_updated_date as last_up21_152_, inspection0_.last_updated_date_feedback_solution as last_up22_152_, inspection0_.last_updated_date_inspection_tracking as last_up23_152_, inspection0_.lat as lat24_152_, inspection0_.lng as lng25_152_, inspection0_.manager_user_id as manager26_152_, inspection0_.priority_suggestion_color as priorit27_152_, inspection0_.priority_suggestion_name as priorit28_152_, inspection0_.priority_suggestion_seq as priorit29_152_, inspection0_.send_email_replied_date as send_em30_152_, inspection0_.send_email_status as send_em31_152_, inspection0_.strategic_plan_id as strateg32_152_, inspection0_.strategic_plan_item_id as strateg33_152_, inspection0_.strategic_plan_item_total_effort as strateg34_152_, inspection0_.strategic_plan_name as strateg35_152_ from v_inspection_report inspection0_ cross join inspection_report inspection1_ where inspection0_.inspection_report_id=inspection1_.id and (inspection1_.inspection_report_status in (@P0)) order by inspection0_.last_updated_date_feedback_solution desc offset 0 rows fetch next @P1 rows only",170247,1359868,-1189621,2810809801,12,510743
"(@P0 nvarchar(4000),@P1 nvarchar(4000),@P2 nvarchar(4000),@P3 nvarchar(4000),@P4 nvarchar(4000),@P5 nvarchar(4000),@P6 nvarchar(4000),@P7 nvarchar(4000),@P8 nvarchar(4000),@P9 bit,@P10 nvarchar(4000),@P11 bit,@P12 int)select distinct inspection0_.id as id1_152_, inspection0_.annual_plan_detail_id as annual_36_152_, inspection0_.annual_plan_draft_id as annual_p2_152_, inspection0_.annual_plan_draft_name as annual_p3_152_, inspection0_.annual_plan_id as annual_p4_152_, inspection0_.audit_plan_info_org_id as audit_p37_152_, inspection0_.audit_procedure_code as audit_pr5_152_, inspection0_.audit_procedure_id as audit_pr6_152_, inspection0_.audit_procedure_name as audit_pr7_152_, inspection0_.audit_procedure_years as audit_pr8_152_, inspection0_.audit_task_status as audit_ta9_152_, inspection0_.audit_work_status as audit_w10_152_, inspection0_.audited_date_set_report as audited11_152_, inspection0_.auditee_org_id as auditee38_152_, inspection0_.auditee_org_name as auditee12_152_, inspection0_.auditee_org_postcode as auditee13_152_, inspection0_.auditee_org_type as auditee14_152_, inspection0_.feedback_status as feedbac15_152_, inspection0_.inspection_date as inspect16_152_, inspection0_.inspection_evaluate_date as inspect17_152_, inspection0_.inspection_evaluate_status as inspect18_152_, inspection0_.inspection_report_id as inspect39_152_, inspection0_.inspection_report_status as inspect19_152_, inspection0_.is_show_leader as is_show20_152_, inspection0_.last_updated_date as last_up21_152_, inspection0_.last_updated_date_feedback_solution as last_up22_152_, inspection0_.last_updated_date_inspection_tracking as last_up23_152_, inspection0_.lat as lat24_152_, inspection0_.lng as lng25_152_, inspection0_.manager_user_id as manager26_152_, inspection0_.priority_suggestion_color as priorit27_152_, inspection0_.priority_suggestion_name as priorit28_152_, inspection0_.priority_suggestion_seq as priorit29_152_, inspection0_.send_email_replied_date as send_em30_152_, inspection0_.send_email_status as send_em31_152_, inspection0_.strategic_plan_id as strateg32_152_, inspection0_.strategic_plan_item_id as strateg33_152_, inspection0_.strategic_plan_item_total_effort as strateg34_152_, inspection0_.strategic_plan_name as strateg35_152_ from v_inspection_report inspection0_ cross join inspection_report inspection1_ cross join audit_plan_info_org auditplani2_ cross join audit_work auditwork3_ cross join audit_work auditwork6_ where inspection0_.inspection_report_id=inspection1_.id and inspection0_.audit_plan_info_org_id=auditplani2_.id and auditplani2_.id=auditwork3_.audit_plan_info_org_id and inspection1_.audit_work_id=auditwork6_.id and (inspection1_.feedback_status in (@P0 , @P1 , @P2 , @P3 , @P4 , @P5 , @P6 , @P7 , @P8)) and auditwork3_.is_show_leader=@P9 and (inspection0_.manager_user_id=2296 or inspection0_.auditee_org_id in (select distinct auditeeorg4_.id from v_auditee_org_flat_tree auditeeorg4_ where auditeeorg4_.auditee_type=@P10 and (auditeeorg4_.parent_id in (1 , 2 , 3 , 5 , 6 , 10099) or auditeeorg4_.id in (1 , 2 , 3 , 5 , 6 , 10099)))) and auditwork6_.is_show_leader=@P11 order by inspection0_.last_updated_date desc, inspection0_.last_updated_date_feedback_solution desc offset 0 rows fetch next @P12 rows only",164400,1273801,-1109401,2784228093,133,164400
"(@P0 nvarchar(4000),@P1 nvarchar(4000),@P2 nvarchar(4000),@P3 nvarchar(4000),@P4 nvarchar(4000),@P5 nvarchar(4000),@P6 nvarchar(4000),@P7 nvarchar(4000),@P8 nvarchar(4000),@P9 bit,@P10 nvarchar(4000),@P11 bit,@P12 int)select distinct inspection0_.id as id1_152_, inspection0_.annual_plan_detail_id as annual_36_152_, inspection0_.annual_plan_draft_id as annual_p2_152_, inspection0_.annual_plan_draft_name as annual_p3_152_, inspection0_.annual_plan_id as annual_p4_152_, inspection0_.audit_plan_info_org_id as audit_p37_152_, inspection0_.audit_procedure_code as audit_pr5_152_, inspection0_.audit_procedure_id as audit_pr6_152_, inspection0_.audit_procedure_name as audit_pr7_152_, inspection0_.audit_procedure_years as audit_pr8_152_, inspection0_.audit_task_status as audit_ta9_152_, inspection0_.audit_work_status as audit_w10_152_, inspection0_.audited_date_set_report as audited11_152_, inspection0_.auditee_org_id as auditee38_152_, inspection0_.auditee_org_name as auditee12_152_, inspection0_.auditee_org_postcode as auditee13_152_, inspection0_.auditee_org_type as auditee14_152_, inspection0_.feedback_status as feedbac15_152_, inspection0_.inspection_date as inspect16_152_, inspection0_.inspection_evaluate_date as inspect17_152_, inspection0_.inspection_evaluate_status as inspect18_152_, inspection0_.inspection_report_id as inspect39_152_, inspection0_.inspection_report_status as inspect19_152_, inspection0_.is_show_leader as is_show20_152_, inspection0_.last_updated_date as last_up21_152_, inspection0_.last_updated_date_feedback_solution as last_up22_152_, inspection0_.last_updated_date_inspection_tracking as last_up23_152_, inspection0_.lat as lat24_152_, inspection0_.lng as lng25_152_, inspection0_.manager_user_id as manager26_152_, inspection0_.priority_suggestion_color as priorit27_152_, inspection0_.priority_suggestion_name as priorit28_152_, inspection0_.priority_suggestion_seq as priorit29_152_, inspection0_.send_email_replied_date as send_em30_152_, inspection0_.send_email_status as send_em31_152_, inspection0_.strategic_plan_id as strateg32_152_, inspection0_.strategic_plan_item_id as strateg33_152_, inspection0_.strategic_plan_item_total_effort as strateg34_152_, inspection0_.strategic_plan_name as strateg35_152_ from v_inspection_report inspection0_ cross join inspection_report inspection1_ cross join audit_plan_info_org auditplani2_ cross join audit_work auditwork3_ cross join audit_work auditwork6_ where inspection0_.inspection_report_id=inspection1_.id and inspection0_.audit_plan_info_org_id=auditplani2_.id and auditplani2_.id=auditwork3_.audit_plan_info_org_id and inspection1_.audit_work_id=auditwork6_.id and (inspection1_.feedback_status in (@P0 , @P1 , @P2 , @P3 , @P4 , @P5 , @P6 , @P7 , @P8)) and auditwork3_.is_show_leader=@P9 and (inspection0_.manager_user_id=2290 or inspection0_.auditee_org_id in (select distinct auditeeorg4_.id from v_auditee_org_flat_tree auditeeorg4_ where auditeeorg4_.auditee_type=@P10 and (auditeeorg4_.parent_id in (1 , 2 , 3 , 5 , 6 , 10099) or auditeeorg4_.id in (1 , 2 , 3 , 5 , 6 , 10099)))) and auditwork6_.is_show_leader=@P11 order by inspection0_.last_updated_date desc, inspection0_.last_updated_date_feedback_solution desc offset 0 rows fetch next @P12 rows only",162103,1276154,-1114051,2469755982,167,162103
"(@P0 nvarchar(4000),@P1 nvarchar(4000),@P2 nvarchar(4000),@P3 nvarchar(4000),@P4 nvarchar(4000),@P5 nvarchar(4000),@P6 nvarchar(4000),@P7 nvarchar(4000),@P8 nvarchar(4000),@P9 bit,@P10 nvarchar(4000),@P11 bit,@P12 int)select distinct inspection0_.id as id1_152_, inspection0_.annual_plan_detail_id as annual_36_152_, inspection0_.annual_plan_draft_id as annual_p2_152_, inspection0_.annual_plan_draft_name as annual_p3_152_, inspection0_.annual_plan_id as annual_p4_152_, inspection0_.audit_plan_info_org_id as audit_p37_152_, inspection0_.audit_procedure_code as audit_pr5_152_, inspection0_.audit_procedure_id as audit_pr6_152_, inspection0_.audit_procedure_name as audit_pr7_152_, inspection0_.audit_procedure_years as audit_pr8_152_, inspection0_.audit_task_status as audit_ta9_152_, inspection0_.audit_work_status as audit_w10_152_, inspection0_.audited_date_set_report as audited11_152_, inspection0_.auditee_org_id as auditee38_152_, inspection0_.auditee_org_name as auditee12_152_, inspection0_.auditee_org_postcode as auditee13_152_, inspection0_.auditee_org_type as auditee14_152_, inspection0_.feedback_status as feedbac15_152_, inspection0_.inspection_date as inspect16_152_, inspection0_.inspection_evaluate_date as inspect17_152_, inspection0_.inspection_evaluate_status as inspect18_152_, inspection0_.inspection_report_id as inspect39_152_, inspection0_.inspection_report_status as inspect19_152_, inspection0_.is_show_leader as is_show20_152_, inspection0_.last_updated_date as last_up21_152_, inspection0_.last_updated_date_feedback_solution as last_up22_152_, inspection0_.last_updated_date_inspection_tracking as last_up23_152_, inspection0_.lat as lat24_152_, inspection0_.lng as lng25_152_, inspection0_.manager_user_id as manager26_152_, inspection0_.priority_suggestion_color as priorit27_152_, inspection0_.priority_suggestion_name as priorit28_152_, inspection0_.priority_suggestion_seq as priorit29_152_, inspection0_.send_email_replied_date as send_em30_152_, inspection0_.send_email_status as send_em31_152_, inspection0_.strategic_plan_id as strateg32_152_, inspection0_.strategic_plan_item_id as strateg33_152_, inspection0_.strategic_plan_item_total_effort as strateg34_152_, inspection0_.strategic_plan_name as strateg35_152_ from v_inspection_report inspection0_ cross join inspection_report inspection1_ cross join audit_plan_info_org auditplani2_ cross join audit_work auditwork3_ cross join audit_work auditwork6_ where inspection0_.inspection_report_id=inspection1_.id and inspection0_.audit_plan_info_org_id=auditplani2_.id and auditplani2_.id=auditwork3_.audit_plan_info_org_id and inspection1_.audit_work_id=auditwork6_.id and (inspection1_.feedback_status in (@P0 , @P1 , @P2 , @P3 , @P4 , @P5 , @P6 , @P7 , @P8)) and auditwork3_.is_show_leader=@P9 and (inspection0_.manager_user_id=2300 or inspection0_.auditee_org_id in (select distinct auditeeorg4_.id from v_auditee_org_flat_tree auditeeorg4_ where auditeeorg4_.auditee_type=@P10 and (auditeeorg4_.parent_id in (1 , 2 , 3 , 5 , 6 , 10099) or auditeeorg4_.id in (1 , 2 , 3 , 5 , 6 , 10099)))) and auditwork6_.is_show_leader=@P11 order by inspection0_.last_updated_date desc, inspection0_.last_updated_date_feedback_solution desc offset 0 rows fetch next @P12 rows only",161006,1255021,-1094015,2784395642,136,322012
"create procedure sys.sp_trace_getdata 	(@traceid int, 	 @records int = 0 	) as select * from OpenRowset(TABLE TRCDATA, @traceid, @records) ",129782,491,129291,1,0,259564
"(@P0 nvarchar(4000),@P1 nvarchar(4000),@P2 nvarchar(4000),@P3 nvarchar(4000),@P4 nvarchar(4000),@P5 nvarchar(4000),@P6 nvarchar(4000),@P7 nvarchar(4000),@P8 nvarchar(4000),@P9 bit,@P10 nvarchar(4000),@P11 bit,@P12 int)select distinct inspection0_.id as id1_152_, inspection0_.annual_plan_detail_id as annual_36_152_, inspection0_.annual_plan_draft_id as annual_p2_152_, inspection0_.annual_plan_draft_name as annual_p3_152_, inspection0_.annual_plan_id as annual_p4_152_, inspection0_.audit_plan_info_org_id as audit_p37_152_, inspection0_.audit_procedure_code as audit_pr5_152_, inspection0_.audit_procedure_id as audit_pr6_152_, inspection0_.audit_procedure_name as audit_pr7_152_, inspection0_.audit_procedure_years as audit_pr8_152_, inspection0_.audit_task_status as audit_ta9_152_, inspection0_.audit_work_status as audit_w10_152_, inspection0_.audited_date_set_report as audited11_152_, inspection0_.auditee_org_id as auditee38_152_, inspection0_.auditee_org_name as auditee12_152_, inspection0_.auditee_org_postcode as auditee13_152_, inspection0_.auditee_org_type as auditee14_152_, inspection0_.feedback_status as feedbac15_152_, inspection0_.inspection_date as inspect16_152_, inspection0_.inspection_evaluate_date as inspect17_152_, inspection0_.inspection_evaluate_status as inspect18_152_, inspection0_.inspection_report_id as inspect39_152_, inspection0_.inspection_report_status as inspect19_152_, inspection0_.is_show_leader as is_show20_152_, inspection0_.last_updated_date as last_up21_152_, inspection0_.last_updated_date_feedback_solution as last_up22_152_, inspection0_.last_updated_date_inspection_tracking as last_up23_152_, inspection0_.lat as lat24_152_, inspection0_.lng as lng25_152_, inspection0_.manager_user_id as manager26_152_, inspection0_.priority_suggestion_color as priorit27_152_, inspection0_.priority_suggestion_name as priorit28_152_, inspection0_.priority_suggestion_seq as priorit29_152_, inspection0_.send_email_replied_date as send_em30_152_, inspection0_.send_email_status as send_em31_152_, inspection0_.strategic_plan_id as strateg32_152_, inspection0_.strategic_plan_item_id as strateg33_152_, inspection0_.strategic_plan_item_total_effort as strateg34_152_, inspection0_.strategic_plan_name as strateg35_152_ from v_inspection_report inspection0_ cross join inspection_report inspection1_ cross join audit_plan_info_org auditplani2_ cross join audit_work auditwork3_ cross join audit_work auditwork6_ where inspection0_.inspection_report_id=inspection1_.id and inspection0_.audit_plan_info_org_id=auditplani2_.id and auditplani2_.id=auditwork3_.audit_plan_info_org_id and inspection1_.audit_work_id=auditwork6_.id and (inspection1_.feedback_status in (@P0 , @P1 , @P2 , @P3 , @P4 , @P5 , @P6 , @P7 , @P8)) and auditwork3_.is_show_leader=@P9 and (inspection0_.manager_user_id=330 or inspection0_.auditee_org_id in (select distinct auditeeorg4_.id from v_auditee_org_flat_tree auditeeorg4_ where auditeeorg4_.auditee_type=@P10 and (auditeeorg4_.parent_id in (71) or auditeeorg4_.id in (71)))) and auditwork6_.is_show_leader=@P11 order by inspection0_.last_updated_date desc, inspection0_.last_updated_date_feedback_solution desc offset 0 rows fetch next @P12 rows only",68949,63755,5194,118132726,145,275797
"(@P0 nvarchar(4000),@P1 nvarchar(4000),@P2 nvarchar(4000),@P3 nvarchar(4000),@P4 nvarchar(4000),@P5 nvarchar(4000),@P6 nvarchar(4000),@P7 nvarchar(4000),@P8 nvarchar(4000),@P9 bit,@P10 nvarchar(4000),@P11 bit,@P12 int)select distinct inspection0_.id as id1_152_, inspection0_.annual_plan_detail_id as annual_36_152_, inspection0_.annual_plan_draft_id as annual_p2_152_, inspection0_.annual_plan_draft_name as annual_p3_152_, inspection0_.annual_plan_id as annual_p4_152_, inspection0_.audit_plan_info_org_id as audit_p37_152_, inspection0_.audit_procedure_code as audit_pr5_152_, inspection0_.audit_procedure_id as audit_pr6_152_, inspection0_.audit_procedure_name as audit_pr7_152_, inspection0_.audit_procedure_years as audit_pr8_152_, inspection0_.audit_task_status as audit_ta9_152_, inspection0_.audit_work_status as audit_w10_152_, inspection0_.audited_date_set_report as audited11_152_, inspection0_.auditee_org_id as auditee38_152_, inspection0_.auditee_org_name as auditee12_152_, inspection0_.auditee_org_postcode as auditee13_152_, inspection0_.auditee_org_type as auditee14_152_, inspection0_.feedback_status as feedbac15_152_, inspection0_.inspection_date as inspect16_152_, inspection0_.inspection_evaluate_date as inspect17_152_, inspection0_.inspection_evaluate_status as inspect18_152_, inspection0_.inspection_report_id as inspect39_152_, inspection0_.inspection_report_status as inspect19_152_, inspection0_.is_show_leader as is_show20_152_, inspection0_.last_updated_date as last_up21_152_, inspection0_.last_updated_date_feedback_solution as last_up22_152_, inspection0_.last_updated_date_inspection_tracking as last_up23_152_, inspection0_.lat as lat24_152_, inspection0_.lng as lng25_152_, inspection0_.manager_user_id as manager26_152_, inspection0_.priority_suggestion_color as priorit27_152_, inspection0_.priority_suggestion_name as priorit28_152_, inspection0_.priority_suggestion_seq as priorit29_152_, inspection0_.send_email_replied_date as send_em30_152_, inspection0_.send_email_status as send_em31_152_, inspection0_.strategic_plan_id as strateg32_152_, inspection0_.strategic_plan_item_id as strateg33_152_, inspection0_.strategic_plan_item_total_effort as strateg34_152_, inspection0_.strategic_plan_name as strateg35_152_ from v_inspection_report inspection0_ cross join inspection_report inspection1_ cross join audit_plan_info_org auditplani2_ cross join audit_work auditwork3_ cross join audit_work auditwork6_ where inspection0_.inspection_report_id=inspection1_.id and inspection0_.audit_plan_info_org_id=auditplani2_.id and auditplani2_.id=auditwork3_.audit_plan_info_org_id and inspection1_.audit_work_id=auditwork6_.id and (inspection1_.feedback_status in (@P0 , @P1 , @P2 , @P3 , @P4 , @P5 , @P6 , @P7 , @P8)) and auditwork3_.is_show_leader=@P9 and (inspection0_.manager_user_id=321 or inspection0_.auditee_org_id in (select distinct auditeeorg4_.id from v_auditee_org_flat_tree auditeeorg4_ where auditeeorg4_.auditee_type=@P10 and (auditeeorg4_.parent_id in (80) or auditeeorg4_.id in (80)))) and auditwork6_.is_show_leader=@P11 order by inspection0_.last_updated_date desc, inspection0_.last_updated_date_feedback_solution desc offset 0 rows fetch next @P12 rows only",44868,160242,-115374,270044772,136,717899
"(@P0 nvarchar(4000),@P1 nvarchar(4000),@P2 nvarchar(4000),@P3 nvarchar(4000),@P4 nvarchar(4000),@P5 nvarchar(4000),@P6 nvarchar(4000),@P7 nvarchar(4000),@P8 nvarchar(4000),@P9 bit,@P10 nvarchar(4000),@P11 bit,@P12 int)select distinct inspection0_.id as id1_152_, inspection0_.annual_plan_detail_id as annual_36_152_, inspection0_.annual_plan_draft_id as annual_p2_152_, inspection0_.annual_plan_draft_name as annual_p3_152_, inspection0_.annual_plan_id as annual_p4_152_, inspection0_.audit_plan_info_org_id as audit_p37_152_, inspection0_.audit_procedure_code as audit_pr5_152_, inspection0_.audit_procedure_id as audit_pr6_152_, inspection0_.audit_procedure_name as audit_pr7_152_, inspection0_.audit_procedure_years as audit_pr8_152_, inspection0_.audit_task_status as audit_ta9_152_, inspection0_.audit_work_status as audit_w10_152_, inspection0_.audited_date_set_report as audited11_152_, inspection0_.auditee_org_id as auditee38_152_, inspection0_.auditee_org_name as auditee12_152_, inspection0_.auditee_org_postcode as auditee13_152_, inspection0_.auditee_org_type as auditee14_152_, inspection0_.feedback_status as feedbac15_152_, inspection0_.inspection_date as inspect16_152_, inspection0_.inspection_evaluate_date as inspect17_152_, inspection0_.inspection_evaluate_status as inspect18_152_, inspection0_.inspection_report_id as inspect39_152_, inspection0_.inspection_report_status as inspect19_152_, inspection0_.is_show_leader as is_show20_152_, inspection0_.last_updated_date as last_up21_152_, inspection0_.last_updated_date_feedback_solution as last_up22_152_, inspection0_.last_updated_date_inspection_tracking as last_up23_152_, inspection0_.lat as lat24_152_, inspection0_.lng as lng25_152_, inspection0_.manager_user_id as manager26_152_, inspection0_.priority_suggestion_color as priorit27_152_, inspection0_.priority_suggestion_name as priorit28_152_, inspection0_.priority_suggestion_seq as priorit29_152_, inspection0_.send_email_replied_date as send_em30_152_, inspection0_.send_email_status as send_em31_152_, inspection0_.strategic_plan_id as strateg32_152_, inspection0_.strategic_plan_item_id as strateg33_152_, inspection0_.strategic_plan_item_total_effort as strateg34_152_, inspection0_.strategic_plan_name as strateg35_152_ from v_inspection_report inspection0_ cross join inspection_report inspection1_ cross join audit_plan_info_org auditplani2_ cross join audit_work auditwork3_ cross join audit_work auditwork6_ where inspection0_.inspection_report_id=inspection1_.id and inspection0_.audit_plan_info_org_id=auditplani2_.id and auditplani2_.id=auditwork3_.audit_plan_info_org_id and inspection1_.audit_work_id=auditwork6_.id and (inspection1_.feedback_status in (@P0 , @P1 , @P2 , @P3 , @P4 , @P5 , @P6 , @P7 , @P8)) and auditwork3_.is_show_leader=@P9 and (inspection0_.manager_user_id=297 or inspection0_.auditee_org_id in (select distinct auditeeorg4_.id from v_auditee_org_flat_tree auditeeorg4_ where auditeeorg4_.auditee_type=@P10 and (auditeeorg4_.parent_id in (1417) or auditeeorg4_.id in (1417)))) and auditwork6_.is_show_leader=@P11 order by inspection0_.last_updated_date desc, inspection0_.last_updated_date_feedback_solution desc offset 0 rows fetch next @P12 rows only",39150,5459,33691,5347478,126,78301
"(@P0 date,@P1 date,@P2 nvarchar(4000),@P3 nvarchar(4000),@P4 nvarchar(4000),@P5 nvarchar(4000),@P6 bit,@P7 nvarchar(4000),@P8 int,@P9 nvarchar(4000),@P10 bit,@P11 int)select distinct inspection0_.id as id1_152_, inspection0_.annual_plan_detail_id as annual_36_152_, inspection0_.annual_plan_draft_id as annual_p2_152_, inspection0_.annual_plan_draft_name as annual_p3_152_, inspection0_.annual_plan_id as annual_p4_152_, inspection0_.audit_plan_info_org_id as audit_p37_152_, inspection0_.audit_procedure_code as audit_pr5_152_, inspection0_.audit_procedure_id as audit_pr6_152_, inspection0_.audit_procedure_name as audit_pr7_152_, inspection0_.audit_procedure_years as audit_pr8_152_, inspection0_.audit_task_status as audit_ta9_152_, inspection0_.audit_work_status as audit_w10_152_, inspection0_.audited_date_set_report as audited11_152_, inspection0_.auditee_org_id as auditee38_152_, inspection0_.auditee_org_name as auditee12_152_, inspection0_.auditee_org_postcode as auditee13_152_, inspection0_.auditee_org_type as auditee14_152_, inspection0_.feedback_status as feedbac15_152_, inspection0_.inspection_date as inspect16_152_, inspection0_.inspection_evaluate_date as inspect17_152_, inspection0_.inspection_evaluate_status as inspect18_152_, inspection0_.inspection_report_id as inspect39_152_, inspection0_.inspection_report_status as inspect19_152_, inspection0_.is_show_leader as is_show20_152_, inspection0_.last_updated_date as last_up21_152_, inspection0_.last_updated_date_feedback_solution as last_up22_152_, inspection0_.last_updated_date_inspection_tracking as last_up23_152_, inspection0_.lat as lat24_152_, inspection0_.lng as lng25_152_, inspection0_.manager_user_id as manager26_152_, inspection0_.priority_suggestion_color as priorit27_152_, inspection0_.priority_suggestion_name as priorit28_152_, inspection0_.priority_suggestion_seq as priorit29_152_, inspection0_.send_email_replied_date as send_em30_152_, inspection0_.send_email_status as send_em31_152_, inspection0_.strategic_plan_id as strateg32_152_, inspection0_.strategic_plan_item_id as strateg33_152_, inspection0_.strategic_plan_item_total_effort as strateg34_152_, inspection0_.strategic_plan_name as strateg35_152_ from v_inspection_report inspection0_ inner join audit_plan_info_org auditplani1_ on inspection0_.audit_plan_info_org_id=auditplani1_.id inner join audit_work auditwork2_ on auditplani1_.id=auditwork2_.audit_plan_info_org_id inner join audit_work_auditor auditworka3_ on auditwork2_.id=auditworka3_.audit_work_id cross join audit_work auditwork5_ cross join inspection_report inspection8_ cross join audit_work auditwork15_ where auditplani1_.id=auditwork5_.audit_plan_info_org_id and inspection0_.inspection_report_id=inspection8_.id and inspection8_.audit_work_id=auditwork15_.id and auditwork5_.inspection_date>=@P0 and auditwork5_.inspection_date<=@P1 and (inspection8_.inspection_report_status in (@P2 , @P3 , @P4) or inspection8_.inspection_report_status=@P5 and (inspection8_.send_manager_date is not null)) and auditwork5_.is_show_leader=@P6 and (auditworka3_.position_name=@P7 and auditworka3_.user_id=@P8 or inspection0_.manager_user_id=924 or inspection0_.auditee_org_id in (select distinct auditeeorg13_.id from v_auditee_org_flat_tree auditeeorg13_ where auditeeorg13_.auditee_type=@P9 and (auditeeorg13_.parent_id in (1568) or auditeeorg13_.id in (1568)))) and auditwork15_.is_show_leader=@P10 order by inspection0_.last_updated_date desc offset 0 rows fetch next @P11 rows only",35890,3054,32836,3993205,1913,35890
"(@P0 nvarchar(4000),@P1 nvarchar(4000),@P2 nvarchar(4000),@P3 nvarchar(4000),@P4 nvarchar(4000),@P5 nvarchar(4000),@P6 nvarchar(4000),@P7 nvarchar(4000),@P8 nvarchar(4000),@P9 nvarchar(4000),@P10 nvarchar(4000),@P11 nvarchar(4000),@P12 nvarchar(4000),@P13 nvarchar(4000),@P14 nvarchar(4000),@P15 nvarchar(4000))select auditee_org_type + ' ' + auditee_org_name auditee_org_name ,auditee_org_postcode ,txt_inspection_date ,risk_detect_note ,suggestion ,priority_suggestion_name ,detect_priority_suggestion_name ,manager_feedback_status_note ,inspector_feedback_status_note ,inspection_date ,detect_note, clause_type_name,clause_note,clause_effect from V_INSPECTION_FEEDBACK_REPORT vifr where 1=1 and ( @P0 is not null and FORMAT(inspection_date,'yyyyMMdd') >=  @P1 or  @P2 is null ) and ( @P3 is not null and FORMAT(inspection_date,'yyyyMMdd') <=  @P4 or  @P5 is null ) and ( @P6  is not null and auditee_org_name like '%null%' or  @P7  is null) and ( @P8  is not null and post_area_name like '%null%' or @P9 is null) and ( @P10  is not null and auditee_org_type like '%null%' or @P11  is null) and ( @P12  is not null and priority_suggestion_name like '%สูง%' or @P13  is null) and ( @P14  is not null and risk_name like '%null%' or @P15 is null) order by vifr.id",35780,475,35305,574819,0,35780
"(@P0 nvarchar(4000),@P1 nvarchar(4000),@P2 nvarchar(4000),@P3 nvarchar(4000),@P4 nvarchar(4000),@P5 nvarchar(4000),@P6 nvarchar(4000),@P7 nvarchar(4000),@P8 nvarchar(4000),@P9 nvarchar(4000),@P10 nvarchar(4000),@P11 nvarchar(4000),@P12 nvarchar(4000),@P13 nvarchar(4000),@P14 nvarchar(4000),@P15 nvarchar(4000))select auditee_org_type + ' ' + auditee_org_name auditee_org_name ,auditee_org_postcode ,txt_inspection_date ,risk_detect_note ,suggestion ,priority_suggestion_name ,detect_priority_suggestion_name ,manager_feedback_status_note ,inspector_feedback_status_note ,inspection_date ,detect_note, clause_type_name,clause_note,clause_effect from V_INSPECTION_FEEDBACK_REPORT vifr where 1=1 and ( @P0 is not null and FORMAT(inspection_date,'yyyyMMdd') >=  @P1 or  @P2 is null ) and ( @P3 is not null and FORMAT(inspection_date,'yyyyMMdd') <=  @P4 or  @P5 is null ) and ( @P6  is not null and auditee_org_name like '%null%' or  @P7  is null) and ( @P8  is not null and post_area_name like '%null%' or @P9 is null) and ( @P10  is not null and auditee_org_type like '%null%' or @P11  is null) and ( @P12  is not null and priority_suggestion_name like '%null%' or @P13  is null) and ( @P14  is not null and risk_name like '%null%' or @P15 is null) order by vifr.id",33513,516,32997,655361,0,201081
"(@P0 bit,@P1 nvarchar(4000),@P2 nvarchar(4000),@P3 nvarchar(4000),@P4 bit,@P5 nvarchar(4000),@P6 nvarchar(4000),@P7 nvarchar(4000),@P8 nvarchar(4000),@P9 nvarchar(4000),@P10 nvarchar(4000),@P11 nvarchar(4000),@P12 int)select distinct inspection0_.audit_work_id as audit_wo1_154_, inspection0_.audit_procedure_years as audit_pr2_154_, inspection0_.auditee_org_id as auditee_3_154_, inspection0_.auditee_org_name as auditee_4_154_, inspection0_.auditee_org_postcode as auditee_5_154_, inspection0_.auditee_org_type as auditee_6_154_, inspection0_.auditee_org_type_id as auditee_7_154_, inspection0_.feedback_status as feedback8_154_, inspection0_.inspection_report_approved_date as inspecti9_154_, inspection0_.inspection_report_status as inspect10_154_, inspection0_.is_show_leader as is_show11_154_, inspection0_.lat as lat12_154_, inspection0_.lng as lng13_154_, inspection0_.office_auditee_org_id as office_14_154_, inspection0_.post_area_auditee_org_id as post_ar15_154_, inspection0_.priority_suggestion_color as priorit16_154_, inspection0_.priority_suggestion_name as priorit17_154_, inspection0_.priority_suggestion_name_freezed as priorit18_154_, inspection0_.priority_suggestion_seq as priorit19_154_, inspection0_.send_email_status as send_em20_154_, inspection0_.send_mail_replied_date as send_ma21_154_ from v_inspection_report_dashboard_slim inspection0_ inner join v_audit_work_auditor auditworka1_ on inspection0_.audit_work_id=auditworka1_.audit_work_id left outer join v_users_auditee_org_in_responsibility usersaudit2_ on inspection0_.audit_work_id=usersaudit2_.audit_work_id where inspection0_.is_show_leader=@P0 and inspection0_.inspection_report_status=@P1 and (inspection0_.inspection_report_status in (@P2)) and (inspection0_.inspection_report_status in (@P3)) and inspection0_.audit_procedure_years=2567 and inspection0_.send_email_status=@P4 and (inspection0_.priority_suggestion_seq is not null) and ((auditworka1_.position_name=@P5 or auditworka1_.position_name=@P6 or auditworka1_.position_name=@P7 or auditworka1_.position_name=@P8 or auditworka1_.position_name=@P9) and auditworka1_.user_id=1432 or inspection0_.auditee_org_id in (select distinct auditeeorg3_.id from v_auditee_org_flat_tree auditeeorg3_ where auditeeorg3_.auditee_type=@P10 and (auditeeorg3_.parent_id in (null) or auditeeorg3_.id in (null))) or usersaudit2_.user_id=1432 or inspection0_.auditee_org_id in (select distinct auditeeorg4_.id from v_auditee_org_flat_tree auditeeorg4_ where auditeeorg4_.auditee_type=@P11 and (auditeeorg4_.parent_id in (457) or auditeeorg4_.id in (457)))) order by inspection0_.priority_suggestion_seq asc offset 0 rows fetch next @P12 rows only",28702,2013,26689,158283,98,28702
"(@P0 nvarchar(4000),@P1 nvarchar(4000),@P2 nvarchar(4000),@P3 nvarchar(4000),@P4 bit,@P5 nvarchar(4000),@P6 int,@P7 nvarchar(4000),@P8 bit,@P9 int)select distinct inspection0_.id as id1_152_, inspection0_.annual_plan_detail_id as annual_36_152_, inspection0_.annual_plan_draft_id as annual_p2_152_, inspection0_.annual_plan_draft_name as annual_p3_152_, inspection0_.annual_plan_id as annual_p4_152_, inspection0_.audit_plan_info_org_id as audit_p37_152_, inspection0_.audit_procedure_code as audit_pr5_152_, inspection0_.audit_procedure_id as audit_pr6_152_, inspection0_.audit_procedure_name as audit_pr7_152_, inspection0_.audit_procedure_years as audit_pr8_152_, inspection0_.audit_task_status as audit_ta9_152_, inspection0_.audit_work_status as audit_w10_152_, inspection0_.audited_date_set_report as audited11_152_, inspection0_.auditee_org_id as auditee38_152_, inspection0_.auditee_org_name as auditee12_152_, inspection0_.auditee_org_postcode as auditee13_152_, inspection0_.auditee_org_type as auditee14_152_, inspection0_.feedback_status as feedbac15_152_, inspection0_.inspection_date as inspect16_152_, inspection0_.inspection_evaluate_date as inspect17_152_, inspection0_.inspection_evaluate_status as inspect18_152_, inspection0_.inspection_report_id as inspect39_152_, inspection0_.inspection_report_status as inspect19_152_, inspection0_.is_show_leader as is_show20_152_, inspection0_.last_updated_date as last_up21_152_, inspection0_.last_updated_date_feedback_solution as last_up22_152_, inspection0_.last_updated_date_inspection_tracking as last_up23_152_, inspection0_.lat as lat24_152_, inspection0_.lng as lng25_152_, inspection0_.manager_user_id as manager26_152_, inspection0_.priority_suggestion_color as priorit27_152_, inspection0_.priority_suggestion_name as priorit28_152_, inspection0_.priority_suggestion_seq as priorit29_152_, inspection0_.send_email_replied_date as send_em30_152_, inspection0_.send_email_status as send_em31_152_, inspection0_.strategic_plan_id as strateg32_152_, inspection0_.strategic_plan_item_id as strateg33_152_, inspection0_.strategic_plan_item_total_effort as strateg34_152_, inspection0_.strategic_plan_name as strateg35_152_ from v_inspection_report inspection0_ inner join audit_plan_info_org auditplani1_ on inspection0_.audit_plan_info_org_id=auditplani1_.id inner join audit_work auditwork2_ on auditplani1_.id=auditwork2_.audit_plan_info_org_id inner join audit_work_auditor auditworka3_ on auditwork2_.id=auditworka3_.audit_work_id cross join inspection_report inspection4_ cross join audit_work auditwork8_ cross join audit_work auditwork11_ where inspection0_.inspection_report_id=inspection4_.id and auditplani1_.id=auditwork8_.audit_plan_info_org_id and inspection4_.audit_work_id=auditwork11_.id and (inspection4_.inspection_report_status in (@P0 , @P1 , @P2) or inspection4_.inspection_report_status=@P3 and (inspection4_.send_manager_date is not null)) and inspection0_.auditee_org_id=1403 and auditwork8_.is_show_leader=@P4 and (auditworka3_.position_name=@P5 and auditworka3_.user_id=@P6 or inspection0_.manager_user_id=156 or inspection0_.auditee_org_id in (select distinct auditeeorg9_.id from v_auditee_org_flat_tree auditeeorg9_ where auditeeorg9_.auditee_type=@P7 and (auditeeorg9_.parent_id in (81) or auditeeorg9_.id in (81)))) and auditwork11_.is_show_leader=@P8 order by inspection0_.last_updated_date desc offset 0 rows fetch next @P9 rows only",25316,232,25084,126370,116,25316
"(@P0 nvarchar(4000),@P1 nvarchar(4000),@P2 nvarchar(4000),@P3 nvarchar(4000),@P4 bit,@P5 nvarchar(4000),@P6 int,@P7 nvarchar(4000),@P8 bit,@P9 int)select distinct inspection0_.id as id1_152_, inspection0_.annual_plan_detail_id as annual_36_152_, inspection0_.annual_plan_draft_id as annual_p2_152_, inspection0_.annual_plan_draft_name as annual_p3_152_, inspection0_.annual_plan_id as annual_p4_152_, inspection0_.audit_plan_info_org_id as audit_p37_152_, inspection0_.audit_procedure_code as audit_pr5_152_, inspection0_.audit_procedure_id as audit_pr6_152_, inspection0_.audit_procedure_name as audit_pr7_152_, inspection0_.audit_procedure_years as audit_pr8_152_, inspection0_.audit_task_status as audit_ta9_152_, inspection0_.audit_work_status as audit_w10_152_, inspection0_.audited_date_set_report as audited11_152_, inspection0_.auditee_org_id as auditee38_152_, inspection0_.auditee_org_name as auditee12_152_, inspection0_.auditee_org_postcode as auditee13_152_, inspection0_.auditee_org_type as auditee14_152_, inspection0_.feedback_status as feedbac15_152_, inspection0_.inspection_date as inspect16_152_, inspection0_.inspection_evaluate_date as inspect17_152_, inspection0_.inspection_evaluate_status as inspect18_152_, inspection0_.inspection_report_id as inspect39_152_, inspection0_.inspection_report_status as inspect19_152_, inspection0_.is_show_leader as is_show20_152_, inspection0_.last_updated_date as last_up21_152_, inspection0_.last_updated_date_feedback_solution as last_up22_152_, inspection0_.last_updated_date_inspection_tracking as last_up23_152_, inspection0_.lat as lat24_152_, inspection0_.lng as lng25_152_, inspection0_.manager_user_id as manager26_152_, inspection0_.priority_suggestion_color as priorit27_152_, inspection0_.priority_suggestion_name as priorit28_152_, inspection0_.priority_suggestion_seq as priorit29_152_, inspection0_.send_email_replied_date as send_em30_152_, inspection0_.send_email_status as send_em31_152_, inspection0_.strategic_plan_id as strateg32_152_, inspection0_.strategic_plan_item_id as strateg33_152_, inspection0_.strategic_plan_item_total_effort as strateg34_152_, inspection0_.strategic_plan_name as strateg35_152_ from v_inspection_report inspection0_ inner join audit_plan_info_org auditplani1_ on inspection0_.audit_plan_info_org_id=auditplani1_.id inner join audit_work auditwork2_ on auditplani1_.id=auditwork2_.audit_plan_info_org_id inner join audit_work_auditor auditworka3_ on auditwork2_.id=auditworka3_.audit_work_id cross join inspection_report inspection4_ cross join audit_work auditwork8_ cross join audit_work auditwork11_ where inspection0_.inspection_report_id=inspection4_.id and auditplani1_.id=auditwork8_.audit_plan_info_org_id and inspection4_.audit_work_id=auditwork11_.id and (inspection4_.inspection_report_status in (@P0 , @P1 , @P2) or inspection4_.inspection_report_status=@P3 and (inspection4_.send_manager_date is not null)) and inspection0_.auditee_org_id=1580 and auditwork8_.is_show_leader=@P4 and (auditworka3_.position_name=@P5 and auditworka3_.user_id=@P6 or inspection0_.manager_user_id=156 or inspection0_.auditee_org_id in (select distinct auditeeorg9_.id from v_auditee_org_flat_tree auditeeorg9_ where auditeeorg9_.auditee_type=@P7 and (auditeeorg9_.parent_id in (81) or auditeeorg9_.id in (81)))) and auditwork11_.is_show_leader=@P8 order by inspection0_.last_updated_date desc offset 0 rows fetch next @P9 rows only",25258,204,25054,116370,100,25258
"(@P0 nvarchar(4000),@P1 nvarchar(4000),@P2 nvarchar(4000),@P3 nvarchar(4000),@P4 bit,@P5 nvarchar(4000),@P6 int,@P7 nvarchar(4000),@P8 bit,@P9 int)select distinct inspection0_.id as id1_152_, inspection0_.annual_plan_detail_id as annual_36_152_, inspection0_.annual_plan_draft_id as annual_p2_152_, inspection0_.annual_plan_draft_name as annual_p3_152_, inspection0_.annual_plan_id as annual_p4_152_, inspection0_.audit_plan_info_org_id as audit_p37_152_, inspection0_.audit_procedure_code as audit_pr5_152_, inspection0_.audit_procedure_id as audit_pr6_152_, inspection0_.audit_procedure_name as audit_pr7_152_, inspection0_.audit_procedure_years as audit_pr8_152_, inspection0_.audit_task_status as audit_ta9_152_, inspection0_.audit_work_status as audit_w10_152_, inspection0_.audited_date_set_report as audited11_152_, inspection0_.auditee_org_id as auditee38_152_, inspection0_.auditee_org_name as auditee12_152_, inspection0_.auditee_org_postcode as auditee13_152_, inspection0_.auditee_org_type as auditee14_152_, inspection0_.feedback_status as feedbac15_152_, inspection0_.inspection_date as inspect16_152_, inspection0_.inspection_evaluate_date as inspect17_152_, inspection0_.inspection_evaluate_status as inspect18_152_, inspection0_.inspection_report_id as inspect39_152_, inspection0_.inspection_report_status as inspect19_152_, inspection0_.is_show_leader as is_show20_152_, inspection0_.last_updated_date as last_up21_152_, inspection0_.last_updated_date_feedback_solution as last_up22_152_, inspection0_.last_updated_date_inspection_tracking as last_up23_152_, inspection0_.lat as lat24_152_, inspection0_.lng as lng25_152_, inspection0_.manager_user_id as manager26_152_, inspection0_.priority_suggestion_color as priorit27_152_, inspection0_.priority_suggestion_name as priorit28_152_, inspection0_.priority_suggestion_seq as priorit29_152_, inspection0_.send_email_replied_date as send_em30_152_, inspection0_.send_email_status as send_em31_152_, inspection0_.strategic_plan_id as strateg32_152_, inspection0_.strategic_plan_item_id as strateg33_152_, inspection0_.strategic_plan_item_total_effort as strateg34_152_, inspection0_.strategic_plan_name as strateg35_152_ from v_inspection_report inspection0_ inner join audit_plan_info_org auditplani1_ on inspection0_.audit_plan_info_org_id=auditplani1_.id inner join audit_work auditwork2_ on auditplani1_.id=auditwork2_.audit_plan_info_org_id inner join audit_work_auditor auditworka3_ on auditwork2_.id=auditworka3_.audit_work_id cross join inspection_report inspection4_ cross join audit_work auditwork8_ cross join audit_work auditwork11_ where inspection0_.inspection_report_id=inspection4_.id and auditplani1_.id=auditwork8_.audit_plan_info_org_id and inspection4_.audit_work_id=auditwork11_.id and (inspection4_.inspection_report_status in (@P0 , @P1 , @P2) or inspection4_.inspection_report_status=@P3 and (inspection4_.send_manager_date is not null)) and inspection0_.auditee_org_id=1474 and auditwork8_.is_show_leader=@P4 and (auditworka3_.position_name=@P5 and auditworka3_.user_id=@P6 or inspection0_.manager_user_id=156 or inspection0_.auditee_org_id in (select distinct auditeeorg9_.id from v_auditee_org_flat_tree auditeeorg9_ where auditeeorg9_.auditee_type=@P7 and (auditeeorg9_.parent_id in (81) or auditeeorg9_.id in (81)))) and auditwork11_.is_show_leader=@P8 order by inspection0_.last_updated_date desc offset 0 rows fetch next @P9 rows only",25066,173,24893,117421,102,25066
"(@P0 nvarchar(4000),@P1 nvarchar(4000),@P2 nvarchar(4000),@P3 nvarchar(4000),@P4 bit,@P5 nvarchar(4000),@P6 int,@P7 nvarchar(4000),@P8 bit,@P9 int)select distinct inspection0_.id as id1_152_, inspection0_.annual_plan_detail_id as annual_36_152_, inspection0_.annual_plan_draft_id as annual_p2_152_, inspection0_.annual_plan_draft_name as annual_p3_152_, inspection0_.annual_plan_id as annual_p4_152_, inspection0_.audit_plan_info_org_id as audit_p37_152_, inspection0_.audit_procedure_code as audit_pr5_152_, inspection0_.audit_procedure_id as audit_pr6_152_, inspection0_.audit_procedure_name as audit_pr7_152_, inspection0_.audit_procedure_years as audit_pr8_152_, inspection0_.audit_task_status as audit_ta9_152_, inspection0_.audit_work_status as audit_w10_152_, inspection0_.audited_date_set_report as audited11_152_, inspection0_.auditee_org_id as auditee38_152_, inspection0_.auditee_org_name as auditee12_152_, inspection0_.auditee_org_postcode as auditee13_152_, inspection0_.auditee_org_type as auditee14_152_, inspection0_.feedback_status as feedbac15_152_, inspection0_.inspection_date as inspect16_152_, inspection0_.inspection_evaluate_date as inspect17_152_, inspection0_.inspection_evaluate_status as inspect18_152_, inspection0_.inspection_report_id as inspect39_152_, inspection0_.inspection_report_status as inspect19_152_, inspection0_.is_show_leader as is_show20_152_, inspection0_.last_updated_date as last_up21_152_, inspection0_.last_updated_date_feedback_solution as last_up22_152_, inspection0_.last_updated_date_inspection_tracking as last_up23_152_, inspection0_.lat as lat24_152_, inspection0_.lng as lng25_152_, inspection0_.manager_user_id as manager26_152_, inspection0_.priority_suggestion_color as priorit27_152_, inspection0_.priority_suggestion_name as priorit28_152_, inspection0_.priority_suggestion_seq as priorit29_152_, inspection0_.send_email_replied_date as send_em30_152_, inspection0_.send_email_status as send_em31_152_, inspection0_.strategic_plan_id as strateg32_152_, inspection0_.strategic_plan_item_id as strateg33_152_, inspection0_.strategic_plan_item_total_effort as strateg34_152_, inspection0_.strategic_plan_name as strateg35_152_ from v_inspection_report inspection0_ inner join audit_plan_info_org auditplani1_ on inspection0_.audit_plan_info_org_id=auditplani1_.id inner join audit_work auditwork2_ on auditplani1_.id=auditwork2_.audit_plan_info_org_id inner join audit_work_auditor auditworka3_ on auditwork2_.id=auditworka3_.audit_work_id cross join inspection_report inspection4_ cross join audit_work auditwork8_ cross join audit_work auditwork11_ where inspection0_.inspection_report_id=inspection4_.id and auditplani1_.id=auditwork8_.audit_plan_info_org_id and inspection4_.audit_work_id=auditwork11_.id and (inspection4_.inspection_report_status in (@P0 , @P1 , @P2) or inspection4_.inspection_report_status=@P3 and (inspection4_.send_manager_date is not null)) and auditwork8_.is_show_leader=@P4 and (auditworka3_.position_name=@P5 and auditworka3_.user_id=@P6 or inspection0_.manager_user_id=196 or inspection0_.auditee_org_id in (select distinct auditeeorg9_.id from v_auditee_org_flat_tree auditeeorg9_ where auditeeorg9_.auditee_type=@P7 and (auditeeorg9_.parent_id in (null) or auditeeorg9_.id in (null)))) and auditwork11_.is_show_leader=@P8 order by inspection0_.last_updated_date desc offset 0 rows fetch next @P9 rows only",24953,24873,80,38581479,0,24953
"(@P0 bit,@P1 nvarchar(4000),@P2 nvarchar(4000),@P3 nvarchar(4000),@P4 nvarchar(4000),@P5 bit,@P6 nvarchar(4000),@P7 nvarchar(4000),@P8 nvarchar(4000),@P9 nvarchar(4000),@P10 nvarchar(4000),@P11 nvarchar(4000),@P12 nvarchar(4000),@P13 int)select distinct inspection0_.audit_work_id as audit_wo1_154_, inspection0_.audit_procedure_years as audit_pr2_154_, inspection0_.auditee_org_id as auditee_3_154_, inspection0_.auditee_org_name as auditee_4_154_, inspection0_.auditee_org_postcode as auditee_5_154_, inspection0_.auditee_org_type as auditee_6_154_, inspection0_.auditee_org_type_id as auditee_7_154_, inspection0_.feedback_status as feedback8_154_, inspection0_.inspection_report_approved_date as inspecti9_154_, inspection0_.inspection_report_status as inspect10_154_, inspection0_.is_show_leader as is_show11_154_, inspection0_.lat as lat12_154_, inspection0_.lng as lng13_154_, inspection0_.office_auditee_org_id as office_14_154_, inspection0_.post_area_auditee_org_id as post_ar15_154_, inspection0_.priority_suggestion_color as priorit16_154_, inspection0_.priority_suggestion_name as priorit17_154_, inspection0_.priority_suggestion_name_freezed as priorit18_154_, inspection0_.priority_suggestion_seq as priorit19_154_, inspection0_.send_email_status as send_em20_154_, inspection0_.send_mail_replied_date as send_ma21_154_ from v_inspection_report_dashboard_slim inspection0_ inner join v_audit_work_auditor auditworka1_ on inspection0_.audit_work_id=auditworka1_.audit_work_id left outer join v_users_auditee_org_in_responsibility usersaudit2_ on inspection0_.audit_work_id=usersaudit2_.audit_work_id where inspection0_.is_show_leader=@P0 and inspection0_.inspection_report_status=@P1 and (inspection0_.inspection_report_status in (@P2)) and (inspection0_.inspection_report_status in (@P3)) and (inspection0_.auditee_org_id in (select distinct auditeeorg3_.id from v_auditee_org_flat_tree auditeeorg3_ where auditeeorg3_.auditee_type=@P4 and (auditeeorg3_.parent_id in (1594) or auditeeorg3_.id in (1594)))) and inspection0_.audit_procedure_years=2566 and inspection0_.send_email_status=@P5 and (inspection0_.priority_suggestion_seq is not null) and ((auditworka1_.position_name=@P6 or auditworka1_.position_name=@P7 or auditworka1_.position_name=@P8 or auditworka1_.position_name=@P9 or auditworka1_.position_name=@P10) and auditworka1_.user_id=156 or inspection0_.auditee_org_id in (select distinct auditeeorg4_.id from v_auditee_org_flat_tree auditeeorg4_ where auditeeorg4_.auditee_type=@P11 and (auditeeorg4_.parent_id in (81) or auditeeorg4_.id in (81))) or usersaudit2_.user_id=156 or inspection0_.auditee_org_id in (select distinct auditeeorg5_.id from v_auditee_org_flat_tree auditeeorg5_ where auditeeorg5_.auditee_type=@P12 and (auditeeorg5_.parent_id in (null) or auditeeorg5_.id in (null)))) order by inspection0_.priority_suggestion_seq asc offset 0 rows fetch next @P13 rows only",24921,252,24669,235984,149,49842
"(@P0 nvarchar(4000),@P1 nvarchar(4000),@P2 int,@P3 nvarchar(4000),@P4 int,@P5 nvarchar(4000),@P6 int,@P7 int,@P8 int)select distinct inspection0_.id as id1_152_, inspection0_.annual_plan_detail_id as annual_36_152_, inspection0_.annual_plan_draft_id as annual_p2_152_, inspection0_.annual_plan_draft_name as annual_p3_152_, inspection0_.annual_plan_id as annual_p4_152_, inspection0_.audit_plan_info_org_id as audit_p37_152_, inspection0_.audit_procedure_code as audit_pr5_152_, inspection0_.audit_procedure_id as audit_pr6_152_, inspection0_.audit_procedure_name as audit_pr7_152_, inspection0_.audit_procedure_years as audit_pr8_152_, inspection0_.audit_task_status as audit_ta9_152_, inspection0_.audit_work_status as audit_w10_152_, inspection0_.audited_date_set_report as audited11_152_, inspection0_.auditee_org_id as auditee38_152_, inspection0_.auditee_org_name as auditee12_152_, inspection0_.auditee_org_postcode as auditee13_152_, inspection0_.auditee_org_type as auditee14_152_, inspection0_.feedback_status as feedbac15_152_, inspection0_.inspection_date as inspect16_152_, inspection0_.inspection_evaluate_date as inspect17_152_, inspection0_.inspection_evaluate_status as inspect18_152_, inspection0_.inspection_report_id as inspect39_152_, inspection0_.inspection_report_status as inspect19_152_, inspection0_.is_show_leader as is_show20_152_, inspection0_.last_updated_date as last_up21_152_, inspection0_.last_updated_date_feedback_solution as last_up22_152_, inspection0_.last_updated_date_inspection_tracking as last_up23_152_, inspection0_.lat as lat24_152_, inspection0_.lng as lng25_152_, inspection0_.manager_user_id as manager26_152_, inspection0_.priority_suggestion_color as priorit27_152_, inspection0_.priority_suggestion_name as priorit28_152_, inspection0_.priority_suggestion_seq as priorit29_152_, inspection0_.send_email_replied_date as send_em30_152_, inspection0_.send_email_status as send_em31_152_, inspection0_.strategic_plan_id as strateg32_152_, inspection0_.strategic_plan_item_id as strateg33_152_, inspection0_.strategic_plan_item_total_effort as strateg34_152_, inspection0_.strategic_plan_name as strateg35_152_ from v_inspection_report inspection0_ inner join inspection_report inspection1_ on inspection0_.inspection_report_id=inspection1_.id inner join audit_work auditwork2_ on inspection1_.audit_work_id=auditwork2_.id inner join audit_work_auditor auditworka3_ on auditwork2_.id=auditworka3_.audit_work_id inner join inspection_report inspection4_ on inspection0_.inspection_report_id=inspection4_.id inner join audit_work auditwork5_ on inspection4_.audit_work_id=auditwork5_.id inner join audit_work_auditor auditworka6_ on auditwork5_.id=auditworka6_.audit_work_id inner join inspection_report inspection7_ on inspection0_.inspection_report_id=inspection7_.id inner join audit_work auditwork8_ on inspection7_.audit_work_id=auditwork8_.id inner join audit_work_auditor auditworka9_ on auditwork8_.id=auditworka9_.audit_work_id where (inspection7_.inspection_report_status in (@P0)) and (auditworka3_.position_name=@P1 and auditworka3_.user_id=@P2 or auditworka6_.position_name=@P3 and auditworka6_.user_id=@P4 or auditworka9_.position_name=@P5 and auditworka9_.user_id=@P6) order by inspection0_.last_updated_date_feedback_solution desc offset @P7 rows fetch next @P8 rows only",24729,101231,-76502,181254444,25,173107
"(@P0 bit,@P1 nvarchar(4000),@P2 nvarchar(4000),@P3 nvarchar(4000),@P4 bit,@P5 nvarchar(4000),@P6 nvarchar(4000),@P7 nvarchar(4000),@P8 nvarchar(4000),@P9 nvarchar(4000),@P10 nvarchar(4000),@P11 nvarchar(4000),@P12 int)select distinct inspection0_.audit_work_id as audit_wo1_154_, inspection0_.audit_procedure_years as audit_pr2_154_, inspection0_.auditee_org_id as auditee_3_154_, inspection0_.auditee_org_name as auditee_4_154_, inspection0_.auditee_org_postcode as auditee_5_154_, inspection0_.auditee_org_type as auditee_6_154_, inspection0_.auditee_org_type_id as auditee_7_154_, inspection0_.feedback_status as feedback8_154_, inspection0_.inspection_report_approved_date as inspecti9_154_, inspection0_.inspection_report_status as inspect10_154_, inspection0_.is_show_leader as is_show11_154_, inspection0_.lat as lat12_154_, inspection0_.lng as lng13_154_, inspection0_.office_auditee_org_id as office_14_154_, inspection0_.post_area_auditee_org_id as post_ar15_154_, inspection0_.priority_suggestion_color as priorit16_154_, inspection0_.priority_suggestion_name as priorit17_154_, inspection0_.priority_suggestion_name_freezed as priorit18_154_, inspection0_.priority_suggestion_seq as priorit19_154_, inspection0_.send_email_status as send_em20_154_, inspection0_.send_mail_replied_date as send_ma21_154_ from v_inspection_report_dashboard_slim inspection0_ inner join v_audit_work_auditor auditworka1_ on inspection0_.audit_work_id=auditworka1_.audit_work_id left outer join v_users_auditee_org_in_responsibility usersaudit2_ on inspection0_.audit_work_id=usersaudit2_.audit_work_id where inspection0_.is_show_leader=@P0 and inspection0_.inspection_report_status=@P1 and (inspection0_.inspection_report_status in (@P2)) and (inspection0_.inspection_report_status in (@P3)) and inspection0_.audit_procedure_years=2565 and inspection0_.send_email_status=@P4 and (inspection0_.priority_suggestion_seq is not null) and ((auditworka1_.position_name=@P5 or auditworka1_.position_name=@P6 or auditworka1_.position_name=@P7 or auditworka1_.position_name=@P8 or auditworka1_.position_name=@P9) and auditworka1_.user_id=1599 or inspection0_.auditee_org_id in (select distinct auditeeorg3_.id from v_auditee_org_flat_tree auditeeorg3_ where auditeeorg3_.auditee_type=@P10 and (auditeeorg3_.parent_id in (1570) or auditeeorg3_.id in (1570))) or usersaudit2_.user_id=1599 or inspection0_.auditee_org_id in (select distinct auditeeorg4_.id from v_auditee_org_flat_tree auditeeorg4_ where auditeeorg4_.auditee_type=@P11 and (auditeeorg4_.parent_id in (551) or auditeeorg4_.id in (551)))) order by inspection0_.priority_suggestion_seq asc offset 0 rows fetch next @P12 rows only",19198,19182,16,571810,202,38397
"(@P0 bit,@P1 nvarchar(4000),@P2 nvarchar(4000),@P3 nvarchar(4000),@P4 nvarchar(4000),@P5 bit,@P6 nvarchar(4000),@P7 nvarchar(4000),@P8 nvarchar(4000),@P9 nvarchar(4000),@P10 nvarchar(4000),@P11 nvarchar(4000),@P12 nvarchar(4000),@P13 int)select distinct inspection0_.audit_work_id as audit_wo1_154_, inspection0_.audit_procedure_years as audit_pr2_154_, inspection0_.auditee_org_id as auditee_3_154_, inspection0_.auditee_org_name as auditee_4_154_, inspection0_.auditee_org_postcode as auditee_5_154_, inspection0_.auditee_org_type as auditee_6_154_, inspection0_.auditee_org_type_id as auditee_7_154_, inspection0_.feedback_status as feedback8_154_, inspection0_.inspection_report_approved_date as inspecti9_154_, inspection0_.inspection_report_status as inspect10_154_, inspection0_.is_show_leader as is_show11_154_, inspection0_.lat as lat12_154_, inspection0_.lng as lng13_154_, inspection0_.office_auditee_org_id as office_14_154_, inspection0_.post_area_auditee_org_id as post_ar15_154_, inspection0_.priority_suggestion_color as priorit16_154_, inspection0_.priority_suggestion_name as priorit17_154_, inspection0_.priority_suggestion_name_freezed as priorit18_154_, inspection0_.priority_suggestion_seq as priorit19_154_, inspection0_.send_email_status as send_em20_154_, inspection0_.send_mail_replied_date as send_ma21_154_ from v_inspection_report_dashboard_slim inspection0_ inner join v_audit_work_auditor auditworka1_ on inspection0_.audit_work_id=auditworka1_.audit_work_id left outer join v_users_auditee_org_in_responsibility usersaudit2_ on inspection0_.audit_work_id=usersaudit2_.audit_work_id where inspection0_.is_show_leader=@P0 and inspection0_.inspection_report_status=@P1 and (inspection0_.inspection_report_status in (@P2)) and (inspection0_.inspection_report_status in (@P3)) and (inspection0_.auditee_org_id in (select distinct auditeeorg3_.id from v_auditee_org_flat_tree auditeeorg3_ where auditeeorg3_.auditee_type=@P4 and (auditeeorg3_.parent_id in (11) or auditeeorg3_.id in (11)))) and inspection0_.audit_procedure_years=2567 and inspection0_.send_email_status=@P5 and (inspection0_.priority_suggestion_seq is not null) and ((auditworka1_.position_name=@P6 or auditworka1_.position_name=@P7 or auditworka1_.position_name=@P8 or auditworka1_.position_name=@P9 or auditworka1_.position_name=@P10) and auditworka1_.user_id=449 or inspection0_.auditee_org_id in (select distinct auditeeorg4_.id from v_auditee_org_flat_tree auditeeorg4_ where auditeeorg4_.auditee_type=@P11 and (auditeeorg4_.parent_id in (208) or auditeeorg4_.id in (208))) or usersaudit2_.user_id=449 or inspection0_.auditee_org_id in (select distinct auditeeorg5_.id from v_auditee_org_flat_tree auditeeorg5_ where auditeeorg5_.auditee_type=@P12 and (auditeeorg5_.parent_id in (null) or auditeeorg5_.id in (null)))) order by inspection0_.priority_suggestion_seq asc offset 0 rows fetch next @P13 rows only",18938,816,18122,269167,161,18938
"(@P0 nvarchar(4000),@P1 nvarchar(4000),@P2 nvarchar(4000),@P3 nvarchar(4000),@P4 nvarchar(4000),@P5 nvarchar(4000),@P6 nvarchar(4000),@P7 nvarchar(4000),@P8 nvarchar(4000),@P9 bit,@P10 nvarchar(4000),@P11 bit,@P12 int)select distinct inspection0_.id as id1_152_, inspection0_.annual_plan_detail_id as annual_36_152_, inspection0_.annual_plan_draft_id as annual_p2_152_, inspection0_.annual_plan_draft_name as annual_p3_152_, inspection0_.annual_plan_id as annual_p4_152_, inspection0_.audit_plan_info_org_id as audit_p37_152_, inspection0_.audit_procedure_code as audit_pr5_152_, inspection0_.audit_procedure_id as audit_pr6_152_, inspection0_.audit_procedure_name as audit_pr7_152_, inspection0_.audit_procedure_years as audit_pr8_152_, inspection0_.audit_task_status as audit_ta9_152_, inspection0_.audit_work_status as audit_w10_152_, inspection0_.audited_date_set_report as audited11_152_, inspection0_.auditee_org_id as auditee38_152_, inspection0_.auditee_org_name as auditee12_152_, inspection0_.auditee_org_postcode as auditee13_152_, inspection0_.auditee_org_type as auditee14_152_, inspection0_.feedback_status as feedbac15_152_, inspection0_.inspection_date as inspect16_152_, inspection0_.inspection_evaluate_date as inspect17_152_, inspection0_.inspection_evaluate_status as inspect18_152_, inspection0_.inspection_report_id as inspect39_152_, inspection0_.inspection_report_status as inspect19_152_, inspection0_.is_show_leader as is_show20_152_, inspection0_.last_updated_date as last_up21_152_, inspection0_.last_updated_date_feedback_solution as last_up22_152_, inspection0_.last_updated_date_inspection_tracking as last_up23_152_, inspection0_.lat as lat24_152_, inspection0_.lng as lng25_152_, inspection0_.manager_user_id as manager26_152_, inspection0_.priority_suggestion_color as priorit27_152_, inspection0_.priority_suggestion_name as priorit28_152_, inspection0_.priority_suggestion_seq as priorit29_152_, inspection0_.send_email_replied_date as send_em30_152_, inspection0_.send_email_status as send_em31_152_, inspection0_.strategic_plan_id as strateg32_152_, inspection0_.strategic_plan_item_id as strateg33_152_, inspection0_.strategic_plan_item_total_effort as strateg34_152_, inspection0_.strategic_plan_name as strateg35_152_ from v_inspection_report inspection0_ cross join inspection_report inspection1_ cross join audit_plan_info_org auditplani2_ cross join audit_work auditwork3_ cross join audit_work auditwork6_ where inspection0_.inspection_report_id=inspection1_.id and inspection0_.audit_plan_info_org_id=auditplani2_.id and auditplani2_.id=auditwork3_.audit_plan_info_org_id and inspection1_.audit_work_id=auditwork6_.id and (inspection1_.feedback_status in (@P0 , @P1 , @P2 , @P3 , @P4 , @P5 , @P6 , @P7 , @P8)) and auditwork3_.is_show_leader=@P9 and (inspection0_.manager_user_id=1348 or inspection0_.auditee_org_id in (select distinct auditeeorg4_.id from v_auditee_org_flat_tree auditeeorg4_ where auditeeorg4_.auditee_type=@P10 and (auditeeorg4_.parent_id in (1595 , 1657) or auditeeorg4_.id in (1595 , 1657)))) and auditwork6_.is_show_leader=@P11 order by inspection0_.last_updated_date desc, inspection0_.last_updated_date_feedback_solution desc offset 0 rows fetch next @P12 rows only",18825,4644,14181,3980365,142,18825
"(@P0 nvarchar(4000),@P1 nvarchar(4000),@P2 nvarchar(4000),@P3 nvarchar(4000),@P4 bit,@P5 nvarchar(4000),@P6 int,@P7 nvarchar(4000),@P8 bit,@P9 int)select distinct inspection0_.id as id1_152_, inspection0_.annual_plan_detail_id as annual_36_152_, inspection0_.annual_plan_draft_id as annual_p2_152_, inspection0_.annual_plan_draft_name as annual_p3_152_, inspection0_.annual_plan_id as annual_p4_152_, inspection0_.audit_plan_info_org_id as audit_p37_152_, inspection0_.audit_procedure_code as audit_pr5_152_, inspection0_.audit_procedure_id as audit_pr6_152_, inspection0_.audit_procedure_name as audit_pr7_152_, inspection0_.audit_procedure_years as audit_pr8_152_, inspection0_.audit_task_status as audit_ta9_152_, inspection0_.audit_work_status as audit_w10_152_, inspection0_.audited_date_set_report as audited11_152_, inspection0_.auditee_org_id as auditee38_152_, inspection0_.auditee_org_name as auditee12_152_, inspection0_.auditee_org_postcode as auditee13_152_, inspection0_.auditee_org_type as auditee14_152_, inspection0_.feedback_status as feedbac15_152_, inspection0_.inspection_date as inspect16_152_, inspection0_.inspection_evaluate_date as inspect17_152_, inspection0_.inspection_evaluate_status as inspect18_152_, inspection0_.inspection_report_id as inspect39_152_, inspection0_.inspection_report_status as inspect19_152_, inspection0_.is_show_leader as is_show20_152_, inspection0_.last_updated_date as last_up21_152_, inspection0_.last_updated_date_feedback_solution as last_up22_152_, inspection0_.last_updated_date_inspection_tracking as last_up23_152_, inspection0_.lat as lat24_152_, inspection0_.lng as lng25_152_, inspection0_.manager_user_id as manager26_152_, inspection0_.priority_suggestion_color as priorit27_152_, inspection0_.priority_suggestion_name as priorit28_152_, inspection0_.priority_suggestion_seq as priorit29_152_, inspection0_.send_email_replied_date as send_em30_152_, inspection0_.send_email_status as send_em31_152_, inspection0_.strategic_plan_id as strateg32_152_, inspection0_.strategic_plan_item_id as strateg33_152_, inspection0_.strategic_plan_item_total_effort as strateg34_152_, inspection0_.strategic_plan_name as strateg35_152_ from v_inspection_report inspection0_ inner join audit_plan_info_org auditplani1_ on inspection0_.audit_plan_info_org_id=auditplani1_.id inner join audit_work auditwork2_ on auditplani1_.id=auditwork2_.audit_plan_info_org_id inner join audit_work_auditor auditworka3_ on auditwork2_.id=auditworka3_.audit_work_id cross join inspection_report inspection4_ cross join audit_work auditwork8_ cross join audit_work auditwork11_ where inspection0_.inspection_report_id=inspection4_.id and auditplani1_.id=auditwork8_.audit_plan_info_org_id and inspection4_.audit_work_id=auditwork11_.id and (inspection4_.inspection_report_status in (@P0 , @P1 , @P2) or inspection4_.inspection_report_status=@P3 and (inspection4_.send_manager_date is not null)) and inspection0_.auditee_org_id=1098 and auditwork8_.is_show_leader=@P4 and (auditworka3_.position_name=@P5 and auditworka3_.user_id=@P6 or inspection0_.manager_user_id=208 or inspection0_.auditee_org_id in (select distinct auditeeorg9_.id from v_auditee_org_flat_tree auditeeorg9_ where auditeeorg9_.auditee_type=@P7 and (auditeeorg9_.parent_id in (60) or auditeeorg9_.id in (60)))) and auditwork11_.is_show_leader=@P8 order by inspection0_.last_updated_date desc offset 0 rows fetch next @P9 rows only",18812,210,18602,120893,129,37624
"(@P0 bit,@P1 nvarchar(4000),@P2 nvarchar(4000),@P3 nvarchar(4000),@P4 nvarchar(4000),@P5 bit,@P6 nvarchar(4000),@P7 nvarchar(4000),@P8 nvarchar(4000),@P9 nvarchar(4000),@P10 nvarchar(4000),@P11 nvarchar(4000),@P12 nvarchar(4000),@P13 int)select distinct inspection0_.audit_work_id as audit_wo1_154_, inspection0_.audit_procedure_years as audit_pr2_154_, inspection0_.auditee_org_id as auditee_3_154_, inspection0_.auditee_org_name as auditee_4_154_, inspection0_.auditee_org_postcode as auditee_5_154_, inspection0_.auditee_org_type as auditee_6_154_, inspection0_.auditee_org_type_id as auditee_7_154_, inspection0_.feedback_status as feedback8_154_, inspection0_.inspection_report_approved_date as inspecti9_154_, inspection0_.inspection_report_status as inspect10_154_, inspection0_.is_show_leader as is_show11_154_, inspection0_.lat as lat12_154_, inspection0_.lng as lng13_154_, inspection0_.office_auditee_org_id as office_14_154_, inspection0_.post_area_auditee_org_id as post_ar15_154_, inspection0_.priority_suggestion_color as priorit16_154_, inspection0_.priority_suggestion_name as priorit17_154_, inspection0_.priority_suggestion_name_freezed as priorit18_154_, inspection0_.priority_suggestion_seq as priorit19_154_, inspection0_.send_email_status as send_em20_154_, inspection0_.send_mail_replied_date as send_ma21_154_ from v_inspection_report_dashboard_slim inspection0_ inner join v_audit_work_auditor auditworka1_ on inspection0_.audit_work_id=auditworka1_.audit_work_id left outer join v_users_auditee_org_in_responsibility usersaudit2_ on inspection0_.audit_work_id=usersaudit2_.audit_work_id where inspection0_.is_show_leader=@P0 and inspection0_.inspection_report_status=@P1 and (inspection0_.inspection_report_status in (@P2)) and (inspection0_.inspection_report_status in (@P3)) and (inspection0_.auditee_org_id in (select distinct auditeeorg3_.id from v_auditee_org_flat_tree auditeeorg3_ where auditeeorg3_.auditee_type=@P4 and (auditeeorg3_.parent_id in (1528) or auditeeorg3_.id in (1528)))) and inspection0_.audit_procedure_years=2567 and inspection0_.send_email_status=@P5 and (inspection0_.priority_suggestion_seq is not null) and ((auditworka1_.position_name=@P6 or auditworka1_.position_name=@P7 or auditworka1_.position_name=@P8 or auditworka1_.position_name=@P9 or auditworka1_.position_name=@P10) and auditworka1_.user_id=156 or inspection0_.auditee_org_id in (select distinct auditeeorg4_.id from v_auditee_org_flat_tree auditeeorg4_ where auditeeorg4_.auditee_type=@P11 and (auditeeorg4_.parent_id in (81) or auditeeorg4_.id in (81))) or usersaudit2_.user_id=156 or inspection0_.auditee_org_id in (select distinct auditeeorg5_.id from v_auditee_org_flat_tree auditeeorg5_ where auditeeorg5_.auditee_type=@P12 and (auditeeorg5_.parent_id in (null) or auditeeorg5_.id in (null)))) order by inspection0_.priority_suggestion_seq asc offset 0 rows fetch next @P13 rows only",18164,204,17960,117243,39,18164
"(@P0 nvarchar(4000),@P1 nvarchar(4000),@P2 nvarchar(4000),@P3 nvarchar(4000),@P4 bit,@P5 nvarchar(4000),@P6 int,@P7 nvarchar(4000),@P8 bit,@P9 int)select distinct inspection0_.id as id1_152_, inspection0_.annual_plan_detail_id as annual_36_152_, inspection0_.annual_plan_draft_id as annual_p2_152_, inspection0_.annual_plan_draft_name as annual_p3_152_, inspection0_.annual_plan_id as annual_p4_152_, inspection0_.audit_plan_info_org_id as audit_p37_152_, inspection0_.audit_procedure_code as audit_pr5_152_, inspection0_.audit_procedure_id as audit_pr6_152_, inspection0_.audit_procedure_name as audit_pr7_152_, inspection0_.audit_procedure_years as audit_pr8_152_, inspection0_.audit_task_status as audit_ta9_152_, inspection0_.audit_work_status as audit_w10_152_, inspection0_.audited_date_set_report as audited11_152_, inspection0_.auditee_org_id as auditee38_152_, inspection0_.auditee_org_name as auditee12_152_, inspection0_.auditee_org_postcode as auditee13_152_, inspection0_.auditee_org_type as auditee14_152_, inspection0_.feedback_status as feedbac15_152_, inspection0_.inspection_date as inspect16_152_, inspection0_.inspection_evaluate_date as inspect17_152_, inspection0_.inspection_evaluate_status as inspect18_152_, inspection0_.inspection_report_id as inspect39_152_, inspection0_.inspection_report_status as inspect19_152_, inspection0_.is_show_leader as is_show20_152_, inspection0_.last_updated_date as last_up21_152_, inspection0_.last_updated_date_feedback_solution as last_up22_152_, inspection0_.last_updated_date_inspection_tracking as last_up23_152_, inspection0_.lat as lat24_152_, inspection0_.lng as lng25_152_, inspection0_.manager_user_id as manager26_152_, inspection0_.priority_suggestion_color as priorit27_152_, inspection0_.priority_suggestion_name as priorit28_152_, inspection0_.priority_suggestion_seq as priorit29_152_, inspection0_.send_email_replied_date as send_em30_152_, inspection0_.send_email_status as send_em31_152_, inspection0_.strategic_plan_id as strateg32_152_, inspection0_.strategic_plan_item_id as strateg33_152_, inspection0_.strategic_plan_item_total_effort as strateg34_152_, inspection0_.strategic_plan_name as strateg35_152_ from v_inspection_report inspection0_ inner join audit_plan_info_org auditplani1_ on inspection0_.audit_plan_info_org_id=auditplani1_.id inner join audit_work auditwork2_ on auditplani1_.id=auditwork2_.audit_plan_info_org_id inner join audit_work_auditor auditworka3_ on auditwork2_.id=auditworka3_.audit_work_id cross join inspection_report inspection4_ cross join audit_work auditwork8_ cross join audit_work auditwork11_ where inspection0_.inspection_report_id=inspection4_.id and auditplani1_.id=auditwork8_.audit_plan_info_org_id and inspection4_.audit_work_id=auditwork11_.id and (inspection4_.inspection_report_status in (@P0 , @P1 , @P2) or inspection4_.inspection_report_status=@P3 and (inspection4_.send_manager_date is not null)) and auditwork8_.is_show_leader=@P4 and (auditworka3_.position_name=@P5 and auditworka3_.user_id=@P6 or inspection0_.manager_user_id=162 or inspection0_.auditee_org_id in (select distinct auditeeorg9_.id from v_auditee_org_flat_tree auditeeorg9_ where auditeeorg9_.auditee_type=@P7 and (auditeeorg9_.parent_id in (null) or auditeeorg9_.id in (null)))) and auditwork11_.is_show_leader=@P8 order by inspection0_.last_updated_date desc offset 0 rows fetch next @P9 rows only",18093,11952,6141,26230757,11,36186
"(@P0 nvarchar(4000),@P1 nvarchar(4000),@P2 nvarchar(4000),@P3 nvarchar(4000),@P4 nvarchar(4000),@P5 nvarchar(4000),@P6 nvarchar(4000),@P7 nvarchar(4000),@P8 nvarchar(4000),@P9 bit,@P10 nvarchar(4000),@P11 bit,@P12 int)select distinct inspection0_.id as id1_152_, inspection0_.annual_plan_detail_id as annual_36_152_, inspection0_.annual_plan_draft_id as annual_p2_152_, inspection0_.annual_plan_draft_name as annual_p3_152_, inspection0_.annual_plan_id as annual_p4_152_, inspection0_.audit_plan_info_org_id as audit_p37_152_, inspection0_.audit_procedure_code as audit_pr5_152_, inspection0_.audit_procedure_id as audit_pr6_152_, inspection0_.audit_procedure_name as audit_pr7_152_, inspection0_.audit_procedure_years as audit_pr8_152_, inspection0_.audit_task_status as audit_ta9_152_, inspection0_.audit_work_status as audit_w10_152_, inspection0_.audited_date_set_report as audited11_152_, inspection0_.auditee_org_id as auditee38_152_, inspection0_.auditee_org_name as auditee12_152_, inspection0_.auditee_org_postcode as auditee13_152_, inspection0_.auditee_org_type as auditee14_152_, inspection0_.feedback_status as feedbac15_152_, inspection0_.inspection_date as inspect16_152_, inspection0_.inspection_evaluate_date as inspect17_152_, inspection0_.inspection_evaluate_status as inspect18_152_, inspection0_.inspection_report_id as inspect39_152_, inspection0_.inspection_report_status as inspect19_152_, inspection0_.is_show_leader as is_show20_152_, inspection0_.last_updated_date as last_up21_152_, inspection0_.last_updated_date_feedback_solution as last_up22_152_, inspection0_.last_updated_date_inspection_tracking as last_up23_152_, inspection0_.lat as lat24_152_, inspection0_.lng as lng25_152_, inspection0_.manager_user_id as manager26_152_, inspection0_.priority_suggestion_color as priorit27_152_, inspection0_.priority_suggestion_name as priorit28_152_, inspection0_.priority_suggestion_seq as priorit29_152_, inspection0_.send_email_replied_date as send_em30_152_, inspection0_.send_email_status as send_em31_152_, inspection0_.strategic_plan_id as strateg32_152_, inspection0_.strategic_plan_item_id as strateg33_152_, inspection0_.strategic_plan_item_total_effort as strateg34_152_, inspection0_.strategic_plan_name as strateg35_152_ from v_inspection_report inspection0_ cross join inspection_report inspection1_ cross join audit_plan_info_org auditplani2_ cross join audit_work auditwork3_ cross join audit_work auditwork6_ where inspection0_.inspection_report_id=inspection1_.id and inspection0_.audit_plan_info_org_id=auditplani2_.id and auditplani2_.id=auditwork3_.audit_plan_info_org_id and inspection1_.audit_work_id=auditwork6_.id and (inspection1_.feedback_status in (@P0 , @P1 , @P2 , @P3 , @P4 , @P5 , @P6 , @P7 , @P8)) and auditwork3_.is_show_leader=@P9 and (inspection0_.manager_user_id=173 or inspection0_.auditee_org_id in (select distinct auditeeorg4_.id from v_auditee_org_flat_tree auditeeorg4_ where auditeeorg4_.auditee_type=@P10 and (auditeeorg4_.parent_id in (80) or auditeeorg4_.id in (80)))) and auditwork6_.is_show_leader=@P11 order by inspection0_.last_updated_date desc, inspection0_.last_updated_date_feedback_solution desc offset 0 rows fetch next @P12 rows only",17313,124300,-106987,273881288,134,17313
"(@P0 nvarchar(4000),@P1 nvarchar(4000),@P2 nvarchar(4000),@P3 nvarchar(4000),@P4 nvarchar(4000),@P5 nvarchar(4000),@P6 nvarchar(4000),@P7 nvarchar(4000),@P8 nvarchar(4000),@P9 bit,@P10 nvarchar(4000),@P11 bit,@P12 int,@P13 int)select distinct inspection0_.id as id1_152_, inspection0_.annual_plan_detail_id as annual_36_152_, inspection0_.annual_plan_draft_id as annual_p2_152_, inspection0_.annual_plan_draft_name as annual_p3_152_, inspection0_.annual_plan_id as annual_p4_152_, inspection0_.audit_plan_info_org_id as audit_p37_152_, inspection0_.audit_procedure_code as audit_pr5_152_, inspection0_.audit_procedure_id as audit_pr6_152_, inspection0_.audit_procedure_name as audit_pr7_152_, inspection0_.audit_procedure_years as audit_pr8_152_, inspection0_.audit_task_status as audit_ta9_152_, inspection0_.audit_work_status as audit_w10_152_, inspection0_.audited_date_set_report as audited11_152_, inspection0_.auditee_org_id as auditee38_152_, inspection0_.auditee_org_name as auditee12_152_, inspection0_.auditee_org_postcode as auditee13_152_, inspection0_.auditee_org_type as auditee14_152_, inspection0_.feedback_status as feedbac15_152_, inspection0_.inspection_date as inspect16_152_, inspection0_.inspection_evaluate_date as inspect17_152_, inspection0_.inspection_evaluate_status as inspect18_152_, inspection0_.inspection_report_id as inspect39_152_, inspection0_.inspection_report_status as inspect19_152_, inspection0_.is_show_leader as is_show20_152_, inspection0_.last_updated_date as last_up21_152_, inspection0_.last_updated_date_feedback_solution as last_up22_152_, inspection0_.last_updated_date_inspection_tracking as last_up23_152_, inspection0_.lat as lat24_152_, inspection0_.lng as lng25_152_, inspection0_.manager_user_id as manager26_152_, inspection0_.priority_suggestion_color as priorit27_152_, inspection0_.priority_suggestion_name as priorit28_152_, inspection0_.priority_suggestion_seq as priorit29_152_, inspection0_.send_email_replied_date as send_em30_152_, inspection0_.send_email_status as send_em31_152_, inspection0_.strategic_plan_id as strateg32_152_, inspection0_.strategic_plan_item_id as strateg33_152_, inspection0_.strategic_plan_item_total_effort as strateg34_152_, inspection0_.strategic_plan_name as strateg35_152_ from v_inspection_report inspection0_ cross join inspection_report inspection1_ cross join audit_plan_info_org auditplani2_ cross join audit_work auditwork3_ cross join audit_work auditwork6_ where inspection0_.inspection_report_id=inspection1_.id and inspection0_.audit_plan_info_org_id=auditplani2_.id and auditplani2_.id=auditwork3_.audit_plan_info_org_id and inspection1_.audit_work_id=auditwork6_.id and (inspection1_.feedback_status in (@P0 , @P1 , @P2 , @P3 , @P4 , @P5 , @P6 , @P7 , @P8)) and auditwork3_.is_show_leader=@P9 and (inspection0_.manager_user_id=321 or inspection0_.auditee_org_id in (select distinct auditeeorg4_.id from v_auditee_org_flat_tree auditeeorg4_ where auditeeorg4_.auditee_type=@P10 and (auditeeorg4_.parent_id in (80) or auditeeorg4_.id in (80)))) and auditwork6_.is_show_leader=@P11 order by inspection0_.last_updated_date desc, inspection0_.last_updated_date_feedback_solution desc offset @P12 rows fetch next @P13 rows only",17109,122990,-105881,270042089,135,34218
"(@P0 bit,@P1 nvarchar(4000),@P2 nvarchar(4000),@P3 nvarchar(4000),@P4 bit,@P5 nvarchar(4000),@P6 nvarchar(4000),@P7 nvarchar(4000),@P8 nvarchar(4000),@P9 nvarchar(4000),@P10 nvarchar(4000),@P11 nvarchar(4000),@P12 int)select distinct inspection0_.audit_work_id as audit_wo1_154_, inspection0_.audit_procedure_years as audit_pr2_154_, inspection0_.auditee_org_id as auditee_3_154_, inspection0_.auditee_org_name as auditee_4_154_, inspection0_.auditee_org_postcode as auditee_5_154_, inspection0_.auditee_org_type as auditee_6_154_, inspection0_.auditee_org_type_id as auditee_7_154_, inspection0_.feedback_status as feedback8_154_, inspection0_.inspection_report_approved_date as inspecti9_154_, inspection0_.inspection_report_status as inspect10_154_, inspection0_.is_show_leader as is_show11_154_, inspection0_.lat as lat12_154_, inspection0_.lng as lng13_154_, inspection0_.office_auditee_org_id as office_14_154_, inspection0_.post_area_auditee_org_id as post_ar15_154_, inspection0_.priority_suggestion_color as priorit16_154_, inspection0_.priority_suggestion_name as priorit17_154_, inspection0_.priority_suggestion_name_freezed as priorit18_154_, inspection0_.priority_suggestion_seq as priorit19_154_, inspection0_.send_email_status as send_em20_154_, inspection0_.send_mail_replied_date as send_ma21_154_ from v_inspection_report_dashboard_slim inspection0_ inner join v_audit_work_auditor auditworka1_ on inspection0_.audit_work_id=auditworka1_.audit_work_id left outer join v_users_auditee_org_in_responsibility usersaudit2_ on inspection0_.audit_work_id=usersaudit2_.audit_work_id where inspection0_.is_show_leader=@P0 and inspection0_.inspection_report_status=@P1 and (inspection0_.inspection_report_status in (@P2)) and (inspection0_.inspection_report_status in (@P3)) and inspection0_.audit_procedure_years=2566 and inspection0_.send_email_status=@P4 and (inspection0_.priority_suggestion_seq is not null) and ((auditworka1_.position_name=@P5 or auditworka1_.position_name=@P6 or auditworka1_.position_name=@P7 or auditworka1_.position_name=@P8 or auditworka1_.position_name=@P9) and auditworka1_.user_id=523 or inspection0_.auditee_org_id in (select distinct auditeeorg3_.id from v_auditee_org_flat_tree auditeeorg3_ where auditeeorg3_.auditee_type=@P10 and (auditeeorg3_.parent_id in (1425 , 1634 , 1653 , 1668 , 1725) or auditeeorg3_.id in (1425 , 1634 , 1653 , 1668 , 1725))) or usersaudit2_.user_id=523 or inspection0_.auditee_org_id in (select distinct auditeeorg4_.id from v_auditee_org_flat_tree auditeeorg4_ where auditeeorg4_.auditee_type=@P11 and (auditeeorg4_.parent_id in (440) or auditeeorg4_.id in (440)))) order by inspection0_.priority_suggestion_seq asc offset 0 rows fetch next @P12 rows only",16823,16750,73,519794,204,33647
"(@P0 bit,@P1 nvarchar(4000),@P2 nvarchar(4000),@P3 nvarchar(4000),@P4 bit,@P5 nvarchar(4000),@P6 nvarchar(4000),@P7 nvarchar(4000),@P8 nvarchar(4000),@P9 nvarchar(4000),@P10 nvarchar(4000),@P11 nvarchar(4000),@P12 int)select distinct inspection0_.audit_work_id as audit_wo1_154_, inspection0_.audit_procedure_years as audit_pr2_154_, inspection0_.auditee_org_id as auditee_3_154_, inspection0_.auditee_org_name as auditee_4_154_, inspection0_.auditee_org_postcode as auditee_5_154_, inspection0_.auditee_org_type as auditee_6_154_, inspection0_.auditee_org_type_id as auditee_7_154_, inspection0_.feedback_status as feedback8_154_, inspection0_.inspection_report_approved_date as inspecti9_154_, inspection0_.inspection_report_status as inspect10_154_, inspection0_.is_show_leader as is_show11_154_, inspection0_.lat as lat12_154_, inspection0_.lng as lng13_154_, inspection0_.office_auditee_org_id as office_14_154_, inspection0_.post_area_auditee_org_id as post_ar15_154_, inspection0_.priority_suggestion_color as priorit16_154_, inspection0_.priority_suggestion_name as priorit17_154_, inspection0_.priority_suggestion_name_freezed as priorit18_154_, inspection0_.priority_suggestion_seq as priorit19_154_, inspection0_.send_email_status as send_em20_154_, inspection0_.send_mail_replied_date as send_ma21_154_ from v_inspection_report_dashboard_slim inspection0_ inner join v_audit_work_auditor auditworka1_ on inspection0_.audit_work_id=auditworka1_.audit_work_id left outer join v_users_auditee_org_in_responsibility usersaudit2_ on inspection0_.audit_work_id=usersaudit2_.audit_work_id where inspection0_.is_show_leader=@P0 and inspection0_.inspection_report_status=@P1 and (inspection0_.inspection_report_status in (@P2)) and (inspection0_.inspection_report_status in (@P3)) and inspection0_.audit_procedure_years=2566 and inspection0_.send_email_status=@P4 and (inspection0_.priority_suggestion_seq is not null) and ((auditworka1_.position_name=@P5 or auditworka1_.position_name=@P6 or auditworka1_.position_name=@P7 or auditworka1_.position_name=@P8 or auditworka1_.position_name=@P9) and auditworka1_.user_id=289 or inspection0_.auditee_org_id in (select distinct auditeeorg3_.id from v_auditee_org_flat_tree auditeeorg3_ where auditeeorg3_.auditee_type=@P10 and (auditeeorg3_.parent_id in (1443) or auditeeorg3_.id in (1443))) or usersaudit2_.user_id=289 or inspection0_.auditee_org_id in (select distinct auditeeorg4_.id from v_auditee_org_flat_tree auditeeorg4_ where auditeeorg4_.auditee_type=@P11 and (auditeeorg4_.parent_id in (1358) or auditeeorg4_.id in (1358)))) order by inspection0_.priority_suggestion_seq asc offset 0 rows fetch next @P12 rows only",16530,16499,31,522722,200,33060
"(@P0 nvarchar(4000),@P1 nvarchar(4000),@P2 nvarchar(4000),@P3 nvarchar(4000),@P4 nvarchar(4000),@P5 nvarchar(4000),@P6 nvarchar(4000),@P7 nvarchar(4000),@P8 nvarchar(4000),@P9 bit,@P10 nvarchar(4000),@P11 bit,@P12 int)select distinct inspection0_.id as id1_152_, inspection0_.annual_plan_detail_id as annual_36_152_, inspection0_.annual_plan_draft_id as annual_p2_152_, inspection0_.annual_plan_draft_name as annual_p3_152_, inspection0_.annual_plan_id as annual_p4_152_, inspection0_.audit_plan_info_org_id as audit_p37_152_, inspection0_.audit_procedure_code as audit_pr5_152_, inspection0_.audit_procedure_id as audit_pr6_152_, inspection0_.audit_procedure_name as audit_pr7_152_, inspection0_.audit_procedure_years as audit_pr8_152_, inspection0_.audit_task_status as audit_ta9_152_, inspection0_.audit_work_status as audit_w10_152_, inspection0_.audited_date_set_report as audited11_152_, inspection0_.auditee_org_id as auditee38_152_, inspection0_.auditee_org_name as auditee12_152_, inspection0_.auditee_org_postcode as auditee13_152_, inspection0_.auditee_org_type as auditee14_152_, inspection0_.feedback_status as feedbac15_152_, inspection0_.inspection_date as inspect16_152_, inspection0_.inspection_evaluate_date as inspect17_152_, inspection0_.inspection_evaluate_status as inspect18_152_, inspection0_.inspection_report_id as inspect39_152_, inspection0_.inspection_report_status as inspect19_152_, inspection0_.is_show_leader as is_show20_152_, inspection0_.last_updated_date as last_up21_152_, inspection0_.last_updated_date_feedback_solution as last_up22_152_, inspection0_.last_updated_date_inspection_tracking as last_up23_152_, inspection0_.lat as lat24_152_, inspection0_.lng as lng25_152_, inspection0_.manager_user_id as manager26_152_, inspection0_.priority_suggestion_color as priorit27_152_, inspection0_.priority_suggestion_name as priorit28_152_, inspection0_.priority_suggestion_seq as priorit29_152_, inspection0_.send_email_replied_date as send_em30_152_, inspection0_.send_email_status as send_em31_152_, inspection0_.strategic_plan_id as strateg32_152_, inspection0_.strategic_plan_item_id as strateg33_152_, inspection0_.strategic_plan_item_total_effort as strateg34_152_, inspection0_.strategic_plan_name as strateg35_152_ from v_inspection_report inspection0_ cross join inspection_report inspection1_ cross join audit_plan_info_org auditplani2_ cross join audit_work auditwork3_ cross join audit_work auditwork6_ where inspection0_.inspection_report_id=inspection1_.id and inspection0_.audit_plan_info_org_id=auditplani2_.id and auditplani2_.id=auditwork3_.audit_plan_info_org_id and inspection1_.audit_work_id=auditwork6_.id and (inspection1_.feedback_status in (@P0 , @P1 , @P2 , @P3 , @P4 , @P5 , @P6 , @P7 , @P8)) and auditwork3_.is_show_leader=@P9 and (inspection0_.manager_user_id=171 or inspection0_.auditee_org_id in (select distinct auditeeorg4_.id from v_auditee_org_flat_tree auditeeorg4_ where auditeeorg4_.auditee_type=@P10 and (auditeeorg4_.parent_id in (40) or auditeeorg4_.id in (40)))) and auditwork6_.is_show_leader=@P11 order by inspection0_.last_updated_date desc, inspection0_.last_updated_date_feedback_solution desc offset 0 rows fetch next @P12 rows only",16262,117900,-101638,231472013,128,48787
"(@P0 nvarchar(4000),@P1 nvarchar(4000),@P2 nvarchar(4000),@P3 nvarchar(4000),@P4 bit,@P5 nvarchar(4000),@P6 int,@P7 nvarchar(4000),@P8 bit,@P9 int)select distinct inspection0_.id as id1_152_, inspection0_.annual_plan_detail_id as annual_36_152_, inspection0_.annual_plan_draft_id as annual_p2_152_, inspection0_.annual_plan_draft_name as annual_p3_152_, inspection0_.annual_plan_id as annual_p4_152_, inspection0_.audit_plan_info_org_id as audit_p37_152_, inspection0_.audit_procedure_code as audit_pr5_152_, inspection0_.audit_procedure_id as audit_pr6_152_, inspection0_.audit_procedure_name as audit_pr7_152_, inspection0_.audit_procedure_years as audit_pr8_152_, inspection0_.audit_task_status as audit_ta9_152_, inspection0_.audit_work_status as audit_w10_152_, inspection0_.audited_date_set_report as audited11_152_, inspection0_.auditee_org_id as auditee38_152_, inspection0_.auditee_org_name as auditee12_152_, inspection0_.auditee_org_postcode as auditee13_152_, inspection0_.auditee_org_type as auditee14_152_, inspection0_.feedback_status as feedbac15_152_, inspection0_.inspection_date as inspect16_152_, inspection0_.inspection_evaluate_date as inspect17_152_, inspection0_.inspection_evaluate_status as inspect18_152_, inspection0_.inspection_report_id as inspect39_152_, inspection0_.inspection_report_status as inspect19_152_, inspection0_.is_show_leader as is_show20_152_, inspection0_.last_updated_date as last_up21_152_, inspection0_.last_updated_date_feedback_solution as last_up22_152_, inspection0_.last_updated_date_inspection_tracking as last_up23_152_, inspection0_.lat as lat24_152_, inspection0_.lng as lng25_152_, inspection0_.manager_user_id as manager26_152_, inspection0_.priority_suggestion_color as priorit27_152_, inspection0_.priority_suggestion_name as priorit28_152_, inspection0_.priority_suggestion_seq as priorit29_152_, inspection0_.send_email_replied_date as send_em30_152_, inspection0_.send_email_status as send_em31_152_, inspection0_.strategic_plan_id as strateg32_152_, inspection0_.strategic_plan_item_id as strateg33_152_, inspection0_.strategic_plan_item_total_effort as strateg34_152_, inspection0_.strategic_plan_name as strateg35_152_ from v_inspection_report inspection0_ inner join audit_plan_info_org auditplani1_ on inspection0_.audit_plan_info_org_id=auditplani1_.id inner join audit_work auditwork2_ on auditplani1_.id=auditwork2_.audit_plan_info_org_id inner join audit_work_auditor auditworka3_ on auditwork2_.id=auditworka3_.audit_work_id cross join inspection_report inspection4_ cross join audit_work auditwork8_ cross join audit_work auditwork11_ where inspection0_.inspection_report_id=inspection4_.id and auditplani1_.id=auditwork8_.audit_plan_info_org_id and inspection4_.audit_work_id=auditwork11_.id and (inspection4_.inspection_report_status in (@P0 , @P1 , @P2) or inspection4_.inspection_report_status=@P3 and (inspection4_.send_manager_date is not null)) and auditwork8_.is_show_leader=@P4 and (auditworka3_.position_name=@P5 and auditworka3_.user_id=@P6 or inspection0_.manager_user_id=166 or inspection0_.auditee_org_id in (select distinct auditeeorg9_.id from v_auditee_org_flat_tree auditeeorg9_ where auditeeorg9_.auditee_type=@P7 and (auditeeorg9_.parent_id in (null) or auditeeorg9_.id in (null)))) and auditwork11_.is_show_leader=@P8 order by inspection0_.last_updated_date desc offset 0 rows fetch next @P9 rows only",15639,15625,14,33778509,9,46918
"(@P0 bit,@P1 nvarchar(4000),@P2 nvarchar(4000),@P3 nvarchar(4000),@P4 nvarchar(4000),@P5 bit,@P6 nvarchar(4000),@P7 nvarchar(4000),@P8 nvarchar(4000),@P9 nvarchar(4000),@P10 nvarchar(4000),@P11 nvarchar(4000),@P12 nvarchar(4000),@P13 int)select distinct inspection0_.audit_work_id as audit_wo1_154_, inspection0_.audit_procedure_years as audit_pr2_154_, inspection0_.auditee_org_id as auditee_3_154_, inspection0_.auditee_org_name as auditee_4_154_, inspection0_.auditee_org_postcode as auditee_5_154_, inspection0_.auditee_org_type as auditee_6_154_, inspection0_.auditee_org_type_id as auditee_7_154_, inspection0_.feedback_status as feedback8_154_, inspection0_.inspection_report_approved_date as inspecti9_154_, inspection0_.inspection_report_status as inspect10_154_, inspection0_.is_show_leader as is_show11_154_, inspection0_.lat as lat12_154_, inspection0_.lng as lng13_154_, inspection0_.office_auditee_org_id as office_14_154_, inspection0_.post_area_auditee_org_id as post_ar15_154_, inspection0_.priority_suggestion_color as priorit16_154_, inspection0_.priority_suggestion_name as priorit17_154_, inspection0_.priority_suggestion_name_freezed as priorit18_154_, inspection0_.priority_suggestion_seq as priorit19_154_, inspection0_.send_email_status as send_em20_154_, inspection0_.send_mail_replied_date as send_ma21_154_ from v_inspection_report_dashboard_slim inspection0_ inner join v_audit_work_auditor auditworka1_ on inspection0_.audit_work_id=auditworka1_.audit_work_id left outer join v_users_auditee_org_in_responsibility usersaudit2_ on inspection0_.audit_work_id=usersaudit2_.audit_work_id where inspection0_.is_show_leader=@P0 and inspection0_.inspection_report_status=@P1 and (inspection0_.inspection_report_status in (@P2)) and (inspection0_.inspection_report_status in (@P3)) and (inspection0_.auditee_org_id in (select distinct auditeeorg3_.id from v_auditee_org_flat_tree auditeeorg3_ where auditeeorg3_.auditee_type=@P4 and (auditeeorg3_.parent_id in (1403) or auditeeorg3_.id in (1403)))) and inspection0_.audit_procedure_years=2566 and inspection0_.send_email_status=@P5 and (inspection0_.priority_suggestion_seq is not null) and ((auditworka1_.position_name=@P6 or auditworka1_.position_name=@P7 or auditworka1_.position_name=@P8 or auditworka1_.position_name=@P9 or auditworka1_.position_name=@P10) and auditworka1_.user_id=156 or inspection0_.auditee_org_id in (select distinct auditeeorg4_.id from v_auditee_org_flat_tree auditeeorg4_ where auditeeorg4_.auditee_type=@P11 and (auditeeorg4_.parent_id in (81) or auditeeorg4_.id in (81))) or usersaudit2_.user_id=156 or inspection0_.auditee_org_id in (select distinct auditeeorg5_.id from v_auditee_org_flat_tree auditeeorg5_ where auditeeorg5_.auditee_type=@P12 and (auditeeorg5_.parent_id in (null) or auditeeorg5_.id in (null)))) order by inspection0_.priority_suggestion_seq asc offset 0 rows fetch next @P13 rows only",15565,341,15224,236561,165,15565
"(@P0 int,@P1 bit,@P2 nvarchar(4000),@P3 nvarchar(4000),@P4 nvarchar(4000),@P5 bit,@P6 nvarchar(4000),@P7 nvarchar(4000),@P8 nvarchar(4000),@P9 nvarchar(4000),@P10 nvarchar(4000),@P11 nvarchar(4000),@P12 nvarchar(4000))select distinct TOP(@P0) inspection0_.audit_work_id as audit_wo1_154_, inspection0_.audit_procedure_years as audit_pr2_154_, inspection0_.auditee_org_id as auditee_3_154_, inspection0_.auditee_org_name as auditee_4_154_, inspection0_.auditee_org_postcode as auditee_5_154_, inspection0_.auditee_org_type as auditee_6_154_, inspection0_.auditee_org_type_id as auditee_7_154_, inspection0_.feedback_status as feedback8_154_, inspection0_.inspection_report_approved_date as inspecti9_154_, inspection0_.inspection_report_status as inspect10_154_, inspection0_.is_show_leader as is_show11_154_, inspection0_.lat as lat12_154_, inspection0_.lng as lng13_154_, inspection0_.office_auditee_org_id as office_14_154_, inspection0_.post_area_auditee_org_id as post_ar15_154_, inspection0_.priority_suggestion_color as priorit16_154_, inspection0_.priority_suggestion_name as priorit17_154_, inspection0_.priority_suggestion_name_freezed as priorit18_154_, inspection0_.priority_suggestion_seq as priorit19_154_, inspection0_.send_email_status as send_em20_154_, inspection0_.send_mail_replied_date as send_ma21_154_ from v_inspection_report_dashboard_slim inspection0_ inner join v_audit_work_auditor auditworka1_ on inspection0_.audit_work_id=auditworka1_.audit_work_id left outer join v_users_auditee_org_in_responsibility usersaudit2_ on inspection0_.audit_work_id=usersaudit2_.audit_work_id where inspection0_.is_show_leader=@P1 and inspection0_.inspection_report_status=@P2 and (inspection0_.inspection_report_status in (@P3)) and (inspection0_.inspection_report_status in (@P4)) and inspection0_.audit_procedure_years=2567 and inspection0_.send_email_status=@P5 and (inspection0_.priority_suggestion_seq is not null) and ((auditworka1_.position_name=@P6 or auditworka1_.position_name=@P7 or auditworka1_.position_name=@P8 or auditworka1_.position_name=@P9 or auditworka1_.position_name=@P10) and auditworka1_.user_id=1555 or inspection0_.auditee_org_id in (select distinct auditeeorg3_.id from v_auditee_org_flat_tree auditeeorg3_ where auditeeorg3_.auditee_type=@P11 and (auditeeorg3_.parent_id in (1468 , 1644 , 1688) or auditeeorg3_.id in (1468 , 1644 , 1688))) or usersaudit2_.user_id=1555 or inspection0_.auditee_org_id in (select distinct auditeeorg4_.id from v_auditee_org_flat_tree auditeeorg4_ where auditeeorg4_.auditee_type=@P12 and (auditeeorg4_.parent_id in (595) or auditeeorg4_.id in (595))))",15488,1502,13986,274273,230,30977
"(@P0 int,@P1 int)WITH query AS (SELECT inner_query.*, ROW_NUMBER() OVER (ORDER BY CURRENT_TIMESTAMP) as __hibernate_row_nr__ FROM ( select inspection0_.id as id1_147_, inspection0_.actual_date as actual_d2_147_, inspection0_.audit_procedure_name as audit_pr3_147_, inspection0_.audit_work_id as audit_wo4_147_, inspection0_.auditee_org_id as auditee_5_147_, inspection0_.auditee_org_name as auditee_6_147_, inspection0_.auditee_org_postcode as auditee_7_147_, inspection0_.comment as comment8_147_, inspection0_.compare as compare9_147_, inspection0_.inspection_date as inspect10_147_, inspection0_.name as name11_147_, inspection0_.post_area_name as post_ar12_147_, inspection0_.schedual_date as schedua13_147_, inspection0_.seq as seq14_147_, inspection0_.seq_name as seq_nam15_147_, inspection0_.user_name as user_na16_147_ from v_inspection_compare_report inspection0_ ) inner_query ) SELECT id1_147_, actual_d2_147_, audit_pr3_147_, audit_wo4_147_, auditee_5_147_, auditee_6_147_, auditee_7_147_, comment8_147_, compare9_147_, inspect10_147_, name11_147_, post_ar12_147_, schedua13_147_, seq14_147_, seq_nam15_147_, user_na16_147_ FROM query WHERE __hibernate_row_nr__ >= @P0 AND __hibernate_row_nr__ < @P1",15438,15438,0,9255332,1267,15438
"(@P0 nvarchar(4000),@P1 nvarchar(4000),@P2 nvarchar(4000),@P3 nvarchar(4000),@P4 nvarchar(4000),@P5 nvarchar(4000),@P6 nvarchar(4000),@P7 nvarchar(4000),@P8 nvarchar(4000),@P9 bit,@P10 nvarchar(4000),@P11 bit)select distinct count(distinct inspection0_.id) as col_0_0_ from v_inspection_report inspection0_ cross join inspection_report inspection1_ cross join audit_plan_info_org auditplani2_ cross join audit_work auditwork3_ cross join audit_work auditwork6_ where inspection0_.inspection_report_id=inspection1_.id and inspection0_.audit_plan_info_org_id=auditplani2_.id and auditplani2_.id=auditwork3_.audit_plan_info_org_id and inspection1_.audit_work_id=auditwork6_.id and (inspection1_.feedback_status in (@P0 , @P1 , @P2 , @P3 , @P4 , @P5 , @P6 , @P7 , @P8)) and auditwork3_.is_show_leader=@P9 and (inspection0_.manager_user_id=330 or inspection0_.auditee_org_id in (select distinct auditeeorg4_.id from v_auditee_org_flat_tree auditeeorg4_ where auditeeorg4_.auditee_type=@P10 and (auditeeorg4_.parent_id in (71) or auditeeorg4_.id in (71)))) and auditwork6_.is_show_leader=@P11",15320,213,15107,135997,116,61282
"(@P0 nvarchar(4000),@P1 nvarchar(4000),@P2 nvarchar(4000),@P3 nvarchar(4000),@P4 bit,@P5 nvarchar(4000),@P6 int,@P7 nvarchar(4000),@P8 bit,@P9 int)select distinct inspection0_.id as id1_152_, inspection0_.annual_plan_detail_id as annual_36_152_, inspection0_.annual_plan_draft_id as annual_p2_152_, inspection0_.annual_plan_draft_name as annual_p3_152_, inspection0_.annual_plan_id as annual_p4_152_, inspection0_.audit_plan_info_org_id as audit_p37_152_, inspection0_.audit_procedure_code as audit_pr5_152_, inspection0_.audit_procedure_id as audit_pr6_152_, inspection0_.audit_procedure_name as audit_pr7_152_, inspection0_.audit_procedure_years as audit_pr8_152_, inspection0_.audit_task_status as audit_ta9_152_, inspection0_.audit_work_status as audit_w10_152_, inspection0_.audited_date_set_report as audited11_152_, inspection0_.auditee_org_id as auditee38_152_, inspection0_.auditee_org_name as auditee12_152_, inspection0_.auditee_org_postcode as auditee13_152_, inspection0_.auditee_org_type as auditee14_152_, inspection0_.feedback_status as feedbac15_152_, inspection0_.inspection_date as inspect16_152_, inspection0_.inspection_evaluate_date as inspect17_152_, inspection0_.inspection_evaluate_status as inspect18_152_, inspection0_.inspection_report_id as inspect39_152_, inspection0_.inspection_report_status as inspect19_152_, inspection0_.is_show_leader as is_show20_152_, inspection0_.last_updated_date as last_up21_152_, inspection0_.last_updated_date_feedback_solution as last_up22_152_, inspection0_.last_updated_date_inspection_tracking as last_up23_152_, inspection0_.lat as lat24_152_, inspection0_.lng as lng25_152_, inspection0_.manager_user_id as manager26_152_, inspection0_.priority_suggestion_color as priorit27_152_, inspection0_.priority_suggestion_name as priorit28_152_, inspection0_.priority_suggestion_seq as priorit29_152_, inspection0_.send_email_replied_date as send_em30_152_, inspection0_.send_email_status as send_em31_152_, inspection0_.strategic_plan_id as strateg32_152_, inspection0_.strategic_plan_item_id as strateg33_152_, inspection0_.strategic_plan_item_total_effort as strateg34_152_, inspection0_.strategic_plan_name as strateg35_152_ from v_inspection_report inspection0_ inner join audit_plan_info_org auditplani1_ on inspection0_.audit_plan_info_org_id=auditplani1_.id inner join audit_work auditwork2_ on auditplani1_.id=auditwork2_.audit_plan_info_org_id inner join audit_work_auditor auditworka3_ on auditwork2_.id=auditworka3_.audit_work_id cross join inspection_report inspection4_ cross join audit_work auditwork8_ cross join audit_work auditwork11_ where inspection0_.inspection_report_id=inspection4_.id and auditplani1_.id=auditwork8_.audit_plan_info_org_id and inspection4_.audit_work_id=auditwork11_.id and (inspection4_.inspection_report_status in (@P0 , @P1 , @P2) or inspection4_.inspection_report_status=@P3 and (inspection4_.send_manager_date is not null)) and inspection0_.auditee_org_id=1621 and auditwork8_.is_show_leader=@P4 and (auditworka3_.position_name=@P5 and auditworka3_.user_id=@P6 or inspection0_.manager_user_id=156 or inspection0_.auditee_org_id in (select distinct auditeeorg9_.id from v_auditee_org_flat_tree auditeeorg9_ where auditeeorg9_.auditee_type=@P7 and (auditeeorg9_.parent_id in (81) or auditeeorg9_.id in (81)))) and auditwork11_.is_show_leader=@P8 order by inspection0_.last_updated_date desc offset 0 rows fetch next @P9 rows only",15172,153,15019,120042,120,15172
"(@P0 nvarchar(4000),@P1 nvarchar(4000),@P2 nvarchar(4000),@P3 nvarchar(4000),@P4 nvarchar(4000),@P5 nvarchar(4000),@P6 nvarchar(4000),@P7 nvarchar(4000),@P8 nvarchar(4000),@P9 bit,@P10 nvarchar(4000),@P11 bit,@P12 int)select distinct inspection0_.id as id1_152_, inspection0_.annual_plan_detail_id as annual_36_152_, inspection0_.annual_plan_draft_id as annual_p2_152_, inspection0_.annual_plan_draft_name as annual_p3_152_, inspection0_.annual_plan_id as annual_p4_152_, inspection0_.audit_plan_info_org_id as audit_p37_152_, inspection0_.audit_procedure_code as audit_pr5_152_, inspection0_.audit_procedure_id as audit_pr6_152_, inspection0_.audit_procedure_name as audit_pr7_152_, inspection0_.audit_procedure_years as audit_pr8_152_, inspection0_.audit_task_status as audit_ta9_152_, inspection0_.audit_work_status as audit_w10_152_, inspection0_.audited_date_set_report as audited11_152_, inspection0_.auditee_org_id as auditee38_152_, inspection0_.auditee_org_name as auditee12_152_, inspection0_.auditee_org_postcode as auditee13_152_, inspection0_.auditee_org_type as auditee14_152_, inspection0_.feedback_status as feedbac15_152_, inspection0_.inspection_date as inspect16_152_, inspection0_.inspection_evaluate_date as inspect17_152_, inspection0_.inspection_evaluate_status as inspect18_152_, inspection0_.inspection_report_id as inspect39_152_, inspection0_.inspection_report_status as inspect19_152_, inspection0_.is_show_leader as is_show20_152_, inspection0_.last_updated_date as last_up21_152_, inspection0_.last_updated_date_feedback_solution as last_up22_152_, inspection0_.last_updated_date_inspection_tracking as last_up23_152_, inspection0_.lat as lat24_152_, inspection0_.lng as lng25_152_, inspection0_.manager_user_id as manager26_152_, inspection0_.priority_suggestion_color as priorit27_152_, inspection0_.priority_suggestion_name as priorit28_152_, inspection0_.priority_suggestion_seq as priorit29_152_, inspection0_.send_email_replied_date as send_em30_152_, inspection0_.send_email_status as send_em31_152_, inspection0_.strategic_plan_id as strateg32_152_, inspection0_.strategic_plan_item_id as strateg33_152_, inspection0_.strategic_plan_item_total_effort as strateg34_152_, inspection0_.strategic_plan_name as strateg35_152_ from v_inspection_report inspection0_ cross join inspection_report inspection1_ cross join audit_plan_info_org auditplani2_ cross join audit_work auditwork3_ cross join audit_work auditwork6_ where inspection0_.inspection_report_id=inspection1_.id and inspection0_.audit_plan_info_org_id=auditplani2_.id and auditplani2_.id=auditwork3_.audit_plan_info_org_id and inspection1_.audit_work_id=auditwork6_.id and (inspection1_.feedback_status in (@P0 , @P1 , @P2 , @P3 , @P4 , @P5 , @P6 , @P7 , @P8)) and auditwork3_.is_show_leader=@P9 and (inspection0_.manager_user_id=195 or inspection0_.auditee_org_id in (select distinct auditeeorg4_.id from v_auditee_org_flat_tree auditeeorg4_ where auditeeorg4_.auditee_type=@P10 and (auditeeorg4_.parent_id in (41) or auditeeorg4_.id in (41)))) and auditwork6_.is_show_leader=@P11 order by inspection0_.last_updated_date desc, inspection0_.last_updated_date_feedback_solution desc offset 0 rows fetch next @P12 rows only",15030,100565,-85535,188118572,116,15030
"(@P0 nvarchar(4000),@P1 nvarchar(4000),@P2 nvarchar(4000),@P3 nvarchar(4000),@P4 nvarchar(4000),@P5 nvarchar(4000),@P6 nvarchar(4000),@P7 nvarchar(4000),@P8 nvarchar(4000),@P9 bit,@P10 nvarchar(4000),@P11 bit,@P12 int,@P13 int)select distinct inspection0_.id as id1_152_, inspection0_.annual_plan_detail_id as annual_36_152_, inspection0_.annual_plan_draft_id as annual_p2_152_, inspection0_.annual_plan_draft_name as annual_p3_152_, inspection0_.annual_plan_id as annual_p4_152_, inspection0_.audit_plan_info_org_id as audit_p37_152_, inspection0_.audit_procedure_code as audit_pr5_152_, inspection0_.audit_procedure_id as audit_pr6_152_, inspection0_.audit_procedure_name as audit_pr7_152_, inspection0_.audit_procedure_years as audit_pr8_152_, inspection0_.audit_task_status as audit_ta9_152_, inspection0_.audit_work_status as audit_w10_152_, inspection0_.audited_date_set_report as audited11_152_, inspection0_.auditee_org_id as auditee38_152_, inspection0_.auditee_org_name as auditee12_152_, inspection0_.auditee_org_postcode as auditee13_152_, inspection0_.auditee_org_type as auditee14_152_, inspection0_.feedback_status as feedbac15_152_, inspection0_.inspection_date as inspect16_152_, inspection0_.inspection_evaluate_date as inspect17_152_, inspection0_.inspection_evaluate_status as inspect18_152_, inspection0_.inspection_report_id as inspect39_152_, inspection0_.inspection_report_status as inspect19_152_, inspection0_.is_show_leader as is_show20_152_, inspection0_.last_updated_date as last_up21_152_, inspection0_.last_updated_date_feedback_solution as last_up22_152_, inspection0_.last_updated_date_inspection_tracking as last_up23_152_, inspection0_.lat as lat24_152_, inspection0_.lng as lng25_152_, inspection0_.manager_user_id as manager26_152_, inspection0_.priority_suggestion_color as priorit27_152_, inspection0_.priority_suggestion_name as priorit28_152_, inspection0_.priority_suggestion_seq as priorit29_152_, inspection0_.send_email_replied_date as send_em30_152_, inspection0_.send_email_status as send_em31_152_, inspection0_.strategic_plan_id as strateg32_152_, inspection0_.strategic_plan_item_id as strateg33_152_, inspection0_.strategic_plan_item_total_effort as strateg34_152_, inspection0_.strategic_plan_name as strateg35_152_ from v_inspection_report inspection0_ cross join inspection_report inspection1_ cross join audit_plan_info_org auditplani2_ cross join audit_work auditwork3_ cross join audit_work auditwork6_ where inspection0_.inspection_report_id=inspection1_.id and inspection0_.audit_plan_info_org_id=auditplani2_.id and auditplani2_.id=auditwork3_.audit_plan_info_org_id and inspection1_.audit_work_id=auditwork6_.id and (inspection1_.feedback_status in (@P0 , @P1 , @P2 , @P3 , @P4 , @P5 , @P6 , @P7 , @P8)) and auditwork3_.is_show_leader=@P9 and (inspection0_.manager_user_id=325 or inspection0_.auditee_org_id in (select distinct auditeeorg4_.id from v_auditee_org_flat_tree auditeeorg4_ where auditeeorg4_.auditee_type=@P10 and (auditeeorg4_.parent_id in (39) or auditeeorg4_.id in (39)))) and auditwork6_.is_show_leader=@P11 order by inspection0_.last_updated_date desc, inspection0_.last_updated_date_feedback_solution desc offset @P12 rows fetch next @P13 rows only",14747,96178,-81431,191295488,128,88485
"(@P0 nvarchar(4000),@P1 nvarchar(4000),@P2 nvarchar(4000),@P3 nvarchar(4000),@P4 nvarchar(4000),@P5 nvarchar(4000),@P6 nvarchar(4000),@P7 nvarchar(4000),@P8 nvarchar(4000),@P9 bit,@P10 nvarchar(4000),@P11 bit,@P12 int)select distinct inspection0_.id as id1_152_, inspection0_.annual_plan_detail_id as annual_36_152_, inspection0_.annual_plan_draft_id as annual_p2_152_, inspection0_.annual_plan_draft_name as annual_p3_152_, inspection0_.annual_plan_id as annual_p4_152_, inspection0_.audit_plan_info_org_id as audit_p37_152_, inspection0_.audit_procedure_code as audit_pr5_152_, inspection0_.audit_procedure_id as audit_pr6_152_, inspection0_.audit_procedure_name as audit_pr7_152_, inspection0_.audit_procedure_years as audit_pr8_152_, inspection0_.audit_task_status as audit_ta9_152_, inspection0_.audit_work_status as audit_w10_152_, inspection0_.audited_date_set_report as audited11_152_, inspection0_.auditee_org_id as auditee38_152_, inspection0_.auditee_org_name as auditee12_152_, inspection0_.auditee_org_postcode as auditee13_152_, inspection0_.auditee_org_type as auditee14_152_, inspection0_.feedback_status as feedbac15_152_, inspection0_.inspection_date as inspect16_152_, inspection0_.inspection_evaluate_date as inspect17_152_, inspection0_.inspection_evaluate_status as inspect18_152_, inspection0_.inspection_report_id as inspect39_152_, inspection0_.inspection_report_status as inspect19_152_, inspection0_.is_show_leader as is_show20_152_, inspection0_.last_updated_date as last_up21_152_, inspection0_.last_updated_date_feedback_solution as last_up22_152_, inspection0_.last_updated_date_inspection_tracking as last_up23_152_, inspection0_.lat as lat24_152_, inspection0_.lng as lng25_152_, inspection0_.manager_user_id as manager26_152_, inspection0_.priority_suggestion_color as priorit27_152_, inspection0_.priority_suggestion_name as priorit28_152_, inspection0_.priority_suggestion_seq as priorit29_152_, inspection0_.send_email_replied_date as send_em30_152_, inspection0_.send_email_status as send_em31_152_, inspection0_.strategic_plan_id as strateg32_152_, inspection0_.strategic_plan_item_id as strateg33_152_, inspection0_.strategic_plan_item_total_effort as strateg34_152_, inspection0_.strategic_plan_name as strateg35_152_ from v_inspection_report inspection0_ cross join inspection_report inspection1_ cross join audit_plan_info_org auditplani2_ cross join audit_work auditwork3_ cross join audit_work auditwork6_ where inspection0_.inspection_report_id=inspection1_.id and inspection0_.audit_plan_info_org_id=auditplani2_.id and auditplani2_.id=auditwork3_.audit_plan_info_org_id and inspection1_.audit_work_id=auditwork6_.id and (inspection1_.feedback_status in (@P0 , @P1 , @P2 , @P3 , @P4 , @P5 , @P6 , @P7 , @P8)) and auditwork3_.is_show_leader=@P9 and (inspection0_.manager_user_id=319 or inspection0_.auditee_org_id in (select distinct auditeeorg4_.id from v_auditee_org_flat_tree auditeeorg4_ where auditeeorg4_.auditee_type=@P10 and (auditeeorg4_.parent_id in (41) or auditeeorg4_.id in (41)))) and auditwork6_.is_show_leader=@P11 order by inspection0_.last_updated_date desc, inspection0_.last_updated_date_feedback_solution desc offset 0 rows fetch next @P12 rows only",14528,97253,-82725,215718152,132,29057
"(@P0 nvarchar(4000),@P1 nvarchar(4000),@P2 nvarchar(4000),@P3 nvarchar(4000),@P4 nvarchar(4000),@P5 nvarchar(4000),@P6 nvarchar(4000),@P7 nvarchar(4000),@P8 nvarchar(4000),@P9 bit,@P10 nvarchar(4000),@P11 bit,@P12 int)select distinct inspection0_.id as id1_152_, inspection0_.annual_plan_detail_id as annual_36_152_, inspection0_.annual_plan_draft_id as annual_p2_152_, inspection0_.annual_plan_draft_name as annual_p3_152_, inspection0_.annual_plan_id as annual_p4_152_, inspection0_.audit_plan_info_org_id as audit_p37_152_, inspection0_.audit_procedure_code as audit_pr5_152_, inspection0_.audit_procedure_id as audit_pr6_152_, inspection0_.audit_procedure_name as audit_pr7_152_, inspection0_.audit_procedure_years as audit_pr8_152_, inspection0_.audit_task_status as audit_ta9_152_, inspection0_.audit_work_status as audit_w10_152_, inspection0_.audited_date_set_report as audited11_152_, inspection0_.auditee_org_id as auditee38_152_, inspection0_.auditee_org_name as auditee12_152_, inspection0_.auditee_org_postcode as auditee13_152_, inspection0_.auditee_org_type as auditee14_152_, inspection0_.feedback_status as feedbac15_152_, inspection0_.inspection_date as inspect16_152_, inspection0_.inspection_evaluate_date as inspect17_152_, inspection0_.inspection_evaluate_status as inspect18_152_, inspection0_.inspection_report_id as inspect39_152_, inspection0_.inspection_report_status as inspect19_152_, inspection0_.is_show_leader as is_show20_152_, inspection0_.last_updated_date as last_up21_152_, inspection0_.last_updated_date_feedback_solution as last_up22_152_, inspection0_.last_updated_date_inspection_tracking as last_up23_152_, inspection0_.lat as lat24_152_, inspection0_.lng as lng25_152_, inspection0_.manager_user_id as manager26_152_, inspection0_.priority_suggestion_color as priorit27_152_, inspection0_.priority_suggestion_name as priorit28_152_, inspection0_.priority_suggestion_seq as priorit29_152_, inspection0_.send_email_replied_date as send_em30_152_, inspection0_.send_email_status as send_em31_152_, inspection0_.strategic_plan_id as strateg32_152_, inspection0_.strategic_plan_item_id as strateg33_152_, inspection0_.strategic_plan_item_total_effort as strateg34_152_, inspection0_.strategic_plan_name as strateg35_152_ from v_inspection_report inspection0_ cross join inspection_report inspection1_ cross join audit_plan_info_org auditplani2_ cross join audit_work auditwork3_ cross join audit_work auditwork6_ where inspection0_.inspection_report_id=inspection1_.id and inspection0_.audit_plan_info_org_id=auditplani2_.id and auditplani2_.id=auditwork3_.audit_plan_info_org_id and inspection1_.audit_work_id=auditwork6_.id and (inspection1_.feedback_status in (@P0 , @P1 , @P2 , @P3 , @P4 , @P5 , @P6 , @P7 , @P8)) and auditwork3_.is_show_leader=@P9 and (inspection0_.manager_user_id=329 or inspection0_.auditee_org_id in (select distinct auditeeorg4_.id from v_auditee_org_flat_tree auditeeorg4_ where auditeeorg4_.auditee_type=@P10 and (auditeeorg4_.parent_id in (73) or auditeeorg4_.id in (73)))) and auditwork6_.is_show_leader=@P11 order by inspection0_.last_updated_date desc, inspection0_.last_updated_date_feedback_solution desc offset 0 rows fetch next @P12 rows only",14459,81447,-66988,184550480,131,14459
"(@P0 nvarchar(4000),@P1 nvarchar(4000),@P2 nvarchar(4000),@P3 nvarchar(4000),@P4 nvarchar(4000),@P5 nvarchar(4000),@P6 nvarchar(4000),@P7 nvarchar(4000),@P8 nvarchar(4000),@P9 bit,@P10 nvarchar(4000),@P11 bit,@P12 int)select distinct inspection0_.id as id1_152_, inspection0_.annual_plan_detail_id as annual_36_152_, inspection0_.annual_plan_draft_id as annual_p2_152_, inspection0_.annual_plan_draft_name as annual_p3_152_, inspection0_.annual_plan_id as annual_p4_152_, inspection0_.audit_plan_info_org_id as audit_p37_152_, inspection0_.audit_procedure_code as audit_pr5_152_, inspection0_.audit_procedure_id as audit_pr6_152_, inspection0_.audit_procedure_name as audit_pr7_152_, inspection0_.audit_procedure_years as audit_pr8_152_, inspection0_.audit_task_status as audit_ta9_152_, inspection0_.audit_work_status as audit_w10_152_, inspection0_.audited_date_set_report as audited11_152_, inspection0_.auditee_org_id as auditee38_152_, inspection0_.auditee_org_name as auditee12_152_, inspection0_.auditee_org_postcode as auditee13_152_, inspection0_.auditee_org_type as auditee14_152_, inspection0_.feedback_status as feedbac15_152_, inspection0_.inspection_date as inspect16_152_, inspection0_.inspection_evaluate_date as inspect17_152_, inspection0_.inspection_evaluate_status as inspect18_152_, inspection0_.inspection_report_id as inspect39_152_, inspection0_.inspection_report_status as inspect19_152_, inspection0_.is_show_leader as is_show20_152_, inspection0_.last_updated_date as last_up21_152_, inspection0_.last_updated_date_feedback_solution as last_up22_152_, inspection0_.last_updated_date_inspection_tracking as last_up23_152_, inspection0_.lat as lat24_152_, inspection0_.lng as lng25_152_, inspection0_.manager_user_id as manager26_152_, inspection0_.priority_suggestion_color as priorit27_152_, inspection0_.priority_suggestion_name as priorit28_152_, inspection0_.priority_suggestion_seq as priorit29_152_, inspection0_.send_email_replied_date as send_em30_152_, inspection0_.send_email_status as send_em31_152_, inspection0_.strategic_plan_id as strateg32_152_, inspection0_.strategic_plan_item_id as strateg33_152_, inspection0_.strategic_plan_item_total_effort as strateg34_152_, inspection0_.strategic_plan_name as strateg35_152_ from v_inspection_report inspection0_ cross join inspection_report inspection1_ cross join audit_plan_info_org auditplani2_ cross join audit_work auditwork3_ cross join audit_work auditwork6_ where inspection0_.inspection_report_id=inspection1_.id and inspection0_.audit_plan_info_org_id=auditplani2_.id and auditplani2_.id=auditwork3_.audit_plan_info_org_id and inspection1_.audit_work_id=auditwork6_.id and (inspection1_.feedback_status in (@P0 , @P1 , @P2 , @P3 , @P4 , @P5 , @P6 , @P7 , @P8)) and auditwork3_.is_show_leader=@P9 and (inspection0_.manager_user_id=168 or inspection0_.auditee_org_id in (select distinct auditeeorg4_.id from v_auditee_org_flat_tree auditeeorg4_ where auditeeorg4_.auditee_type=@P10 and (auditeeorg4_.parent_id in (51) or auditeeorg4_.id in (51)))) and auditwork6_.is_show_leader=@P11 order by inspection0_.last_updated_date desc, inspection0_.last_updated_date_feedback_solution desc offset 0 rows fetch next @P12 rows only",14441,93769,-79328,209001250,120,14441
"(@P0 nvarchar(4000),@P1 nvarchar(4000),@P2 nvarchar(4000),@P3 nvarchar(4000),@P4 nvarchar(4000),@P5 nvarchar(4000),@P6 nvarchar(4000),@P7 nvarchar(4000),@P8 nvarchar(4000),@P9 bit,@P10 nvarchar(4000),@P11 bit,@P12 int,@P13 int)select distinct inspection0_.id as id1_152_, inspection0_.annual_plan_detail_id as annual_36_152_, inspection0_.annual_plan_draft_id as annual_p2_152_, inspection0_.annual_plan_draft_name as annual_p3_152_, inspection0_.annual_plan_id as annual_p4_152_, inspection0_.audit_plan_info_org_id as audit_p37_152_, inspection0_.audit_procedure_code as audit_pr5_152_, inspection0_.audit_procedure_id as audit_pr6_152_, inspection0_.audit_procedure_name as audit_pr7_152_, inspection0_.audit_procedure_years as audit_pr8_152_, inspection0_.audit_task_status as audit_ta9_152_, inspection0_.audit_work_status as audit_w10_152_, inspection0_.audited_date_set_report as audited11_152_, inspection0_.auditee_org_id as auditee38_152_, inspection0_.auditee_org_name as auditee12_152_, inspection0_.auditee_org_postcode as auditee13_152_, inspection0_.auditee_org_type as auditee14_152_, inspection0_.feedback_status as feedbac15_152_, inspection0_.inspection_date as inspect16_152_, inspection0_.inspection_evaluate_date as inspect17_152_, inspection0_.inspection_evaluate_status as inspect18_152_, inspection0_.inspection_report_id as inspect39_152_, inspection0_.inspection_report_status as inspect19_152_, inspection0_.is_show_leader as is_show20_152_, inspection0_.last_updated_date as last_up21_152_, inspection0_.last_updated_date_feedback_solution as last_up22_152_, inspection0_.last_updated_date_inspection_tracking as last_up23_152_, inspection0_.lat as lat24_152_, inspection0_.lng as lng25_152_, inspection0_.manager_user_id as manager26_152_, inspection0_.priority_suggestion_color as priorit27_152_, inspection0_.priority_suggestion_name as priorit28_152_, inspection0_.priority_suggestion_seq as priorit29_152_, inspection0_.send_email_replied_date as send_em30_152_, inspection0_.send_email_status as send_em31_152_, inspection0_.strategic_plan_id as strateg32_152_, inspection0_.strategic_plan_item_id as strateg33_152_, inspection0_.strategic_plan_item_total_effort as strateg34_152_, inspection0_.strategic_plan_name as strateg35_152_ from v_inspection_report inspection0_ cross join inspection_report inspection1_ cross join audit_plan_info_org auditplani2_ cross join audit_work auditwork3_ cross join audit_work auditwork6_ where inspection0_.inspection_report_id=inspection1_.id and inspection0_.audit_plan_info_org_id=auditplani2_.id and auditplani2_.id=auditwork3_.audit_plan_info_org_id and inspection1_.audit_work_id=auditwork6_.id and (inspection1_.feedback_status in (@P0 , @P1 , @P2 , @P3 , @P4 , @P5 , @P6 , @P7 , @P8)) and auditwork3_.is_show_leader=@P9 and (inspection0_.manager_user_id=319 or inspection0_.auditee_org_id in (select distinct auditeeorg4_.id from v_auditee_org_flat_tree auditeeorg4_ where auditeeorg4_.auditee_type=@P10 and (auditeeorg4_.parent_id in (41) or auditeeorg4_.id in (41)))) and auditwork6_.is_show_leader=@P11 order by inspection0_.last_updated_date desc, inspection0_.last_updated_date_feedback_solution desc offset @P12 rows fetch next @P13 rows only",14409,96181,-81772,215792414,134,172919
"(@P0 nvarchar(4000),@P1 nvarchar(4000),@P2 nvarchar(4000),@P3 nvarchar(4000),@P4 nvarchar(4000),@P5 nvarchar(4000),@P6 nvarchar(4000),@P7 nvarchar(4000),@P8 nvarchar(4000),@P9 bit,@P10 nvarchar(4000),@P11 bit,@P12 int)select distinct inspection0_.id as id1_152_, inspection0_.annual_plan_detail_id as annual_36_152_, inspection0_.annual_plan_draft_id as annual_p2_152_, inspection0_.annual_plan_draft_name as annual_p3_152_, inspection0_.annual_plan_id as annual_p4_152_, inspection0_.audit_plan_info_org_id as audit_p37_152_, inspection0_.audit_procedure_code as audit_pr5_152_, inspection0_.audit_procedure_id as audit_pr6_152_, inspection0_.audit_procedure_name as audit_pr7_152_, inspection0_.audit_procedure_years as audit_pr8_152_, inspection0_.audit_task_status as audit_ta9_152_, inspection0_.audit_work_status as audit_w10_152_, inspection0_.audited_date_set_report as audited11_152_, inspection0_.auditee_org_id as auditee38_152_, inspection0_.auditee_org_name as auditee12_152_, inspection0_.auditee_org_postcode as auditee13_152_, inspection0_.auditee_org_type as auditee14_152_, inspection0_.feedback_status as feedbac15_152_, inspection0_.inspection_date as inspect16_152_, inspection0_.inspection_evaluate_date as inspect17_152_, inspection0_.inspection_evaluate_status as inspect18_152_, inspection0_.inspection_report_id as inspect39_152_, inspection0_.inspection_report_status as inspect19_152_, inspection0_.is_show_leader as is_show20_152_, inspection0_.last_updated_date as last_up21_152_, inspection0_.last_updated_date_feedback_solution as last_up22_152_, inspection0_.last_updated_date_inspection_tracking as last_up23_152_, inspection0_.lat as lat24_152_, inspection0_.lng as lng25_152_, inspection0_.manager_user_id as manager26_152_, inspection0_.priority_suggestion_color as priorit27_152_, inspection0_.priority_suggestion_name as priorit28_152_, inspection0_.priority_suggestion_seq as priorit29_152_, inspection0_.send_email_replied_date as send_em30_152_, inspection0_.send_email_status as send_em31_152_, inspection0_.strategic_plan_id as strateg32_152_, inspection0_.strategic_plan_item_id as strateg33_152_, inspection0_.strategic_plan_item_total_effort as strateg34_152_, inspection0_.strategic_plan_name as strateg35_152_ from v_inspection_report inspection0_ cross join inspection_report inspection1_ cross join audit_plan_info_org auditplani2_ cross join audit_work auditwork3_ cross join audit_work auditwork6_ where inspection0_.inspection_report_id=inspection1_.id and inspection0_.audit_plan_info_org_id=auditplani2_.id and auditplani2_.id=auditwork3_.audit_plan_info_org_id and inspection1_.audit_work_id=auditwork6_.id and (inspection1_.feedback_status in (@P0 , @P1 , @P2 , @P3 , @P4 , @P5 , @P6 , @P7 , @P8)) and auditwork3_.is_show_leader=@P9 and (inspection0_.manager_user_id=320 or inspection0_.auditee_org_id in (select distinct auditeeorg4_.id from v_auditee_org_flat_tree auditeeorg4_ where auditeeorg4_.auditee_type=@P10 and (auditeeorg4_.parent_id in (29) or auditeeorg4_.id in (29)))) and auditwork6_.is_show_leader=@P11 order by inspection0_.last_updated_date desc, inspection0_.last_updated_date_feedback_solution desc offset 0 rows fetch next @P12 rows only",14334,104635,-90301,210115467,129,14334
"(@P0 nvarchar(4000),@P1 nvarchar(4000),@P2 nvarchar(4000),@P3 nvarchar(4000),@P4 nvarchar(4000),@P5 nvarchar(4000),@P6 nvarchar(4000),@P7 nvarchar(4000),@P8 nvarchar(4000),@P9 bit,@P10 nvarchar(4000),@P11 bit,@P12 int)select distinct inspection0_.id as id1_152_, inspection0_.annual_plan_detail_id as annual_36_152_, inspection0_.annual_plan_draft_id as annual_p2_152_, inspection0_.annual_plan_draft_name as annual_p3_152_, inspection0_.annual_plan_id as annual_p4_152_, inspection0_.audit_plan_info_org_id as audit_p37_152_, inspection0_.audit_procedure_code as audit_pr5_152_, inspection0_.audit_procedure_id as audit_pr6_152_, inspection0_.audit_procedure_name as audit_pr7_152_, inspection0_.audit_procedure_years as audit_pr8_152_, inspection0_.audit_task_status as audit_ta9_152_, inspection0_.audit_work_status as audit_w10_152_, inspection0_.audited_date_set_report as audited11_152_, inspection0_.auditee_org_id as auditee38_152_, inspection0_.auditee_org_name as auditee12_152_, inspection0_.auditee_org_postcode as auditee13_152_, inspection0_.auditee_org_type as auditee14_152_, inspection0_.feedback_status as feedbac15_152_, inspection0_.inspection_date as inspect16_152_, inspection0_.inspection_evaluate_date as inspect17_152_, inspection0_.inspection_evaluate_status as inspect18_152_, inspection0_.inspection_report_id as inspect39_152_, inspection0_.inspection_report_status as inspect19_152_, inspection0_.is_show_leader as is_show20_152_, inspection0_.last_updated_date as last_up21_152_, inspection0_.last_updated_date_feedback_solution as last_up22_152_, inspection0_.last_updated_date_inspection_tracking as last_up23_152_, inspection0_.lat as lat24_152_, inspection0_.lng as lng25_152_, inspection0_.manager_user_id as manager26_152_, inspection0_.priority_suggestion_color as priorit27_152_, inspection0_.priority_suggestion_name as priorit28_152_, inspection0_.priority_suggestion_seq as priorit29_152_, inspection0_.send_email_replied_date as send_em30_152_, inspection0_.send_email_status as send_em31_152_, inspection0_.strategic_plan_id as strateg32_152_, inspection0_.strategic_plan_item_id as strateg33_152_, inspection0_.strategic_plan_item_total_effort as strateg34_152_, inspection0_.strategic_plan_name as strateg35_152_ from v_inspection_report inspection0_ cross join inspection_report inspection1_ cross join audit_plan_info_org auditplani2_ cross join audit_work auditwork3_ cross join audit_work auditwork6_ where inspection0_.inspection_report_id=inspection1_.id and inspection0_.audit_plan_info_org_id=auditplani2_.id and auditplani2_.id=auditwork3_.audit_plan_info_org_id and inspection1_.audit_work_id=auditwork6_.id and (inspection1_.feedback_status in (@P0 , @P1 , @P2 , @P3 , @P4 , @P5 , @P6 , @P7 , @P8)) and auditwork3_.is_show_leader=@P9 and (inspection0_.manager_user_id=175 or inspection0_.auditee_org_id in (select distinct auditeeorg4_.id from v_auditee_org_flat_tree auditeeorg4_ where auditeeorg4_.auditee_type=@P10 and (auditeeorg4_.parent_id in (39) or auditeeorg4_.id in (39)))) and auditwork6_.is_show_leader=@P11 order by inspection0_.last_updated_date desc, inspection0_.last_updated_date_feedback_solution desc offset 0 rows fetch next @P12 rows only",14019,92591,-78572,204545760,131,14019
"(@P0 bit,@P1 nvarchar(4000),@P2 nvarchar(4000),@P3 nvarchar(4000),@P4 bit,@P5 nvarchar(4000),@P6 nvarchar(4000),@P7 nvarchar(4000),@P8 nvarchar(4000),@P9 nvarchar(4000),@P10 nvarchar(4000),@P11 nvarchar(4000),@P12 int)select distinct inspection0_.audit_work_id as audit_wo1_154_, inspection0_.audit_procedure_years as audit_pr2_154_, inspection0_.auditee_org_id as auditee_3_154_, inspection0_.auditee_org_name as auditee_4_154_, inspection0_.auditee_org_postcode as auditee_5_154_, inspection0_.auditee_org_type as auditee_6_154_, inspection0_.auditee_org_type_id as auditee_7_154_, inspection0_.feedback_status as feedback8_154_, inspection0_.inspection_report_approved_date as inspecti9_154_, inspection0_.inspection_report_status as inspect10_154_, inspection0_.is_show_leader as is_show11_154_, inspection0_.lat as lat12_154_, inspection0_.lng as lng13_154_, inspection0_.office_auditee_org_id as office_14_154_, inspection0_.post_area_auditee_org_id as post_ar15_154_, inspection0_.priority_suggestion_color as priorit16_154_, inspection0_.priority_suggestion_name as priorit17_154_, inspection0_.priority_suggestion_name_freezed as priorit18_154_, inspection0_.priority_suggestion_seq as priorit19_154_, inspection0_.send_email_status as send_em20_154_, inspection0_.send_mail_replied_date as send_ma21_154_ from v_inspection_report_dashboard_slim inspection0_ inner join v_audit_work_auditor auditworka1_ on inspection0_.audit_work_id=auditworka1_.audit_work_id left outer join v_users_auditee_org_in_responsibility usersaudit2_ on inspection0_.audit_work_id=usersaudit2_.audit_work_id where inspection0_.is_show_leader=@P0 and inspection0_.inspection_report_status=@P1 and (inspection0_.inspection_report_status in (@P2)) and (inspection0_.inspection_report_status in (@P3)) and inspection0_.audit_procedure_years=2567 and inspection0_.send_email_status=@P4 and (inspection0_.priority_suggestion_seq is not null) and ((auditworka1_.position_name=@P5 or auditworka1_.position_name=@P6 or auditworka1_.position_name=@P7 or auditworka1_.position_name=@P8 or auditworka1_.position_name=@P9) and auditworka1_.user_id=1042 or inspection0_.auditee_org_id in (select distinct auditeeorg3_.id from v_auditee_org_flat_tree auditeeorg3_ where auditeeorg3_.auditee_type=@P10 and (auditeeorg3_.parent_id in (1597) or auditeeorg3_.id in (1597))) or usersaudit2_.user_id=1042 or inspection0_.auditee_org_id in (select distinct auditeeorg4_.id from v_auditee_org_flat_tree auditeeorg4_ where auditeeorg4_.auditee_type=@P11 and (auditeeorg4_.parent_id in (1076) or auditeeorg4_.id in (1076)))) order by inspection0_.priority_suggestion_seq asc offset 0 rows fetch next @P12 rows only",13876,3976,9900,294845,231,13876
"(@P0 nvarchar(4000),@P1 nvarchar(4000),@P2 nvarchar(4000),@P3 nvarchar(4000),@P4 nvarchar(4000),@P5 nvarchar(4000),@P6 nvarchar(4000),@P7 nvarchar(4000),@P8 nvarchar(4000),@P9 bit,@P10 nvarchar(4000),@P11 bit,@P12 int)select distinct inspection0_.id as id1_152_, inspection0_.annual_plan_detail_id as annual_36_152_, inspection0_.annual_plan_draft_id as annual_p2_152_, inspection0_.annual_plan_draft_name as annual_p3_152_, inspection0_.annual_plan_id as annual_p4_152_, inspection0_.audit_plan_info_org_id as audit_p37_152_, inspection0_.audit_procedure_code as audit_pr5_152_, inspection0_.audit_procedure_id as audit_pr6_152_, inspection0_.audit_procedure_name as audit_pr7_152_, inspection0_.audit_procedure_years as audit_pr8_152_, inspection0_.audit_task_status as audit_ta9_152_, inspection0_.audit_work_status as audit_w10_152_, inspection0_.audited_date_set_report as audited11_152_, inspection0_.auditee_org_id as auditee38_152_, inspection0_.auditee_org_name as auditee12_152_, inspection0_.auditee_org_postcode as auditee13_152_, inspection0_.auditee_org_type as auditee14_152_, inspection0_.feedback_status as feedbac15_152_, inspection0_.inspection_date as inspect16_152_, inspection0_.inspection_evaluate_date as inspect17_152_, inspection0_.inspection_evaluate_status as inspect18_152_, inspection0_.inspection_report_id as inspect39_152_, inspection0_.inspection_report_status as inspect19_152_, inspection0_.is_show_leader as is_show20_152_, inspection0_.last_updated_date as last_up21_152_, inspection0_.last_updated_date_feedback_solution as last_up22_152_, inspection0_.last_updated_date_inspection_tracking as last_up23_152_, inspection0_.lat as lat24_152_, inspection0_.lng as lng25_152_, inspection0_.manager_user_id as manager26_152_, inspection0_.priority_suggestion_color as priorit27_152_, inspection0_.priority_suggestion_name as priorit28_152_, inspection0_.priority_suggestion_seq as priorit29_152_, inspection0_.send_email_replied_date as send_em30_152_, inspection0_.send_email_status as send_em31_152_, inspection0_.strategic_plan_id as strateg32_152_, inspection0_.strategic_plan_item_id as strateg33_152_, inspection0_.strategic_plan_item_total_effort as strateg34_152_, inspection0_.strategic_plan_name as strateg35_152_ from v_inspection_report inspection0_ cross join inspection_report inspection1_ cross join audit_plan_info_org auditplani2_ cross join audit_work auditwork3_ cross join audit_work auditwork6_ where inspection0_.inspection_report_id=inspection1_.id and inspection0_.audit_plan_info_org_id=auditplani2_.id and auditplani2_.id=auditwork3_.audit_plan_info_org_id and inspection1_.audit_work_id=auditwork6_.id and (inspection1_.feedback_status in (@P0 , @P1 , @P2 , @P3 , @P4 , @P5 , @P6 , @P7 , @P8)) and auditwork3_.is_show_leader=@P9 and (inspection0_.manager_user_id=323 or inspection0_.auditee_org_id in (select distinct auditeeorg4_.id from v_auditee_org_flat_tree auditeeorg4_ where auditeeorg4_.auditee_type=@P10 and (auditeeorg4_.parent_id in (51) or auditeeorg4_.id in (51)))) and auditwork6_.is_show_leader=@P11 order by inspection0_.last_updated_date desc, inspection0_.last_updated_date_feedback_solution desc offset 0 rows fetch next @P12 rows only",13818,91923,-78105,199458611,133,138184
