"DELETE [VRO].[dbo].[RAW_DATA] where DATEDIFF(DAY, timestamp, GETDATE()) > 35",5377,5354,23,2608256,34809,5377
"SELECT     DB_NAME (database_id) as [Database Name],     name as [Database File Name],     [Type] = CASE WHEN Type_Desc = 'ROWS' THEN 'Data File(s)'             WHEN Type_Desc = 'LOG'  THEN 'Log File(s)'             ELSE Type_Desc END,     size*8/1024 as 'Size (MB)',     physical_name as [Database_File_Location] FROM sys.master_files ORDER BY 1,3  IF OBJECT_ID('tempdb.dbo.#space') IS NOT NULL     DROP TABLE #space  CREATE TABLE #space (       database_id INT PRIMARY KEY     , data_used_size DECIMAL(18,2)     , log_used_size DECIMAL(18,2) )  DECLARE @SQL NVARCHAR(MAX)  SELECT @SQL = STUFF((     SELECT '     USE [' + d.name + ']     INSERT INTO #space (database_id, data_used_size, log_used_size)     SELECT           DB_ID()         , SUM(CASE WHEN [type] = 0 THEN space_used END)         , SUM(CASE WHEN [type] = 1 THEN space_used END)     FROM (         SELECT s.[type], space_used = SUM(FILEPROPERTY(s.name, ''SpaceUsed'') * 8. / 1024)         FROM sys.database_files s         GROUP BY s.[type]     ) t;'     FROM sys.databases d     WHERE d.[state] = 0     FOR XML PATH(''), TYPE).value('.', 'NVARCHAR(MAX)'), 1, 2, '')  EXEC sys.sp_executesql @SQL  SELECT       d.database_id     , d.name     , d.state_desc     , d.recovery_model_desc     , t.total_size     , t.data_size     , s.data_used_size     , t.log_size     , s.log_used_size     , bu.full_last_date     , bu.full_size     , bu.log_last_date     , bu.log_size FROM (     SELECT           database_id         , log_size = CAST(SUM(CASE WHEN [type] = 1 THEN size END) * 8. / 1024 AS DECIMAL(18,2))         , data_size = CAST(SUM(CASE WHEN [type] = 0 THEN size END) * 8. / 1024 AS DECIMAL(18,2))         , total_size = CAST(SUM(size) * 8. / 1024 AS DECIMAL(18,2))     FROM sys.master_files     GROUP BY database_id ) t JOIN sys.databases d ON d.database_id = t.database_id LEFT JOIN #space s ON d.database_id = s.database_id LEFT JOIN (     SELECT           database_name         , full_last_date = MAX(CASE WHEN [type] = 'D' THEN backup_finish_date END)         , full_size = MAX(CASE WHEN [type] = 'D' THEN backup_size END)         , log_last_date = MAX(CASE WHEN [type] = 'L' THEN backup_finish_date END)         , log_size = MAX(CASE WHEN [type] = 'L' THEN backup_size END)     FROM (         SELECT               s.database_name             , s.[type]             , s.backup_finish_date             , backup_size =                         CAST(CASE WHEN s.backup_size = s.compressed_backup_size                                     THEN s.backup_size                                     ELSE s.compressed_backup_size                         END / 1048576.0 AS DECIMAL(18,2))             , RowNum = ROW_NUMBER() OVER (PARTITION BY s.database_name, s.[type] ORDER BY s.backup_finish_date DESC)         FROM msdb.dbo.backupset s         WHERE s.[type] IN ('D', 'L')     ) f     WHERE f.RowNum = 1     GROUP BY f.database_name ) bu ON d.name = bu.database_name ORDER BY t.total_size DESC  SELECT      req.session_id     , req.total_elapsed_time AS duration_ms     , req.cpu_time AS cpu_time_ms     , req.total_elapsed_time - req.cpu_time AS wait_time     , req.logical_reads     , SUBSTRING (REPLACE (REPLACE (SUBSTRING (ST.text, (req.statement_start_offset/2) + 1,         ((CASE statement_end_offset            WHEN -1            THEN DATALENGTH(ST.text)              ELSE req.statement_end_offset          END - req.statement_start_offset)/2) + 1) , CHAR(10), ' '), CHAR(13), ' '),        1, 512)  AS statement_text   FROM sys.dm_exec_requests AS req     CROSS APPLY sys.dm_exec_sql_text(req.sql_handle) AS ST ORDER BY total_elapsed_time DESC;  SELECT top 100 t.text,      (qs.total_elapsed_time/1000) / qs.execution_count AS avg_elapsed_time,      (qs.total_worker_time/1000) / qs.execution_count AS avg_cpu_time,      ((qs.total_elapsed_time/1000) / qs.execution_count ) - ((qs.total_worker_time/1000) / qs.execution_count) AS avg_wait_time,      qs.total_logical_reads / qs.execution_count AS avg_logical_reads,      qs.total_logical_writes / qs.execution_count AS avg_writes,      (qs.total_elapsed_time/1000) AS cumulative_elapsed_time_all_executions FROM sys.dm_exec_query_stats qs      CROSS apply sys.Dm_exec_sql_text (sql_handle) t -- WHERE t.text like '<Your Query>%' -- Replace <Your Query> with your query or the beginning part of your query. The special chars like '[','_','%','^' in the query should be escaped. ORDER BY (qs.total_elapsed_time / qs.execution_count) DESC  --Deadlock sql check SELECT     session_id,     start_time,      [status],     command,     blocking_session_id,     wait_type,     wait_time,     open_transaction_count,     transaction_id,     total_elapsed_time,     Definition = CAST(text AS VARCHAR(MAX)) FROM     SYS.DM_EXEC_REQUESTS     CROSS APPLY sys.dm_exec_sql_text(sql_handle)  WHERE blocking_session_id != 0  SELECT sqlserver_start_time, (committed_kb/1024) AS Total_Server_Memory_MB, (committed_target_kb/1024)  AS Target_Server_Memory_MB FROM sys.dm_os_sys_info; ",1764,1581,183,70616,11309,1764
"SELECT     DB_NAME (database_id) as [Database Name],     name as [Database File Name],     [Type] = CASE WHEN Type_Desc = 'ROWS' THEN 'Data File(s)'             WHEN Type_Desc = 'LOG'  THEN 'Log File(s)'             ELSE Type_Desc END,     size*8/1024 as 'Size (MB)',     physical_name as [Database_File_Location] FROM sys.master_files ORDER BY 1,3  IF OBJECT_ID('tempdb.dbo.#space') IS NOT NULL     DROP TABLE #space  CREATE TABLE #space (       database_id INT PRIMARY KEY     , data_used_size DECIMAL(18,2)     , log_used_size DECIMAL(18,2) )  DECLARE @SQL NVARCHAR(MAX)  SELECT @SQL = STUFF((     SELECT '     USE [' + d.name + ']     INSERT INTO #space (database_id, data_used_size, log_used_size)     SELECT           DB_ID()         , SUM(CASE WHEN [type] = 0 THEN space_used END)         , SUM(CASE WHEN [type] = 1 THEN space_used END)     FROM (         SELECT s.[type], space_used = SUM(FILEPROPERTY(s.name, ''SpaceUsed'') * 8. / 1024)         FROM sys.database_files s         GROUP BY s.[type]     ) t;'     FROM sys.databases d     WHERE d.[state] = 0     FOR XML PATH(''), TYPE).value('.', 'NVARCHAR(MAX)'), 1, 2, '')  EXEC sys.sp_executesql @SQL  SELECT       d.database_id     , d.name     , d.state_desc     , d.recovery_model_desc     , t.total_size     , t.data_size     , s.data_used_size     , t.log_size     , s.log_used_size     , bu.full_last_date     , bu.full_size     , bu.log_last_date     , bu.log_size FROM (     SELECT           database_id         , log_size = CAST(SUM(CASE WHEN [type] = 1 THEN size END) * 8. / 1024 AS DECIMAL(18,2))         , data_size = CAST(SUM(CASE WHEN [type] = 0 THEN size END) * 8. / 1024 AS DECIMAL(18,2))         , total_size = CAST(SUM(size) * 8. / 1024 AS DECIMAL(18,2))     FROM sys.master_files     GROUP BY database_id ) t JOIN sys.databases d ON d.database_id = t.database_id LEFT JOIN #space s ON d.database_id = s.database_id LEFT JOIN (     SELECT           database_name         , full_last_date = MAX(CASE WHEN [type] = 'D' THEN backup_finish_date END)         , full_size = MAX(CASE WHEN [type] = 'D' THEN backup_size END)         , log_last_date = MAX(CASE WHEN [type] = 'L' THEN backup_finish_date END)         , log_size = MAX(CASE WHEN [type] = 'L' THEN backup_size END)     FROM (         SELECT               s.database_name             , s.[type]             , s.backup_finish_date             , backup_size =                         CAST(CASE WHEN s.backup_size = s.compressed_backup_size                                     THEN s.backup_size                                     ELSE s.compressed_backup_size                         END / 1048576.0 AS DECIMAL(18,2))             , RowNum = ROW_NUMBER() OVER (PARTITION BY s.database_name, s.[type] ORDER BY s.backup_finish_date DESC)         FROM msdb.dbo.backupset s         WHERE s.[type] IN ('D', 'L')     ) f     WHERE f.RowNum = 1     GROUP BY f.database_name ) bu ON d.name = bu.database_name ORDER BY t.total_size DESC  SELECT      req.session_id     , req.total_elapsed_time AS duration_ms     , req.cpu_time AS cpu_time_ms     , req.total_elapsed_time - req.cpu_time AS wait_time     , req.logical_reads     , SUBSTRING (REPLACE (REPLACE (SUBSTRING (ST.text, (req.statement_start_offset/2) + 1,         ((CASE statement_end_offset            WHEN -1            THEN DATALENGTH(ST.text)              ELSE req.statement_end_offset          END - req.statement_start_offset)/2) + 1) , CHAR(10), ' '), CHAR(13), ' '),        1, 512)  AS statement_text   FROM sys.dm_exec_requests AS req     CROSS APPLY sys.dm_exec_sql_text(req.sql_handle) AS ST ORDER BY total_elapsed_time DESC;  SELECT top 100 t.text,      (qs.total_elapsed_time/1000) / qs.execution_count AS avg_elapsed_time,      (qs.total_worker_time/1000) / qs.execution_count AS avg_cpu_time,      ((qs.total_elapsed_time/1000) / qs.execution_count ) - ((qs.total_worker_time/1000) / qs.execution_count) AS avg_wait_time,      qs.total_logical_reads / qs.execution_count AS avg_logical_reads,      qs.total_logical_writes / qs.execution_count AS avg_writes,      (qs.total_elapsed_time/1000) AS cumulative_elapsed_time_all_executions FROM sys.dm_exec_query_stats qs      CROSS apply sys.Dm_exec_sql_text (sql_handle) t -- WHERE t.text like '<Your Query>%' -- Replace <Your Query> with your query or the beginning part of your query. The special chars like '[','_','%','^' in the query should be escaped. ORDER BY (qs.total_elapsed_time / qs.execution_count) DESC  --Deadlock sql check SELECT     session_id,     start_time,      [status],     command,     blocking_session_id,     wait_type,     wait_time,     open_transaction_count,     transaction_id,     total_elapsed_time,     Definition = CAST(text AS VARCHAR(MAX)) FROM     SYS.DM_EXEC_REQUESTS     CROSS APPLY sys.dm_exec_sql_text(sql_handle)  WHERE blocking_session_id != 0   ",1061,758,303,112709,18806,4247
"(@_msparam_0 nvarchar(4000))SELECT SCHEMA_NAME(udf.schema_id) AS [Schema], udf.name AS [Name], udf.object_id AS [ID], (case when 'FN' = udf.type then 1 when 'FS' = udf.type then 1 when 'IF' = udf.type then 3 when 'TF' = udf.type then 2 when 'FT' = udf.type then 2 else 0 end) AS [FunctionType], CASE WHEN udf.type IN ('FN','IF','TF') THEN 1 WHEN udf.type IN ('FS','FT') THEN 2 ELSE 1 END AS [ImplementationType], CAST(  case      when udf.is_ms_shipped = 1 then 1     when (         select              major_id          from              sys.extended_properties          where              major_id = udf.object_id and              minor_id = 0 and              class = 1 and              name = N'microsoft_database_tools_support')          is not null then 1     else 0 end                        AS bit) AS [IsSystemObject], CAST(CASE WHEN ISNULL(smudf.definition, ssmudf.definition) IS NULL THEN 1 ELSE 0 END AS bit) AS [IsEncrypted], CAST(ISNULL(OBJECTPROPERTYEX(udf.object_id, N'IsSchemaBound'),0) AS bit) AS [IsSchemaBound], usrt.name AS [DataType], ISNULL(baset.name, N'') AS [SystemType], CAST(CASE WHEN baset.name IN (N'nchar', N'nvarchar') AND ret_param.max_length <> -1 THEN ret_param.max_length/2 ELSE ret_param.max_length END AS int) AS [Length], CAST(ret_param.precision AS int) AS [NumericPrecision], CAST(ret_param.scale AS int) AS [NumericScale], ISNULL(xscret_param.name, N'') AS [XmlSchemaNamespace], ISNULL(s2ret_param.name, N'') AS [XmlSchemaNamespaceSchema], ISNULL( (case ret_param.is_xml_document when 1 then 2 else 1 end), 0) AS [XmlDocumentConstraint], s1ret_param.name AS [DataTypeSchema] FROM sys.all_objects AS udf LEFT OUTER JOIN sys.sql_modules AS smudf ON smudf.object_id = udf.object_id LEFT OUTER JOIN sys.system_sql_modules AS ssmudf ON ssmudf.object_id = udf.object_id LEFT OUTER JOIN sys.all_parameters AS ret_param ON ret_param.object_id = udf.object_id and ret_param.is_output = @_msparam_0 LEFT OUTER JOIN sys.types AS usrt ON usrt.user_type_id = ret_param.user_type_id LEFT OUTER JOIN sys.types AS baset ON (baset.user_type_id = ret_param.system_type_id and baset.user_type_id = baset.system_type_id) or ((baset.system_type_id = ret_param.system_type_id) and (baset.user_type_id = ret_param.user_type_id) and (baset.is_user_defined = 0) and (baset.is_assembly_type = 1))  LEFT OUTER JOIN sys.xml_schema_collections AS xscret_param ON xscret_param.xml_collection_id = ret_param.xml_collection_id LEFT OUTER JOIN sys.schemas AS s2ret_param ON s2ret_param.schema_id = xscret_param.schema_id LEFT OUTER JOIN sys.schemas AS s1ret_param ON s1ret_param.schema_id = usrt.schema_id WHERE (udf.type in ('TF', 'FN', 'IF', 'FS', 'FT')) ORDER BY [Schema] ASC,[Name] ASC",537,270,267,74122,0,537
" 	SELECT 	CASE 		WHEN name like  '%msdtcprx.dll%' THEN 'msdtcprx' 		WHEN name like  '%sqljdbc_xa.dll%' THEN 'sqljdbc_xa' 		ELSE NULL 	END AS LoadedModules, 	COUNT(1) AS ModuleCount         FROM sys.dm_os_loaded_modules WITH (NOLOCK)         WHERE name like  '%msdtcprx.dll%' 	OR name like  '%sqljdbc_xa.dll%'         GROUP BY 	CASE WHEN name like  '%msdtcprx.dll%' THEN 'msdtcprx' 		WHEN name like  '%sqljdbc_xa.dll%' THEN 'sqljdbc_xa' 		ELSE NULL 	END;     ",518,518,0,3,0,65351
"(@_msparam_0 nvarchar(4000),@_msparam_1 nvarchar(4000),@_msparam_2 nvarchar(4000))SELECT SCHEMA_NAME(sp.schema_id) AS [Schema], sp.name AS [Name], sp.object_id AS [ID], CAST(  case      when sp.is_ms_shipped = 1 then 1     when (         select              major_id          from              sys.extended_properties          where              major_id = sp.object_id and              minor_id = 0 and              class = 1 and              name = N'microsoft_database_tools_support')          is not null then 1     else 0 end                        AS bit) AS [IsSystemObject], CASE WHEN sp.type = N'P' THEN 1 WHEN sp.type = N'PC' THEN 2 ELSE 1 END AS [ImplementationType], CAST(CASE WHEN ISNULL(smsp.definition, ssmsp.definition) IS NULL THEN 1 ELSE 0 END AS bit) AS [IsEncrypted] FROM sys.all_objects AS sp LEFT OUTER JOIN sys.sql_modules AS smsp ON smsp.object_id = sp.object_id LEFT OUTER JOIN sys.system_sql_modules AS ssmsp ON ssmsp.object_id = sp.object_id WHERE (sp.type = @_msparam_0 OR sp.type = @_msparam_1 OR sp.type=@_msparam_2) ORDER BY [Schema] ASC,[Name] ASC",213,114,99,80479,0,853
"(@_msparam_0 nvarchar(4000),@_msparam_1 nvarchar(4000),@_msparam_2 nvarchar(4000))SELECT SCHEMA_NAME(sp.schema_id) AS [Schema], sp.name AS [Name], sp.object_id AS [ID], CAST(  case      when sp.is_ms_shipped = 1 then 1     when (         select              major_id          from              sys.extended_properties          where              major_id = sp.object_id and              minor_id = 0 and              class = 1 and              name = N'microsoft_database_tools_support')          is not null then 1     else 0 end                        AS bit) AS [IsSystemObject], CASE WHEN sp.type = N'P' THEN 1 WHEN sp.type = N'PC' THEN 2 ELSE 1 END AS [ImplementationType], CAST(CASE WHEN ISNULL(smsp.definition, ssmsp.definition) IS NULL THEN 1 ELSE 0 END AS bit) AS [IsEncrypted] FROM sys.all_objects AS sp LEFT OUTER JOIN sys.sql_modules AS smsp ON smsp.object_id = sp.object_id LEFT OUTER JOIN sys.system_sql_modules AS ssmsp ON ssmsp.object_id = sp.object_id WHERE (sp.type = @_msparam_0 OR sp.type = @_msparam_1 OR sp.type=@_msparam_2) ORDER BY [Schema] ASC,[Name] ASC",206,143,63,90798,0,827
"SELECT     DB_NAME (database_id) as [Database Name],     name as [Database File Name],     [Type] = CASE WHEN Type_Desc = 'ROWS' THEN 'Data File(s)'             WHEN Type_Desc = 'LOG'  THEN 'Log File(s)'             ELSE Type_Desc END,     size*8/1024 as 'Size (MB)',     physical_name as [Database_File_Location] FROM sys.master_files ORDER BY 1,3  IF OBJECT_ID('tempdb.dbo.#space') IS NOT NULL     DROP TABLE #space  CREATE TABLE #space (       database_id INT PRIMARY KEY     , data_used_size DECIMAL(18,2)     , log_used_size DECIMAL(18,2) )  DECLARE @SQL NVARCHAR(MAX)  SELECT @SQL = STUFF((     SELECT '     USE [' + d.name + ']     INSERT INTO #space (database_id, data_used_size, log_used_size)     SELECT           DB_ID()         , SUM(CASE WHEN [type] = 0 THEN space_used END)         , SUM(CASE WHEN [type] = 1 THEN space_used END)     FROM (         SELECT s.[type], space_used = SUM(FILEPROPERTY(s.name, ''SpaceUsed'') * 8. / 1024)         FROM sys.database_files s         GROUP BY s.[type]     ) t;'     FROM sys.databases d     WHERE d.[state] = 0     FOR XML PATH(''), TYPE).value('.', 'NVARCHAR(MAX)'), 1, 2, '')  EXEC sys.sp_executesql @SQL  SELECT       d.database_id     , d.name     , d.state_desc     , d.recovery_model_desc     , t.total_size     , t.data_size     , s.data_used_size     , t.log_size     , s.log_used_size     , bu.full_last_date     , bu.full_size     , bu.log_last_date     , bu.log_size FROM (     SELECT           database_id         , log_size = CAST(SUM(CASE WHEN [type] = 1 THEN size END) * 8. / 1024 AS DECIMAL(18,2))         , data_size = CAST(SUM(CASE WHEN [type] = 0 THEN size END) * 8. / 1024 AS DECIMAL(18,2))         , total_size = CAST(SUM(size) * 8. / 1024 AS DECIMAL(18,2))     FROM sys.master_files     GROUP BY database_id ) t JOIN sys.databases d ON d.database_id = t.database_id LEFT JOIN #space s ON d.database_id = s.database_id LEFT JOIN (     SELECT           database_name         , full_last_date = MAX(CASE WHEN [type] = 'D' THEN backup_finish_date END)         , full_size = MAX(CASE WHEN [type] = 'D' THEN backup_size END)         , log_last_date = MAX(CASE WHEN [type] = 'L' THEN backup_finish_date END)         , log_size = MAX(CASE WHEN [type] = 'L' THEN backup_size END)     FROM (         SELECT               s.database_name             , s.[type]             , s.backup_finish_date             , backup_size =                         CAST(CASE WHEN s.backup_size = s.compressed_backup_size                                     THEN s.backup_size                                     ELSE s.compressed_backup_size                         END / 1048576.0 AS DECIMAL(18,2))             , RowNum = ROW_NUMBER() OVER (PARTITION BY s.database_name, s.[type] ORDER BY s.backup_finish_date DESC)         FROM msdb.dbo.backupset s         WHERE s.[type] IN ('D', 'L')     ) f     WHERE f.RowNum = 1     GROUP BY f.database_name ) bu ON d.name = bu.database_name ORDER BY t.total_size DESC  SELECT      req.session_id     , req.total_elapsed_time AS duration_ms     , req.cpu_time AS cpu_time_ms     , req.total_elapsed_time - req.cpu_time AS wait_time     , req.logical_reads     , SUBSTRING (REPLACE (REPLACE (SUBSTRING (ST.text, (req.statement_start_offset/2) + 1,         ((CASE statement_end_offset            WHEN -1            THEN DATALENGTH(ST.text)              ELSE req.statement_end_offset          END - req.statement_start_offset)/2) + 1) , CHAR(10), ' '), CHAR(13), ' '),        1, 512)  AS statement_text   FROM sys.dm_exec_requests AS req     CROSS APPLY sys.dm_exec_sql_text(req.sql_handle) AS ST ORDER BY total_elapsed_time DESC;  SELECT top 100 t.text,      (qs.total_elapsed_time/1000) / qs.execution_count AS avg_elapsed_time,      (qs.total_worker_time/1000) / qs.execution_count AS avg_cpu_time,      ((qs.total_elapsed_time/1000) / qs.execution_count ) - ((qs.total_worker_time/1000) / qs.execution_count) AS avg_wait_time,      qs.total_logical_reads / qs.execution_count AS avg_logical_reads,      qs.total_logical_writes / qs.execution_count AS avg_writes,      (qs.total_elapsed_time/1000) AS cumulative_elapsed_time_all_executions FROM sys.dm_exec_query_stats qs      CROSS apply sys.Dm_exec_sql_text (sql_handle) t -- WHERE t.text like '<Your Query>%' -- Replace <Your Query> with your query or the beginning part of your query. The special chars like '[','_','%','^' in the query should be escaped. ORDER BY (qs.total_elapsed_time / qs.execution_count) DESC  --Deadlock sql check SELECT     session_id,     start_time,      [status],     command,     blocking_session_id,     wait_type,     wait_time,     open_transaction_count,     transaction_id,     total_elapsed_time,     Definition = CAST(text AS VARCHAR(MAX)) FROM     SYS.DM_EXEC_REQUESTS     CROSS APPLY sys.dm_exec_sql_text(sql_handle)  WHERE blocking_session_id != 0   ",175,175,0,3422,0,175
"SELECT     DB_NAME (database_id) as [Database Name],     name as [Database File Name],     [Type] = CASE WHEN Type_Desc = 'ROWS' THEN 'Data File(s)'             WHEN Type_Desc = 'LOG'  THEN 'Log File(s)'             ELSE Type_Desc END,     size*8/1024 as 'Size (MB)',     physical_name as [Database_File_Location] FROM sys.master_files ORDER BY 1,3  IF OBJECT_ID('tempdb.dbo.#space') IS NOT NULL     DROP TABLE #space  CREATE TABLE #space (       database_id INT PRIMARY KEY     , data_used_size DECIMAL(18,2)     , log_used_size DECIMAL(18,2) )  DECLARE @SQL NVARCHAR(MAX)  SELECT @SQL = STUFF((     SELECT '     USE [' + d.name + ']     INSERT INTO #space (database_id, data_used_size, log_used_size)     SELECT           DB_ID()         , SUM(CASE WHEN [type] = 0 THEN space_used END)         , SUM(CASE WHEN [type] = 1 THEN space_used END)     FROM (         SELECT s.[type], space_used = SUM(FILEPROPERTY(s.name, ''SpaceUsed'') * 8. / 1024)         FROM sys.database_files s         GROUP BY s.[type]     ) t;'     FROM sys.databases d     WHERE d.[state] = 0     FOR XML PATH(''), TYPE).value('.', 'NVARCHAR(MAX)'), 1, 2, '')  EXEC sys.sp_executesql @SQL  SELECT       d.database_id     , d.name     , d.state_desc     , d.recovery_model_desc     , t.total_size     , t.data_size     , s.data_used_size     , t.log_size     , s.log_used_size     , bu.full_last_date     , bu.full_size     , bu.log_last_date     , bu.log_size FROM (     SELECT           database_id         , log_size = CAST(SUM(CASE WHEN [type] = 1 THEN size END) * 8. / 1024 AS DECIMAL(18,2))         , data_size = CAST(SUM(CASE WHEN [type] = 0 THEN size END) * 8. / 1024 AS DECIMAL(18,2))         , total_size = CAST(SUM(size) * 8. / 1024 AS DECIMAL(18,2))     FROM sys.master_files     GROUP BY database_id ) t JOIN sys.databases d ON d.database_id = t.database_id LEFT JOIN #space s ON d.database_id = s.database_id LEFT JOIN (     SELECT           database_name         , full_last_date = MAX(CASE WHEN [type] = 'D' THEN backup_finish_date END)         , full_size = MAX(CASE WHEN [type] = 'D' THEN backup_size END)         , log_last_date = MAX(CASE WHEN [type] = 'L' THEN backup_finish_date END)         , log_size = MAX(CASE WHEN [type] = 'L' THEN backup_size END)     FROM (         SELECT               s.database_name             , s.[type]             , s.backup_finish_date             , backup_size =                         CAST(CASE WHEN s.backup_size = s.compressed_backup_size                                     THEN s.backup_size                                     ELSE s.compressed_backup_size                         END / 1048576.0 AS DECIMAL(18,2))             , RowNum = ROW_NUMBER() OVER (PARTITION BY s.database_name, s.[type] ORDER BY s.backup_finish_date DESC)         FROM msdb.dbo.backupset s         WHERE s.[type] IN ('D', 'L')     ) f     WHERE f.RowNum = 1     GROUP BY f.database_name ) bu ON d.name = bu.database_name ORDER BY t.total_size DESC  SELECT      req.session_id     , req.total_elapsed_time AS duration_ms     , req.cpu_time AS cpu_time_ms     , req.total_elapsed_time - req.cpu_time AS wait_time     , req.logical_reads     , SUBSTRING (REPLACE (REPLACE (SUBSTRING (ST.text, (req.statement_start_offset/2) + 1,         ((CASE statement_end_offset            WHEN -1            THEN DATALENGTH(ST.text)              ELSE req.statement_end_offset          END - req.statement_start_offset)/2) + 1) , CHAR(10), ' '), CHAR(13), ' '),        1, 512)  AS statement_text   FROM sys.dm_exec_requests AS req     CROSS APPLY sys.dm_exec_sql_text(req.sql_handle) AS ST ORDER BY total_elapsed_time DESC;  SELECT top 100 t.text,      (qs.total_elapsed_time/1000) / qs.execution_count AS avg_elapsed_time,      (qs.total_worker_time/1000) / qs.execution_count AS avg_cpu_time,      ((qs.total_elapsed_time/1000) / qs.execution_count ) - ((qs.total_worker_time/1000) / qs.execution_count) AS avg_wait_time,      qs.total_logical_reads / qs.execution_count AS avg_logical_reads,      qs.total_logical_writes / qs.execution_count AS avg_writes,      (qs.total_elapsed_time/1000) AS cumulative_elapsed_time_all_executions FROM sys.dm_exec_query_stats qs      CROSS apply sys.Dm_exec_sql_text (sql_handle) t -- WHERE t.text like '<Your Query>%' -- Replace <Your Query> with your query or the beginning part of your query. The special chars like '[','_','%','^' in the query should be escaped. ORDER BY (qs.total_elapsed_time / qs.execution_count) DESC  --Deadlock sql check SELECT     session_id,     start_time,      [status],     command,     blocking_session_id,     wait_type,     wait_time,     open_transaction_count,     transaction_id,     total_elapsed_time,     Definition = CAST(text AS VARCHAR(MAX)) FROM     SYS.DM_EXEC_REQUESTS     CROSS APPLY sys.dm_exec_sql_text(sql_handle)  WHERE blocking_session_id != 0  SELECT sqlserver_start_time, (committed_kb/1024) AS Total_Server_Memory_MB, (committed_target_kb/1024)  AS Target_Server_Memory_MB FROM sys.dm_os_sys_info; ",150,150,0,3584,0,150
"SELECT [server_id] as 'serverID'                                 ,[item_id] as 'logID'                                 ,[outlet_id] as 'outletID'                                 ,isnull([scan_cntry_postcode], '10001') as 'outletCode'                                 ,[wkstn_no] as 'wkstnNo'                                 ,[wckt_id] as 'wcktID'                                 ,[user_id] as 'userName'                                 ,case when [status_code] = 3 then 1 else [status_code] end as 'tndStatusID'                                 ,[document_number] as 'trnstnNbr'                                 ,convert(varchar, [status_dtm], 121) as 'createDate'                                 ,[item_barcode] as 'mailingNo' 	                            ,SUBSTRING([item_barcode], 1, 2) as 'prefix' 	                            ,SUBSTRING([item_barcode], 12, 2) as 'suffix'                                 ,[item_gross_weight] as 'weight'                                 ,[addressee_postcode] as 'mailPostCode'                                 ,[addressee_cntry_cd] as 'mailcountryCode'                                 ,[remark]                                 ,[sender_name] as 'senderName'                                 ,[sender_tel] as 'senderTelphone'                                 ,[addressee_name] as 'addressName'                                 ,[addressee_tel] as 'addressTelephone'                                 ,[addressee_postcode] as 'addressPostCode'                                 ,[delivery_status_id] as 'dStatusID'                                 ,[delivery_relation_id] as 'dRelationID'                                 ,[delivery_recipient_name] as 'recipientName'                                                               ,[signatureUrl] as 'signatureUrl'                                 ,[podUrl] as 'podImgUrl'                                 ,[lat]                                 ,[long] as 'lng'                                 ,convert(varchar, [transmit_dtm], 121) as 'createLogDate'                                 , null as 'serviceType'                                 , null as 'gServiceType'                                 ,[item_price] as 'price'                                 ,[delivery_code] as 'deliveryCode'                                 ,null as 'countryID'                                 ,[outlet_port] as 'outletPort'                                 ,[dest_outlet_port] as 'destOutletPort'                                 ,[dest_outlet_id] as 'destOutletID'                                 ,[member_id] as 'memberID'                               FROM [VRO].[dbo].[RAW_DATA]                                WHERE state = 1 ",149,1036,-887,267603,0,597
"SELECT     DB_NAME (database_id) as [Database Name],     name as [Database File Name],     [Type] = CASE WHEN Type_Desc = 'ROWS' THEN 'Data File(s)'             WHEN Type_Desc = 'LOG'  THEN 'Log File(s)'             ELSE Type_Desc END,     size*8/1024 as 'Size (MB)',     physical_name as [Database_File_Location] FROM sys.master_files ORDER BY 1,3  IF OBJECT_ID('tempdb.dbo.#space') IS NOT NULL     DROP TABLE #space  CREATE TABLE #space (       database_id INT PRIMARY KEY     , data_used_size DECIMAL(18,2)     , log_used_size DECIMAL(18,2) )  DECLARE @SQL NVARCHAR(MAX)  SELECT @SQL = STUFF((     SELECT '     USE [' + d.name + ']     INSERT INTO #space (database_id, data_used_size, log_used_size)     SELECT           DB_ID()         , SUM(CASE WHEN [type] = 0 THEN space_used END)         , SUM(CASE WHEN [type] = 1 THEN space_used END)     FROM (         SELECT s.[type], space_used = SUM(FILEPROPERTY(s.name, ''SpaceUsed'') * 8. / 1024)         FROM sys.database_files s         GROUP BY s.[type]     ) t;'     FROM sys.databases d     WHERE d.[state] = 0     FOR XML PATH(''), TYPE).value('.', 'NVARCHAR(MAX)'), 1, 2, '')  EXEC sys.sp_executesql @SQL  SELECT       d.database_id     , d.name     , d.state_desc     , d.recovery_model_desc     , t.total_size     , t.data_size     , s.data_used_size     , t.log_size     , s.log_used_size     , bu.full_last_date     , bu.full_size     , bu.log_last_date     , bu.log_size FROM (     SELECT           database_id         , log_size = CAST(SUM(CASE WHEN [type] = 1 THEN size END) * 8. / 1024 AS DECIMAL(18,2))         , data_size = CAST(SUM(CASE WHEN [type] = 0 THEN size END) * 8. / 1024 AS DECIMAL(18,2))         , total_size = CAST(SUM(size) * 8. / 1024 AS DECIMAL(18,2))     FROM sys.master_files     GROUP BY database_id ) t JOIN sys.databases d ON d.database_id = t.database_id LEFT JOIN #space s ON d.database_id = s.database_id LEFT JOIN (     SELECT           database_name         , full_last_date = MAX(CASE WHEN [type] = 'D' THEN backup_finish_date END)         , full_size = MAX(CASE WHEN [type] = 'D' THEN backup_size END)         , log_last_date = MAX(CASE WHEN [type] = 'L' THEN backup_finish_date END)         , log_size = MAX(CASE WHEN [type] = 'L' THEN backup_size END)     FROM (         SELECT               s.database_name             , s.[type]             , s.backup_finish_date             , backup_size =                         CAST(CASE WHEN s.backup_size = s.compressed_backup_size                                     THEN s.backup_size                                     ELSE s.compressed_backup_size                         END / 1048576.0 AS DECIMAL(18,2))             , RowNum = ROW_NUMBER() OVER (PARTITION BY s.database_name, s.[type] ORDER BY s.backup_finish_date DESC)         FROM msdb.dbo.backupset s         WHERE s.[type] IN ('D', 'L')     ) f     WHERE f.RowNum = 1     GROUP BY f.database_name ) bu ON d.name = bu.database_name ORDER BY t.total_size DESC  SELECT      req.session_id     , req.total_elapsed_time AS duration_ms     , req.cpu_time AS cpu_time_ms     , req.total_elapsed_time - req.cpu_time AS wait_time     , req.logical_reads     , SUBSTRING (REPLACE (REPLACE (SUBSTRING (ST.text, (req.statement_start_offset/2) + 1,         ((CASE statement_end_offset            WHEN -1            THEN DATALENGTH(ST.text)              ELSE req.statement_end_offset          END - req.statement_start_offset)/2) + 1) , CHAR(10), ' '), CHAR(13), ' '),        1, 512)  AS statement_text   FROM sys.dm_exec_requests AS req     CROSS APPLY sys.dm_exec_sql_text(req.sql_handle) AS ST ORDER BY total_elapsed_time DESC;  SELECT top 100 t.text,      (qs.total_elapsed_time/1000) / qs.execution_count AS avg_elapsed_time,      (qs.total_worker_time/1000) / qs.execution_count AS avg_cpu_time,      ((qs.total_elapsed_time/1000) / qs.execution_count ) - ((qs.total_worker_time/1000) / qs.execution_count) AS avg_wait_time,      qs.total_logical_reads / qs.execution_count AS avg_logical_reads,      qs.total_logical_writes / qs.execution_count AS avg_writes,      (qs.total_elapsed_time/1000) AS cumulative_elapsed_time_all_executions FROM sys.dm_exec_query_stats qs      CROSS apply sys.Dm_exec_sql_text (sql_handle) t -- WHERE t.text like '<Your Query>%' -- Replace <Your Query> with your query or the beginning part of your query. The special chars like '[','_','%','^' in the query should be escaped. ORDER BY (qs.total_elapsed_time / qs.execution_count) DESC  --Deadlock sql check SELECT     session_id,     start_time,      [status],     command,     blocking_session_id,     wait_type,     wait_time,     open_transaction_count,     transaction_id,     total_elapsed_time,     Definition = CAST(text AS VARCHAR(MAX)) FROM     SYS.DM_EXEC_REQUESTS     CROSS APPLY sys.dm_exec_sql_text(sql_handle)  WHERE blocking_session_id != 0  SELECT sqlserver_start_time, (committed_kb/1024) AS Total_Server_Memory_MB, (committed_target_kb/1024)  AS Target_Server_Memory_MB FROM sys.dm_os_sys_info;",130,130,0,3656,0,130
SELECT target_data 									FROM sys.dm_xe_session_targets xet WITH(nolock) 									JOIN sys.dm_xe_sessions xes WITH(nolock) 									ON xes.address = xet.event_session_address 									WHERE xes.name = 'telemetry_xevents' 									AND xet.target_name = 'ring_buffer',127,119,8,0,0,8822689
"(@_msparam_0 nvarchar(4000))SELECT SCHEMA_NAME(v.schema_id) AS [Schema], v.name AS [Name], v.object_id AS [ID] FROM sys.all_views AS v WHERE (v.type = @_msparam_0) ORDER BY [Schema] ASC,[Name] ASC",105,58,47,22923,0,422
"(@_msparam_0 nvarchar(4000))SELECT SCHEMA_NAME(udf.schema_id) AS [Schema], udf.name AS [Name], udf.object_id AS [ID], (case when 'FN' = udf.type then 1 when 'FS' = udf.type then 1 when 'IF' = udf.type then 3 when 'TF' = udf.type then 2 when 'FT' = udf.type then 2 else 0 end) AS [FunctionType], CASE WHEN udf.type IN ('FN','IF','TF') THEN 1 WHEN udf.type IN ('FS','FT') THEN 2 ELSE 1 END AS [ImplementationType], CAST(  case      when udf.is_ms_shipped = 1 then 1     when (         select              major_id          from              sys.extended_properties          where              major_id = udf.object_id and              minor_id = 0 and              class = 1 and              name = N'microsoft_database_tools_support')          is not null then 1     else 0 end                        AS bit) AS [IsSystemObject], CAST(CASE WHEN ISNULL(smudf.definition, ssmudf.definition) IS NULL THEN 1 ELSE 0 END AS bit) AS [IsEncrypted], CAST(ISNULL(OBJECTPROPERTYEX(udf.object_id, N'IsSchemaBound'),0) AS bit) AS [IsSchemaBound], usrt.name AS [DataType], ISNULL(baset.name, N'') AS [SystemType], CAST(CASE WHEN baset.name IN (N'nchar', N'nvarchar') AND ret_param.max_length <> -1 THEN ret_param.max_length/2 ELSE ret_param.max_length END AS int) AS [Length], CAST(ret_param.precision AS int) AS [NumericPrecision], CAST(ret_param.scale AS int) AS [NumericScale], ISNULL(xscret_param.name, N'') AS [XmlSchemaNamespace], ISNULL(s2ret_param.name, N'') AS [XmlSchemaNamespaceSchema], ISNULL( (case ret_param.is_xml_document when 1 then 2 else 1 end), 0) AS [XmlDocumentConstraint], s1ret_param.name AS [DataTypeSchema] FROM sys.all_objects AS udf LEFT OUTER JOIN sys.sql_modules AS smudf ON smudf.object_id = udf.object_id LEFT OUTER JOIN sys.system_sql_modules AS ssmudf ON ssmudf.object_id = udf.object_id LEFT OUTER JOIN sys.all_parameters AS ret_param ON ret_param.object_id = udf.object_id and ret_param.is_output = @_msparam_0 LEFT OUTER JOIN sys.types AS usrt ON usrt.user_type_id = ret_param.user_type_id LEFT OUTER JOIN sys.types AS baset ON (baset.user_type_id = ret_param.system_type_id and baset.user_type_id = baset.system_type_id) or ((baset.system_type_id = ret_param.system_type_id) and (baset.user_type_id = ret_param.user_type_id) and (baset.is_user_defined = 0) and (baset.is_assembly_type = 1))  LEFT OUTER JOIN sys.xml_schema_collections AS xscret_param ON xscret_param.xml_collection_id = ret_param.xml_collection_id LEFT OUTER JOIN sys.schemas AS s2ret_param ON s2ret_param.schema_id = xscret_param.schema_id LEFT OUTER JOIN sys.schemas AS s1ret_param ON s1ret_param.schema_id = usrt.schema_id WHERE (udf.type in ('TF', 'FN', 'IF', 'FS', 'FT')) ORDER BY [Schema] ASC,[Name] ASC",82,66,16,11588,5,328
"         DECLARE @msticks bigint, @mstickstime datetime, @LastHour datetime                 SELECT @mstickstime = GETDATE(), @msticks = ms_ticks from sys.dm_os_sys_info                 SELECT @LastHour = DATEADD(HOUR, -1, @mstickstime);                  WITH Quartiles AS (                 SELECT DISTINCT                     CONVERT(VARCHAR(10), CAST(DATEADD (ms, -1 * (@msticks - [timestamp]),@mstickstime) AS DATE), 112) EventDate,                        CONVERT(VARCHAR(30), TIMEFROMPARTS(DATEPART(HOUR, DATEADD (ms, -1 * (@msticks - [timestamp]),@mstickstime)), 00,00,00,00), 114) AS [EventTime],                        PERCENTILE_DISC(0.5) WITHIN GROUP (ORDER BY record.value('(Record/SchedulerMonitorEvent/SystemHealth/ProcessUtilization)[1]', 'int')                            )                            OVER (PARTITION BY CONVERT(VARCHAR(10), CAST(DATEADD (ms, -1 * (@msticks - [timestamp]),@mstickstime) AS DATE), 112),                                   CONVERT(VARCHAR(30), TIMEFROMPARTS(DATEPART(HOUR, DATEADD (ms, -1 * (@msticks - [timestamp]),@mstickstime)), 00,00,00,00), 114)                            ) AS MedianSQLCPU                            ,                        PERCENTILE_CONT(0.75) WITHIN GROUP (ORDER BY record.value('(Record/SchedulerMonitorEvent/SystemHealth/ProcessUtilization)[1]', 'int')                            )                            OVER (PARTITION BY CONVERT(VARCHAR(10), CAST(DATEADD (ms, -1 * (@msticks - [timestamp]),@mstickstime) AS DATE), 112),                                   CONVERT(VARCHAR(30), TIMEFROMPARTS(DATEPART(HOUR, DATEADD (ms, -1 * (@msticks - [timestamp]),@mstickstime)), 00,00,00,00), 114)                            ) AS Q3SQLCPU                      ,                        PERCENTILE_CONT(0.25) WITHIN GROUP (ORDER BY record.value('(Record/SchedulerMonitorEvent/SystemHealth/ProcessUtilization)[1]', 'int')                            )                            OVER (PARTITION BY CONVERT(VARCHAR(10), CAST(DATEADD (ms, -1 * (@msticks - [timestamp]),@mstickstime) AS DATE), 112),                                   CONVERT(VARCHAR(30), TIMEFROMPARTS(DATEPART(HOUR, DATEADD (ms, -1 * (@msticks - [timestamp]),@mstickstime)), 00,00,00,00), 114)                            ) AS Q1SQLCPU                   FROM (                     SELECT timestamp, CONVERT (xml, record) AS 'record'                     FROM sys.dm_os_ring_buffers                     WHERE ring_buffer_type = 'RING_BUFFER_SCHEDULER_MONITOR'                       AND record LIKE '%<SystemHealth>%'                             ) AS t                      WHERE DATEPART(HOUR, DATEADD (ms, -1 * (@msticks - [timestamp]),@mstickstime)) = DATEPART(HOUR, @LastHour)                      AND CAST(DATEADD (ms, -1 * (@msticks - [timestamp]),@mstickstime) AS DATE) = CAST(@LastHour AS DATE)               ),               SimpleStats AS (                 SELECT                     CONVERT(VARCHAR(10), CAST(DATEADD (ms, -1 * (@msticks - [timestamp]),@mstickstime) AS DATE), 112) EventDate,                        CONVERT(VARCHAR(30), TIMEFROMPARTS(DATEPART(HOUR, DATEADD (ms, -1 * (@msticks - [timestamp]),@mstickstime)), 00,00,00,00), 114) AS [EventTime],                     MAX(record.value('(Record/SchedulerMonitorEvent/SystemHealth/ProcessUtilization)[1]', 'int')) AS [MaxSQLCPU],                        MIN(record.value('(Record/SchedulerMonitorEvent/SystemHealth/ProcessUtilization)[1]', 'int')) AS [MinSQLCPU],                        AVG(record.value('(Record/SchedulerMonitorEvent/SystemHealth/ProcessUtilization)[1]', 'int')) AS [AvgSQLCPU]                   FROM (                     SELECT timestamp, CONVERT (xml, record) AS 'record'                     FROM sys.dm_os_ring_buffers                     WHERE ring_buffer_type = 'RING_BUFFER_SCHEDULER_MONITOR'                       AND record LIKE '%<SystemHealth>%'                             ) AS t               WHERE DATEPART(HOUR, DATEADD (ms, -1 * (@msticks - [timestamp]),@mstickstime)) = DATEPART(HOUR, @LastHour)                      AND CAST(DATEADD (ms, -1 * (@msticks - [timestamp]),@mstickstime) AS DATE) = CAST(@LastHour AS DATE)               GROUP BY                      CONVERT(VARCHAR(10), CAST(DATEADD (ms, -1 * (@msticks - [timestamp]),@mstickstime) AS DATE), 112) ,                      CONVERT(VARCHAR(30), TIMEFROMPARTS(DATEPART(HOUR, DATEADD (ms, -1 * (@msticks - [timestamp]),@mstickstime)), 00,00,00,00), 114)               )               SELECT                      ss.EventDate AS EventDate,                      ss.EventTime AS EventTime,                      ss.MaxSQLCPU,                      ss.MinSQLCPU,                      ss.AvgSQLCPU,                      q.MedianSQLCPU,                      q.Q1SQLCPU,                      q.Q3SQLCPU               FROM SimpleStats ss                      INNER JOIN Quartiles q                            ON q.EventDate = ss.EventDate                            AND q.EventTime = ss.EventTime      ",39,39,0,781,0,210508
"(@_msparam_0 nvarchar(4000),@_msparam_1 nvarchar(4000),@_msparam_2 nvarchar(4000))SELECT udf.name AS [Name], udf.object_id AS [ID], udf.create_date AS [CreateDate], udf.modify_date AS [DateLastModified], ISNULL(sudf.name, N'') AS [Owner], CAST(case when udf.principal_id is null then 1 else 0 end AS bit) AS [IsSchemaOwned], SCHEMA_NAME(udf.schema_id) AS [Schema], CAST(  case      when udf.is_ms_shipped = 1 then 1     when (         select              major_id          from              sys.extended_properties          where              major_id = udf.object_id and              minor_id = 0 and              class = 1 and              name = N'microsoft_database_tools_support')          is not null then 1     else 0 end                        AS bit) AS [IsSystemObject], usrt.name AS [DataType], s1ret_param.name AS [DataTypeSchema], ISNULL(baset.name, N'') AS [SystemType], CAST(CASE WHEN baset.name IN (N'nchar', N'nvarchar') AND ret_param.max_length <> -1 THEN ret_param.max_length/2 ELSE ret_param.max_length END AS int) AS [Length], CAST(ret_param.precision AS int) AS [NumericPrecision], CAST(ret_param.scale AS int) AS [NumericScale], ISNULL(xscret_param.name, N'') AS [XmlSchemaNamespace], ISNULL(s2ret_param.name, N'') AS [XmlSchemaNamespaceSchema], ISNULL( (case ret_param.is_xml_document when 1 then 2 else 1 end), 0) AS [XmlDocumentConstraint], CASE WHEN usrt.is_table_type = 1 THEN N'structured' ELSE N'' END AS [UserType], CAST(ISNULL(OBJECTPROPERTYEX(udf.object_id,N'ExecIsAnsiNullsOn'),0) AS bit) AS [AnsiNullsStatus], CAST(ISNULL(OBJECTPROPERTYEX(udf.object_id, N'IsSchemaBound'),0) AS bit) AS [IsSchemaBound], CAST(CASE WHEN ISNULL(smudf.definition, ssmudf.definition) IS NULL THEN 1 ELSE 0 END AS bit) AS [IsEncrypted], case when amudf.object_id is null then N'' else asmbludf.name end AS [AssemblyName], case when amudf.object_id is null then N'' else amudf.assembly_class end AS [ClassName], case when amudf.object_id is null then N'' else amudf.assembly_method end AS [MethodName], CAST(case when amudf.object_id is null then CAST(smudf.null_on_null_input AS bit) else amudf.null_on_null_input end AS bit) AS [ReturnsNullOnNullInput], case when amudf.object_id is null then case isnull(smudf.execute_as_principal_id, -1) when -1 then 1 when -2 then 2 else 3 end else case isnull(amudf.execute_as_principal_id, -1) when -1 then 1 when -2 then 2 else 3 end end AS [ExecutionContext], case when amudf.object_id is null then ISNULL(user_name(smudf.execute_as_principal_id),N'') else ISNULL(user_name(amudf.execute_as_principal_id), N'') end AS [ExecutionContextPrincipal], CAST(OBJECTPROPERTYEX(udf.object_id, N'IsDeterministic') AS bit) AS [IsDeterministic], (case when 'FN' = udf.type then 1 when 'FS' = udf.type then 1 when 'IF' = udf.type then 3 when 'TF' = udf.type then 2 when 'FT' = udf.type then 2 else 0 end) AS [FunctionType], CASE WHEN udf.type IN ('FN','IF','TF') THEN 1 WHEN udf.type IN ('FS','FT') THEN 2 ELSE 1 END AS [ImplementationType], CAST(ISNULL(OBJECTPROPERTYEX(udf.object_id,N'ExecIsQuotedIdentOn'),0) AS bit) AS [QuotedIdentifierStatus], ret_param.name AS [TableVariableName], ISNULL(sm.uses_native_compilation,0) AS [IsNativelyCompiled], CAST(ISNULL(sm.inline_type,0) AS bit) AS [InlineType], CAST(ISNULL(sm.is_inlineable,0) AS bit) AS [IsInlineable], ISNULL(smudf.definition, ssmudf.definition) AS [Definition] FROM sys.all_objects AS udf LEFT OUTER JOIN sys.database_principals AS sudf ON sudf.principal_id = ISNULL(udf.principal_id, (OBJECTPROPERTY(udf.object_id, 'OwnerId'))) LEFT OUTER JOIN sys.all_parameters AS ret_param ON ret_param.object_id = udf.object_id and ret_param.is_output = @_msparam_0 LEFT OUTER JOIN sys.types AS usrt ON usrt.user_type_id = ret_param.user_type_id LEFT OUTER JOIN sys.schemas AS s1ret_param ON s1ret_param.schema_id = usrt.schema_id LEFT OUTER JOIN sys.types AS baset ON (baset.user_type_id = ret_param.system_type_id and baset.user_type_id = baset.system_type_id) or ((baset.system_type_id = ret_param.system_type_id) and (baset.user_type_id = ret_param.user_type_id) and (baset.is_user_defined = 0) and (baset.is_assembly_type = 1))  LEFT OUTER JOIN sys.xml_schema_collections AS xscret_param ON xscret_param.xml_collection_id = ret_param.xml_collection_id LEFT OUTER JOIN sys.schemas AS s2ret_param ON s2ret_param.schema_id = xscret_param.schema_id LEFT OUTER JOIN sys.sql_modules AS smudf ON smudf.object_id = udf.object_id LEFT OUTER JOIN sys.system_sql_modules AS ssmudf ON ssmudf.object_id = udf.object_id LEFT OUTER JOIN sys.assembly_modules AS amudf ON amudf.object_id = udf.object_id LEFT OUTER JOIN sys.assemblies AS asmbludf ON asmbludf.assembly_id = amudf.assembly_id LEFT OUTER JOIN sys.all_sql_modules AS sm ON sm.object_id = udf.object_id WHERE (udf.type in ('TF', 'FN', 'IF', 'FS', 'FT'))and(udf.name=@_msparam_1 and SCHEMA_NAME(udf.schema_id)=@_msparam_2)",36,36,0,110,0,36
"(@_msparam_0 nvarchar(4000))SELECT SCHEMA_NAME(udf.schema_id) AS [Schema], udf.name AS [Name], udf.object_id AS [ID], (case when 'FN' = udf.type then 1 when 'FS' = udf.type then 1 when 'IF' = udf.type then 3 when 'TF' = udf.type then 2 when 'FT' = udf.type then 2 else 0 end) AS [FunctionType], CASE WHEN udf.type IN ('FN','IF','TF') THEN 1 WHEN udf.type IN ('FS','FT') THEN 2 ELSE 1 END AS [ImplementationType], CAST(  case      when udf.is_ms_shipped = 1 then 1     when (         select              major_id          from              sys.extended_properties          where              major_id = udf.object_id and              minor_id = 0 and              class = 1 and              name = N'microsoft_database_tools_support')          is not null then 1     else 0 end                        AS bit) AS [IsSystemObject], CAST(CASE WHEN ISNULL(smudf.definition, ssmudf.definition) IS NULL THEN 1 ELSE 0 END AS bit) AS [IsEncrypted], CAST(ISNULL(OBJECTPROPERTYEX(udf.object_id, N'IsSchemaBound'),0) AS bit) AS [IsSchemaBound], usrt.name AS [DataType], ISNULL(baset.name, N'') AS [SystemType], CAST(CASE WHEN baset.name IN (N'nchar', N'nvarchar') AND ret_param.max_length <> -1 THEN ret_param.max_length/2 ELSE ret_param.max_length END AS int) AS [Length], CAST(ret_param.precision AS int) AS [NumericPrecision], CAST(ret_param.scale AS int) AS [NumericScale], ISNULL(xscret_param.name, N'') AS [XmlSchemaNamespace], ISNULL(s2ret_param.name, N'') AS [XmlSchemaNamespaceSchema], ISNULL( (case ret_param.is_xml_document when 1 then 2 else 1 end), 0) AS [XmlDocumentConstraint], s1ret_param.name AS [DataTypeSchema] FROM sys.all_objects AS udf LEFT OUTER JOIN sys.sql_modules AS smudf ON smudf.object_id = udf.object_id LEFT OUTER JOIN sys.system_sql_modules AS ssmudf ON ssmudf.object_id = udf.object_id LEFT OUTER JOIN sys.all_parameters AS ret_param ON ret_param.object_id = udf.object_id and ret_param.is_output = @_msparam_0 LEFT OUTER JOIN sys.types AS usrt ON usrt.user_type_id = ret_param.user_type_id LEFT OUTER JOIN sys.types AS baset ON (baset.user_type_id = ret_param.system_type_id and baset.user_type_id = baset.system_type_id) or ((baset.system_type_id = ret_param.system_type_id) and (baset.user_type_id = ret_param.user_type_id) and (baset.is_user_defined = 0) and (baset.is_assembly_type = 1))  LEFT OUTER JOIN sys.xml_schema_collections AS xscret_param ON xscret_param.xml_collection_id = ret_param.xml_collection_id LEFT OUTER JOIN sys.schemas AS s2ret_param ON s2ret_param.schema_id = xscret_param.schema_id LEFT OUTER JOIN sys.schemas AS s1ret_param ON s1ret_param.schema_id = usrt.schema_id WHERE (udf.type in ('TF', 'FN', 'IF', 'FS', 'FT')) ORDER BY [Schema] ASC,[Name] ASC",32,31,1,2312,0,32
"       SELECT       db_id() AS database_id,       c.system_type_id,       c.user_type_id,       c.is_sparse,       c.is_column_set,       c.is_filestream,       c.encryption_type,       CASE WHEN o.object_id IS NOT NULL THEN 1 ELSE 0 END AS is_user,       COUNT_BIG(*) AS [ColCount],       CASE WHEN c.collation_name IS NULL THEN CONVERT(VARCHAR(128), SERVERPROPERTY('Collation')) ELSE c.collation_name END AS collation_name,       AVG(c.max_length) AS avg_max_length       FROM sys.columns c WITH (NOLOCK)       LEFT OUTER JOIN sys.objects o WITH (NOLOCK)       ON o.object_id = c.object_id       AND o.type = 'U'       GROUP BY       c.system_type_id,       c.user_type_id,       c.is_sparse,       c.is_column_set,       c.encryption_type,       c.is_filestream,       CASE WHEN o.object_id IS NOT NULL THEN 1 ELSE 0 END,       CASE WHEN c.collation_name IS NULL THEN CONVERT(VARCHAR(128), SERVERPROPERTY('Collation')) ELSE c.collation_name END     ",23,23,0,219,0,2997
"         create table #tmp_sp_get_sqlagent_properties         (auto_start int null, msx_server_name sysname null, sqlagent_type int null, startup_account nvarchar(255) null, sqlserver_restart int null, jobhistory_max_rows int null, jobhistory_max_rows_per_job int null, errorlog_file nvarchar(255) null, errorlogging_level int null, error_recipient nvarchar(30) null, monitor_autostart int null, local_host_server sysname null, job_shutdown_timeout int null, cmdexec_account varbinary(64) null, regular_connections int null, host_login_name sysname null, host_login_password varbinary(512) null, login_timeout int null, idle_cpu_percent int null, idle_cpu_duration int null, oem_errorlog int null, sysadmin_only int null, email_profile nvarchar(64) null, email_save_in_sent_folder int null, cpu_poller_enabled int null, replace_alert_tokens_enabled int null)         insert into #tmp_sp_get_sqlagent_properties(auto_start, msx_server_name, sqlagent_type, startup_account, sqlserver_restart, jobhistory_max_rows, jobhistory_max_rows_per_job, errorlog_file, errorlogging_level, error_recipient, monitor_autostart, local_host_server, job_shutdown_timeout, cmdexec_account, regular_connections, host_login_name, host_login_password, login_timeout, idle_cpu_percent, idle_cpu_duration, oem_errorlog, sysadmin_only, email_profile, email_save_in_sent_folder, cpu_poller_enabled, replace_alert_tokens_enabled)         exec msdb.dbo.sp_get_sqlagent_properties                  declare @DatabaseMailProfile nvarchar(255)         exec master.dbo.xp_instance_regread N'HKEY_LOCAL_MACHINE', N'SOFTWARE\Microsoft\MSSQLServer\SQLServerAgent', N'DatabaseMailProfile', @param = @DatabaseMailProfile OUT, @no_output = N'no_output'                  declare @AgentMailType int         exec master.dbo.xp_instance_regread N'HKEY_LOCAL_MACHINE', N'SOFTWARE\Microsoft\MSSQLServer\SQLServerAgent', N'UseDatabaseMail', @param = @AgentMailType OUT, @no_output = N'no_output'                  declare @ServiceStartMode int         set @ServiceStartMode = 2         EXEC master.sys.xp_instance_regread 'HKEY_LOCAL_MACHINE', 'SYSTEM\CurrentControlSet\Services\SQLSERVERAGENT', N'Start', @ServiceStartMode OUTPUT                  declare @ServiceAccount nvarchar(512)         EXEC master.sys.xp_instance_regread 'HKEY_LOCAL_MACHINE', 'SYSTEM\CurrentControlSet\Services\SQLSERVERAGENT', N'ObjectName', @ServiceAccount OUTPUT                  declare @AgtGroup nvarchar(512)         exec master.dbo.xp_instance_regread N'HKEY_LOCAL_MACHINE', N'SOFTWARE\Microsoft\MSSQLServer\Setup', N'AGTGroup', @AgtGroup OUTPUT          SELECT CAST(serverproperty(N'Servername') AS sysname) AS [Name], ISNULL(tsgsp.msx_server_name,N'') AS [MsxServerName], tsgsp.sqlagent_type AS [JobServerType], CAST(tsgsp.sqlserver_restart AS bit) AS [SqlServerRestart], CAST(tsgsp.monitor_autostart AS bit) AS [SqlAgentRestart], tsgsp.jobhistory_max_rows AS [MaximumHistoryRows], tsgsp.jobhistory_max_rows_per_job AS [MaximumJobHistoryRows], tsgsp.errorlog_file AS [ErrorLogFile], tsgsp.errorlogging_level AS [AgentLogLevel], ISNULL(tsgsp.error_recipient,N'') AS [NetSendRecipient], tsgsp.job_shutdown_timeout AS [AgentShutdownWaitTime], ISNULL(tsgsp.email_profile,N'') AS [SqlAgentMailProfile], CAST(tsgsp.email_save_in_sent_folder AS bit) AS [SaveInSentFolder], CAST(tsgsp.oem_errorlog AS bit) AS [WriteOemErrorLog], CAST(tsgsp.cpu_poller_enabled AS bit) AS [IsCpuPollingEnabled], tsgsp.idle_cpu_percent AS [IdleCpuPercentage], tsgsp.idle_cpu_duration AS [IdleCpuDuration], tsgsp.login_timeout AS [LoginTimeout], ISNULL(tsgsp.host_login_name,N'') AS [HostLoginName], ISNULL(tsgsp.local_host_server,N'') AS [LocalHostAlias], CAST(tsgsp.auto_start AS bit) AS [SqlAgentAutoStart], CAST(tsgsp.replace_alert_tokens_enabled AS bit) AS [ReplaceAlertTokensEnabled], ISNULL(@DatabaseMailProfile,N'') AS [DatabaseMailProfile], ISNULL(@AgentMailType, 0) AS [AgentMailType], CAST(1 AS bit) AS [SysAdminOnly], @ServiceStartMode AS [ServiceStartMode], ISNULL(@ServiceAccount,N'') AS [ServiceAccount], ISNULL(suser_sname(sid_binary(ISNULL(@AgtGroup,N''))),N'') AS [AgentDomainGroup] FROM #tmp_sp_get_sqlagent_properties AS tsgsp  drop table #tmp_sp_get_sqlagent_properties          ",23,16,7,130,0,93
"       select counter_name, cntr_value from sys.dm_os_performance_counters where object_name like '%External Scripts%'     ",22,22,0,0,0,2799
"SELECT SCHEMA_NAME(obj.schema_id) AS [Schema], obj.name AS [Name], obj.object_id AS [ID], usrt.name AS [DataType], ISNULL(baset.name, N'') AS [SystemType], CAST(CASE WHEN baset.name IN (N'nchar', N'nvarchar') AND ret_param.max_length <> -1 THEN ret_param.max_length/2 ELSE ret_param.max_length END AS int) AS [Length], CAST(ret_param.precision AS int) AS [NumericPrecision], CAST(ret_param.scale AS int) AS [NumericScale], ISNULL(xscret_param.name, N'') AS [XmlSchemaNamespace], ISNULL(s2ret_param.name, N'') AS [XmlSchemaNamespaceSchema], ISNULL( (case ret_param.is_xml_document when 1 then 2 else 1 end), 0) AS [XmlDocumentConstraint], s1ret_param.name AS [DataTypeSchema] FROM sys.objects AS obj LEFT OUTER JOIN sys.all_parameters AS ret_param ON ret_param.object_id = obj.object_id and ret_param.is_output = 1 LEFT OUTER JOIN sys.types AS usrt ON usrt.user_type_id = ret_param.user_type_id LEFT OUTER JOIN sys.types AS baset ON (baset.user_type_id = ret_param.system_type_id and baset.user_type_id = baset.system_type_id) or ((baset.system_type_id = ret_param.system_type_id) and (baset.user_type_id = ret_param.user_type_id) and (baset.is_user_defined = 0) and (baset.is_assembly_type = 1))  LEFT OUTER JOIN sys.xml_schema_collections AS xscret_param ON xscret_param.xml_collection_id = ret_param.xml_collection_id LEFT OUTER JOIN sys.schemas AS s2ret_param ON s2ret_param.schema_id = xscret_param.schema_id LEFT OUTER JOIN sys.schemas AS s1ret_param ON s1ret_param.schema_id = usrt.schema_id WHERE (obj.type=N'AF') ORDER BY [Schema] ASC,[Name] ASC",20,19,1,722,0,82
FETCH API_CURSOR0000000000004EC8 ,19,13,6,9279,0,386
"       SELECT       db_id() AS database_id,       c.system_type_id,       c.user_type_id,       c.is_sparse,       c.is_column_set,       c.is_filestream,       c.encryption_type,       CASE WHEN o.object_id IS NOT NULL THEN 1 ELSE 0 END AS is_user,       COUNT_BIG(*) AS [ColCount],       CASE WHEN c.collation_name IS NULL THEN CONVERT(VARCHAR(128), SERVERPROPERTY('Collation')) ELSE c.collation_name END AS collation_name,       AVG(c.max_length) AS avg_max_length       FROM sys.columns c WITH (NOLOCK)       LEFT OUTER JOIN sys.objects o WITH (NOLOCK)       ON o.object_id = c.object_id       AND o.type = 'U'       GROUP BY       c.system_type_id,       c.user_type_id,       c.is_sparse,       c.is_column_set,       c.encryption_type,       c.is_filestream,       CASE WHEN o.object_id IS NOT NULL THEN 1 ELSE 0 END,       CASE WHEN c.collation_name IS NULL THEN CONVERT(VARCHAR(128), SERVERPROPERTY('Collation')) ELSE c.collation_name END     ",18,18,0,66,0,222
FETCH API_CURSOR0000000000004EB5 ,15,14,1,8867,0,5467
FETCH API_CURSOR0000000000004EC1 ,14,14,0,8967,0,1846
FETCH API_CURSOR0000000000004EB6 ,13,13,0,9198,0,913
"(@_msparam_0 nvarchar(4000))SELECT SCHEMA_NAME(v.schema_id) AS [Schema], v.name AS [Name], v.object_id AS [ID] FROM sys.all_views AS v WHERE (v.type = @_msparam_0) ORDER BY [Schema] ASC,[Name] ASC",13,8,5,63,0,53
FETCH API_CURSOR0000000000004EB9 ,13,13,0,9087,0,2247
FETCH API_CURSOR0000000000004EB7 ,12,12,0,8633,0,2309
FETCH API_CURSOR0000000000004EBA ,12,12,0,8818,0,652
"SELECT SCHEMA_NAME(obj.schema_id) AS [Schema], obj.name AS [Name], obj.object_id AS [ID], usrt.name AS [DataType], ISNULL(baset.name, N'') AS [SystemType], CAST(CASE WHEN baset.name IN (N'nchar', N'nvarchar') AND ret_param.max_length <> -1 THEN ret_param.max_length/2 ELSE ret_param.max_length END AS int) AS [Length], CAST(ret_param.precision AS int) AS [NumericPrecision], CAST(ret_param.scale AS int) AS [NumericScale], ISNULL(xscret_param.name, N'') AS [XmlSchemaNamespace], ISNULL(s2ret_param.name, N'') AS [XmlSchemaNamespaceSchema], ISNULL( (case ret_param.is_xml_document when 1 then 2 else 1 end), 0) AS [XmlDocumentConstraint], s1ret_param.name AS [DataTypeSchema] FROM sys.objects AS obj LEFT OUTER JOIN sys.all_parameters AS ret_param ON ret_param.object_id = obj.object_id and ret_param.is_output = 1 LEFT OUTER JOIN sys.types AS usrt ON usrt.user_type_id = ret_param.user_type_id LEFT OUTER JOIN sys.types AS baset ON (baset.user_type_id = ret_param.system_type_id and baset.user_type_id = baset.system_type_id) or ((baset.system_type_id = ret_param.system_type_id) and (baset.user_type_id = ret_param.user_type_id) and (baset.is_user_defined = 0) and (baset.is_assembly_type = 1))  LEFT OUTER JOIN sys.xml_schema_collections AS xscret_param ON xscret_param.xml_collection_id = ret_param.xml_collection_id LEFT OUTER JOIN sys.schemas AS s2ret_param ON s2ret_param.schema_id = xscret_param.schema_id LEFT OUTER JOIN sys.schemas AS s1ret_param ON s1ret_param.schema_id = usrt.schema_id WHERE (obj.type=N'AF') ORDER BY [Schema] ASC,[Name] ASC",12,10,2,547,0,12
"(@p0 nvarchar(4000),@p1 nvarchar(4000),@p2 nvarchar(4000),@p3 nvarchar(4000),@p4 nvarchar(4000),@p5 nvarchar(4000),@p6 nvarchar(4000),@p7 nvarchar(4000),@p8 nvarchar(4000),@p9 nvarchar(4000),@p10 nvarchar(4000),@p11 datetime2(7),@p12 nvarchar(4000),@p13 nvarchar(4000),@p14 int,@p15 int,@p16 int,@p17 nvarchar(4000),@p18 nvarchar(4000),@p19 nvarchar(4000),@p20 nvarchar(4000),@p21 nvarchar(4000),@p22 nvarchar(4000),@p23 nvarchar(4000),@p24 nvarchar(4000),@p25 nvarchar(4000),@p26 nvarchar(4000),@p27 nvarchar(4000),@p28 nvarchar(4000),@p29 int,@p30 nvarchar(4000),@p31 nvarchar(4000),@p32 nvarchar(4000),@p33 nvarchar(4000),@p34 nvarchar(4000),@p35 nvarchar(4000),@p36 nvarchar(4000),@p37 nvarchar(4000),@p38 nvarchar(4000),@p39 nvarchar(4000),@p40 int,@p41 nvarchar(4000),@p42 nvarchar(4000),@p43 nvarchar(4000),@p44 nvarchar(4000),@p45 nvarchar(4000),@p46 int,@p47 nvarchar(4000),@p48 int,@p49 int,@p50 datetime2(7),@p51 datetime2(7),@p52 datetime2(7),@p53 nvarchar(4000),@p54 nvarchar(4000),@p55 nvarchar(4000),@p56 nvarchar(4000),@p57 nvarchar(4000),@p58 nvarchar(4000),@p59 nvarchar(4000),@p60 nvarchar(4000),@p61 nvarchar(4000),@p62 nvarchar(4000),@p63 nvarchar(4000),@p64 nvarchar(4000),@p65 nvarchar(4000),@p66 nvarchar(4000),@p67 datetime2(7),@p68 nvarchar(4000),@p69 nvarchar(4000),@p70 int,@p71 int,@p72 int,@p73 nvarchar(4000),@p74 nvarchar(4000),@p75 nvarchar(4000),@p76 nvarchar(4000),@p77 nvarchar(4000),@p78 nvarchar(4000),@p79 nvarchar(4000),@p80 nvarchar(4000),@p81 nvarchar(4000),@p82 nvarchar(4000),@p83 nvarchar(4000),@p84 nvarchar(4000),@p85 int,@p86 nvarchar(4000),@p87 nvarchar(4000),@p88 nvarchar(4000),@p89 nvarchar(4000),@p90 nvarchar(4000),@p91 nvarchar(4000),@p92 nvarchar(4000),@p93 nvarchar(4000),@p94 nvarchar(4000),@p95 nvarchar(4000),@p96 int,@p97 nvarchar(4000),@p98 nvarchar(4000),@p99 nvarchar(4000),@p100 nvarchar(4000),@p101 nvarchar(4000),@p102 int,@p103 nvarchar(4000),@p104 int,@p105 int,@p106 datetime2(7),@p107 datetime2(7),@p108 datetime2(7),@p109 nvarchar(4000),@p110 nvarchar(4000),@p111 nvarchar(4000),@p112 nvarchar(4000),@p113 nvarchar(4000),@p114 nvarchar(4000),@p115 nvarchar(4000),@p116 nvarchar(4000),@p117 nvarchar(4000),@p118 nvarchar(4000),@p119 nvarchar(4000),@p120 nvarchar(4000),@p121 nvarchar(4000),@p122 nvarchar(4000),@p123 datetime2(7),@p124 nvarchar(4000),@p125 nvarchar(4000),@p126 int,@p127 int,@p128 int,@p129 nvarchar(4000),@p130 nvarchar(4000),@p131 nvarchar(4000),@p132 nvarchar(4000),@p133 nvarchar(4000),@p134 nvarchar(4000),@p135 nvarchar(4000),@p136 nvarchar(4000),@p137 nvarchar(4000),@p138 nvarchar(4000),@p139 nvarchar(4000),@p140 nvarchar(4000),@p141 int,@p142 nvarchar(4000),@p143 nvarchar(4000),@p144 nvarchar(4000),@p145 nvarchar(4000),@p146 nvarchar(4000),@p147 nvarchar(4000),@p148 nvarchar(4000),@p149 nvarchar(4000),@p150 nvarchar(4000),@p151 nvarchar(4000),@p152 int,@p153 nvarchar(4000),@p154 nvarchar(4000),@p155 nvarchar(4000),@p156 nvarchar(4000),@p157 nvarchar(4000),@p158 int,@p159 nvarchar(4000),@p160 int,@p161 int,@p162 datetime2(7),@p163 datetime2(7),@p164 datetime2(7),@p165 nvarchar(4000),@p166 nvarchar(4000),@p167 nvarchar(4000),@p168 nvarchar(4000),@p169 nvarchar(4000),@p170 nvarchar(4000),@p171 nvarchar(4000),@p172 nvarchar(4000),@p173 nvarchar(4000),@p174 nvarchar(4000),@p175 nvarchar(4000),@p176 nvarchar(4000),@p177 nvarchar(4000),@p178 nvarchar(4000),@p179 datetime2(7),@p180 nvarchar(4000),@p181 nvarchar(4000),@p182 int,@p183 int,@p184 int,@p185 nvarchar(4000),@p186 nvarchar(4000),@p187 nvarchar(4000),@p188 nvarchar(4000),@p189 nvarchar(4000),@p190 nvarchar(4000),@p191 nvarchar(4000),@p192 nvarchar(4000),@p193 nvarchar(4000),@p194 nvarchar(4000),@p195 nvarchar(4000),@p196 nvarchar(4000),@p197 int,@p198 nvarchar(4000),@p199 nvarchar(4000),@p200 nvarchar(4000),@p201 nvarchar(4000),@p202 nvarchar(4000),@p203 nvarchar(4000),@p204 nvarchar(4000),@p205 nvarchar(4000),@p206 nvarchar(4000),@p207 nvarchar(4000),@p208 int,@p209 nvarchar(4000),@p210 nvarchar(4000),@p211 nvarchar(4000),@p212 nvarchar(4000),@p213 nvarchar(4000),@p214 int,@p215 nvarchar(4000),@p216 int,@p217 int,@p218 datetime2(7),@p219 datetime2(7),@p220 datetime2(7),@p221 nvarchar(4000),@p222 nvarchar(4000),@p223 nvarchar(4000),@p224 nvarchar(4000),@p225 nvarchar(4000),@p226 nvarchar(4000),@p227 nvarchar(4000),@p228 nvarchar(4000),@p229 nvarchar(4000),@p230 nvarchar(4000),@p231 nvarchar(4000),@p232 nvarchar(4000),@p233 nvarchar(4000),@p234 nvarchar(4000),@p235 datetime2(7),@p236 nvarchar(4000),@p237 nvarchar(4000),@p238 int,@p239 int,@p240 int,@p241 nvarchar(4000),@p242 nvarchar(4000),@p243 nvarchar(4000),@p244 nvarchar(4000),@p245 nvarchar(4000),@p246 nvarchar(4000),@p247 nvarchar(4000),@p248 nvarchar(4000),@p249 nvarchar(4000),@p250 nvarchar(4000),@p251 nvarchar(4000),@p252 nvarchar(4000),@p253 int,@p254 nvarchar(4000),@p255 nvarchar(4000),@p256 nvarchar(4000),@p257 nvarchar(4000),@p258 nvarchar(4000),@p259 nvarchar(4000),@p260 nvarchar(4000),@p261 nvarchar(4000),@p262 nvarchar(4000),@p263 nvarchar(4000),@p264 int,@p265 nvarchar(4000),@p266 nvarchar(4000),@p267 nvarchar(4000),@p268 nvarchar(4000),@p269 nvarchar(4000),@p270 int,@p271 nvarchar(4000),@p272 int,@p273 int,@p274 datetime2(7),@p275 datetime2(7),@p276 datetime2(7),@p277 nvarchar(4000),@p278 nvarchar(4000),@p279 nvarchar(4000),@p280 nvarchar(4000),@p281 nvarchar(4000),@p282 nvarchar(4000),@p283 nvarchar(4000),@p284 nvarchar(4000),@p285 nvarchar(4000),@p286 nvarchar(4000),@p287 nvarchar(4000),@p288 nvarchar(4000),@p289 nvarchar(4000),@p290 nvarchar(4000),@p291 datetime2(7),@p292 nvarchar(4000),@p293 nvarchar(4000),@p294 int,@p295 int,@p296 int,@p297 nvarchar(4000),@p298 nvarchar(4000),@p299 nvarchar(4000),@p300 nvarchar(4000),@p301 nvarchar(4000),@p302 nvarchar(4000),@p303 nvarchar(4000),@p304 nvarchar(4000),@p305 nvarchar(4000),@p306 nvarchar(4000),@p307 nvarchar(4000),@p308 nvarchar(4000),@p309 int,@p310 nvarchar(4000),@p311 nvarchar(4000),@p312 nvarchar(4000),@p313 nvarchar(4000),@p314 nvarchar(4000),@p315 nvarchar(4000),@p316 nvarchar(4000),@p317 nvarchar(4000),@p318 nvarchar(4000),@p319 nvarchar(4000),@p320 int,@p321 nvarchar(4000),@p322 nvarchar(4000),@p323 nvarchar(4000),@p324 nvarchar(4000),@p325 nvarchar(4000),@p326 int,@p327 nvarchar(4000),@p328 int,@p329 int,@p330 datetime2(7),@p331 datetime2(7),@p332 datetime2(7),@p333 nvarchar(4000),@p334 nvarchar(4000),@p335 nvarchar(4000),@p336 nvarchar(4000),@p337 nvarchar(4000),@p338 nvarchar(4000),@p339 nvarchar(4000),@p340 nvarchar(4000),@p341 nvarchar(4000),@p342 nvarchar(4000),@p343 nvarchar(4000),@p344 nvarchar(4000),@p345 nvarchar(4000),@p346 nvarchar(4000),@p347 datetime2(7),@p348 nvarchar(4000),@p349 nvarchar(4000),@p350 int,@p351 int,@p352 int,@p353 nvarchar(4000),@p354 nvarchar(4000),@p355 nvarchar(4000),@p356 nvarchar(4000),@p357 nvarchar(4000),@p358 nvarchar(4000),@p359 nvarchar(4000),@p360 nvarchar(4000),@p361 nvarchar(4000),@p362 nvarchar(4000),@p363 nvarchar(4000),@p364 nvarchar(4000),@p365 int,@p366 nvarchar(4000),@p367 nvarchar(4000),@p368 nvarchar(4000),@p369 nvarchar(4000),@p370 nvarchar(4000),@p371 nvarchar(4000),@p372 nvarchar(4000),@p373 nvarchar(4000),@p374 nvarchar(4000),@p375 nvarchar(4000),@p376 int,@p377 nvarchar(4000),@p378 nvarchar(4000),@p379 nvarchar(4000),@p380 nvarchar(4000),@p381 nvarchar(4000),@p382 int,@p383 nvarchar(4000),@p384 int,@p385 int,@p386 datetime2(7),@p387 datetime2(7),@p388 datetime2(7),@p389 nvarchar(4000),@p390 nvarchar(4000),@p391 nvarchar(4000),@p392 nvarchar(4000),@p393 nvarchar(4000),@p394 nvarchar(4000),@p395 nvarchar(4000),@p396 nvarchar(4000),@p397 nvarchar(4000),@p398 nvarchar(4000),@p399 nvarchar(4000),@p400 nvarchar(4000),@p401 nvarchar(4000),@p402 nvarchar(4000),@p403 datetime2(7),@p404 nvarchar(4000),@p405 nvarchar(4000),@p406 int,@p407 int,@p408 int,@p409 nvarchar(4000),@p410 nvarchar(4000),@p411 nvarchar(4000),@p412 nvarchar(4000),@p413 nvarchar(4000),@p414 nvarchar(4000),@p415 nvarchar(4000),@p416 nvarchar(4000),@p417 nvarchar(4000),@p418 nvarchar(4000),@p419 nvarchar(4000),@p420 nvarchar(4000),@p421 int,@p422 nvarchar(4000),@p423 nvarchar(4000),@p424 nvarchar(4000),@p425 nvarchar(4000),@p426 nvarchar(4000),@p427 nvarchar(4000),@p428 nvarchar(4000),@p429 nvarchar(4000),@p430 nvarchar(4000),@p431 nvarchar(4000),@p432 int,@p433 nvarchar(4000),@p434 nvarchar(4000),@p435 nvarchar(4000),@p436 nvarchar(4000),@p437 nvarchar(4000),@p438 int,@p439 nvarchar(4000),@p440 int,@p441 int,@p442 datetime2(7),@p443 datetime2(7),@p444 datetime2(7),@p445 nvarchar(4000),@p446 nvarchar(4000),@p447 nvarchar(4000),@p448 nvarchar(4000),@p449 nvarchar(4000),@p450 nvarchar(4000),@p451 nvarchar(4000),@p452 nvarchar(4000),@p453 nvarchar(4000),@p454 nvarchar(4000),@p455 nvarchar(4000),@p456 nvarchar(4000),@p457 nvarchar(4000),@p458 nvarchar(4000),@p459 datetime2(7),@p460 nvarchar(4000),@p461 nvarchar(4000),@p462 int,@p463 int,@p464 int,@p465 nvarchar(4000),@p466 nvarchar(4000),@p467 nvarchar(4000),@p468 nvarchar(4000),@p469 nvarchar(4000),@p470 nvarchar(4000),@p471 nvarchar(4000),@p472 nvarchar(4000),@p473 nvarchar(4000),@p474 nvarchar(4000),@p475 nvarchar(4000),@p476 nvarchar(4000),@p477 int,@p478 nvarchar(4000),@p479 nvarchar(4000),@p480 nvarchar(4000),@p481 nvarchar(4000),@p482 nvarchar(4000),@p483 nvarchar(4000),@p484 nvarchar(4000),@p485 nvarchar(4000),@p486 nvarchar(4000),@p487 nvarchar(4000),@p488 int,@p489 nvarchar(4000),@p490 nvarchar(4000),@p491 nvarchar(4000),@p492 nvarchar(4000),@p493 nvarchar(4000),@p494 int,@p495 nvarchar(4000),@p496 int,@p497 int,@p498 datetime2(7),@p499 datetime2(7),@p500 datetime2(7),@p501 nvarchar(4000),@p502 nvarchar(4000),@p503 nvarchar(4000),@p504 nvarchar(4000),@p505 nvarchar(4000),@p506 nvarchar(4000),@p507 nvarchar(4000),@p508 nvarchar(4000),@p509 nvarchar(4000),@p510 nvarchar(4000),@p511 nvarchar(4000),@p512 nvarchar(4000),@p513 nvarchar(4000),@p514 nvarchar(4000),@p515 datetime2(7),@p516 nvarchar(4000),@p517 nvarchar(4000),@p518 int,@p519 int,@p520 int,@p521 nvarchar(4000),@p522 nvarchar(4000),@p523 nvarchar(4000),@p524 nvarchar(4000),@p525 nvarchar(4000),@p526 nvarchar(4000),@p527 nvarchar(4000),@p528 nvarchar(4000),@p529 nvarchar(4000),@p530 nvarchar(4000),@p531 nvarchar(4000),@p532 nvarchar(4000),@p533 int,@p534 nvarchar(4000),@p535 nvarchar(4000),@p536 nvarchar(4000),@p537 nvarchar(4000),@p538 nvarchar(4000),@p539 nvarchar(4000),@p540 nvarchar(4000),@p541 nvarchar(4000),@p542 nvarchar(4000),@p543 nvarchar(4000),@p544 int,@p545 nvarchar(4000),@p546 nvarchar(4000),@p547 nvarchar(4000),@p548 nvarchar(4000),@p549 nvarchar(4000),@p550 int,@p551 nvarchar(4000),@p552 int,@p553 int,@p554 datetime2(7),@p555 datetime2(7),@p556 datetime2(7),@p557 nvarchar(4000),@p558 nvarchar(4000),@p559 nvarchar(4000),@p560 nvarchar(4000),@p561 nvarchar(4000),@p562 nvarchar(4000),@p563 nvarchar(4000),@p564 nvarchar(4000),@p565 nvarchar(4000),@p566 nvarchar(4000),@p567 nvarchar(4000),@p568 nvarchar(4000),@p569 nvarchar(4000),@p570 nvarchar(4000),@p571 datetime2(7),@p572 nvarchar(4000),@p573 nvarchar(4000),@p574 int,@p575 int,@p576 int,@p577 nvarchar(4000),@p578 nvarchar(4000),@p579 nvarchar(4000),@p580 nvarchar(4000),@p581 nvarchar(4000),@p582 nvarchar(4000),@p583 nvarchar(4000),@p584 nvarchar(4000),@p585 nvarchar(4000),@p586 nvarchar(4000),@p587 nvarchar(4000),@p588 nvarchar(4000),@p589 int,@p590 nvarchar(4000),@p591 nvarchar(4000),@p592 nvarchar(4000),@p593 nvarchar(4000),@p594 nvarchar(4000),@p595 nvarchar(4000),@p596 nvarchar(4000),@p597 nvarchar(4000),@p598 nvarchar(4000),@p599 nvarchar(4000),@p600 int,@p601 nvarchar(4000),@p602 nvarchar(4000),@p603 nvarchar(4000),@p604 nvarchar(4000),@p605 nvarchar(4000),@p606 int,@p607 nvarchar(4000),@p608 int,@p609 int,@p610 datetime2(7),@p611 datetime2(7),@p612 datetime2(7),@p613 nvarchar(4000),@p614 nvarchar(4000),@p615 nvarchar(4000),@p616 nvarchar(4000),@p617 nvarchar(4000),@p618 nvarchar(4000),@p619 nvarchar(4000),@p620 nvarchar(4000),@p621 nvarchar(4000),@p622 nvarchar(4000),@p623 nvarchar(4000),@p624 nvarchar(4000),@p625 nvarchar(4000),@p626 nvarchar(4000),@p627 datetime2(7),@p628 nvarchar(4000),@p629 nvarchar(4000),@p630 int,@p631 int,@p632 int,@p633 nvarchar(4000),@p634 nvarchar(4000),@p635 nvarchar(4000),@p636 nvarchar(4000),@p637 nvarchar(4000),@p638 nvarchar(4000),@p639 nvarchar(4000),@p640 nvarchar(4000),@p641 nvarchar(4000),@p642 nvarchar(4000),@p643 nvarchar(4000),@p644 nvarchar(4000),@p645 int,@p646 nvarchar(4000),@p647 nvarchar(4000),@p648 nvarchar(4000),@p649 nvarchar(4000),@p650 nvarchar(4000),@p651 nvarchar(4000),@p652 nvarchar(4000),@p653 nvarchar(4000),@p654 nvarchar(4000),@p655 nvarchar(4000),@p656 int,@p657 nvarchar(4000),@p658 nvarchar(4000),@p659 nvarchar(4000),@p660 nvarchar(4000),@p661 nvarchar(4000),@p662 int,@p663 nvarchar(4000),@p664 int,@p665 int,@p666 datetime2(7),@p667 datetime2(7),@p668 datetime2(7),@p669 nvarchar(4000),@p670 nvarchar(4000),@p671 nvarchar(4000))SET NOCOUNT ON; DECLARE @inserted0 TABLE ([item_id] int, [_Position] [int]); MERGE [raw_data] USING ( VALUES (@p0, @p1, @p2, @p3, @p4, @p5, @p6, @p7, @p8, @p9, @p10, @p11, @p12, @p13, @p14, @p15, @p16, @p17, @p18, @p19, @p20, @p21, @p22, @p23, @p24, @p25, @p26, @p27, @p28, @p29, @p30, @p31, @p32, @p33, @p34, @p35, @p36, @p37, @p38, @p39, @p40, @p41, @p42, @p43, @p44, @p45, @p46, @p47, @p48, @p49, @p50, @p51, @p52, @p53, @p54, @p55, 0), (@p56, @p57, @p58, @p59, @p60, @p61, @p62, @p63, @p64, @p65, @p66, @p67, @p68, @p69, @p70, @p71, @p72, @p73, @p74, @p75, @p76, @p77, @p78, @p79, @p80, @p81, @p82, @p83, @p84, @p85, @p86, @p87, @p88, @p89, @p90, @p91, @p92, @p93, @p94, @p95, @p96, @p97, @p98, @p99, @p100, @p101, @p102, @p103, @p104, @p105, @p106, @p107, @p108, @p109, @p110, @p111, 1), (@p112, @p113, @p114, @p115, @p116, @p117, @p118, @p119, @p120, @p121, @p122, @p123, @p124, @p125, @p126, @p127, @p128, @p129, @p130, @p131, @p132, @p133, @p134, @p135, @p136, @p137, @p138, @p139, @p140, @p141, @p142, @p143, @p144, @p145, @p146, @p147, @p148, @p149, @p150, @p151, @p152, @p153, @p154, @p155, @p156, @p157, @p158, @p159, @p160, @p161, @p162, @p163, @p164, @p165, @p166, @p167, 2), (@p168, @p169, @p170, @p171, @p172, @p173, @p174, @p175, @p176, @p177, @p178, @p179, @p180, @p181, @p182, @p183, @p184, @p185, @p186, @p187, @p188, @p189, @p190, @p191, @p192, @p193, @p194, @p195, @p196, @p197, @p198, @p199, @p200, @p201, @p202, @p203, @p204, @p205, @p206, @p207, @p208, @p209, @p210, @p211, @p212, @p213, @p214, @p215, @p216, @p217, @p218, @p219, @p220, @p221, @p222, @p223, 3), (@p224, @p225, @p226, @p227, @p228, @p229, @p230, @p231, @p232, @p233, @p234, @p235, @p236, @p237, @p238, @p239, @p240, @p241, @p242, @p243, @p244, @p245, @p246, @p247, @p248, @p249, @p250, @p251, @p252, @p253, @p254, @p255, @p256, @p257, @p258, @p259, @p260, @p261, @p262, @p263, @p264, @p265, @p266, @p267, @p268, @p269, @p270, @p271, @p272, @p273, @p274, @p275, @p276, @p277, @p278, @p279, 4), (@p280, @p281, @p282, @p283, @p284, @p285, @p286, @p287, @p288, @p289, @p290, @p291, @p292, @p293, @p294, @p295, @p296, @p297, @p298, @p299, @p300, @p301, @p302, @p303, @p304, @p305, @p306, @p307, @p308, @p309, @p310, @p311, @p312, @p313, @p314, @p315, @p316, @p317, @p318, @p319, @p320, @p321, @p322, @p323, @p324, @p325, @p326, @p327, @p328, @p329, @p330, @p331, @p332, @p333, @p334, @p335, 5), (@p336, @p337, @p338, @p339, @p340, @p341, @p342, @p343, @p344, @p345, @p346, @p347, @p348, @p349, @p350, @p351, @p352, @p353, @p354, @p355, @p356, @p357, @p358, @p359, @p360, @p361, @p362, @p363, @p364, @p365, @p366, @p367, @p368, @p369, @p370, @p371, @p372, @p373, @p374, @p375, @p376, @p377, @p378, @p379, @p380, @p381, @p382, @p383, @p384, @p385, @p386, @p387, @p388, @p389, @p390, @p391, 6), (@p392, @p393, @p394, @p395, @p396, @p397, @p398, @p399, @p400, @p401, @p402, @p403, @p404, @p405, @p406, @p407, @p408, @p409, @p410, @p411, @p412, @p413, @p414, @p415, @p416, @p417, @p418, @p419, @p420, @p421, @p422, @p423, @p424, @p425, @p426, @p427, @p428, @p429, @p430, @p431, @p432, @p433, @p434, @p435, @p436, @p437, @p438, @p439, @p440, @p441, @p442, @p443, @p444, @p445, @p446, @p447, 7), (@p448, @p449, @p450, @p451, @p452, @p453, @p454, @p455, @p456, @p457, @p458, @p459, @p460, @p461, @p462, @p463, @p464, @p465, @p466, @p467, @p468, @p469, @p470, @p471, @p472, @p473, @p474, @p475, @p476, @p477, @p478, @p479, @p480, @p481, @p482, @p483, @p484, @p485, @p486, @p487, @p488, @p489, @p490, @p491, @p492, @p493, @p494, @p495, @p496, @p497, @p498, @p499, @p500, @p501, @p502, @p503, 8), (@p504, @p505, @p506, @p507, @p508, @p509, @p510, @p511, @p512, @p513, @p514, @p515, @p516, @p517, @p518, @p519, @p520, @p521, @p522, @p523, @p524, @p525, @p526, @p527, @p528, @p529, @p530, @p531, @p532, @p533, @p534, @p535, @p536, @p537, @p538, @p539, @p540, @p541, @p542, @p543, @p544, @p545, @p546, @p547, @p548, @p549, @p550, @p551, @p552, @p553, @p554, @p555, @p556, @p557, @p558, @p559, 9), (@p560, @p561, @p562, @p563, @p564, @p565, @p566, @p567, @p568, @p569, @p570, @p571, @p572, @p573, @p574, @p575, @p576, @p577, @p578, @p579, @p580, @p581, @p582, @p583, @p584, @p585, @p586, @p587, @p588, @p589, @p590, @p591, @p592, @p593, @p594, @p595, @p596, @p597, @p598, @p599, @p600, @p601, @p602, @p603, @p604, @p605, @p606, @p607, @p608, @p609, @p610, @p611, @p612, @p613, @p614, @p615, 10), (@p616, @p617, @p618, @p619, @p620, @p621, @p622, @p623, @p624, @p625, @p626, @p627, @p628, @p629, @p630, @p631, @p632, @p633, @p634, @p635, @p636, @p637, @p638, @p639, @p640, @p641, @p642, @p643, @p644, @p645, @p646, @p647, @p648, @p649, @p650, @p651, @p652, @p653, @p654, @p655, @p656, @p657, @p658, @p659, @p660, @p661, @p662, @p663, @p664, @p665, @p666, @p667, @p668, @p669, @p670, @p671, 11)) AS i ([addressee_cntry_cd], [addressee_city], [addressee_district], [addressee_email], [addressee_full_address], [addressee_home_address], [addressee_name], [addressee_postcode], [addressee_province], [addressee_subdistrict], [addressee_tel], [create_table], [delivery_code], [delivery_recipient_name], [delivery_relation_id], [delivery_status_id], [dest_outlet_id], [dest_outlet_port], [document_number], [item_barcode], [item_cod], [item_gross_weight], [item_height], [item_length], [item_price], [item_width], [lat], [log_id], [long], [outlet_id], [outlet_port], [podUrl], [remark], [scan_cntry_cd], [scan_cntry_postcode], [sender_cntry_cd], [sender_district], [sender_email], [sender_full_address], [sender_home_address], [member_id], [sender_name], [sender_postcode], [sender_province], [sender_subdistrict], [sender_tel], [server_id], [signatureUrl], [state], [status_code], [status_dtm], [timestamp], [transmit_dtm], [user_id], [wckt_id], [wkstn_no], _Position) ON 1=0 WHEN NOT MATCHED THEN INSERT ([addressee_cntry_cd], [addressee_city], [addressee_district], [addressee_email], [addressee_full_address], [addressee_home_address], [addressee_name], [addressee_postcode], [addressee_province], [addressee_subdistrict], [addressee_tel], [create_table], [delivery_code], [delivery_recipient_name], [delivery_relation_id], [delivery_status_id], [dest_outlet_id], [dest_outlet_port], [document_number], [item_barcode], [item_cod], [item_gross_weight], [item_height], [item_length], [item_price], [item_width], [lat], [log_id], [long], [outlet_id], [outlet_port], [podUrl], [remark], [scan_cntry_cd], [scan_cntry_postcode], [sender_cntry_cd], [sender_district], [sender_email], [sender_full_address], [sender_home_address], [member_id], [sender_name], [sender_postcode], [sender_province], [sender_subdistrict], [sender_tel], [server_id], [signatureUrl], [state], [status_code], [status_dtm], [timestamp], [transmit_dtm], [user_id], [wckt_id], [wkstn_no]) VALUES (i.[addressee_cntry_cd], i.[addressee_city], i.[addressee_district], i.[addressee_email], i.[addressee_full_address], i.[addressee_home_address], i.[addressee_name], i.[addressee_postcode], i.[addressee_province], i.[addressee_subdistrict], i.[addressee_tel], i.[create_table], i.[delivery_code], i.[delivery_recipient_name], i.[delivery_relation_id], i.[delivery_status_id], i.[dest_outlet_id], i.[dest_outlet_port], i.[document_number], i.[item_barcode], i.[item_cod], i.[item_gross_weight], i.[item_height], i.[item_length], i.[item_price], i.[item_width], i.[lat], i.[log_id], i.[long], i.[outlet_id], i.[outlet_port], i.[podUrl], i.[remark], i.[scan_cntry_cd], i.[scan_cntry_postcode], i.[sender_cntry_cd], i.[sender_district], i.[sender_email], i.[sender_full_address], i.[sender_home_address], i.[member_id], i.[sender_name], i.[sender_postcode], i.[sender_province], i.[sender_subdistrict], i.[sender_tel], i.[server_id], i.[signatureUrl], i.[state], i.[status_code], i.[status_dtm], i.[timestamp], i.[transmit_dtm], i.[user_id], i.[wckt_id], i.[wkstn_no]) OUTPUT INSERTED.[item_id], i._Position INTO @inserted0;  SELECT [t].[item_id] FROM [raw_data] t INNER JOIN @inserted0 i ON ([t].[item_id] = [i].[item_id]) ORDER BY [i].[_Position];  ",12,0,12,127,5,3061
FETCH API_CURSOR0000000000004EF2 ,12,12,0,9802,0,72
"(@_msparam_0 nvarchar(4000))SELECT CAST(COLLATIONPROPERTY(name, 'LCID') AS int) AS [LocaleID] FROM sys.fn_helpcollations() cl WHERE (cl.name=@_msparam_0)",11,11,0,0,0,2897
FETCH API_CURSOR0000000000004F24 ,11,11,0,9279,0,22
"SELECT     DB_NAME (database_id) as [Database Name],     name as [Database File Name],     [Type] = CASE WHEN Type_Desc = 'ROWS' THEN 'Data File(s)'             WHEN Type_Desc = 'LOG'  THEN 'Log File(s)'             ELSE Type_Desc END,     size*8/1024 as 'Size (MB)',     physical_name as [Database_File_Location] FROM sys.master_files ORDER BY 1,3  IF OBJECT_ID('tempdb.dbo.#space') IS NOT NULL     DROP TABLE #space  CREATE TABLE #space (       database_id INT PRIMARY KEY     , data_used_size DECIMAL(18,2)     , log_used_size DECIMAL(18,2) )  DECLARE @SQL NVARCHAR(MAX)  SELECT @SQL = STUFF((     SELECT '     USE [' + d.name + ']     INSERT INTO #space (database_id, data_used_size, log_used_size)     SELECT           DB_ID()         , SUM(CASE WHEN [type] = 0 THEN space_used END)         , SUM(CASE WHEN [type] = 1 THEN space_used END)     FROM (         SELECT s.[type], space_used = SUM(FILEPROPERTY(s.name, ''SpaceUsed'') * 8. / 1024)         FROM sys.database_files s         GROUP BY s.[type]     ) t;'     FROM sys.databases d     WHERE d.[state] = 0     FOR XML PATH(''), TYPE).value('.', 'NVARCHAR(MAX)'), 1, 2, '')  EXEC sys.sp_executesql @SQL  SELECT       d.database_id     , d.name     , d.state_desc     , d.recovery_model_desc     , t.total_size     , t.data_size     , s.data_used_size     , t.log_size     , s.log_used_size     , bu.full_last_date     , bu.full_size     , bu.log_last_date     , bu.log_size FROM (     SELECT           database_id         , log_size = CAST(SUM(CASE WHEN [type] = 1 THEN size END) * 8. / 1024 AS DECIMAL(18,2))         , data_size = CAST(SUM(CASE WHEN [type] = 0 THEN size END) * 8. / 1024 AS DECIMAL(18,2))         , total_size = CAST(SUM(size) * 8. / 1024 AS DECIMAL(18,2))     FROM sys.master_files     GROUP BY database_id ) t JOIN sys.databases d ON d.database_id = t.database_id LEFT JOIN #space s ON d.database_id = s.database_id LEFT JOIN (     SELECT           database_name         , full_last_date = MAX(CASE WHEN [type] = 'D' THEN backup_finish_date END)         , full_size = MAX(CASE WHEN [type] = 'D' THEN backup_size END)         , log_last_date = MAX(CASE WHEN [type] = 'L' THEN backup_finish_date END)         , log_size = MAX(CASE WHEN [type] = 'L' THEN backup_size END)     FROM (         SELECT               s.database_name             , s.[type]             , s.backup_finish_date             , backup_size =                         CAST(CASE WHEN s.backup_size = s.compressed_backup_size                                     THEN s.backup_size                                     ELSE s.compressed_backup_size                         END / 1048576.0 AS DECIMAL(18,2))             , RowNum = ROW_NUMBER() OVER (PARTITION BY s.database_name, s.[type] ORDER BY s.backup_finish_date DESC)         FROM msdb.dbo.backupset s         WHERE s.[type] IN ('D', 'L')     ) f     WHERE f.RowNum = 1     GROUP BY f.database_name ) bu ON d.name = bu.database_name ORDER BY t.total_size DESC  SELECT      req.session_id     , req.total_elapsed_time AS duration_ms     , req.cpu_time AS cpu_time_ms     , req.total_elapsed_time - req.cpu_time AS wait_time     , req.logical_reads     , SUBSTRING (REPLACE (REPLACE (SUBSTRING (ST.text, (req.statement_start_offset/2) + 1,         ((CASE statement_end_offset            WHEN -1            THEN DATALENGTH(ST.text)              ELSE req.statement_end_offset          END - req.statement_start_offset)/2) + 1) , CHAR(10), ' '), CHAR(13), ' '),        1, 512)  AS statement_text   FROM sys.dm_exec_requests AS req     CROSS APPLY sys.dm_exec_sql_text(req.sql_handle) AS ST ORDER BY total_elapsed_time DESC;  SELECT top 100 t.text,      (qs.total_elapsed_time/1000) / qs.execution_count AS avg_elapsed_time,      (qs.total_worker_time/1000) / qs.execution_count AS avg_cpu_time,      ((qs.total_elapsed_time/1000) / qs.execution_count ) - ((qs.total_worker_time/1000) / qs.execution_count) AS avg_wait_time,      qs.total_logical_reads / qs.execution_count AS avg_logical_reads,      qs.total_logical_writes / qs.execution_count AS avg_writes,      (qs.total_elapsed_time/1000) AS cumulative_elapsed_time_all_executions FROM sys.dm_exec_query_stats qs      CROSS apply sys.Dm_exec_sql_text (sql_handle) t -- WHERE t.text like '<Your Query>%' -- Replace <Your Query> with your query or the beginning part of your query. The special chars like '[','_','%','^' in the query should be escaped. ORDER BY (qs.total_elapsed_time / qs.execution_count) DESC  --Deadlock sql check SELECT     session_id,     start_time,      [status],     command,     blocking_session_id,     wait_type,     wait_time,     open_transaction_count,     transaction_id,     total_elapsed_time,     Definition = CAST(text AS VARCHAR(MAX)) FROM     SYS.DM_EXEC_REQUESTS     CROSS APPLY sys.dm_exec_sql_text(sql_handle)  WHERE blocking_session_id != 0  SELECT sqlserver_start_time, (committed_kb/1024) AS Total_Server_Memory_MB, (committed_target_kb/1024)  AS Target_Server_Memory_MB FROM sys.dm_os_sys_info; ",10,10,0,0,0,10
FETCH API_CURSOR0000000000004EC9 ,10,10,0,9407,0,106
"       SELECT       db_id() AS database_id,       o.[type] AS object_type,       i.[type] AS index_type,       p.[data_compression],       COUNT_BIG(DISTINCT p.[object_id]) AS NumTables,       COUNT_BIG(DISTINCT CAST(p.[object_id] AS VARCHAR(30)) + '|' + CAST(p.[index_id] AS VARCHAR(10))) AS NumIndexes,       ISNULL(px.[IsPartitioned], 0) AS IsPartitioned,       IIF(px.[IsPartitioned] = 1, COUNT_BIG(1), 0) NumPartitions,       SUM(p.[rows]) NumRows       FROM sys.partitions p       INNER JOIN sys.objects o       ON o.[object_id] = p.[object_id]       INNER JOIN sys.indexes i       ON i.[object_id] = p.[object_id]       AND i.[index_id] = p.[index_id]       OUTER APPLY (SELECT       x.[object_id], 1 AS [IsPartitioned]       FROM sys.partitions x       WHERE x.[object_id] = p.[object_id]       GROUP by       x.[object_id]       HAVING MAX(x.partition_number) > 1) px       WHERE o.[type] NOT IN ('S', 'IT')       GROUP BY       o.[type]       ,i.[type]       ,p.[data_compression]       ,px.[IsPartitioned]     ",10,10,0,1560,0,1328
"       SELECT       db_id() AS database_id,       o.[type] AS object_type,       i.[type] AS index_type,       p.[data_compression],       COUNT_BIG(DISTINCT p.[object_id]) AS NumTables,       COUNT_BIG(DISTINCT CAST(p.[object_id] AS VARCHAR(30)) + '|' + CAST(p.[index_id] AS VARCHAR(10))) AS NumIndexes,       ISNULL(px.[IsPartitioned], 0) AS IsPartitioned,       IIF(px.[IsPartitioned] = 1, COUNT_BIG(1), 0) NumPartitions,       SUM(p.[rows]) NumRows       FROM sys.partitions p       INNER JOIN sys.objects o       ON o.[object_id] = p.[object_id]       INNER JOIN sys.indexes i       ON i.[object_id] = p.[object_id]       AND i.[index_id] = p.[index_id]       OUTER APPLY (SELECT       x.[object_id], 1 AS [IsPartitioned]       FROM sys.partitions x       WHERE x.[object_id] = p.[object_id]       GROUP by       x.[object_id]       HAVING MAX(x.partition_number) > 1) px       WHERE o.[type] NOT IN ('S', 'IT')       GROUP BY       o.[type]       ,i.[type]       ,p.[data_compression]       ,px.[IsPartitioned]     ",9,9,0,1544,0,1186
"(@_msparam_0 nvarchar(4000),@_msparam_1 nvarchar(4000))SELECT clmns.column_id AS [ID], clmns.name AS [Name], ISNULL(dc.Name, N'') AS [DefaultConstraintName], clmns.is_nullable AS [Nullable], CAST(ISNULL(cik.index_column_id, 0) AS bit) AS [InPrimaryKey], clmns.is_identity AS [Identity], usrt.name AS [DataType], ISNULL(baset.name, N'') AS [SystemType], CAST(CASE WHEN baset.name IN (N'nchar', N'nvarchar') AND clmns.max_length <> -1 THEN clmns.max_length/2 ELSE clmns.max_length END AS int) AS [Length], CAST(clmns.precision AS int) AS [NumericPrecision], CAST(clmns.scale AS int) AS [NumericScale], ISNULL(xscclmns.name, N'') AS [XmlSchemaNamespace], ISNULL(s2clmns.name, N'') AS [XmlSchemaNamespaceSchema], ISNULL( (case clmns.is_xml_document when 1 then 2 else 1 end), 0) AS [XmlDocumentConstraint], s1clmns.name AS [DataTypeSchema], clmns.is_computed AS [Computed] FROM sys.tables AS tbl INNER JOIN sys.all_columns AS clmns ON clmns.object_id=tbl.object_id LEFT OUTER JOIN sys.default_constraints as dc ON clmns.default_object_id = dc.object_id LEFT OUTER JOIN sys.indexes AS ik ON ik.object_id = clmns.object_id and 1=ik.is_primary_key LEFT OUTER JOIN sys.index_columns AS cik ON cik.index_id = ik.index_id and cik.column_id = clmns.column_id and cik.object_id = clmns.object_id and 0 = cik.is_included_column LEFT OUTER JOIN sys.types AS usrt ON usrt.user_type_id = clmns.user_type_id LEFT OUTER JOIN sys.types AS baset ON (baset.user_type_id = clmns.system_type_id and baset.user_type_id = baset.system_type_id) or ((baset.system_type_id = clmns.system_type_id) and (baset.user_type_id = clmns.user_type_id) and (baset.is_user_defined = 0) and (baset.is_assembly_type = 1))  LEFT OUTER JOIN sys.xml_schema_collections AS xscclmns ON xscclmns.xml_collection_id = clmns.xml_collection_id LEFT OUTER JOIN sys.schemas AS s2clmns ON s2clmns.schema_id = xscclmns.schema_id LEFT OUTER JOIN sys.schemas AS s1clmns ON s1clmns.schema_id = usrt.schema_id WHERE (tbl.name=@_msparam_0 and SCHEMA_NAME(tbl.schema_id)=@_msparam_1) ORDER BY [ID] ASC",8,8,0,2235,0,34
"(@_msparam_0 nvarchar(4000),@_msparam_1 nvarchar(4000))         create table #tempbackup (database_name nvarchar(128), [type] char(1), backup_finish_date datetime)         insert into #tempbackup select database_name, [type], max(backup_finish_date) from msdb..backupset where [type] = 'D' or [type] = 'L' or [type]='I' group by database_name, [type]          SELECT (select backup_finish_date from #tempbackup where type = @_msparam_0 and db_id(database_name) = dtb.database_id) AS [LastBackupDate] FROM master.sys.databases AS dtb WHERE (dtb.name=@_msparam_1)          drop table #tempbackup        ",8,8,0,596,0,8
"(@_msparam_0 nvarchar(4000),@_msparam_1 nvarchar(4000))         create table #tempbackup (database_name nvarchar(128), [type] char(1), backup_finish_date datetime)         insert into #tempbackup select database_name, [type], max(backup_finish_date) from msdb..backupset where [type] = 'D' or [type] = 'L' or [type]='I' group by database_name, [type]          SELECT (select backup_finish_date from #tempbackup where type = @_msparam_0 and db_id(database_name) = dtb.database_id) AS [LastLogBackupDate] FROM master.sys.databases AS dtb WHERE (dtb.name=@_msparam_1)          drop table #tempbackup        ",8,8,0,596,0,8
"       SELECT db_id() AS database_id, o.[type] as ModuleType, COUNT_BIG(*) as ModuleCount       FROM sys.objects AS o WITH(nolock)       WHERE o.type in ('AF', 'F', 'FN', 'FS', 'FT', 'IF', 'P', 'PC', 'TA', 'TF', 'TR', 'X', 'C', 'D', 'PG', 'SN', 'SO', 'SQ', 'TT', 'UQ', 'V')       GROUP BY o.[type]     ",7,7,0,36,0,960
"(@p0 nvarchar(4000),@p1 nvarchar(4000),@p2 nvarchar(4000),@p3 nvarchar(4000),@p4 nvarchar(4000),@p5 nvarchar(4000),@p6 nvarchar(4000),@p7 nvarchar(4000),@p8 nvarchar(4000),@p9 nvarchar(4000),@p10 nvarchar(4000),@p11 datetime2(7),@p12 nvarchar(4000),@p13 nvarchar(4000),@p14 int,@p15 int,@p16 int,@p17 nvarchar(4000),@p18 nvarchar(4000),@p19 nvarchar(4000),@p20 nvarchar(4000),@p21 decimal(18,2),@p22 nvarchar(4000),@p23 nvarchar(4000),@p24 decimal(18,2),@p25 nvarchar(4000),@p26 nvarchar(4000),@p27 nvarchar(4000),@p28 nvarchar(4000),@p29 int,@p30 nvarchar(4000),@p31 nvarchar(4000),@p32 nvarchar(4000),@p33 nvarchar(4000),@p34 nvarchar(4000),@p35 nvarchar(4000),@p36 nvarchar(4000),@p37 nvarchar(4000),@p38 nvarchar(4000),@p39 nvarchar(4000),@p40 int,@p41 nvarchar(4000),@p42 nvarchar(4000),@p43 nvarchar(4000),@p44 nvarchar(4000),@p45 nvarchar(4000),@p46 int,@p47 nvarchar(4000),@p48 int,@p49 int,@p50 datetime2(7),@p51 datetime2(7),@p52 datetime2(7),@p53 nvarchar(4000),@p54 nvarchar(4000),@p55 nvarchar(4000),@p56 nvarchar(4000),@p57 nvarchar(4000),@p58 nvarchar(4000),@p59 nvarchar(4000),@p60 nvarchar(4000),@p61 nvarchar(4000),@p62 nvarchar(4000),@p63 nvarchar(4000),@p64 nvarchar(4000),@p65 nvarchar(4000),@p66 nvarchar(4000),@p67 datetime2(7),@p68 nvarchar(4000),@p69 nvarchar(4000),@p70 int,@p71 int,@p72 int,@p73 nvarchar(4000),@p74 nvarchar(4000),@p75 nvarchar(4000),@p76 nvarchar(4000),@p77 decimal(18,2),@p78 nvarchar(4000),@p79 nvarchar(4000),@p80 decimal(18,2),@p81 nvarchar(4000),@p82 nvarchar(4000),@p83 nvarchar(4000),@p84 nvarchar(4000),@p85 int,@p86 nvarchar(4000),@p87 nvarchar(4000),@p88 nvarchar(4000),@p89 nvarchar(4000),@p90 nvarchar(4000),@p91 nvarchar(4000),@p92 nvarchar(4000),@p93 nvarchar(4000),@p94 nvarchar(4000),@p95 nvarchar(4000),@p96 int,@p97 nvarchar(4000),@p98 nvarchar(4000),@p99 nvarchar(4000),@p100 nvarchar(4000),@p101 nvarchar(4000),@p102 int,@p103 nvarchar(4000),@p104 int,@p105 int,@p106 datetime2(7),@p107 datetime2(7),@p108 datetime2(7),@p109 nvarchar(4000),@p110 nvarchar(4000),@p111 nvarchar(4000),@p112 nvarchar(4000),@p113 nvarchar(4000),@p114 nvarchar(4000),@p115 nvarchar(4000),@p116 nvarchar(4000),@p117 nvarchar(4000),@p118 nvarchar(4000),@p119 nvarchar(4000),@p120 nvarchar(4000),@p121 nvarchar(4000),@p122 nvarchar(4000),@p123 datetime2(7),@p124 nvarchar(4000),@p125 nvarchar(4000),@p126 int,@p127 int,@p128 int,@p129 nvarchar(4000),@p130 nvarchar(4000),@p131 nvarchar(4000),@p132 nvarchar(4000),@p133 decimal(18,2),@p134 nvarchar(4000),@p135 nvarchar(4000),@p136 decimal(18,2),@p137 nvarchar(4000),@p138 nvarchar(4000),@p139 nvarchar(4000),@p140 nvarchar(4000),@p141 int,@p142 nvarchar(4000),@p143 nvarchar(4000),@p144 nvarchar(4000),@p145 nvarchar(4000),@p146 nvarchar(4000),@p147 nvarchar(4000),@p148 nvarchar(4000),@p149 nvarchar(4000),@p150 nvarchar(4000),@p151 nvarchar(4000),@p152 int,@p153 nvarchar(4000),@p154 nvarchar(4000),@p155 nvarchar(4000),@p156 nvarchar(4000),@p157 nvarchar(4000),@p158 int,@p159 nvarchar(4000),@p160 int,@p161 int,@p162 datetime2(7),@p163 datetime2(7),@p164 datetime2(7),@p165 nvarchar(4000),@p166 nvarchar(4000),@p167 nvarchar(4000),@p168 nvarchar(4000),@p169 nvarchar(4000),@p170 nvarchar(4000),@p171 nvarchar(4000),@p172 nvarchar(4000),@p173 nvarchar(4000),@p174 nvarchar(4000),@p175 nvarchar(4000),@p176 nvarchar(4000),@p177 nvarchar(4000),@p178 nvarchar(4000),@p179 datetime2(7),@p180 nvarchar(4000),@p181 nvarchar(4000),@p182 int,@p183 int,@p184 int,@p185 nvarchar(4000),@p186 nvarchar(4000),@p187 nvarchar(4000),@p188 nvarchar(4000),@p189 decimal(18,2),@p190 nvarchar(4000),@p191 nvarchar(4000),@p192 decimal(18,2),@p193 nvarchar(4000),@p194 nvarchar(4000),@p195 nvarchar(4000),@p196 nvarchar(4000),@p197 int,@p198 nvarchar(4000),@p199 nvarchar(4000),@p200 nvarchar(4000),@p201 nvarchar(4000),@p202 nvarchar(4000),@p203 nvarchar(4000),@p204 nvarchar(4000),@p205 nvarchar(4000),@p206 nvarchar(4000),@p207 nvarchar(4000),@p208 int,@p209 nvarchar(4000),@p210 nvarchar(4000),@p211 nvarchar(4000),@p212 nvarchar(4000),@p213 nvarchar(4000),@p214 int,@p215 nvarchar(4000),@p216 int,@p217 int,@p218 datetime2(7),@p219 datetime2(7),@p220 datetime2(7),@p221 nvarchar(4000),@p222 nvarchar(4000),@p223 nvarchar(4000),@p224 nvarchar(4000),@p225 nvarchar(4000),@p226 nvarchar(4000),@p227 nvarchar(4000),@p228 nvarchar(4000),@p229 nvarchar(4000),@p230 nvarchar(4000),@p231 nvarchar(4000),@p232 nvarchar(4000),@p233 nvarchar(4000),@p234 nvarchar(4000),@p235 datetime2(7),@p236 nvarchar(4000),@p237 nvarchar(4000),@p238 int,@p239 int,@p240 int,@p241 nvarchar(4000),@p242 nvarchar(4000),@p243 nvarchar(4000),@p244 nvarchar(4000),@p245 decimal(18,2),@p246 nvarchar(4000),@p247 nvarchar(4000),@p248 decimal(18,2),@p249 nvarchar(4000),@p250 nvarchar(4000),@p251 nvarchar(4000),@p252 nvarchar(4000),@p253 int,@p254 nvarchar(4000),@p255 nvarchar(4000),@p256 nvarchar(4000),@p257 nvarchar(4000),@p258 nvarchar(4000),@p259 nvarchar(4000),@p260 nvarchar(4000),@p261 nvarchar(4000),@p262 nvarchar(4000),@p263 nvarchar(4000),@p264 int,@p265 nvarchar(4000),@p266 nvarchar(4000),@p267 nvarchar(4000),@p268 nvarchar(4000),@p269 nvarchar(4000),@p270 int,@p271 nvarchar(4000),@p272 int,@p273 int,@p274 datetime2(7),@p275 datetime2(7),@p276 datetime2(7),@p277 nvarchar(4000),@p278 nvarchar(4000),@p279 nvarchar(4000),@p280 nvarchar(4000),@p281 nvarchar(4000),@p282 nvarchar(4000),@p283 nvarchar(4000),@p284 nvarchar(4000),@p285 nvarchar(4000),@p286 nvarchar(4000),@p287 nvarchar(4000),@p288 nvarchar(4000),@p289 nvarchar(4000),@p290 nvarchar(4000),@p291 datetime2(7),@p292 nvarchar(4000),@p293 nvarchar(4000),@p294 int,@p295 int,@p296 int,@p297 nvarchar(4000),@p298 nvarchar(4000),@p299 nvarchar(4000),@p300 nvarchar(4000),@p301 decimal(18,2),@p302 nvarchar(4000),@p303 nvarchar(4000),@p304 decimal(18,2),@p305 nvarchar(4000),@p306 nvarchar(4000),@p307 nvarchar(4000),@p308 nvarchar(4000),@p309 int,@p310 nvarchar(4000),@p311 nvarchar(4000),@p312 nvarchar(4000),@p313 nvarchar(4000),@p314 nvarchar(4000),@p315 nvarchar(4000),@p316 nvarchar(4000),@p317 nvarchar(4000),@p318 nvarchar(4000),@p319 nvarchar(4000),@p320 int,@p321 nvarchar(4000),@p322 nvarchar(4000),@p323 nvarchar(4000),@p324 nvarchar(4000),@p325 nvarchar(4000),@p326 int,@p327 nvarchar(4000),@p328 int,@p329 int,@p330 datetime2(7),@p331 datetime2(7),@p332 datetime2(7),@p333 nvarchar(4000),@p334 nvarchar(4000),@p335 nvarchar(4000),@p336 nvarchar(4000),@p337 nvarchar(4000),@p338 nvarchar(4000),@p339 nvarchar(4000),@p340 nvarchar(4000),@p341 nvarchar(4000),@p342 nvarchar(4000),@p343 nvarchar(4000),@p344 nvarchar(4000),@p345 nvarchar(4000),@p346 nvarchar(4000),@p347 datetime2(7),@p348 nvarchar(4000),@p349 nvarchar(4000),@p350 int,@p351 int,@p352 int,@p353 nvarchar(4000),@p354 nvarchar(4000),@p355 nvarchar(4000),@p356 nvarchar(4000),@p357 decimal(18,2),@p358 nvarchar(4000),@p359 nvarchar(4000),@p360 decimal(18,2),@p361 nvarchar(4000),@p362 nvarchar(4000),@p363 nvarchar(4000),@p364 nvarchar(4000),@p365 int,@p366 nvarchar(4000),@p367 nvarchar(4000),@p368 nvarchar(4000),@p369 nvarchar(4000),@p370 nvarchar(4000),@p371 nvarchar(4000),@p372 nvarchar(4000),@p373 nvarchar(4000),@p374 nvarchar(4000),@p375 nvarchar(4000),@p376 int,@p377 nvarchar(4000),@p378 nvarchar(4000),@p379 nvarchar(4000),@p380 nvarchar(4000),@p381 nvarchar(4000),@p382 int,@p383 nvarchar(4000),@p384 int,@p385 int,@p386 datetime2(7),@p387 datetime2(7),@p388 datetime2(7),@p389 nvarchar(4000),@p390 nvarchar(4000),@p391 nvarchar(4000),@p392 nvarchar(4000),@p393 nvarchar(4000),@p394 nvarchar(4000),@p395 nvarchar(4000),@p396 nvarchar(4000),@p397 nvarchar(4000),@p398 nvarchar(4000),@p399 nvarchar(4000),@p400 nvarchar(4000),@p401 nvarchar(4000),@p402 nvarchar(4000),@p403 datetime2(7),@p404 nvarchar(4000),@p405 nvarchar(4000),@p406 int,@p407 int,@p408 int,@p409 nvarchar(4000),@p410 nvarchar(4000),@p411 nvarchar(4000),@p412 nvarchar(4000),@p413 decimal(18,2),@p414 nvarchar(4000),@p415 nvarchar(4000),@p416 decimal(18,2),@p417 nvarchar(4000),@p418 nvarchar(4000),@p419 nvarchar(4000),@p420 nvarchar(4000),@p421 int,@p422 nvarchar(4000),@p423 nvarchar(4000),@p424 nvarchar(4000),@p425 nvarchar(4000),@p426 nvarchar(4000),@p427 nvarchar(4000),@p428 nvarchar(4000),@p429 nvarchar(4000),@p430 nvarchar(4000),@p431 nvarchar(4000),@p432 int,@p433 nvarchar(4000),@p434 nvarchar(4000),@p435 nvarchar(4000),@p436 nvarchar(4000),@p437 nvarchar(4000),@p438 int,@p439 nvarchar(4000),@p440 int,@p441 int,@p442 datetime2(7),@p443 datetime2(7),@p444 datetime2(7),@p445 nvarchar(4000),@p446 nvarchar(4000),@p447 nvarchar(4000),@p448 nvarchar(4000),@p449 nvarchar(4000),@p450 nvarchar(4000),@p451 nvarchar(4000),@p452 nvarchar(4000),@p453 nvarchar(4000),@p454 nvarchar(4000),@p455 nvarchar(4000),@p456 nvarchar(4000),@p457 nvarchar(4000),@p458 nvarchar(4000),@p459 datetime2(7),@p460 nvarchar(4000),@p461 nvarchar(4000),@p462 int,@p463 int,@p464 int,@p465 nvarchar(4000),@p466 nvarchar(4000),@p467 nvarchar(4000),@p468 nvarchar(4000),@p469 decimal(18,2),@p470 nvarchar(4000),@p471 nvarchar(4000),@p472 decimal(18,2),@p473 nvarchar(4000),@p474 nvarchar(4000),@p475 nvarchar(4000),@p476 nvarchar(4000),@p477 int,@p478 nvarchar(4000),@p479 nvarchar(4000),@p480 nvarchar(4000),@p481 nvarchar(4000),@p482 nvarchar(4000),@p483 nvarchar(4000),@p484 nvarchar(4000),@p485 nvarchar(4000),@p486 nvarchar(4000),@p487 nvarchar(4000),@p488 int,@p489 nvarchar(4000),@p490 nvarchar(4000),@p491 nvarchar(4000),@p492 nvarchar(4000),@p493 nvarchar(4000),@p494 int,@p495 nvarchar(4000),@p496 int,@p497 int,@p498 datetime2(7),@p499 datetime2(7),@p500 datetime2(7),@p501 nvarchar(4000),@p502 nvarchar(4000),@p503 nvarchar(4000),@p504 nvarchar(4000),@p505 nvarchar(4000),@p506 nvarchar(4000),@p507 nvarchar(4000),@p508 nvarchar(4000),@p509 nvarchar(4000),@p510 nvarchar(4000),@p511 nvarchar(4000),@p512 nvarchar(4000),@p513 nvarchar(4000),@p514 nvarchar(4000),@p515 datetime2(7),@p516 nvarchar(4000),@p517 nvarchar(4000),@p518 int,@p519 int,@p520 int,@p521 nvarchar(4000),@p522 nvarchar(4000),@p523 nvarchar(4000),@p524 nvarchar(4000),@p525 decimal(18,2),@p526 nvarchar(4000),@p527 nvarchar(4000),@p528 decimal(18,2),@p529 nvarchar(4000),@p530 nvarchar(4000),@p531 nvarchar(4000),@p532 nvarchar(4000),@p533 int,@p534 nvarchar(4000),@p535 nvarchar(4000),@p536 nvarchar(4000),@p537 nvarchar(4000),@p538 nvarchar(4000),@p539 nvarchar(4000),@p540 nvarchar(4000),@p541 nvarchar(4000),@p542 nvarchar(4000),@p543 nvarchar(4000),@p544 int,@p545 nvarchar(4000),@p546 nvarchar(4000),@p547 nvarchar(4000),@p548 nvarchar(4000),@p549 nvarchar(4000),@p550 int,@p551 nvarchar(4000),@p552 int,@p553 int,@p554 datetime2(7),@p555 datetime2(7),@p556 datetime2(7),@p557 nvarchar(4000),@p558 nvarchar(4000),@p559 nvarchar(4000),@p560 nvarchar(4000),@p561 nvarchar(4000),@p562 nvarchar(4000),@p563 nvarchar(4000),@p564 nvarchar(4000),@p565 nvarchar(4000),@p566 nvarchar(4000),@p567 nvarchar(4000),@p568 nvarchar(4000),@p569 nvarchar(4000),@p570 nvarchar(4000),@p571 datetime2(7),@p572 nvarchar(4000),@p573 nvarchar(4000),@p574 int,@p575 int,@p576 int,@p577 nvarchar(4000),@p578 nvarchar(4000),@p579 nvarchar(4000),@p580 nvarchar(4000),@p581 decimal(18,2),@p582 nvarchar(4000),@p583 nvarchar(4000),@p584 decimal(18,2),@p585 nvarchar(4000),@p586 nvarchar(4000),@p587 nvarchar(4000),@p588 nvarchar(4000),@p589 int,@p590 nvarchar(4000),@p591 nvarchar(4000),@p592 nvarchar(4000),@p593 nvarchar(4000),@p594 nvarchar(4000),@p595 nvarchar(4000),@p596 nvarchar(4000),@p597 nvarchar(4000),@p598 nvarchar(4000),@p599 nvarchar(4000),@p600 int,@p601 nvarchar(4000),@p602 nvarchar(4000),@p603 nvarchar(4000),@p604 nvarchar(4000),@p605 nvarchar(4000),@p606 int,@p607 nvarchar(4000),@p608 int,@p609 int,@p610 datetime2(7),@p611 datetime2(7),@p612 datetime2(7),@p613 nvarchar(4000),@p614 nvarchar(4000),@p615 nvarchar(4000),@p616 nvarchar(4000),@p617 nvarchar(4000),@p618 nvarchar(4000),@p619 nvarchar(4000),@p620 nvarchar(4000),@p621 nvarchar(4000),@p622 nvarchar(4000),@p623 nvarchar(4000),@p624 nvarchar(4000),@p625 nvarchar(4000),@p626 nvarchar(4000),@p627 datetime2(7),@p628 nvarchar(4000),@p629 nvarchar(4000),@p630 int,@p631 int,@p632 int,@p633 nvarchar(4000),@p634 nvarchar(4000),@p635 nvarchar(4000),@p636 nvarchar(4000),@p637 decimal(18,2),@p638 nvarchar(4000),@p639 nvarchar(4000),@p640 decimal(18,2),@p641 nvarchar(4000),@p642 nvarchar(4000),@p643 nvarchar(4000),@p644 nvarchar(4000),@p645 int,@p646 nvarchar(4000),@p647 nvarchar(4000),@p648 nvarchar(4000),@p649 nvarchar(4000),@p650 nvarchar(4000),@p651 nvarchar(4000),@p652 nvarchar(4000),@p653 nvarchar(4000),@p654 nvarchar(4000),@p655 nvarchar(4000),@p656 int,@p657 nvarchar(4000),@p658 nvarchar(4000),@p659 nvarchar(4000),@p660 nvarchar(4000),@p661 nvarchar(4000),@p662 int,@p663 nvarchar(4000),@p664 int,@p665 int,@p666 datetime2(7),@p667 datetime2(7),@p668 datetime2(7),@p669 nvarchar(4000),@p670 nvarchar(4000),@p671 nvarchar(4000),@p672 nvarchar(4000),@p673 nvarchar(4000),@p674 nvarchar(4000),@p675 nvarchar(4000),@p676 nvarchar(4000),@p677 nvarchar(4000),@p678 nvarchar(4000),@p679 nvarchar(4000),@p680 nvarchar(4000),@p681 nvarchar(4000),@p682 nvarchar(4000),@p683 datetime2(7),@p684 nvarchar(4000),@p685 nvarchar(4000),@p686 int,@p687 int,@p688 int,@p689 nvarchar(4000),@p690 nvarchar(4000),@p691 nvarchar(4000),@p692 nvarchar(4000),@p693 decimal(18,2),@p694 nvarchar(4000),@p695 nvarchar(4000),@p696 decimal(18,2),@p697 nvarchar(4000),@p698 nvarchar(4000),@p699 nvarchar(4000),@p700 nvarchar(4000),@p701 int,@p702 nvarchar(4000),@p703 nvarchar(4000),@p704 nvarchar(4000),@p705 nvarchar(4000),@p706 nvarchar(4000),@p707 nvarchar(4000),@p708 nvarchar(4000),@p709 nvarchar(4000),@p710 nvarchar(4000),@p711 nvarchar(4000),@p712 int,@p713 nvarchar(4000),@p714 nvarchar(4000),@p715 nvarchar(4000),@p716 nvarchar(4000),@p717 nvarchar(4000),@p718 int,@p719 nvarchar(4000),@p720 int,@p721 int,@p722 datetime2(7),@p723 datetime2(7),@p724 datetime2(7),@p725 nvarchar(4000),@p726 nvarchar(4000),@p727 nvarchar(4000),@p728 nvarchar(4000),@p729 nvarchar(4000),@p730 nvarchar(4000),@p731 nvarchar(4000),@p732 nvarchar(4000),@p733 nvarchar(4000),@p734 nvarchar(4000),@p735 nvarchar(4000),@p736 nvarchar(4000),@p737 nvarchar(4000),@p738 nvarchar(4000),@p739 datetime2(7),@p740 nvarchar(4000),@p741 nvarchar(4000),@p742 int,@p743 int,@p744 int,@p745 nvarchar(4000),@p746 nvarchar(4000),@p747 nvarchar(4000),@p748 nvarchar(4000),@p749 decimal(18,2),@p750 nvarchar(4000),@p751 nvarchar(4000),@p752 decimal(18,2),@p753 nvarchar(4000),@p754 nvarchar(4000),@p755 nvarchar(4000),@p756 nvarchar(4000),@p757 int,@p758 nvarchar(4000),@p759 nvarchar(4000),@p760 nvarchar(4000),@p761 nvarchar(4000),@p762 nvarchar(4000),@p763 nvarchar(4000),@p764 nvarchar(4000),@p765 nvarchar(4000),@p766 nvarchar(4000),@p767 nvarchar(4000),@p768 int,@p769 nvarchar(4000),@p770 nvarchar(4000),@p771 nvarchar(4000),@p772 nvarchar(4000),@p773 nvarchar(4000),@p774 int,@p775 nvarchar(4000),@p776 int,@p777 int,@p778 datetime2(7),@p779 datetime2(7),@p780 datetime2(7),@p781 nvarchar(4000),@p782 nvarchar(4000),@p783 nvarchar(4000),@p784 nvarchar(4000),@p785 nvarchar(4000),@p786 nvarchar(4000),@p787 nvarchar(4000),@p788 nvarchar(4000),@p789 nvarchar(4000),@p790 nvarchar(4000),@p791 nvarchar(4000),@p792 nvarchar(4000),@p793 nvarchar(4000),@p794 nvarchar(4000),@p795 datetime2(7),@p796 nvarchar(4000),@p797 nvarchar(4000),@p798 int,@p799 int,@p800 int,@p801 nvarchar(4000),@p802 nvarchar(4000),@p803 nvarchar(4000),@p804 decimal(18,2),@p805 decimal(18,2),@p806 nvarchar(4000),@p807 nvarchar(4000),@p808 decimal(18,2),@p809 nvarchar(4000),@p810 nvarchar(4000),@p811 nvarchar(4000),@p812 nvarchar(4000),@p813 int,@p814 nvarchar(4000),@p815 nvarchar(4000),@p816 nvarchar(4000),@p817 nvarchar(4000),@p818 nvarchar(4000),@p819 nvarchar(4000),@p820 nvarchar(4000),@p821 nvarchar(4000),@p822 nvarchar(4000),@p823 nvarchar(4000),@p824 int,@p825 nvarchar(4000),@p826 nvarchar(4000),@p827 nvarchar(4000),@p828 nvarchar(4000),@p829 nvarchar(4000),@p830 int,@p831 nvarchar(4000),@p832 int,@p833 int,@p834 datetime2(7),@p835 datetime2(7),@p836 datetime2(7),@p837 nvarchar(4000),@p838 nvarchar(4000),@p839 nvarchar(4000),@p840 nvarchar(4000),@p841 nvarchar(4000),@p842 nvarchar(4000),@p843 nvarchar(4000),@p844 nvarchar(4000),@p845 nvarchar(4000),@p846 nvarchar(4000),@p847 nvarchar(4000),@p848 nvarchar(4000),@p849 nvarchar(4000),@p850 nvarchar(4000),@p851 datetime2(7),@p852 nvarchar(4000),@p853 nvarchar(4000),@p854 int,@p855 int,@p856 int,@p857 nvarchar(4000),@p858 nvarchar(4000),@p859 nvarchar(4000),@p860 nvarchar(4000),@p861 decimal(18,2),@p862 nvarchar(4000),@p863 nvarchar(4000),@p864 decimal(18,2),@p865 nvarchar(4000),@p866 nvarchar(4000),@p867 nvarchar(4000),@p868 nvarchar(4000),@p869 int,@p870 nvarchar(4000),@p871 nvarchar(4000),@p872 nvarchar(4000),@p873 nvarchar(4000),@p874 nvarchar(4000),@p875 nvarchar(4000),@p876 nvarchar(4000),@p877 nvarchar(4000),@p878 nvarchar(4000),@p879 nvarchar(4000),@p880 int,@p881 nvarchar(4000),@p882 nvarchar(4000),@p883 nvarchar(4000),@p884 nvarchar(4000),@p885 nvarchar(4000),@p886 int,@p887 nvarchar(4000),@p888 int,@p889 int,@p890 datetime2(7),@p891 datetime2(7),@p892 datetime2(7),@p893 nvarchar(4000),@p894 nvarchar(4000),@p895 nvarchar(4000),@p896 nvarchar(4000),@p897 nvarchar(4000),@p898 nvarchar(4000),@p899 nvarchar(4000),@p900 nvarchar(4000),@p901 nvarchar(4000),@p902 nvarchar(4000),@p903 nvarchar(4000),@p904 nvarchar(4000),@p905 nvarchar(4000),@p906 nvarchar(4000),@p907 datetime2(7),@p908 nvarchar(4000),@p909 nvarchar(4000),@p910 int,@p911 int,@p912 int,@p913 nvarchar(4000),@p914 nvarchar(4000),@p915 nvarchar(4000),@p916 decimal(18,2),@p917 decimal(18,2),@p918 nvarchar(4000),@p919 nvarchar(4000),@p920 decimal(18,2),@p921 nvarchar(4000),@p922 nvarchar(4000),@p923 nvarchar(4000),@p924 nvarchar(4000),@p925 int,@p926 nvarchar(4000),@p927 nvarchar(4000),@p928 nvarchar(4000),@p929 nvarchar(4000),@p930 nvarchar(4000),@p931 nvarchar(4000),@p932 nvarchar(4000),@p933 nvarchar(4000),@p934 nvarchar(4000),@p935 nvarchar(4000),@p936 int,@p937 nvarchar(4000),@p938 nvarchar(4000),@p939 nvarchar(4000),@p940 nvarchar(4000),@p941 nvarchar(4000),@p942 int,@p943 nvarchar(4000),@p944 int,@p945 int,@p946 datetime2(7),@p947 datetime2(7),@p948 datetime2(7),@p949 nvarchar(4000),@p950 nvarchar(4000),@p951 nvarchar(4000),@p952 nvarchar(4000),@p953 nvarchar(4000),@p954 nvarchar(4000),@p955 nvarchar(4000),@p956 nvarchar(4000),@p957 nvarchar(4000),@p958 nvarchar(4000),@p959 nvarchar(4000),@p960 nvarchar(4000),@p961 nvarchar(4000),@p962 nvarchar(4000),@p963 datetime2(7),@p964 nvarchar(4000),@p965 nvarchar(4000),@p966 int,@p967 int,@p968 int,@p969 nvarchar(4000),@p970 nvarchar(4000),@p971 nvarchar(4000),@p972 decimal(18,2),@p973 decimal(18,2),@p974 nvarchar(4000),@p975 nvarchar(4000),@p976 decimal(18,2),@p977 nvarchar(4000),@p978 nvarchar(4000),@p979 nvarchar(4000),@p980 nvarchar(4000),@p981 int,@p982 nvarchar(4000),@p983 nvarchar(4000),@p984 nvarchar(4000),@p985 nvarchar(4000),@p986 nvarchar(4000),@p987 nvarchar(4000),@p988 nvarchar(4000),@p989 nvarchar(4000),@p990 nvarchar(4000),@p991 nvarchar(4000),@p992 int,@p993 nvarchar(4000),@p994 nvarchar(4000),@p995 nvarchar(4000),@p996 nvarchar(4000),@p997 nvarchar(4000),@p998 int,@p999 nvarchar(4000),@p1000 int,@p1001 int,@p1002 datetime2(7),@p1003 datetime2(7),@p1004 datetime2(7),@p1005 nvarchar(4000),@p1006 nvarchar(4000),@p1007 nvarchar(4000),@p1008 nvarchar(4000),@p1009 nvarchar(4000),@p1010 nvarchar(4000),@p1011 nvarchar(4000),@p1012 nvarchar(4000),@p1013 nvarchar(4000),@p1014 nvarchar(4000),@p1015 nvarchar(4000),@p1016 nvarchar(4000),@p1017 nvarchar(4000),@p1018 nvarchar(4000),@p1019 datetime2(7),@p1020 nvarchar(4000),@p1021 nvarchar(4000),@p1022 int,@p1023 int,@p1024 int,@p1025 nvarchar(4000),@p1026 nvarchar(4000),@p1027 nvarchar(4000),@p1028 decimal(18,2),@p1029 decimal(18,2),@p1030 nvarchar(4000),@p1031 nvarchar(4000),@p1032 decimal(18,2),@p1033 nvarchar(4000),@p1034 nvarchar(4000),@p1035 nvarchar(4000),@p1036 nvarchar(4000),@p1037 int,@p1038 nvarchar(4000),@p1039 nvarchar(4000),@p1040 nvarchar(4000),@p1041 nvarchar(4000),@p1042 nvarchar(4000),@p1043 nvarchar(4000),@p1044 nvarchar(4000),@p1045 nvarchar(4000),@p1046 nvarchar(4000),@p1047 nvarchar(4000),@p1048 int,@p1049 nvarchar(4000),@p1050 nvarchar(4000),@p1051 nvarchar(4000),@p1052 nvarchar(4000),@p1053 nvarchar(4000),@p1054 int,@p1055 nvarchar(4000),@p1056 int,@p1057 int,@p1058 datetime2(7),@p1059 datetime2(7),@p1060 datetime2(7),@p1061 nvarchar(4000),@p1062 nvarchar(4000),@p1063 nvarchar(4000),@p1064 nvarchar(4000),@p1065 nvarchar(4000),@p1066 nvarchar(4000),@p1067 nvarchar(4000),@p1068 nvarchar(4000),@p1069 nvarchar(4000),@p1070 nvarchar(4000),@p1071 nvarchar(4000),@p1072 nvarchar(4000),@p1073 nvarchar(4000),@p1074 nvarchar(4000),@p1075 datetime2(7),@p1076 nvarchar(4000),@p1077 nvarchar(4000),@p1078 int,@p1079 int,@p1080 int,@p1081 nvarchar(4000),@p1082 nvarchar(4000),@p1083 nvarchar(4000),@p1084 nvarchar(4000),@p1085 decimal(18,2),@p1086 nvarchar(4000),@p1087 nvarchar(4000),@p1088 decimal(18,2),@p1089 nvarchar(4000),@p1090 nvarchar(4000),@p1091 nvarchar(4000),@p1092 nvarchar(4000),@p1093 int,@p1094 nvarchar(4000),@p1095 nvarchar(4000),@p1096 nvarchar(4000),@p1097 nvarchar(4000),@p1098 nvarchar(4000),@p1099 nvarchar(4000),@p1100 nvarchar(4000),@p1101 nvarchar(4000),@p1102 nvarchar(4000),@p1103 nvarchar(4000),@p1104 int,@p1105 nvarchar(4000),@p1106 nvarchar(4000),@p1107 nvarchar(4000),@p1108 nvarchar(4000),@p1109 nvarchar(4000),@p1110 int,@p1111 nvarchar(4000),@p1112 int,@p1113 int,@p1114 datetime2(7),@p1115 datetime2(7),@p1116 datetime2(7),@p1117 nvarchar(4000),@p1118 nvarchar(4000),@p1119 nvarchar(4000),@p1120 nvarchar(4000),@p1121 nvarchar(4000),@p1122 nvarchar(4000),@p1123 nvarchar(4000),@p1124 nvarchar(4000),@p1125 nvarchar(4000),@p1126 nvarchar(4000),@p1127 nvarchar(4000),@p1128 nvarchar(4000),@p1129 nvarchar(4000),@p1130 nvarchar(4000),@p1131 datetime2(7),@p1132 nvarchar(4000),@p1133 nvarchar(4000),@p1134 int,@p1135 int,@p1136 int,@p1137 nvarchar(4000),@p1138 nvarchar(4000),@p1139 nvarchar(4000),@p1140 nvarchar(4000),@p1141 decimal(18,2),@p1142 nvarchar(4000),@p1143 nvarchar(4000),@p1144 decimal(18,2),@p1145 nvarchar(4000),@p1146 nvarchar(4000),@p1147 nvarchar(4000),@p1148 nvarchar(4000),@p1149 int,@p1150 nvarchar(4000),@p1151 nvarchar(4000),@p1152 nvarchar(4000),@p1153 nvarchar(4000),@p1154 nvarchar(4000),@p1155 nvarchar(4000),@p1156 nvarchar(4000),@p1157 nvarchar(4000),@p1158 nvarchar(4000),@p1159 nvarchar(4000),@p1160 int,@p1161 nvarchar(4000),@p1162 nvarchar(4000),@p1163 nvarchar(4000),@p1164 nvarchar(4000),@p1165 nvarchar(4000),@p1166 int,@p1167 nvarchar(4000),@p1168 int,@p1169 int,@p1170 datetime2(7),@p1171 datetime2(7),@p1172 datetime2(7),@p1173 nvarchar(4000),@p1174 nvarchar(4000),@p1175 nvarchar(4000),@p1176 nvarchar(4000),@p1177 nvarchar(4000),@p1178 nvarchar(4000),@p1179 nvarchar(4000),@p1180 nvarchar(4000),@p1181 nvarchar(4000),@p1182 nvarchar(4000),@p1183 nvarchar(4000),@p1184 nvarchar(4000),@p1185 nvarchar(4000),@p1186 nvarchar(4000),@p1187 datetime2(7),@p1188 nvarchar(4000),@p1189 nvarchar(4000),@p1190 int,@p1191 int,@p1192 int,@p1193 nvarchar(4000),@p1194 nvarchar(4000),@p1195 nvarchar(4000),@p1196 nvarchar(4000),@p1197 decimal(18,2),@p1198 nvarchar(4000),@p1199 nvarchar(4000),@p1200 decimal(18,2),@p1201 nvarchar(4000),@p1202 nvarchar(4000),@p1203 nvarchar(4000),@p1204 nvarchar(4000),@p1205 int,@p1206 nvarchar(4000),@p1207 nvarchar(4000),@p1208 nvarchar(4000),@p1209 nvarchar(4000),@p1210 nvarchar(4000),@p1211 nvarchar(4000),@p1212 nvarchar(4000),@p1213 nvarchar(4000),@p1214 nvarchar(4000),@p1215 nvarchar(4000),@p1216 int,@p1217 nvarchar(4000),@p1218 nvarchar(4000),@p1219 nvarchar(4000),@p1220 nvarchar(4000),@p1221 nvarchar(4000),@p1222 int,@p1223 nvarchar(4000),@p1224 int,@p1225 int,@p1226 datetime2(7),@p1227 datetime2(7),@p1228 datetime2(7),@p1229 nvarchar(4000),@p1230 nvarchar(4000),@p1231 nvarchar(4000),@p1232 nvarchar(4000),@p1233 nvarchar(4000),@p1234 nvarchar(4000),@p1235 nvarchar(4000),@p1236 nvarchar(4000),@p1237 nvarchar(4000),@p1238 nvarchar(4000),@p1239 nvarchar(4000),@p1240 nvarchar(4000),@p1241 nvarchar(4000),@p1242 nvarchar(4000),@p1243 datetime2(7),@p1244 nvarchar(4000),@p1245 nvarchar(4000),@p1246 int,@p1247 int,@p1248 int,@p1249 nvarchar(4000),@p1250 nvarchar(4000),@p1251 nvarchar(4000),@p1252 nvarchar(4000),@p1253 decimal(18,2),@p1254 nvarchar(4000),@p1255 nvarchar(4000),@p1256 decimal(18,2),@p1257 nvarchar(4000),@p1258 nvarchar(4000),@p1259 nvarchar(4000),@p1260 nvarchar(4000),@p1261 int,@p1262 nvarchar(4000),@p1263 nvarchar(4000),@p1264 nvarchar(4000),@p1265 nvarchar(4000),@p1266 nvarchar(4000),@p1267 nvarchar(4000),@p1268 nvarchar(4000),@p1269 nvarchar(4000),@p1270 nvarchar(4000),@p1271 nvarchar(4000),@p1272 int,@p1273 nvarchar(4000),@p1274 nvarchar(4000),@p1275 nvarchar(4000),@p1276 nvarchar(4000),@p1277 nvarchar(4000),@p1278 int,@p1279 nvarchar(4000),@p1280 int,@p1281 int,@p1282 datetime2(7),@p1283 datetime2(7),@p1284 datetime2(7),@p1285 nvarchar(4000),@p1286 nvarchar(4000),@p1287 nvarchar(4000),@p1288 nvarchar(4000),@p1289 nvarchar(4000),@p1290 nvarchar(4000),@p1291 nvarchar(4000),@p1292 nvarchar(4000),@p1293 nvarchar(4000),@p1294 nvarchar(4000),@p1295 nvarchar(4000),@p1296 nvarchar(4000),@p1297 nvarchar(4000),@p1298 nvarchar(4000),@p1299 datetime2(7),@p1300 nvarchar(4000),@p1301 nvarchar(4000),@p1302 int,@p1303 int,@p1304 int,@p1305 nvarchar(4000),@p1306 nvarchar(4000),@p1307 nvarchar(4000),@p1308 nvarchar(4000),@p1309 decimal(18,2),@p1310 nvarchar(4000),@p1311 nvarchar(4000),@p1312 decimal(18,2),@p1313 nvarchar(4000),@p1314 nvarchar(4000),@p1315 nvarchar(4000),@p1316 nvarchar(4000),@p1317 int,@p1318 nvarchar(4000),@p1319 nvarchar(4000),@p1320 nvarchar(4000),@p1321 nvarchar(4000),@p1322 nvarchar(4000),@p1323 nvarchar(4000),@p1324 nvarchar(4000),@p1325 nvarchar(4000),@p1326 nvarchar(4000),@p1327 nvarchar(4000),@p1328 int,@p1329 nvarchar(4000),@p1330 nvarchar(4000),@p1331 nvarchar(4000),@p1332 nvarchar(4000),@p1333 nvarchar(4000),@p1334 int,@p1335 nvarchar(4000),@p1336 int,@p1337 int,@p1338 datetime2(7),@p1339 datetime2(7),@p1340 datetime2(7),@p1341 nvarchar(4000),@p1342 nvarchar(4000),@p1343 nvarchar(4000),@p1344 nvarchar(4000),@p1345 nvarchar(4000),@p1346 nvarchar(4000),@p1347 nvarchar(4000),@p1348 nvarchar(4000),@p1349 nvarchar(4000),@p1350 nvarchar(4000),@p1351 nvarchar(4000),@p1352 nvarchar(4000),@p1353 nvarchar(4000),@p1354 nvarchar(4000),@p1355 datetime2(7),@p1356 nvarchar(4000),@p1357 nvarchar(4000),@p1358 int,@p1359 int,@p1360 int,@p1361 nvarchar(4000),@p1362 nvarchar(4000),@p1363 nvarchar(4000),@p1364 nvarchar(4000),@p1365 decimal(18,2),@p1366 nvarchar(4000),@p1367 nvarchar(4000),@p1368 decimal(18,2),@p1369 nvarchar(4000),@p1370 nvarchar(4000),@p1371 nvarchar(4000),@p1372 nvarchar(4000),@p1373 int,@p1374 nvarchar(4000),@p1375 nvarchar(4000),@p1376 nvarchar(4000),@p1377 nvarchar(4000),@p1378 nvarchar(4000),@p1379 nvarchar(4000),@p1380 nvarchar(4000),@p1381 nvarchar(4000),@p1382 nvarchar(4000),@p1383 nvarchar(4000),@p1384 int,@p1385 nvarchar(4000),@p1386 nvarchar(4000),@p1387 nvarchar(4000),@p1388 nvarchar(4000),@p1389 nvarchar(4000),@p1390 int,@p1391 nvarchar(4000),@p1392 int,@p1393 int,@p1394 datetime2(7),@p1395 datetime2(7),@p1396 datetime2(7),@p1397 nvarchar(4000),@p1398 nvarchar(4000),@p1399 nvarchar(4000),@p1400 nvarchar(4000),@p1401 nvarchar(4000),@p1402 nvarchar(4000),@p1403 nvarchar(4000),@p1404 nvarchar(4000),@p1405 nvarchar(4000),@p1406 nvarchar(4000),@p1407 nvarchar(4000),@p1408 nvarchar(4000),@p1409 nvarchar(4000),@p1410 nvarchar(4000),@p1411 datetime2(7),@p1412 nvarchar(4000),@p1413 nvarchar(4000),@p1414 int,@p1415 int,@p1416 int,@p1417 nvarchar(4000),@p1418 nvarchar(4000),@p1419 nvarchar(4000),@p1420 nvarchar(4000),@p1421 decimal(18,2),@p1422 nvarchar(4000),@p1423 nvarchar(4000),@p1424 decimal(18,2),@p1425 nvarchar(4000),@p1426 nvarchar(4000),@p1427 nvarchar(4000),@p1428 nvarchar(4000),@p1429 int,@p1430 nvarchar(4000),@p1431 nvarchar(4000),@p1432 nvarchar(4000),@p1433 nvarchar(4000),@p1434 nvarchar(4000),@p1435 nvarchar(4000),@p1436 nvarchar(4000),@p1437 nvarchar(4000),@p1438 nvarchar(4000),@p1439 nvarchar(4000),@p1440 int,@p1441 nvarchar(4000),@p1442 nvarchar(4000),@p1443 nvarchar(4000),@p1444 nvarchar(4000),@p1445 nvarchar(4000),@p1446 int,@p1447 nvarchar(4000),@p1448 int,@p1449 int,@p1450 datetime2(7),@p1451 datetime2(7),@p1452 datetime2(7),@p1453 nvarchar(4000),@p1454 nvarchar(4000),@p1455 nvarchar(4000),@p1456 nvarchar(4000),@p1457 nvarchar(4000),@p1458 nvarchar(4000),@p1459 nvarchar(4000),@p1460 nvarchar(4000),@p1461 nvarchar(4000),@p1462 nvarchar(4000),@p1463 nvarchar(4000),@p1464 nvarchar(4000),@p1465 nvarchar(4000),@p1466 nvarchar(4000),@p1467 datetime2(7),@p1468 nvarchar(4000),@p1469 nvarchar(4000),@p1470 int,@p1471 int,@p1472 int,@p1473 nvarchar(4000),@p1474 nvarchar(4000),@p1475 nvarchar(4000),@p1476 nvarchar(4000),@p1477 decimal(18,2),@p1478 nvarchar(4000),@p1479 nvarchar(4000),@p1480 decimal(18,2),@p1481 nvarchar(4000),@p1482 nvarchar(4000),@p1483 nvarchar(4000),@p1484 nvarchar(4000),@p1485 int,@p1486 nvarchar(4000),@p1487 nvarchar(4000),@p1488 nvarchar(4000),@p1489 nvarchar(4000),@p1490 nvarchar(4000),@p1491 nvarchar(4000),@p1492 nvarchar(4000),@p1493 nvarchar(4000),@p1494 nvarchar(4000),@p1495 nvarchar(4000),@p1496 int,@p1497 nvarchar(4000),@p1498 nvarchar(4000),@p1499 nvarchar(4000),@p1500 nvarchar(4000),@p1501 nvarchar(4000),@p1502 int,@p1503 nvarchar(4000),@p1504 int,@p1505 int,@p1506 datetime2(7),@p1507 datetime2(7),@p1508 datetime2(7),@p1509 nvarchar(4000),@p1510 nvarchar(4000),@p1511 nvarchar(4000),@p1512 nvarchar(4000),@p1513 nvarchar(4000),@p1514 nvarchar(4000),@p1515 nvarchar(4000),@p1516 nvarchar(4000),@p1517 nvarchar(4000),@p1518 nvarchar(4000),@p1519 nvarchar(4000),@p1520 nvarchar(4000),@p1521 nvarchar(4000),@p1522 nvarchar(4000),@p1523 datetime2(7),@p1524 nvarchar(4000),@p1525 nvarchar(4000),@p1526 int,@p1527 int,@p1528 int,@p1529 nvarchar(4000),@p1530 nvarchar(4000),@p1531 nvarchar(4000),@p1532 nvarchar(4000),@p1533 decimal(18,2),@p1534 nvarchar(4000),@p1535 nvarchar(4000),@p1536 decimal(18,2),@p1537 nvarchar(4000),@p1538 nvarchar(4000),@p1539 nvarchar(4000),@p1540 nvarchar(4000),@p1541 int,@p1542 nvarchar(4000),@p1543 nvarchar(4000),@p1544 nvarchar(4000),@p1545 nvarchar(4000),@p1546 nvarchar(4000),@p1547 nvarchar(4000),@p1548 nvarchar(4000),@p1549 nvarchar(4000),@p1550 nvarchar(4000),@p1551 nvarchar(4000),@p1552 int,@p1553 nvarchar(4000),@p1554 nvarchar(4000),@p1555 nvarchar(4000),@p1556 nvarchar(4000),@p1557 nvarchar(4000),@p1558 int,@p1559 nvarchar(4000),@p1560 int,@p1561 int,@p1562 datetime2(7),@p1563 datetime2(7),@p1564 datetime2(7),@p1565 nvarchar(4000),@p1566 nvarchar(4000),@p1567 nvarchar(4000),@p1568 nvarchar(4000),@p1569 nvarchar(4000),@p1570 nvarchar(4000),@p1571 nvarchar(4000),@p1572 nvarchar(4000),@p1573 nvarchar(4000),@p1574 nvarchar(4000),@p1575 nvarchar(4000),@p1576 nvarchar(4000),@p1577 nvarchar(4000),@p1578 nvarchar(4000),@p1579 datetime2(7),@p1580 nvarchar(4000),@p1581 nvarchar(4000),@p1582 int,@p1583 int,@p1584 int,@p1585 nvarchar(4000),@p1586 nvarchar(4000),@p1587 nvarchar(4000),@p1588 nvarchar(4000),@p1589 decimal(18,2),@p1590 nvarchar(4000),@p1591 nvarchar(4000),@p1592 decimal(18,2),@p1593 nvarchar(4000),@p1594 nvarchar(4000),@p1595 nvarchar(4000),@p1596 nvarchar(4000),@p1597 int,@p1598 nvarchar(4000),@p1599 nvarchar(4000),@p1600 nvarchar(4000),@p1601 nvarchar(4000),@p1602 nvarchar(4000),@p1603 nvarchar(4000),@p1604 nvarchar(4000),@p1605 nvarchar(4000),@p1606 nvarchar(4000),@p1607 nvarchar(4000),@p1608 int,@p1609 nvarchar(4000),@p1610 nvarchar(4000),@p1611 nvarchar(4000),@p1612 nvarchar(4000),@p1613 nvarchar(4000),@p1614 int,@p1615 nvarchar(4000),@p1616 int,@p1617 int,@p1618 datetime2(7),@p1619 datetime2(7),@p1620 datetime2(7),@p1621 nvarchar(4000),@p1622 nvarchar(4000),@p1623 nvarchar(4000),@p1624 nvarchar(4000),@p1625 nvarchar(4000),@p1626 nvarchar(4000),@p1627 nvarchar(4000),@p1628 nvarchar(4000),@p1629 nvarchar(4000),@p1630 nvarchar(4000),@p1631 nvarchar(4000),@p1632 nvarchar(4000),@p1633 nvarchar(4000),@p1634 nvarchar(4000),@p1635 datetime2(7),@p1636 nvarchar(4000),@p1637 nvarchar(4000),@p1638 int,@p1639 int,@p1640 int,@p1641 nvarchar(4000),@p1642 nvarchar(4000),@p1643 nvarchar(4000),@p1644 nvarchar(4000),@p1645 decimal(18,2),@p1646 nvarchar(4000),@p1647 nvarchar(4000),@p1648 decimal(18,2),@p1649 nvarchar(4000),@p1650 nvarchar(4000),@p1651 nvarchar(4000),@p1652 nvarchar(4000),@p1653 int,@p1654 nvarchar(4000),@p1655 nvarchar(4000),@p1656 nvarchar(4000),@p1657 nvarchar(4000),@p1658 nvarchar(4000),@p1659 nvarchar(4000),@p1660 nvarchar(4000),@p1661 nvarchar(4000),@p1662 nvarchar(4000),@p1663 nvarchar(4000),@p1664 int,@p1665 nvarchar(4000),@p1666 nvarchar(4000),@p1667 nvarchar(4000),@p1668 nvarchar(4000),@p1669 nvarchar(4000),@p1670 int,@p1671 nvarchar(4000),@p1672 int,@p1673 int,@p1674 datetime2(7),@p1675 datetime2(7),@p1676 datetime2(7),@p1677 nvarchar(4000),@p1678 nvarchar(4000),@p1679 nvarchar(4000),@p1680 nvarchar(4000),@p1681 nvarchar(4000),@p1682 nvarchar(4000),@p1683 nvarchar(4000),@p1684 nvarchar(4000),@p1685 nvarchar(4000),@p1686 nvarchar(4000),@p1687 nvarchar(4000),@p1688 nvarchar(4000),@p1689 nvarchar(4000),@p1690 nvarchar(4000),@p1691 datetime2(7),@p1692 nvarchar(4000),@p1693 nvarchar(4000),@p1694 int,@p1695 int,@p1696 int,@p1697 nvarchar(4000),@p1698 nvarchar(4000),@p1699 nvarchar(4000),@p1700 nvarchar(4000),@p1701 decimal(18,2),@p1702 nvarchar(4000),@p1703 nvarchar(4000),@p1704 decimal(18,2),@p1705 nvarchar(4000),@p1706 nvarchar(4000),@p1707 nvarchar(4000),@p1708 nvarchar(4000),@p1709 int,@p1710 nvarchar(4000),@p1711 nvarchar(4000),@p1712 nvarchar(4000),@p1713 nvarchar(4000),@p1714 nvarchar(4000),@p1715 nvarchar(4000),@p1716 nvarchar(4000),@p1717 nvarchar(4000),@p1718 nvarchar(4000),@p1719 nvarchar(4000),@p1720 int,@p1721 nvarchar(4000),@p1722 nvarchar(4000),@p1723 nvarchar(4000),@p1724 nvarchar(4000),@p1725 nvarchar(4000),@p1726 int,@p1727 nvarchar(4000),@p1728 int,@p1729 int,@p1730 datetime2(7),@p1731 datetime2(7),@p1732 datetime2(7),@p1733 nvarchar(4000),@p1734 nvarchar(4000),@p1735 nvarchar(4000),@p1736 nvarchar(4000),@p1737 nvarchar(4000),@p1738 nvarchar(4000),@p1739 nvarchar(4000),@p1740 nvarchar(4000),@p1741 nvarchar(4000),@p1742 nvarchar(4000),@p1743 nvarchar(4000),@p1744 nvarchar(4000),@p1745 nvarchar(4000),@p1746 nvarchar(4000),@p1747 datetime2(7),@p1748 nvarchar(4000),@p1749 nvarchar(4000),@p1750 int,@p1751 int,@p1752 int,@p1753 nvarchar(4000),@p1754 nvarchar(4000),@p1755 nvarchar(4000),@p1756 nvarchar(4000),@p1757 decimal(18,2),@p1758 nvarchar(4000),@p1759 nvarchar(4000),@p1760 decimal(18,2),@p1761 nvarchar(4000),@p1762 nvarchar(4000),@p1763 nvarchar(4000),@p1764 nvarchar(4000),@p1765 int,@p1766 nvarchar(4000),@p1767 nvarchar(4000),@p1768 nvarchar(4000),@p1769 nvarchar(4000),@p1770 nvarchar(4000),@p1771 nvarchar(4000),@p1772 nvarchar(4000),@p1773 nvarchar(4000),@p1774 nvarchar(4000),@p1775 nvarchar(4000),@p1776 int,@p1777 nvarchar(4000),@p1778 nvarchar(4000),@p1779 nvarchar(4000),@p1780 nvarchar(4000),@p1781 nvarchar(4000),@p1782 int,@p1783 nvarchar(4000),@p1784 int,@p1785 int,@p1786 datetime2(7),@p1787 datetime2(7),@p1788 datetime2(7),@p1789 nvarchar(4000),@p1790 nvarchar(4000),@p1791 nvarchar(4000),@p1792 nvarchar(4000),@p1793 nvarchar(4000),@p1794 nvarchar(4000),@p1795 nvarchar(4000),@p1796 nvarchar(4000),@p1797 nvarchar(4000),@p1798 nvarchar(4000),@p1799 nvarchar(4000),@p1800 nvarchar(4000),@p1801 nvarchar(4000),@p1802 nvarchar(4000),@p1803 datetime2(7),@p1804 nvarchar(4000),@p1805 nvarchar(4000),@p1806 int,@p1807 int,@p1808 int,@p1809 nvarchar(4000),@p1810 nvarchar(4000),@p1811 nvarchar(4000),@p1812 nvarchar(4000),@p1813 decimal(18,2),@p1814 nvarchar(4000),@p1815 nvarchar(4000),@p1816 decimal(18,2),@p1817 nvarchar(4000),@p1818 nvarchar(4000),@p1819 nvarchar(4000),@p1820 nvarchar(4000),@p1821 int,@p1822 nvarchar(4000),@p1823 nvarchar(4000),@p1824 nvarchar(4000),@p1825 nvarchar(4000),@p1826 nvarchar(4000),@p1827 nvarchar(4000),@p1828 nvarchar(4000),@p1829 nvarchar(4000),@p1830 nvarchar(4000),@p1831 nvarchar(4000),@p1832 int,@p1833 nvarchar(4000),@p1834 nvarchar(4000),@p1835 nvarchar(4000),@p1836 nvarchar(4000),@p1837 nvarchar(4000),@p1838 int,@p1839 nvarchar(4000),@p1840 int,@p1841 int,@p1842 datetime2(7),@p1843 datetime2(7),@p1844 datetime2(7),@p1845 nvarchar(4000),@p1846 nvarchar(4000),@p1847 nvarchar(4000),@p1848 nvarchar(4000),@p1849 nvarchar(4000),@p1850 nvarchar(4000),@p1851 nvarchar(4000),@p1852 nvarchar(4000),@p1853 nvarchar(4000),@p1854 nvarchar(4000),@p1855 nvarchar(4000),@p1856 nvarchar(4000),@p1857 nvarchar(4000),@p1858 nvarchar(4000),@p1859 datetime2(7),@p1860 nvarchar(4000),@p1861 nvarchar(4000),@p1862 int,@p1863 int,@p1864 int,@p1865 nvarchar(4000),@p1866 nvarchar(4000),@p1867 nvarchar(4000),@p1868 nvarchar(4000),@p1869 decimal(18,2),@p1870 nvarchar(4000),@p1871 nvarchar(4000),@p1872 decimal(18,2),@p1873 nvarchar(4000),@p1874 nvarchar(4000),@p1875 nvarchar(4000),@p1876 nvarchar(4000),@p1877 int,@p1878 nvarchar(4000),@p1879 nvarchar(4000),@p1880 nvarchar(4000),@p1881 nvarchar(4000),@p1882 nvarchar(4000),@p1883 nvarchar(4000),@p1884 nvarchar(4000),@p1885 nvarchar(4000),@p1886 nvarchar(4000),@p1887 nvarchar(4000),@p1888 int,@p1889 nvarchar(4000),@p1890 nvarchar(4000),@p1891 nvarchar(4000),@p1892 nvarchar(4000),@p1893 nvarchar(4000),@p1894 int,@p1895 nvarchar(4000),@p1896 int,@p1897 int,@p1898 datetime2(7),@p1899 datetime2(7),@p1900 datetime2(7),@p1901 nvarchar(4000),@p1902 nvarchar(4000),@p1903 nvarchar(4000),@p1904 nvarchar(4000),@p1905 nvarchar(4000),@p1906 nvarchar(4000),@p1907 nvarchar(4000),@p1908 nvarchar(4000),@p1909 nvarchar(4000),@p1910 nvarchar(4000),@p1911 nvarchar(4000),@p1912 nvarchar(4000),@p1913 nvarchar(4000),@p1914 nvarchar(4000),@p1915 datetime2(7),@p1916 nvarchar(4000),@p1917 nvarchar(4000),@p1918 int,@p1919 int,@p1920 int,@p1921 nvarchar(4000),@p1922 nvarchar(4000),@p1923 nvarchar(4000),@p1924 nvarchar(4000),@p1925 decimal(18,2),@p1926 nvarchar(4000),@p1927 nvarchar(4000),@p1928 decimal(18,2),@p1929 nvarchar(4000),@p1930 nvarchar(4000),@p1931 nvarchar(4000),@p1932 nvarchar(4000),@p1933 int,@p1934 nvarchar(4000),@p1935 nvarchar(4000),@p1936 nvarchar(4000),@p1937 nvarchar(4000),@p1938 nvarchar(4000),@p1939 nvarchar(4000),@p1940 nvarchar(4000),@p1941 nvarchar(4000),@p1942 nvarchar(4000),@p1943 nvarchar(4000),@p1944 int,@p1945 nvarchar(4000),@p1946 nvarchar(4000),@p1947 nvarchar(4000),@p1948 nvarchar(4000),@p1949 nvarchar(4000),@p1950 int,@p1951 nvarchar(4000),@p1952 int,@p1953 int,@p1954 datetime2(7),@p1955 datetime2(7),@p1956 datetime2(7),@p1957 nvarchar(4000),@p1958 nvarchar(4000),@p1959 nvarchar(4000),@p1960 nvarchar(4000),@p1961 nvarchar(4000),@p1962 nvarchar(4000),@p1963 nvarchar(4000),@p1964 nvarchar(4000),@p1965 nvarchar(4000),@p1966 nvarchar(4000),@p1967 nvarchar(4000),@p1968 nvarchar(4000),@p1969 nvarchar(4000),@p1970 nvarchar(4000),@p1971 datetime2(7),@p1972 nvarchar(4000),@p1973 nvarchar(4000),@p1974 int,@p1975 int,@p1976 int,@p1977 nvarchar(4000),@p1978 nvarchar(4000),@p1979 nvarchar(4000),@p1980 nvarchar(4000),@p1981 decimal(18,2),@p1982 nvarchar(4000),@p1983 nvarchar(4000),@p1984 decimal(18,2),@p1985 nvarchar(4000),@p1986 nvarchar(4000),@p1987 nvarchar(4000),@p1988 nvarchar(4000),@p1989 int,@p1990 nvarchar(4000),@p1991 nvarchar(4000),@p1992 nvarchar(4000),@p1993 nvarchar(4000),@p1994 nvarchar(4000),@p1995 nvarchar(4000),@p1996 nvarchar(4000),@p1997 nvarchar(4000),@p1998 nvarchar(4000),@p1999 nvarchar(4000),@p2000 int,@p2001 nvarchar(4000),@p2002 nvarchar(4000),@p2003 nvarchar(4000),@p2004 nvarchar(4000),@p2005 nvarchar(4000),@p2006 int,@p2007 nvarchar(4000),@p2008 int,@p2009 int,@p2010 datetime2(7),@p2011 datetime2(7),@p2012 datetime2(7),@p2013 nvarchar(4000),@p2014 nvarchar(4000),@p2015 nvarchar(4000),@p2016 nvarchar(4000),@p2017 nvarchar(4000),@p2018 nvarchar(4000),@p2019 nvarchar(4000),@p2020 nvarchar(4000),@p2021 nvarchar(4000),@p2022 nvarchar(4000),@p2023 nvarchar(4000),@p2024 nvarchar(4000),@p2025 nvarchar(4000),@p2026 nvarchar(4000),@p2027 datetime2(7),@p2028 nvarchar(4000),@p2029 nvarchar(4000),@p2030 int,@p2031 int,@p2032 int,@p2033 nvarchar(4000),@p2034 nvarchar(4000),@p2035 nvarchar(4000),@p2036 nvarchar(4000),@p2037 decimal(18,2),@p2038 nvarchar(4000),@p2039 nvarchar(4000),@p2040 decimal(18,2),@p2041 nvarchar(4000),@p2042 nvarchar(4000),@p2043 nvarchar(4000),@p2044 nvarchar(4000),@p2045 int,@p2046 nvarchar(4000),@p2047 nvarchar(4000),@p2048 nvarchar(4000),@p2049 nvarchar(4000),@p2050 nvarchar(4000),@p2051 nvarchar(4000),@p2052 nvarchar(4000),@p2053 nvarchar(4000),@p2054 nvarchar(4000),@p2055 nvarchar(4000),@p2056 int,@p2057 nvarchar(4000),@p2058 nvarchar(4000),@p2059 nvarchar(4000),@p2060 nvarchar(4000),@p2061 nvarchar(4000),@p2062 int,@p2063 nvarchar(4000),@p2064 int,@p2065 int,@p2066 datetime2(7),@p2067 datetime2(7),@p2068 datetime2(7),@p2069 nvarchar(4000),@p2070 nvarchar(4000),@p2071 nvarchar(4000))SET NOCOUNT ON; DECLARE @inserted0 TABLE ([item_id] int, [_Position] [int]); MERGE [raw_data] USING ( VALUES (@p0, @p1, @p2, @p3, @p4, @p5, @p6, @p7, @p8, @p9, @p10, @p11, @p12, @p13, @p14, @p15, @p16, @p17, @p18, @p19, @p20, @p21, @p22, @p23, @p24, @p25, @p26, @p27, @p28, @p29, @p30, @p31, @p32, @p33, @p34, @p35, @p36, @p37, @p38, @p39, @p40, @p41, @p42, @p43, @p44, @p45, @p46, @p47, @p48, @p49, @p50, @p51, @p52, @p53, @p54, @p55, 0), (@p56, @p57, @p58, @p59, @p60, @p61, @p62, @p63, @p64, @p65, @p66, @p67, @p68, @p69, @p70, @p71, @p72, @p73, @p74, @p75, @p76, @p77, @p78, @p79, @p80, @p81, @p82, @p83, @p84, @p85, @p86, @p87, @p88, @p89, @p90, @p91, @p92, @p93, @p94, @p95, @p96, @p97, @p98, @p99, @p100, @p101, @p102, @p103, @p104, @p105, @p106, @p107, @p108, @p109, @p110, @p111, 1), (@p112, @p113, @p114, @p115, @p116, @p117, @p118, @p119, @p120, @p121, @p122, @p123, @p124, @p125, @p126, @p127, @p128, @p129, @p130, @p131, @p132, @p133, @p134, @p135, @p136, @p137, @p138, @p139, @p140, @p141, @p142, @p143, @p144, @p145, @p146, @p147, @p148, @p149, @p150, @p151, @p152, @p153, @p154, @p155, @p156, @p157, @p158, @p159, @p160, @p161, @p162, @p163, @p164, @p165, @p166, @p167, 2), (@p168, @p169, @p170, @p171, @p172, @p173, @p174, @p175, @p176, @p177, @p178, @p179, @p180, @p181, @p182, @p183, @p184, @p185, @p186, @p187, @p188, @p189, @p190, @p191, @p192, @p193, @p194, @p195, @p196, @p197, @p198, @p199, @p200, @p201, @p202, @p203, @p204, @p205, @p206, @p207, @p208, @p209, @p210, @p211, @p212, @p213, @p214, @p215, @p216, @p217, @p218, @p219, @p220, @p221, @p222, @p223, 3), (@p224, @p225, @p226, @p227, @p228, @p229, @p230, @p231, @p232, @p233, @p234, @p235, @p236, @p237, @p238, @p239, @p240, @p241, @p242, @p243, @p244, @p245, @p246, @p247, @p248, @p249, @p250, @p251, @p252, @p253, @p254, @p255, @p256, @p257, @p258, @p259, @p260, @p261, @p262, @p263, @p264, @p265, @p266, @p267, @p268, @p269, @p270, @p271, @p272, @p273, @p274, @p275, @p276, @p277, @p278, @p279, 4), (@p280, @p281, @p282, @p283, @p284, @p285, @p286, @p287, @p288, @p289, @p290, @p291, @p292, @p293, @p294, @p295, @p296, @p297, @p298, @p299, @p300, @p301, @p302, @p303, @p304, @p305, @p306, @p307, @p308, @p309, @p310, @p311, @p312, @p313, @p314, @p315, @p316, @p317, @p318, @p319, @p320, @p321, @p322, @p323, @p324, @p325, @p326, @p327, @p328, @p329, @p330, @p331, @p332, @p333, @p334, @p335, 5), (@p336, @p337, @p338, @p339, @p340, @p341, @p342, @p343, @p344, @p345, @p346, @p347, @p348, @p349, @p350, @p351, @p352, @p353, @p354, @p355, @p356, @p357, @p358, @p359, @p360, @p361, @p362, @p363, @p364, @p365, @p366, @p367, @p368, @p369, @p370, @p371, @p372, @p373, @p374, @p375, @p376, @p377, @p378, @p379, @p380, @p381, @p382, @p383, @p384, @p385, @p386, @p387, @p388, @p389, @p390, @p391, 6), (@p392, @p393, @p394, @p395, @p396, @p397, @p398, @p399, @p400, @p401, @p402, @p403, @p404, @p405, @p406, @p407, @p408, @p409, @p410, @p411, @p412, @p413, @p414, @p415, @p416, @p417, @p418, @p419, @p420, @p421, @p422, @p423, @p424, @p425, @p426, @p427, @p428, @p429, @p430, @p431, @p432, @p433, @p434, @p435, @p436, @p437, @p438, @p439, @p440, @p441, @p442, @p443, @p444, @p445, @p446, @p447, 7), (@p448, @p449, @p450, @p451, @p452, @p453, @p454, @p455, @p456, @p457, @p458, @p459, @p460, @p461, @p462, @p463, @p464, @p465, @p466, @p467, @p468, @p469, @p470, @p471, @p472, @p473, @p474, @p475, @p476, @p477, @p478, @p479, @p480, @p481, @p482, @p483, @p484, @p485, @p486, @p487, @p488, @p489, @p490, @p491, @p492, @p493, @p494, @p495, @p496, @p497, @p498, @p499, @p500, @p501, @p502, @p503, 8), (@p504, @p505, @p506, @p507, @p508, @p509, @p510, @p511, @p512, @p513, @p514, @p515, @p516, @p517, @p518, @p519, @p520, @p521, @p522, @p523, @p524, @p525, @p526, @p527, @p528, @p529, @p530, @p531, @p532, @p533, @p534, @p535, @p536, @p537, @p538, @p539, @p540, @p541, @p542, @p543, @p544, @p545, @p546, @p547, @p548, @p549, @p550, @p551, @p552, @p553, @p554, @p555, @p556, @p557, @p558, @p559, 9), (@p560, @p561, @p562, @p563, @p564, @p565, @p566, @p567, @p568, @p569, @p570, @p571, @p572, @p573, @p574, @p575, @p576, @p577, @p578, @p579, @p580, @p581, @p582, @p583, @p584, @p585, @p586, @p587, @p588, @p589, @p590, @p591, @p592, @p593, @p594, @p595, @p596, @p597, @p598, @p599, @p600, @p601, @p602, @p603, @p604, @p605, @p606, @p607, @p608, @p609, @p610, @p611, @p612, @p613, @p614, @p615, 10), (@p616, @p617, @p618, @p619, @p620, @p621, @p622, @p623, @p624, @p625, @p626, @p627, @p628, @p629, @p630, @p631, @p632, @p633, @p634, @p635, @p636, @p637, @p638, @p639, @p640, @p641, @p642, @p643, @p644, @p645, @p646, @p647, @p648, @p649, @p650, @p651, @p652, @p653, @p654, @p655, @p656, @p657, @p658, @p659, @p660, @p661, @p662, @p663, @p664, @p665, @p666, @p667, @p668, @p669, @p670, @p671, 11), (@p672, @p673, @p674, @p675, @p676, @p677, @p678, @p679, @p680, @p681, @p682, @p683, @p684, @p685, @p686, @p687, @p688, @p689, @p690, @p691, @p692, @p693, @p694, @p695, @p696, @p697, @p698, @p699, @p700, @p701, @p702, @p703, @p704, @p705, @p706, @p707, @p708, @p709, @p710, @p711, @p712, @p713, @p714, @p715, @p716, @p717, @p718, @p719, @p720, @p721, @p722, @p723, @p724, @p725, @p726, @p727, 12), (@p728, @p729, @p730, @p731, @p732, @p733, @p734, @p735, @p736, @p737, @p738, @p739, @p740, @p741, @p742, @p743, @p744, @p745, @p746, @p747, @p748, @p749, @p750, @p751, @p752, @p753, @p754, @p755, @p756, @p757, @p758, @p759, @p760, @p761, @p762, @p763, @p764, @p765, @p766, @p767, @p768, @p769, @p770, @p771, @p772, @p773, @p774, @p775, @p776, @p777, @p778, @p779, @p780, @p781, @p782, @p783, 13), (@p784, @p785, @p786, @p787, @p788, @p789, @p790, @p791, @p792, @p793, @p794, @p795, @p796, @p797, @p798, @p799, @p800, @p801, @p802, @p803, @p804, @p805, @p806, @p807, @p808, @p809, @p810, @p811, @p812, @p813, @p814, @p815, @p816, @p817, @p818, @p819, @p820, @p821, @p822, @p823, @p824, @p825, @p826, @p827, @p828, @p829, @p830, @p831, @p832, @p833, @p834, @p835, @p836, @p837, @p838, @p839, 14), (@p840, @p841, @p842, @p843, @p844, @p845, @p846, @p847, @p848, @p849, @p850, @p851, @p852, @p853, @p854, @p855, @p856, @p857, @p858, @p859, @p860, @p861, @p862, @p863, @p864, @p865, @p866, @p867, @p868, @p869, @p870, @p871, @p872, @p873, @p874, @p875, @p876, @p877, @p878, @p879, @p880, @p881, @p882, @p883, @p884, @p885, @p886, @p887, @p888, @p889, @p890, @p891, @p892, @p893, @p894, @p895, 15), (@p896, @p897, @p898, @p899, @p900, @p901, @p902, @p903, @p904, @p905, @p906, @p907, @p908, @p909, @p910, @p911, @p912, @p913, @p914, @p915, @p916, @p917, @p918, @p919, @p920, @p921, @p922, @p923, @p924, @p925, @p926, @p927, @p928, @p929, @p930, @p931, @p932, @p933, @p934, @p935, @p936, @p937, @p938, @p939, @p940, @p941, @p942, @p943, @p944, @p945, @p946, @p947, @p948, @p949, @p950, @p951, 16), (@p952, @p953, @p954, @p955, @p956, @p957, @p958, @p959, @p960, @p961, @p962, @p963, @p964, @p965, @p966, @p967, @p968, @p969, @p970, @p971, @p972, @p973, @p974, @p975, @p976, @p977, @p978, @p979, @p980, @p981, @p982, @p983, @p984, @p985, @p986, @p987, @p988, @p989, @p990, @p991, @p992, @p993, @p994, @p995, @p996, @p997, @p998, @p999, @p1000, @p1001, @p1002, @p1003, @p1004, @p1005, @p1006, @p1007, 17), (@p1008, @p1009, @p1010, @p1011, @p1012, @p1013, @p1014, @p1015, @p1016, @p1017, @p1018, @p1019, @p1020, @p1021, @p1022, @p1023, @p1024, @p1025, @p1026, @p1027, @p1028, @p1029, @p1030, @p1031, @p1032, @p1033, @p1034, @p1035, @p1036, @p1037, @p1038, @p1039, @p1040, @p1041, @p1042, @p1043, @p1044, @p1045, @p1046, @p1047, @p1048, @p1049, @p1050, @p1051, @p1052, @p1053, @p1054, @p1055, @p1056, @p1057, @p1058, @p1059, @p1060, @p1061, @p1062, @p1063, 18), (@p1064, @p1065, @p1066, @p1067, @p1068, @p1069, @p1070, @p1071, @p1072, @p1073, @p1074, @p1075, @p1076, @p1077, @p1078, @p1079, @p1080, @p1081, @p1082, @p1083, @p1084, @p1085, @p1086, @p1087, @p1088, @p1089, @p1090, @p1091, @p1092, @p1093, @p1094, @p1095, @p1096, @p1097, @p1098, @p1099, @p1100, @p1101, @p1102, @p1103, @p1104, @p1105, @p1106, @p1107, @p1108, @p1109, @p1110, @p1111, @p1112, @p1113, @p1114, @p1115, @p1116, @p1117, @p1118, @p1119, 19), (@p1120, @p1121, @p1122, @p1123, @p1124, @p1125, @p1126, @p1127, @p1128, @p1129, @p1130, @p1131, @p1132, @p1133, @p1134, @p1135, @p1136, @p1137, @p1138, @p1139, @p1140, @p1141, @p1142, @p1143, @p1144, @p1145, @p1146, @p1147, @p1148, @p1149, @p1150, @p1151, @p1152, @p1153, @p1154, @p1155, @p1156, @p1157, @p1158, @p1159, @p1160, @p1161, @p1162, @p1163, @p1164, @p1165, @p1166, @p1167, @p1168, @p1169, @p1170, @p1171, @p1172, @p1173, @p1174, @p1175, 20), (@p1176, @p1177, @p1178, @p1179, @p1180, @p1181, @p1182, @p1183, @p1184, @p1185, @p1186, @p1187, @p1188, @p1189, @p1190, @p1191, @p1192, @p1193, @p1194, @p1195, @p1196, @p1197, @p1198, @p1199, @p1200, @p1201, @p1202, @p1203, @p1204, @p1205, @p1206, @p1207, @p1208, @p1209, @p1210, @p1211, @p1212, @p1213, @p1214, @p1215, @p1216, @p1217, @p1218, @p1219, @p1220, @p1221, @p1222, @p1223, @p1224, @p1225, @p1226, @p1227, @p1228, @p1229, @p1230, @p1231, 21), (@p1232, @p1233, @p1234, @p1235, @p1236, @p1237, @p1238, @p1239, @p1240, @p1241, @p1242, @p1243, @p1244, @p1245, @p1246, @p1247, @p1248, @p1249, @p1250, @p1251, @p1252, @p1253, @p1254, @p1255, @p1256, @p1257, @p1258, @p1259, @p1260, @p1261, @p1262, @p1263, @p1264, @p1265, @p1266, @p1267, @p1268, @p1269, @p1270, @p1271, @p1272, @p1273, @p1274, @p1275, @p1276, @p1277, @p1278, @p1279, @p1280, @p1281, @p1282, @p1283, @p1284, @p1285, @p1286, @p1287, 22), (@p1288, @p1289, @p1290, @p1291, @p1292, @p1293, @p1294, @p1295, @p1296, @p1297, @p1298, @p1299, @p1300, @p1301, @p1302, @p1303, @p1304, @p1305, @p1306, @p1307, @p1308, @p1309, @p1310, @p1311, @p1312, @p1313, @p1314, @p1315, @p1316, @p1317, @p1318, @p1319, @p1320, @p1321, @p1322, @p1323, @p1324, @p1325, @p1326, @p1327, @p1328, @p1329, @p1330, @p1331, @p1332, @p1333, @p1334, @p1335, @p1336, @p1337, @p1338, @p1339, @p1340, @p1341, @p1342, @p1343, 23), (@p1344, @p1345, @p1346, @p1347, @p1348, @p1349, @p1350, @p1351, @p1352, @p1353, @p1354, @p1355, @p1356, @p1357, @p1358, @p1359, @p1360, @p1361, @p1362, @p1363, @p1364, @p1365, @p1366, @p1367, @p1368, @p1369, @p1370, @p1371, @p1372, @p1373, @p1374, @p1375, @p1376, @p1377, @p1378, @p1379, @p1380, @p1381, @p1382, @p1383, @p1384, @p1385, @p1386, @p1387, @p1388, @p1389, @p1390, @p1391, @p1392, @p1393, @p1394, @p1395, @p1396, @p1397, @p1398, @p1399, 24), (@p1400, @p1401, @p1402, @p1403, @p1404, @p1405, @p1406, @p1407, @p1408, @p1409, @p1410, @p1411, @p1412, @p1413, @p1414, @p1415, @p1416, @p1417, @p1418, @p1419, @p1420, @p1421, @p1422, @p1423, @p1424, @p1425, @p1426, @p1427, @p1428, @p1429, @p1430, @p1431, @p1432, @p1433, @p1434, @p1435, @p1436, @p1437, @p1438, @p1439, @p1440, @p1441, @p1442, @p1443, @p1444, @p1445, @p1446, @p1447, @p1448, @p1449, @p1450, @p1451, @p1452, @p1453, @p1454, @p1455, 25), (@p1456, @p1457, @p1458, @p1459, @p1460, @p1461, @p1462, @p1463, @p1464, @p1465, @p1466, @p1467, @p1468, @p1469, @p1470, @p1471, @p1472, @p1473, @p1474, @p1475, @p1476, @p1477, @p1478, @p1479, @p1480, @p1481, @p1482, @p1483, @p1484, @p1485, @p1486, @p1487, @p1488, @p1489, @p1490, @p1491, @p1492, @p1493, @p1494, @p1495, @p1496, @p1497, @p1498, @p1499, @p1500, @p1501, @p1502, @p1503, @p1504, @p1505, @p1506, @p1507, @p1508, @p1509, @p1510, @p1511, 26), (@p1512, @p1513, @p1514, @p1515, @p1516, @p1517, @p1518, @p1519, @p1520, @p1521, @p1522, @p1523, @p1524, @p1525, @p1526, @p1527, @p1528, @p1529, @p1530, @p1531, @p1532, @p1533, @p1534, @p1535, @p1536, @p1537, @p1538, @p1539, @p1540, @p1541, @p1542, @p1543, @p1544, @p1545, @p1546, @p1547, @p1548, @p1549, @p1550, @p1551, @p1552, @p1553, @p1554, @p1555, @p1556, @p1557, @p1558, @p1559, @p1560, @p1561, @p1562, @p1563, @p1564, @p1565, @p1566, @p1567, 27), (@p1568, @p1569, @p1570, @p1571, @p1572, @p1573, @p1574, @p1575, @p1576, @p1577, @p1578, @p1579, @p1580, @p1581, @p1582, @p1583, @p1584, @p1585, @p1586, @p1587, @p1588, @p1589, @p1590, @p1591, @p1592, @p1593, @p1594, @p1595, @p1596, @p1597, @p1598, @p1599, @p1600, @p1601, @p1602, @p1603, @p1604, @p1605, @p1606, @p1607, @p1608, @p1609, @p1610, @p1611, @p1612, @p1613, @p1614, @p1615, @p1616, @p1617, @p1618, @p1619, @p1620, @p1621, @p1622, @p1623, 28), (@p1624, @p1625, @p1626, @p1627, @p1628, @p1629, @p1630, @p1631, @p1632, @p1633, @p1634, @p1635, @p1636, @p1637, @p1638, @p1639, @p1640, @p1641, @p1642, @p1643, @p1644, @p1645, @p1646, @p1647, @p1648, @p1649, @p1650, @p1651, @p1652, @p1653, @p1654, @p1655, @p1656, @p1657, @p1658, @p1659, @p1660, @p1661, @p1662, @p1663, @p1664, @p1665, @p1666, @p1667, @p1668, @p1669, @p1670, @p1671, @p1672, @p1673, @p1674, @p1675, @p1676, @p1677, @p1678, @p1679, 29), (@p1680, @p1681, @p1682, @p1683, @p1684, @p1685, @p1686, @p1687, @p1688, @p1689, @p1690, @p1691, @p1692, @p1693, @p1694, @p1695, @p1696, @p1697, @p1698, @p1699, @p1700, @p1701, @p1702, @p1703, @p1704, @p1705, @p1706, @p1707, @p1708, @p1709, @p1710, @p1711, @p1712, @p1713, @p1714, @p1715, @p1716, @p1717, @p1718, @p1719, @p1720, @p1721, @p1722, @p1723, @p1724, @p1725, @p1726, @p1727, @p1728, @p1729, @p1730, @p1731, @p1732, @p1733, @p1734, @p1735, 30), (@p1736, @p1737, @p1738, @p1739, @p1740, @p1741, @p1742, @p1743, @p1744, @p1745, @p1746, @p1747, @p1748, @p1749, @p1750, @p1751, @p1752, @p1753, @p1754, @p1755, @p1756, @p1757, @p1758, @p1759, @p1760, @p1761, @p1762, @p1763, @p1764, @p1765, @p1766, @p1767, @p1768, @p1769, @p1770, @p1771, @p1772, @p1773, @p1774, @p1775, @p1776, @p1777, @p1778, @p1779, @p1780, @p1781, @p1782, @p1783, @p1784, @p1785, @p1786, @p1787, @p1788, @p1789, @p1790, @p1791, 31), (@p1792, @p1793, @p1794, @p1795, @p1796, @p1797, @p1798, @p1799, @p1800, @p1801, @p1802, @p1803, @p1804, @p1805, @p1806, @p1807, @p1808, @p1809, @p1810, @p1811, @p1812, @p1813, @p1814, @p1815, @p1816, @p1817, @p1818, @p1819, @p1820, @p1821, @p1822, @p1823, @p1824, @p1825, @p1826, @p1827, @p1828, @p1829, @p1830, @p1831, @p1832, @p1833, @p1834, @p1835, @p1836, @p1837, @p1838, @p1839, @p1840, @p1841, @p1842, @p1843, @p1844, @p1845, @p1846, @p1847, 32), (@p1848, @p1849, @p1850, @p1851, @p1852, @p1853, @p1854, @p1855, @p1856, @p1857, @p1858, @p1859, @p1860, @p1861, @p1862, @p1863, @p1864, @p1865, @p1866, @p1867, @p1868, @p1869, @p1870, @p1871, @p1872, @p1873, @p1874, @p1875, @p1876, @p1877, @p1878, @p1879, @p1880, @p1881, @p1882, @p1883, @p1884, @p1885, @p1886, @p1887, @p1888, @p1889, @p1890, @p1891, @p1892, @p1893, @p1894, @p1895, @p1896, @p1897, @p1898, @p1899, @p1900, @p1901, @p1902, @p1903, 33), (@p1904, @p1905, @p1906, @p1907, @p1908, @p1909, @p1910, @p1911, @p1912, @p1913, @p1914, @p1915, @p1916, @p1917, @p1918, @p1919, @p1920, @p1921, @p1922, @p1923, @p1924, @p1925, @p1926, @p1927, @p1928, @p1929, @p1930, @p1931, @p1932, @p1933, @p1934, @p1935, @p1936, @p1937, @p1938, @p1939, @p1940, @p1941, @p1942, @p1943, @p1944, @p1945, @p1946, @p1947, @p1948, @p1949, @p1950, @p1951, @p1952, @p1953, @p1954, @p1955, @p1956, @p1957, @p1958, @p1959, 34), (@p1960, @p1961, @p1962, @p1963, @p1964, @p1965, @p1966, @p1967, @p1968, @p1969, @p1970, @p1971, @p1972, @p1973, @p1974, @p1975, @p1976, @p1977, @p1978, @p1979, @p1980, @p1981, @p1982, @p1983, @p1984, @p1985, @p1986, @p1987, @p1988, @p1989, @p1990, @p1991, @p1992, @p1993, @p1994, @p1995, @p1996, @p1997, @p1998, @p1999, @p2000, @p2001, @p2002, @p2003, @p2004, @p2005, @p2006, @p2007, @p2008, @p2009, @p2010, @p2011, @p2012, @p2013, @p2014, @p2015, 35), (@p2016, @p2017, @p2018, @p2019, @p2020, @p2021, @p2022, @p2023, @p2024, @p2025, @p2026, @p2027, @p2028, @p2029, @p2030, @p2031, @p2032, @p2033, @p2034, @p2035, @p2036, @p2037, @p2038, @p2039, @p2040, @p2041, @p2042, @p2043, @p2044, @p2045, @p2046, @p2047, @p2048, @p2049, @p2050, @p2051, @p2052, @p2053, @p2054, @p2055, @p2056, @p2057, @p2058, @p2059, @p2060, @p2061, @p2062, @p2063, @p2064, @p2065, @p2066, @p2067, @p2068, @p2069, @p2070, @p2071, 36)) AS i ([addressee_cntry_cd], [addressee_city], [addressee_district], [addressee_email], [addressee_full_address], [addressee_home_address], [addressee_name], [addressee_postcode], [addressee_province], [addressee_subdistrict], [addressee_tel], [create_table], [delivery_code], [delivery_recipient_name], [delivery_relation_id], [delivery_status_id], [dest_outlet_id], [dest_outlet_port], [document_number], [item_barcode], [item_cod], [item_gross_weight], [item_height], [item_length], [item_price], [item_width], [lat], [log_id], [long], [outlet_id], [outlet_port], [podUrl], [remark], [scan_cntry_cd], [scan_cntry_postcode], [sender_cntry_cd], [sender_district], [sender_email], [sender_full_address], [sender_home_address], [member_id], [sender_name], [sender_postcode], [sender_province], [sender_subdistrict], [sender_tel], [server_id], [signatureUrl], [state], [status_code], [status_dtm], [timestamp], [transmit_dtm], [user_id], [wckt_id], [wkstn_no], _Position) ON 1=0 WHEN NOT MATCHED THEN INSERT ([addressee_cntry_cd], [addressee_city], [addressee_district], [addressee_email], [addressee_full_address], [addressee_home_address], [addressee_name], [addressee_postcode], [addressee_province], [addressee_subdistrict], [addressee_tel], [create_table], [delivery_code], [delivery_recipient_name], [delivery_relation_id], [delivery_status_id], [dest_outlet_id], [dest_outlet_port], [document_number], [item_barcode], [item_cod], [item_gross_weight], [item_height], [item_length], [item_price], [item_width], [lat], [log_id], [long], [outlet_id], [outlet_port], [podUrl], [remark], [scan_cntry_cd], [scan_cntry_postcode], [sender_cntry_cd], [sender_district], [sender_email], [sender_full_address], [sender_home_address], [member_id], [sender_name], [sender_postcode], [sender_province], [sender_subdistrict], [sender_tel], [server_id], [signatureUrl], [state], [status_code], [status_dtm], [timestamp], [transmit_dtm], [user_id], [wckt_id], [wkstn_no]) VALUES (i.[addressee_cntry_cd], i.[addressee_city], i.[addressee_district], i.[addressee_email], i.[addressee_full_address], i.[addressee_home_address], i.[addressee_name], i.[addressee_postcode], i.[addressee_province], i.[addressee_subdistrict], i.[addressee_tel], i.[create_table], i.[delivery_code], i.[delivery_recipient_name], i.[delivery_relation_id], i.[delivery_status_id], i.[dest_outlet_id], i.[dest_outlet_port], i.[document_number], i.[item_barcode], i.[item_cod], i.[item_gross_weight], i.[item_height], i.[item_length], i.[item_price], i.[item_width], i.[lat], i.[log_id], i.[long], i.[outlet_id], i.[outlet_port], i.[podUrl], i.[remark], i.[scan_cntry_cd], i.[scan_cntry_postcode], i.[sender_cntry_cd], i.[sender_district], i.[sender_email], i.[sender_full_address], i.[sender_home_address], i.[member_id], i.[sender_name], i.[sender_postcode], i.[sender_province], i.[sender_subdistrict], i.[sender_tel], i.[server_id], i.[signatureUrl], i.[state], i.[status_code], i.[status_dtm], i.[timestamp], i.[transmit_dtm], i.[user_id], i.[wckt_id], i.[wkstn_no]) OUTPUT INSERTED.[item_id], i._Position INTO @inserted0;  SELECT [t].[item_id] FROM [raw_data] t INNER JOIN @inserted0 i ON ([t].[item_id] = [i].[item_id]) ORDER BY [i].[_Position];  ",7,7,0,439,3,7
"       SELECT db_id() AS database_id, o.[type] as ModuleType, COUNT_BIG(*) as ModuleCount       FROM sys.objects AS o WITH(nolock)       WHERE o.type in ('AF', 'F', 'FN', 'FS', 'FT', 'IF', 'P', 'PC', 'TA', 'TF', 'TR', 'X', 'C', 'D', 'PG', 'SN', 'SO', 'SQ', 'TT', 'UQ', 'V')       GROUP BY o.[type]     ",7,7,0,36,0,918
"(@p0 nvarchar(4000),@p1 nvarchar(4000),@p2 nvarchar(4000),@p3 nvarchar(4000),@p4 nvarchar(4000),@p5 nvarchar(4000),@p6 nvarchar(4000),@p7 nvarchar(4000),@p8 nvarchar(4000),@p9 nvarchar(4000),@p10 nvarchar(4000),@p11 datetime2(7),@p12 nvarchar(4000),@p13 nvarchar(4000),@p14 int,@p15 int,@p16 int,@p17 nvarchar(4000),@p18 nvarchar(4000),@p19 nvarchar(4000),@p20 decimal(18,2),@p21 decimal(18,2),@p22 nvarchar(4000),@p23 nvarchar(4000),@p24 decimal(18,2),@p25 nvarchar(4000),@p26 nvarchar(4000),@p27 nvarchar(4000),@p28 nvarchar(4000),@p29 int,@p30 nvarchar(4000),@p31 nvarchar(4000),@p32 nvarchar(4000),@p33 nvarchar(4000),@p34 nvarchar(4000),@p35 nvarchar(4000),@p36 nvarchar(4000),@p37 nvarchar(4000),@p38 nvarchar(4000),@p39 nvarchar(4000),@p40 int,@p41 nvarchar(4000),@p42 nvarchar(4000),@p43 nvarchar(4000),@p44 nvarchar(4000),@p45 nvarchar(4000),@p46 int,@p47 nvarchar(4000),@p48 int,@p49 int,@p50 datetime2(7),@p51 datetime2(7),@p52 datetime2(7),@p53 nvarchar(4000),@p54 nvarchar(4000),@p55 nvarchar(4000),@p56 nvarchar(4000),@p57 nvarchar(4000),@p58 nvarchar(4000),@p59 nvarchar(4000),@p60 nvarchar(4000),@p61 nvarchar(4000),@p62 nvarchar(4000),@p63 nvarchar(4000),@p64 nvarchar(4000),@p65 nvarchar(4000),@p66 nvarchar(4000),@p67 datetime2(7),@p68 nvarchar(4000),@p69 nvarchar(4000),@p70 int,@p71 int,@p72 int,@p73 nvarchar(4000),@p74 nvarchar(4000),@p75 nvarchar(4000),@p76 decimal(18,2),@p77 decimal(18,2),@p78 nvarchar(4000),@p79 nvarchar(4000),@p80 decimal(18,2),@p81 nvarchar(4000),@p82 nvarchar(4000),@p83 nvarchar(4000),@p84 nvarchar(4000),@p85 int,@p86 nvarchar(4000),@p87 nvarchar(4000),@p88 nvarchar(4000),@p89 nvarchar(4000),@p90 nvarchar(4000),@p91 nvarchar(4000),@p92 nvarchar(4000),@p93 nvarchar(4000),@p94 nvarchar(4000),@p95 nvarchar(4000),@p96 int,@p97 nvarchar(4000),@p98 nvarchar(4000),@p99 nvarchar(4000),@p100 nvarchar(4000),@p101 nvarchar(4000),@p102 int,@p103 nvarchar(4000),@p104 int,@p105 int,@p106 datetime2(7),@p107 datetime2(7),@p108 datetime2(7),@p109 nvarchar(4000),@p110 nvarchar(4000),@p111 nvarchar(4000),@p112 nvarchar(4000),@p113 nvarchar(4000),@p114 nvarchar(4000),@p115 nvarchar(4000),@p116 nvarchar(4000),@p117 nvarchar(4000),@p118 nvarchar(4000),@p119 nvarchar(4000),@p120 nvarchar(4000),@p121 nvarchar(4000),@p122 nvarchar(4000),@p123 datetime2(7),@p124 nvarchar(4000),@p125 nvarchar(4000),@p126 int,@p127 int,@p128 int,@p129 nvarchar(4000),@p130 nvarchar(4000),@p131 nvarchar(4000),@p132 decimal(18,2),@p133 decimal(18,2),@p134 nvarchar(4000),@p135 nvarchar(4000),@p136 decimal(18,2),@p137 nvarchar(4000),@p138 nvarchar(4000),@p139 nvarchar(4000),@p140 nvarchar(4000),@p141 int,@p142 nvarchar(4000),@p143 nvarchar(4000),@p144 nvarchar(4000),@p145 nvarchar(4000),@p146 nvarchar(4000),@p147 nvarchar(4000),@p148 nvarchar(4000),@p149 nvarchar(4000),@p150 nvarchar(4000),@p151 nvarchar(4000),@p152 int,@p153 nvarchar(4000),@p154 nvarchar(4000),@p155 nvarchar(4000),@p156 nvarchar(4000),@p157 nvarchar(4000),@p158 int,@p159 nvarchar(4000),@p160 int,@p161 int,@p162 datetime2(7),@p163 datetime2(7),@p164 datetime2(7),@p165 nvarchar(4000),@p166 nvarchar(4000),@p167 nvarchar(4000),@p168 nvarchar(4000),@p169 nvarchar(4000),@p170 nvarchar(4000),@p171 nvarchar(4000),@p172 nvarchar(4000),@p173 nvarchar(4000),@p174 nvarchar(4000),@p175 nvarchar(4000),@p176 nvarchar(4000),@p177 nvarchar(4000),@p178 nvarchar(4000),@p179 datetime2(7),@p180 nvarchar(4000),@p181 nvarchar(4000),@p182 int,@p183 int,@p184 int,@p185 nvarchar(4000),@p186 nvarchar(4000),@p187 nvarchar(4000),@p188 decimal(18,2),@p189 decimal(18,2),@p190 nvarchar(4000),@p191 nvarchar(4000),@p192 decimal(18,2),@p193 nvarchar(4000),@p194 nvarchar(4000),@p195 nvarchar(4000),@p196 nvarchar(4000),@p197 int,@p198 nvarchar(4000),@p199 nvarchar(4000),@p200 nvarchar(4000),@p201 nvarchar(4000),@p202 nvarchar(4000),@p203 nvarchar(4000),@p204 nvarchar(4000),@p205 nvarchar(4000),@p206 nvarchar(4000),@p207 nvarchar(4000),@p208 int,@p209 nvarchar(4000),@p210 nvarchar(4000),@p211 nvarchar(4000),@p212 nvarchar(4000),@p213 nvarchar(4000),@p214 int,@p215 nvarchar(4000),@p216 int,@p217 int,@p218 datetime2(7),@p219 datetime2(7),@p220 datetime2(7),@p221 nvarchar(4000),@p222 nvarchar(4000),@p223 nvarchar(4000),@p224 nvarchar(4000),@p225 nvarchar(4000),@p226 nvarchar(4000),@p227 nvarchar(4000),@p228 nvarchar(4000),@p229 nvarchar(4000),@p230 nvarchar(4000),@p231 nvarchar(4000),@p232 nvarchar(4000),@p233 nvarchar(4000),@p234 nvarchar(4000),@p235 datetime2(7),@p236 nvarchar(4000),@p237 nvarchar(4000),@p238 int,@p239 int,@p240 int,@p241 nvarchar(4000),@p242 nvarchar(4000),@p243 nvarchar(4000),@p244 decimal(18,2),@p245 decimal(18,2),@p246 nvarchar(4000),@p247 nvarchar(4000),@p248 decimal(18,2),@p249 nvarchar(4000),@p250 nvarchar(4000),@p251 nvarchar(4000),@p252 nvarchar(4000),@p253 int,@p254 nvarchar(4000),@p255 nvarchar(4000),@p256 nvarchar(4000),@p257 nvarchar(4000),@p258 nvarchar(4000),@p259 nvarchar(4000),@p260 nvarchar(4000),@p261 nvarchar(4000),@p262 nvarchar(4000),@p263 nvarchar(4000),@p264 int,@p265 nvarchar(4000),@p266 nvarchar(4000),@p267 nvarchar(4000),@p268 nvarchar(4000),@p269 nvarchar(4000),@p270 int,@p271 nvarchar(4000),@p272 int,@p273 int,@p274 datetime2(7),@p275 datetime2(7),@p276 datetime2(7),@p277 nvarchar(4000),@p278 nvarchar(4000),@p279 nvarchar(4000),@p280 nvarchar(4000),@p281 nvarchar(4000),@p282 nvarchar(4000),@p283 nvarchar(4000),@p284 nvarchar(4000),@p285 nvarchar(4000),@p286 nvarchar(4000),@p287 nvarchar(4000),@p288 nvarchar(4000),@p289 nvarchar(4000),@p290 nvarchar(4000),@p291 datetime2(7),@p292 nvarchar(4000),@p293 nvarchar(4000),@p294 int,@p295 int,@p296 int,@p297 nvarchar(4000),@p298 nvarchar(4000),@p299 nvarchar(4000),@p300 decimal(18,2),@p301 decimal(18,2),@p302 nvarchar(4000),@p303 nvarchar(4000),@p304 decimal(18,2),@p305 nvarchar(4000),@p306 nvarchar(4000),@p307 nvarchar(4000),@p308 nvarchar(4000),@p309 int,@p310 nvarchar(4000),@p311 nvarchar(4000),@p312 nvarchar(4000),@p313 nvarchar(4000),@p314 nvarchar(4000),@p315 nvarchar(4000),@p316 nvarchar(4000),@p317 nvarchar(4000),@p318 nvarchar(4000),@p319 nvarchar(4000),@p320 int,@p321 nvarchar(4000),@p322 nvarchar(4000),@p323 nvarchar(4000),@p324 nvarchar(4000),@p325 nvarchar(4000),@p326 int,@p327 nvarchar(4000),@p328 int,@p329 int,@p330 datetime2(7),@p331 datetime2(7),@p332 datetime2(7),@p333 nvarchar(4000),@p334 nvarchar(4000),@p335 nvarchar(4000),@p336 nvarchar(4000),@p337 nvarchar(4000),@p338 nvarchar(4000),@p339 nvarchar(4000),@p340 nvarchar(4000),@p341 nvarchar(4000),@p342 nvarchar(4000),@p343 nvarchar(4000),@p344 nvarchar(4000),@p345 nvarchar(4000),@p346 nvarchar(4000),@p347 datetime2(7),@p348 nvarchar(4000),@p349 nvarchar(4000),@p350 int,@p351 int,@p352 int,@p353 nvarchar(4000),@p354 nvarchar(4000),@p355 nvarchar(4000),@p356 decimal(18,2),@p357 decimal(18,2),@p358 nvarchar(4000),@p359 nvarchar(4000),@p360 decimal(18,2),@p361 nvarchar(4000),@p362 nvarchar(4000),@p363 nvarchar(4000),@p364 nvarchar(4000),@p365 int,@p366 nvarchar(4000),@p367 nvarchar(4000),@p368 nvarchar(4000),@p369 nvarchar(4000),@p370 nvarchar(4000),@p371 nvarchar(4000),@p372 nvarchar(4000),@p373 nvarchar(4000),@p374 nvarchar(4000),@p375 nvarchar(4000),@p376 int,@p377 nvarchar(4000),@p378 nvarchar(4000),@p379 nvarchar(4000),@p380 nvarchar(4000),@p381 nvarchar(4000),@p382 int,@p383 nvarchar(4000),@p384 int,@p385 int,@p386 datetime2(7),@p387 datetime2(7),@p388 datetime2(7),@p389 nvarchar(4000),@p390 nvarchar(4000),@p391 nvarchar(4000),@p392 nvarchar(4000),@p393 nvarchar(4000),@p394 nvarchar(4000),@p395 nvarchar(4000),@p396 nvarchar(4000),@p397 nvarchar(4000),@p398 nvarchar(4000),@p399 nvarchar(4000),@p400 nvarchar(4000),@p401 nvarchar(4000),@p402 nvarchar(4000),@p403 datetime2(7),@p404 nvarchar(4000),@p405 nvarchar(4000),@p406 int,@p407 int,@p408 int,@p409 nvarchar(4000),@p410 nvarchar(4000),@p411 nvarchar(4000),@p412 decimal(18,2),@p413 decimal(18,2),@p414 nvarchar(4000),@p415 nvarchar(4000),@p416 decimal(18,2),@p417 nvarchar(4000),@p418 nvarchar(4000),@p419 nvarchar(4000),@p420 nvarchar(4000),@p421 int,@p422 nvarchar(4000),@p423 nvarchar(4000),@p424 nvarchar(4000),@p425 nvarchar(4000),@p426 nvarchar(4000),@p427 nvarchar(4000),@p428 nvarchar(4000),@p429 nvarchar(4000),@p430 nvarchar(4000),@p431 nvarchar(4000),@p432 int,@p433 nvarchar(4000),@p434 nvarchar(4000),@p435 nvarchar(4000),@p436 nvarchar(4000),@p437 nvarchar(4000),@p438 int,@p439 nvarchar(4000),@p440 int,@p441 int,@p442 datetime2(7),@p443 datetime2(7),@p444 datetime2(7),@p445 nvarchar(4000),@p446 nvarchar(4000),@p447 nvarchar(4000),@p448 nvarchar(4000),@p449 nvarchar(4000),@p450 nvarchar(4000),@p451 nvarchar(4000),@p452 nvarchar(4000),@p453 nvarchar(4000),@p454 nvarchar(4000),@p455 nvarchar(4000),@p456 nvarchar(4000),@p457 nvarchar(4000),@p458 nvarchar(4000),@p459 datetime2(7),@p460 nvarchar(4000),@p461 nvarchar(4000),@p462 int,@p463 int,@p464 int,@p465 nvarchar(4000),@p466 nvarchar(4000),@p467 nvarchar(4000),@p468 decimal(18,2),@p469 decimal(18,2),@p470 nvarchar(4000),@p471 nvarchar(4000),@p472 decimal(18,2),@p473 nvarchar(4000),@p474 nvarchar(4000),@p475 nvarchar(4000),@p476 nvarchar(4000),@p477 int,@p478 nvarchar(4000),@p479 nvarchar(4000),@p480 nvarchar(4000),@p481 nvarchar(4000),@p482 nvarchar(4000),@p483 nvarchar(4000),@p484 nvarchar(4000),@p485 nvarchar(4000),@p486 nvarchar(4000),@p487 nvarchar(4000),@p488 int,@p489 nvarchar(4000),@p490 nvarchar(4000),@p491 nvarchar(4000),@p492 nvarchar(4000),@p493 nvarchar(4000),@p494 int,@p495 nvarchar(4000),@p496 int,@p497 int,@p498 datetime2(7),@p499 datetime2(7),@p500 datetime2(7),@p501 nvarchar(4000),@p502 nvarchar(4000),@p503 nvarchar(4000),@p504 nvarchar(4000),@p505 nvarchar(4000),@p506 nvarchar(4000),@p507 nvarchar(4000),@p508 nvarchar(4000),@p509 nvarchar(4000),@p510 nvarchar(4000),@p511 nvarchar(4000),@p512 nvarchar(4000),@p513 nvarchar(4000),@p514 nvarchar(4000),@p515 datetime2(7),@p516 nvarchar(4000),@p517 nvarchar(4000),@p518 int,@p519 int,@p520 int,@p521 nvarchar(4000),@p522 nvarchar(4000),@p523 nvarchar(4000),@p524 decimal(18,2),@p525 decimal(18,2),@p526 nvarchar(4000),@p527 nvarchar(4000),@p528 decimal(18,2),@p529 nvarchar(4000),@p530 nvarchar(4000),@p531 nvarchar(4000),@p532 nvarchar(4000),@p533 int,@p534 nvarchar(4000),@p535 nvarchar(4000),@p536 nvarchar(4000),@p537 nvarchar(4000),@p538 nvarchar(4000),@p539 nvarchar(4000),@p540 nvarchar(4000),@p541 nvarchar(4000),@p542 nvarchar(4000),@p543 nvarchar(4000),@p544 int,@p545 nvarchar(4000),@p546 nvarchar(4000),@p547 nvarchar(4000),@p548 nvarchar(4000),@p549 nvarchar(4000),@p550 int,@p551 nvarchar(4000),@p552 int,@p553 int,@p554 datetime2(7),@p555 datetime2(7),@p556 datetime2(7),@p557 nvarchar(4000),@p558 nvarchar(4000),@p559 nvarchar(4000),@p560 nvarchar(4000),@p561 nvarchar(4000),@p562 nvarchar(4000),@p563 nvarchar(4000),@p564 nvarchar(4000),@p565 nvarchar(4000),@p566 nvarchar(4000),@p567 nvarchar(4000),@p568 nvarchar(4000),@p569 nvarchar(4000),@p570 nvarchar(4000),@p571 datetime2(7),@p572 nvarchar(4000),@p573 nvarchar(4000),@p574 int,@p575 int,@p576 int,@p577 nvarchar(4000),@p578 nvarchar(4000),@p579 nvarchar(4000),@p580 decimal(18,2),@p581 decimal(18,2),@p582 nvarchar(4000),@p583 nvarchar(4000),@p584 decimal(18,2),@p585 nvarchar(4000),@p586 nvarchar(4000),@p587 nvarchar(4000),@p588 nvarchar(4000),@p589 int,@p590 nvarchar(4000),@p591 nvarchar(4000),@p592 nvarchar(4000),@p593 nvarchar(4000),@p594 nvarchar(4000),@p595 nvarchar(4000),@p596 nvarchar(4000),@p597 nvarchar(4000),@p598 nvarchar(4000),@p599 nvarchar(4000),@p600 int,@p601 nvarchar(4000),@p602 nvarchar(4000),@p603 nvarchar(4000),@p604 nvarchar(4000),@p605 nvarchar(4000),@p606 int,@p607 nvarchar(4000),@p608 int,@p609 int,@p610 datetime2(7),@p611 datetime2(7),@p612 datetime2(7),@p613 nvarchar(4000),@p614 nvarchar(4000),@p615 nvarchar(4000),@p616 nvarchar(4000),@p617 nvarchar(4000),@p618 nvarchar(4000),@p619 nvarchar(4000),@p620 nvarchar(4000),@p621 nvarchar(4000),@p622 nvarchar(4000),@p623 nvarchar(4000),@p624 nvarchar(4000),@p625 nvarchar(4000),@p626 nvarchar(4000),@p627 datetime2(7),@p628 nvarchar(4000),@p629 nvarchar(4000),@p630 int,@p631 int,@p632 int,@p633 nvarchar(4000),@p634 nvarchar(4000),@p635 nvarchar(4000),@p636 decimal(18,2),@p637 decimal(18,2),@p638 nvarchar(4000),@p639 nvarchar(4000),@p640 decimal(18,2),@p641 nvarchar(4000),@p642 nvarchar(4000),@p643 nvarchar(4000),@p644 nvarchar(4000),@p645 int,@p646 nvarchar(4000),@p647 nvarchar(4000),@p648 nvarchar(4000),@p649 nvarchar(4000),@p650 nvarchar(4000),@p651 nvarchar(4000),@p652 nvarchar(4000),@p653 nvarchar(4000),@p654 nvarchar(4000),@p655 nvarchar(4000),@p656 int,@p657 nvarchar(4000),@p658 nvarchar(4000),@p659 nvarchar(4000),@p660 nvarchar(4000),@p661 nvarchar(4000),@p662 int,@p663 nvarchar(4000),@p664 int,@p665 int,@p666 datetime2(7),@p667 datetime2(7),@p668 datetime2(7),@p669 nvarchar(4000),@p670 nvarchar(4000),@p671 nvarchar(4000),@p672 nvarchar(4000),@p673 nvarchar(4000),@p674 nvarchar(4000),@p675 nvarchar(4000),@p676 nvarchar(4000),@p677 nvarchar(4000),@p678 nvarchar(4000),@p679 nvarchar(4000),@p680 nvarchar(4000),@p681 nvarchar(4000),@p682 nvarchar(4000),@p683 datetime2(7),@p684 nvarchar(4000),@p685 nvarchar(4000),@p686 int,@p687 int,@p688 int,@p689 nvarchar(4000),@p690 nvarchar(4000),@p691 nvarchar(4000),@p692 decimal(18,2),@p693 decimal(18,2),@p694 nvarchar(4000),@p695 nvarchar(4000),@p696 decimal(18,2),@p697 nvarchar(4000),@p698 nvarchar(4000),@p699 nvarchar(4000),@p700 nvarchar(4000),@p701 int,@p702 nvarchar(4000),@p703 nvarchar(4000),@p704 nvarchar(4000),@p705 nvarchar(4000),@p706 nvarchar(4000),@p707 nvarchar(4000),@p708 nvarchar(4000),@p709 nvarchar(4000),@p710 nvarchar(4000),@p711 nvarchar(4000),@p712 int,@p713 nvarchar(4000),@p714 nvarchar(4000),@p715 nvarchar(4000),@p716 nvarchar(4000),@p717 nvarchar(4000),@p718 int,@p719 nvarchar(4000),@p720 int,@p721 int,@p722 datetime2(7),@p723 datetime2(7),@p724 datetime2(7),@p725 nvarchar(4000),@p726 nvarchar(4000),@p727 nvarchar(4000),@p728 nvarchar(4000),@p729 nvarchar(4000),@p730 nvarchar(4000),@p731 nvarchar(4000),@p732 nvarchar(4000),@p733 nvarchar(4000),@p734 nvarchar(4000),@p735 nvarchar(4000),@p736 nvarchar(4000),@p737 nvarchar(4000),@p738 nvarchar(4000),@p739 datetime2(7),@p740 nvarchar(4000),@p741 nvarchar(4000),@p742 int,@p743 int,@p744 int,@p745 nvarchar(4000),@p746 nvarchar(4000),@p747 nvarchar(4000),@p748 decimal(18,2),@p749 decimal(18,2),@p750 nvarchar(4000),@p751 nvarchar(4000),@p752 decimal(18,2),@p753 nvarchar(4000),@p754 nvarchar(4000),@p755 nvarchar(4000),@p756 nvarchar(4000),@p757 int,@p758 nvarchar(4000),@p759 nvarchar(4000),@p760 nvarchar(4000),@p761 nvarchar(4000),@p762 nvarchar(4000),@p763 nvarchar(4000),@p764 nvarchar(4000),@p765 nvarchar(4000),@p766 nvarchar(4000),@p767 nvarchar(4000),@p768 int,@p769 nvarchar(4000),@p770 nvarchar(4000),@p771 nvarchar(4000),@p772 nvarchar(4000),@p773 nvarchar(4000),@p774 int,@p775 nvarchar(4000),@p776 int,@p777 int,@p778 datetime2(7),@p779 datetime2(7),@p780 datetime2(7),@p781 nvarchar(4000),@p782 nvarchar(4000),@p783 nvarchar(4000),@p784 nvarchar(4000),@p785 nvarchar(4000),@p786 nvarchar(4000),@p787 nvarchar(4000),@p788 nvarchar(4000),@p789 nvarchar(4000),@p790 nvarchar(4000),@p791 nvarchar(4000),@p792 nvarchar(4000),@p793 nvarchar(4000),@p794 nvarchar(4000),@p795 datetime2(7),@p796 nvarchar(4000),@p797 nvarchar(4000),@p798 int,@p799 int,@p800 int,@p801 nvarchar(4000),@p802 nvarchar(4000),@p803 nvarchar(4000),@p804 decimal(18,2),@p805 decimal(18,2),@p806 nvarchar(4000),@p807 nvarchar(4000),@p808 decimal(18,2),@p809 nvarchar(4000),@p810 nvarchar(4000),@p811 nvarchar(4000),@p812 nvarchar(4000),@p813 int,@p814 nvarchar(4000),@p815 nvarchar(4000),@p816 nvarchar(4000),@p817 nvarchar(4000),@p818 nvarchar(4000),@p819 nvarchar(4000),@p820 nvarchar(4000),@p821 nvarchar(4000),@p822 nvarchar(4000),@p823 nvarchar(4000),@p824 int,@p825 nvarchar(4000),@p826 nvarchar(4000),@p827 nvarchar(4000),@p828 nvarchar(4000),@p829 nvarchar(4000),@p830 int,@p831 nvarchar(4000),@p832 int,@p833 int,@p834 datetime2(7),@p835 datetime2(7),@p836 datetime2(7),@p837 nvarchar(4000),@p838 nvarchar(4000),@p839 nvarchar(4000),@p840 nvarchar(4000),@p841 nvarchar(4000),@p842 nvarchar(4000),@p843 nvarchar(4000),@p844 nvarchar(4000),@p845 nvarchar(4000),@p846 nvarchar(4000),@p847 nvarchar(4000),@p848 nvarchar(4000),@p849 nvarchar(4000),@p850 nvarchar(4000),@p851 datetime2(7),@p852 nvarchar(4000),@p853 nvarchar(4000),@p854 int,@p855 int,@p856 int,@p857 nvarchar(4000),@p858 nvarchar(4000),@p859 nvarchar(4000),@p860 decimal(18,2),@p861 decimal(18,2),@p862 nvarchar(4000),@p863 nvarchar(4000),@p864 decimal(18,2),@p865 nvarchar(4000),@p866 nvarchar(4000),@p867 nvarchar(4000),@p868 nvarchar(4000),@p869 int,@p870 nvarchar(4000),@p871 nvarchar(4000),@p872 nvarchar(4000),@p873 nvarchar(4000),@p874 nvarchar(4000),@p875 nvarchar(4000),@p876 nvarchar(4000),@p877 nvarchar(4000),@p878 nvarchar(4000),@p879 nvarchar(4000),@p880 int,@p881 nvarchar(4000),@p882 nvarchar(4000),@p883 nvarchar(4000),@p884 nvarchar(4000),@p885 nvarchar(4000),@p886 int,@p887 nvarchar(4000),@p888 int,@p889 int,@p890 datetime2(7),@p891 datetime2(7),@p892 datetime2(7),@p893 nvarchar(4000),@p894 nvarchar(4000),@p895 nvarchar(4000),@p896 nvarchar(4000),@p897 nvarchar(4000),@p898 nvarchar(4000),@p899 nvarchar(4000),@p900 nvarchar(4000),@p901 nvarchar(4000),@p902 nvarchar(4000),@p903 nvarchar(4000),@p904 nvarchar(4000),@p905 nvarchar(4000),@p906 nvarchar(4000),@p907 datetime2(7),@p908 nvarchar(4000),@p909 nvarchar(4000),@p910 int,@p911 int,@p912 int,@p913 nvarchar(4000),@p914 nvarchar(4000),@p915 nvarchar(4000),@p916 decimal(18,2),@p917 decimal(18,2),@p918 nvarchar(4000),@p919 nvarchar(4000),@p920 decimal(18,2),@p921 nvarchar(4000),@p922 nvarchar(4000),@p923 nvarchar(4000),@p924 nvarchar(4000),@p925 int,@p926 nvarchar(4000),@p927 nvarchar(4000),@p928 nvarchar(4000),@p929 nvarchar(4000),@p930 nvarchar(4000),@p931 nvarchar(4000),@p932 nvarchar(4000),@p933 nvarchar(4000),@p934 nvarchar(4000),@p935 nvarchar(4000),@p936 int,@p937 nvarchar(4000),@p938 nvarchar(4000),@p939 nvarchar(4000),@p940 nvarchar(4000),@p941 nvarchar(4000),@p942 int,@p943 nvarchar(4000),@p944 int,@p945 int,@p946 datetime2(7),@p947 datetime2(7),@p948 datetime2(7),@p949 nvarchar(4000),@p950 nvarchar(4000),@p951 nvarchar(4000),@p952 nvarchar(4000),@p953 nvarchar(4000),@p954 nvarchar(4000),@p955 nvarchar(4000),@p956 nvarchar(4000),@p957 nvarchar(4000),@p958 nvarchar(4000),@p959 nvarchar(4000),@p960 nvarchar(4000),@p961 nvarchar(4000),@p962 nvarchar(4000),@p963 datetime2(7),@p964 nvarchar(4000),@p965 nvarchar(4000),@p966 int,@p967 int,@p968 int,@p969 nvarchar(4000),@p970 nvarchar(4000),@p971 nvarchar(4000),@p972 decimal(18,2),@p973 decimal(18,2),@p974 nvarchar(4000),@p975 nvarchar(4000),@p976 decimal(18,2),@p977 nvarchar(4000),@p978 nvarchar(4000),@p979 nvarchar(4000),@p980 nvarchar(4000),@p981 int,@p982 nvarchar(4000),@p983 nvarchar(4000),@p984 nvarchar(4000),@p985 nvarchar(4000),@p986 nvarchar(4000),@p987 nvarchar(4000),@p988 nvarchar(4000),@p989 nvarchar(4000),@p990 nvarchar(4000),@p991 nvarchar(4000),@p992 int,@p993 nvarchar(4000),@p994 nvarchar(4000),@p995 nvarchar(4000),@p996 nvarchar(4000),@p997 nvarchar(4000),@p998 int,@p999 nvarchar(4000),@p1000 int,@p1001 int,@p1002 datetime2(7),@p1003 datetime2(7),@p1004 datetime2(7),@p1005 nvarchar(4000),@p1006 nvarchar(4000),@p1007 nvarchar(4000),@p1008 nvarchar(4000),@p1009 nvarchar(4000),@p1010 nvarchar(4000),@p1011 nvarchar(4000),@p1012 nvarchar(4000),@p1013 nvarchar(4000),@p1014 nvarchar(4000),@p1015 nvarchar(4000),@p1016 nvarchar(4000),@p1017 nvarchar(4000),@p1018 nvarchar(4000),@p1019 datetime2(7),@p1020 nvarchar(4000),@p1021 nvarchar(4000),@p1022 int,@p1023 int,@p1024 int,@p1025 nvarchar(4000),@p1026 nvarchar(4000),@p1027 nvarchar(4000),@p1028 decimal(18,2),@p1029 decimal(18,2),@p1030 nvarchar(4000),@p1031 nvarchar(4000),@p1032 decimal(18,2),@p1033 nvarchar(4000),@p1034 nvarchar(4000),@p1035 nvarchar(4000),@p1036 nvarchar(4000),@p1037 int,@p1038 nvarchar(4000),@p1039 nvarchar(4000),@p1040 nvarchar(4000),@p1041 nvarchar(4000),@p1042 nvarchar(4000),@p1043 nvarchar(4000),@p1044 nvarchar(4000),@p1045 nvarchar(4000),@p1046 nvarchar(4000),@p1047 nvarchar(4000),@p1048 int,@p1049 nvarchar(4000),@p1050 nvarchar(4000),@p1051 nvarchar(4000),@p1052 nvarchar(4000),@p1053 nvarchar(4000),@p1054 int,@p1055 nvarchar(4000),@p1056 int,@p1057 int,@p1058 datetime2(7),@p1059 datetime2(7),@p1060 datetime2(7),@p1061 nvarchar(4000),@p1062 nvarchar(4000),@p1063 nvarchar(4000),@p1064 nvarchar(4000),@p1065 nvarchar(4000),@p1066 nvarchar(4000),@p1067 nvarchar(4000),@p1068 nvarchar(4000),@p1069 nvarchar(4000),@p1070 nvarchar(4000),@p1071 nvarchar(4000),@p1072 nvarchar(4000),@p1073 nvarchar(4000),@p1074 nvarchar(4000),@p1075 datetime2(7),@p1076 nvarchar(4000),@p1077 nvarchar(4000),@p1078 int,@p1079 int,@p1080 int,@p1081 nvarchar(4000),@p1082 nvarchar(4000),@p1083 nvarchar(4000),@p1084 decimal(18,2),@p1085 decimal(18,2),@p1086 nvarchar(4000),@p1087 nvarchar(4000),@p1088 decimal(18,2),@p1089 nvarchar(4000),@p1090 nvarchar(4000),@p1091 nvarchar(4000),@p1092 nvarchar(4000),@p1093 int,@p1094 nvarchar(4000),@p1095 nvarchar(4000),@p1096 nvarchar(4000),@p1097 nvarchar(4000),@p1098 nvarchar(4000),@p1099 nvarchar(4000),@p1100 nvarchar(4000),@p1101 nvarchar(4000),@p1102 nvarchar(4000),@p1103 nvarchar(4000),@p1104 int,@p1105 nvarchar(4000),@p1106 nvarchar(4000),@p1107 nvarchar(4000),@p1108 nvarchar(4000),@p1109 nvarchar(4000),@p1110 int,@p1111 nvarchar(4000),@p1112 int,@p1113 int,@p1114 datetime2(7),@p1115 datetime2(7),@p1116 datetime2(7),@p1117 nvarchar(4000),@p1118 nvarchar(4000),@p1119 nvarchar(4000),@p1120 nvarchar(4000),@p1121 nvarchar(4000),@p1122 nvarchar(4000),@p1123 nvarchar(4000),@p1124 nvarchar(4000),@p1125 nvarchar(4000),@p1126 nvarchar(4000),@p1127 nvarchar(4000),@p1128 nvarchar(4000),@p1129 nvarchar(4000),@p1130 nvarchar(4000),@p1131 datetime2(7),@p1132 nvarchar(4000),@p1133 nvarchar(4000),@p1134 int,@p1135 int,@p1136 int,@p1137 nvarchar(4000),@p1138 nvarchar(4000),@p1139 nvarchar(4000),@p1140 decimal(18,2),@p1141 decimal(18,2),@p1142 nvarchar(4000),@p1143 nvarchar(4000),@p1144 decimal(18,2),@p1145 nvarchar(4000),@p1146 nvarchar(4000),@p1147 nvarchar(4000),@p1148 nvarchar(4000),@p1149 int,@p1150 nvarchar(4000),@p1151 nvarchar(4000),@p1152 nvarchar(4000),@p1153 nvarchar(4000),@p1154 nvarchar(4000),@p1155 nvarchar(4000),@p1156 nvarchar(4000),@p1157 nvarchar(4000),@p1158 nvarchar(4000),@p1159 nvarchar(4000),@p1160 int,@p1161 nvarchar(4000),@p1162 nvarchar(4000),@p1163 nvarchar(4000),@p1164 nvarchar(4000),@p1165 nvarchar(4000),@p1166 int,@p1167 nvarchar(4000),@p1168 int,@p1169 int,@p1170 datetime2(7),@p1171 datetime2(7),@p1172 datetime2(7),@p1173 nvarchar(4000),@p1174 nvarchar(4000),@p1175 nvarchar(4000),@p1176 nvarchar(4000),@p1177 nvarchar(4000),@p1178 nvarchar(4000),@p1179 nvarchar(4000),@p1180 nvarchar(4000),@p1181 nvarchar(4000),@p1182 nvarchar(4000),@p1183 nvarchar(4000),@p1184 nvarchar(4000),@p1185 nvarchar(4000),@p1186 nvarchar(4000),@p1187 datetime2(7),@p1188 nvarchar(4000),@p1189 nvarchar(4000),@p1190 int,@p1191 int,@p1192 int,@p1193 nvarchar(4000),@p1194 nvarchar(4000),@p1195 nvarchar(4000),@p1196 nvarchar(4000),@p1197 decimal(18,2),@p1198 nvarchar(4000),@p1199 nvarchar(4000),@p1200 decimal(18,2),@p1201 nvarchar(4000),@p1202 nvarchar(4000),@p1203 nvarchar(4000),@p1204 nvarchar(4000),@p1205 int,@p1206 nvarchar(4000),@p1207 nvarchar(4000),@p1208 nvarchar(4000),@p1209 nvarchar(4000),@p1210 nvarchar(4000),@p1211 nvarchar(4000),@p1212 nvarchar(4000),@p1213 nvarchar(4000),@p1214 nvarchar(4000),@p1215 nvarchar(4000),@p1216 int,@p1217 nvarchar(4000),@p1218 nvarchar(4000),@p1219 nvarchar(4000),@p1220 nvarchar(4000),@p1221 nvarchar(4000),@p1222 int,@p1223 nvarchar(4000),@p1224 int,@p1225 int,@p1226 datetime2(7),@p1227 datetime2(7),@p1228 datetime2(7),@p1229 nvarchar(4000),@p1230 nvarchar(4000),@p1231 nvarchar(4000),@p1232 nvarchar(4000),@p1233 nvarchar(4000),@p1234 nvarchar(4000),@p1235 nvarchar(4000),@p1236 nvarchar(4000),@p1237 nvarchar(4000),@p1238 nvarchar(4000),@p1239 nvarchar(4000),@p1240 nvarchar(4000),@p1241 nvarchar(4000),@p1242 nvarchar(4000),@p1243 datetime2(7),@p1244 nvarchar(4000),@p1245 nvarchar(4000),@p1246 int,@p1247 int,@p1248 int,@p1249 nvarchar(4000),@p1250 nvarchar(4000),@p1251 nvarchar(4000),@p1252 nvarchar(4000),@p1253 decimal(18,2),@p1254 nvarchar(4000),@p1255 nvarchar(4000),@p1256 decimal(18,2),@p1257 nvarchar(4000),@p1258 nvarchar(4000),@p1259 nvarchar(4000),@p1260 nvarchar(4000),@p1261 int,@p1262 nvarchar(4000),@p1263 nvarchar(4000),@p1264 nvarchar(4000),@p1265 nvarchar(4000),@p1266 nvarchar(4000),@p1267 nvarchar(4000),@p1268 nvarchar(4000),@p1269 nvarchar(4000),@p1270 nvarchar(4000),@p1271 nvarchar(4000),@p1272 int,@p1273 nvarchar(4000),@p1274 nvarchar(4000),@p1275 nvarchar(4000),@p1276 nvarchar(4000),@p1277 nvarchar(4000),@p1278 int,@p1279 nvarchar(4000),@p1280 int,@p1281 int,@p1282 datetime2(7),@p1283 datetime2(7),@p1284 datetime2(7),@p1285 nvarchar(4000),@p1286 nvarchar(4000),@p1287 nvarchar(4000),@p1288 nvarchar(4000),@p1289 nvarchar(4000),@p1290 nvarchar(4000),@p1291 nvarchar(4000),@p1292 nvarchar(4000),@p1293 nvarchar(4000),@p1294 nvarchar(4000),@p1295 nvarchar(4000),@p1296 nvarchar(4000),@p1297 nvarchar(4000),@p1298 nvarchar(4000),@p1299 datetime2(7),@p1300 nvarchar(4000),@p1301 nvarchar(4000),@p1302 int,@p1303 int,@p1304 int,@p1305 nvarchar(4000),@p1306 nvarchar(4000),@p1307 nvarchar(4000),@p1308 nvarchar(4000),@p1309 decimal(18,2),@p1310 nvarchar(4000),@p1311 nvarchar(4000),@p1312 decimal(18,2),@p1313 nvarchar(4000),@p1314 nvarchar(4000),@p1315 nvarchar(4000),@p1316 nvarchar(4000),@p1317 int,@p1318 nvarchar(4000),@p1319 nvarchar(4000),@p1320 nvarchar(4000),@p1321 nvarchar(4000),@p1322 nvarchar(4000),@p1323 nvarchar(4000),@p1324 nvarchar(4000),@p1325 nvarchar(4000),@p1326 nvarchar(4000),@p1327 nvarchar(4000),@p1328 int,@p1329 nvarchar(4000),@p1330 nvarchar(4000),@p1331 nvarchar(4000),@p1332 nvarchar(4000),@p1333 nvarchar(4000),@p1334 int,@p1335 nvarchar(4000),@p1336 int,@p1337 int,@p1338 datetime2(7),@p1339 datetime2(7),@p1340 datetime2(7),@p1341 nvarchar(4000),@p1342 nvarchar(4000),@p1343 nvarchar(4000),@p1344 nvarchar(4000),@p1345 nvarchar(4000),@p1346 nvarchar(4000),@p1347 nvarchar(4000),@p1348 nvarchar(4000),@p1349 nvarchar(4000),@p1350 nvarchar(4000),@p1351 nvarchar(4000),@p1352 nvarchar(4000),@p1353 nvarchar(4000),@p1354 nvarchar(4000),@p1355 datetime2(7),@p1356 nvarchar(4000),@p1357 nvarchar(4000),@p1358 int,@p1359 int,@p1360 int,@p1361 nvarchar(4000),@p1362 nvarchar(4000),@p1363 nvarchar(4000),@p1364 nvarchar(4000),@p1365 decimal(18,2),@p1366 nvarchar(4000),@p1367 nvarchar(4000),@p1368 decimal(18,2),@p1369 nvarchar(4000),@p1370 nvarchar(4000),@p1371 nvarchar(4000),@p1372 nvarchar(4000),@p1373 int,@p1374 nvarchar(4000),@p1375 nvarchar(4000),@p1376 nvarchar(4000),@p1377 nvarchar(4000),@p1378 nvarchar(4000),@p1379 nvarchar(4000),@p1380 nvarchar(4000),@p1381 nvarchar(4000),@p1382 nvarchar(4000),@p1383 nvarchar(4000),@p1384 int,@p1385 nvarchar(4000),@p1386 nvarchar(4000),@p1387 nvarchar(4000),@p1388 nvarchar(4000),@p1389 nvarchar(4000),@p1390 int,@p1391 nvarchar(4000),@p1392 int,@p1393 int,@p1394 datetime2(7),@p1395 datetime2(7),@p1396 datetime2(7),@p1397 nvarchar(4000),@p1398 nvarchar(4000),@p1399 nvarchar(4000),@p1400 nvarchar(4000),@p1401 nvarchar(4000),@p1402 nvarchar(4000),@p1403 nvarchar(4000),@p1404 nvarchar(4000),@p1405 nvarchar(4000),@p1406 nvarchar(4000),@p1407 nvarchar(4000),@p1408 nvarchar(4000),@p1409 nvarchar(4000),@p1410 nvarchar(4000),@p1411 datetime2(7),@p1412 nvarchar(4000),@p1413 nvarchar(4000),@p1414 int,@p1415 int,@p1416 int,@p1417 nvarchar(4000),@p1418 nvarchar(4000),@p1419 nvarchar(4000),@p1420 nvarchar(4000),@p1421 decimal(18,2),@p1422 nvarchar(4000),@p1423 nvarchar(4000),@p1424 decimal(18,2),@p1425 nvarchar(4000),@p1426 nvarchar(4000),@p1427 nvarchar(4000),@p1428 nvarchar(4000),@p1429 int,@p1430 nvarchar(4000),@p1431 nvarchar(4000),@p1432 nvarchar(4000),@p1433 nvarchar(4000),@p1434 nvarchar(4000),@p1435 nvarchar(4000),@p1436 nvarchar(4000),@p1437 nvarchar(4000),@p1438 nvarchar(4000),@p1439 nvarchar(4000),@p1440 int,@p1441 nvarchar(4000),@p1442 nvarchar(4000),@p1443 nvarchar(4000),@p1444 nvarchar(4000),@p1445 nvarchar(4000),@p1446 int,@p1447 nvarchar(4000),@p1448 int,@p1449 int,@p1450 datetime2(7),@p1451 datetime2(7),@p1452 datetime2(7),@p1453 nvarchar(4000),@p1454 nvarchar(4000),@p1455 nvarchar(4000),@p1456 nvarchar(4000),@p1457 nvarchar(4000),@p1458 nvarchar(4000),@p1459 nvarchar(4000),@p1460 nvarchar(4000),@p1461 nvarchar(4000),@p1462 nvarchar(4000),@p1463 nvarchar(4000),@p1464 nvarchar(4000),@p1465 nvarchar(4000),@p1466 nvarchar(4000),@p1467 datetime2(7),@p1468 nvarchar(4000),@p1469 nvarchar(4000),@p1470 int,@p1471 int,@p1472 int,@p1473 nvarchar(4000),@p1474 nvarchar(4000),@p1475 nvarchar(4000),@p1476 nvarchar(4000),@p1477 decimal(18,2),@p1478 nvarchar(4000),@p1479 nvarchar(4000),@p1480 decimal(18,2),@p1481 nvarchar(4000),@p1482 nvarchar(4000),@p1483 nvarchar(4000),@p1484 nvarchar(4000),@p1485 int,@p1486 nvarchar(4000),@p1487 nvarchar(4000),@p1488 nvarchar(4000),@p1489 nvarchar(4000),@p1490 nvarchar(4000),@p1491 nvarchar(4000),@p1492 nvarchar(4000),@p1493 nvarchar(4000),@p1494 nvarchar(4000),@p1495 nvarchar(4000),@p1496 int,@p1497 nvarchar(4000),@p1498 nvarchar(4000),@p1499 nvarchar(4000),@p1500 nvarchar(4000),@p1501 nvarchar(4000),@p1502 int,@p1503 nvarchar(4000),@p1504 int,@p1505 int,@p1506 datetime2(7),@p1507 datetime2(7),@p1508 datetime2(7),@p1509 nvarchar(4000),@p1510 nvarchar(4000),@p1511 nvarchar(4000),@p1512 nvarchar(4000),@p1513 nvarchar(4000),@p1514 nvarchar(4000),@p1515 nvarchar(4000),@p1516 nvarchar(4000),@p1517 nvarchar(4000),@p1518 nvarchar(4000),@p1519 nvarchar(4000),@p1520 nvarchar(4000),@p1521 nvarchar(4000),@p1522 nvarchar(4000),@p1523 datetime2(7),@p1524 nvarchar(4000),@p1525 nvarchar(4000),@p1526 int,@p1527 int,@p1528 int,@p1529 nvarchar(4000),@p1530 nvarchar(4000),@p1531 nvarchar(4000),@p1532 decimal(18,2),@p1533 decimal(18,2),@p1534 nvarchar(4000),@p1535 nvarchar(4000),@p1536 decimal(18,2),@p1537 nvarchar(4000),@p1538 nvarchar(4000),@p1539 nvarchar(4000),@p1540 nvarchar(4000),@p1541 int,@p1542 nvarchar(4000),@p1543 nvarchar(4000),@p1544 nvarchar(4000),@p1545 nvarchar(4000),@p1546 nvarchar(4000),@p1547 nvarchar(4000),@p1548 nvarchar(4000),@p1549 nvarchar(4000),@p1550 nvarchar(4000),@p1551 nvarchar(4000),@p1552 int,@p1553 nvarchar(4000),@p1554 nvarchar(4000),@p1555 nvarchar(4000),@p1556 nvarchar(4000),@p1557 nvarchar(4000),@p1558 int,@p1559 nvarchar(4000),@p1560 int,@p1561 int,@p1562 datetime2(7),@p1563 datetime2(7),@p1564 datetime2(7),@p1565 nvarchar(4000),@p1566 nvarchar(4000),@p1567 nvarchar(4000),@p1568 nvarchar(4000),@p1569 nvarchar(4000),@p1570 nvarchar(4000),@p1571 nvarchar(4000),@p1572 nvarchar(4000),@p1573 nvarchar(4000),@p1574 nvarchar(4000),@p1575 nvarchar(4000),@p1576 nvarchar(4000),@p1577 nvarchar(4000),@p1578 nvarchar(4000),@p1579 datetime2(7),@p1580 nvarchar(4000),@p1581 nvarchar(4000),@p1582 int,@p1583 int,@p1584 int,@p1585 nvarchar(4000),@p1586 nvarchar(4000),@p1587 nvarchar(4000),@p1588 decimal(18,2),@p1589 decimal(18,2),@p1590 nvarchar(4000),@p1591 nvarchar(4000),@p1592 decimal(18,2),@p1593 nvarchar(4000),@p1594 nvarchar(4000),@p1595 nvarchar(4000),@p1596 nvarchar(4000),@p1597 int,@p1598 nvarchar(4000),@p1599 nvarchar(4000),@p1600 nvarchar(4000),@p1601 nvarchar(4000),@p1602 nvarchar(4000),@p1603 nvarchar(4000),@p1604 nvarchar(4000),@p1605 nvarchar(4000),@p1606 nvarchar(4000),@p1607 nvarchar(4000),@p1608 int,@p1609 nvarchar(4000),@p1610 nvarchar(4000),@p1611 nvarchar(4000),@p1612 nvarchar(4000),@p1613 nvarchar(4000),@p1614 int,@p1615 nvarchar(4000),@p1616 int,@p1617 int,@p1618 datetime2(7),@p1619 datetime2(7),@p1620 datetime2(7),@p1621 nvarchar(4000),@p1622 nvarchar(4000),@p1623 nvarchar(4000),@p1624 nvarchar(4000),@p1625 nvarchar(4000),@p1626 nvarchar(4000),@p1627 nvarchar(4000),@p1628 nvarchar(4000),@p1629 nvarchar(4000),@p1630 nvarchar(4000),@p1631 nvarchar(4000),@p1632 nvarchar(4000),@p1633 nvarchar(4000),@p1634 nvarchar(4000),@p1635 datetime2(7),@p1636 nvarchar(4000),@p1637 nvarchar(4000),@p1638 int,@p1639 int,@p1640 int,@p1641 nvarchar(4000),@p1642 nvarchar(4000),@p1643 nvarchar(4000),@p1644 nvarchar(4000),@p1645 decimal(18,2),@p1646 nvarchar(4000),@p1647 nvarchar(4000),@p1648 decimal(18,2),@p1649 nvarchar(4000),@p1650 nvarchar(4000),@p1651 nvarchar(4000),@p1652 nvarchar(4000),@p1653 int,@p1654 nvarchar(4000),@p1655 nvarchar(4000),@p1656 nvarchar(4000),@p1657 nvarchar(4000),@p1658 nvarchar(4000),@p1659 nvarchar(4000),@p1660 nvarchar(4000),@p1661 nvarchar(4000),@p1662 nvarchar(4000),@p1663 nvarchar(4000),@p1664 int,@p1665 nvarchar(4000),@p1666 nvarchar(4000),@p1667 nvarchar(4000),@p1668 nvarchar(4000),@p1669 nvarchar(4000),@p1670 int,@p1671 nvarchar(4000),@p1672 int,@p1673 int,@p1674 datetime2(7),@p1675 datetime2(7),@p1676 datetime2(7),@p1677 nvarchar(4000),@p1678 nvarchar(4000),@p1679 nvarchar(4000),@p1680 nvarchar(4000),@p1681 nvarchar(4000),@p1682 nvarchar(4000),@p1683 nvarchar(4000),@p1684 nvarchar(4000),@p1685 nvarchar(4000),@p1686 nvarchar(4000),@p1687 nvarchar(4000),@p1688 nvarchar(4000),@p1689 nvarchar(4000),@p1690 nvarchar(4000),@p1691 datetime2(7),@p1692 nvarchar(4000),@p1693 nvarchar(4000),@p1694 int,@p1695 int,@p1696 int,@p1697 nvarchar(4000),@p1698 nvarchar(4000),@p1699 nvarchar(4000),@p1700 nvarchar(4000),@p1701 decimal(18,2),@p1702 nvarchar(4000),@p1703 nvarchar(4000),@p1704 decimal(18,2),@p1705 nvarchar(4000),@p1706 nvarchar(4000),@p1707 nvarchar(4000),@p1708 nvarchar(4000),@p1709 int,@p1710 nvarchar(4000),@p1711 nvarchar(4000),@p1712 nvarchar(4000),@p1713 nvarchar(4000),@p1714 nvarchar(4000),@p1715 nvarchar(4000),@p1716 nvarchar(4000),@p1717 nvarchar(4000),@p1718 nvarchar(4000),@p1719 nvarchar(4000),@p1720 int,@p1721 nvarchar(4000),@p1722 nvarchar(4000),@p1723 nvarchar(4000),@p1724 nvarchar(4000),@p1725 nvarchar(4000),@p1726 int,@p1727 nvarchar(4000),@p1728 int,@p1729 int,@p1730 datetime2(7),@p1731 datetime2(7),@p1732 datetime2(7),@p1733 nvarchar(4000),@p1734 nvarchar(4000),@p1735 nvarchar(4000),@p1736 nvarchar(4000),@p1737 nvarchar(4000),@p1738 nvarchar(4000),@p1739 nvarchar(4000),@p1740 nvarchar(4000),@p1741 nvarchar(4000),@p1742 nvarchar(4000),@p1743 nvarchar(4000),@p1744 nvarchar(4000),@p1745 nvarchar(4000),@p1746 nvarchar(4000),@p1747 datetime2(7),@p1748 nvarchar(4000),@p1749 nvarchar(4000),@p1750 int,@p1751 int,@p1752 int,@p1753 nvarchar(4000),@p1754 nvarchar(4000),@p1755 nvarchar(4000),@p1756 decimal(18,2),@p1757 decimal(18,2),@p1758 nvarchar(4000),@p1759 nvarchar(4000),@p1760 decimal(18,2),@p1761 nvarchar(4000),@p1762 nvarchar(4000),@p1763 nvarchar(4000),@p1764 nvarchar(4000),@p1765 int,@p1766 nvarchar(4000),@p1767 nvarchar(4000),@p1768 nvarchar(4000),@p1769 nvarchar(4000),@p1770 nvarchar(4000),@p1771 nvarchar(4000),@p1772 nvarchar(4000),@p1773 nvarchar(4000),@p1774 nvarchar(4000),@p1775 nvarchar(4000),@p1776 int,@p1777 nvarchar(4000),@p1778 nvarchar(4000),@p1779 nvarchar(4000),@p1780 nvarchar(4000),@p1781 nvarchar(4000),@p1782 int,@p1783 nvarchar(4000),@p1784 int,@p1785 int,@p1786 datetime2(7),@p1787 datetime2(7),@p1788 datetime2(7),@p1789 nvarchar(4000),@p1790 nvarchar(4000),@p1791 nvarchar(4000),@p1792 nvarchar(4000),@p1793 nvarchar(4000),@p1794 nvarchar(4000),@p1795 nvarchar(4000),@p1796 nvarchar(4000),@p1797 nvarchar(4000),@p1798 nvarchar(4000),@p1799 nvarchar(4000),@p1800 nvarchar(4000),@p1801 nvarchar(4000),@p1802 nvarchar(4000),@p1803 datetime2(7),@p1804 nvarchar(4000),@p1805 nvarchar(4000),@p1806 int,@p1807 int,@p1808 int,@p1809 nvarchar(4000),@p1810 nvarchar(4000),@p1811 nvarchar(4000),@p1812 decimal(18,2),@p1813 decimal(18,2),@p1814 nvarchar(4000),@p1815 nvarchar(4000),@p1816 decimal(18,2),@p1817 nvarchar(4000),@p1818 nvarchar(4000),@p1819 nvarchar(4000),@p1820 nvarchar(4000),@p1821 int,@p1822 nvarchar(4000),@p1823 nvarchar(4000),@p1824 nvarchar(4000),@p1825 nvarchar(4000),@p1826 nvarchar(4000),@p1827 nvarchar(4000),@p1828 nvarchar(4000),@p1829 nvarchar(4000),@p1830 nvarchar(4000),@p1831 nvarchar(4000),@p1832 int,@p1833 nvarchar(4000),@p1834 nvarchar(4000),@p1835 nvarchar(4000),@p1836 nvarchar(4000),@p1837 nvarchar(4000),@p1838 int,@p1839 nvarchar(4000),@p1840 int,@p1841 int,@p1842 datetime2(7),@p1843 datetime2(7),@p1844 datetime2(7),@p1845 nvarchar(4000),@p1846 nvarchar(4000),@p1847 nvarchar(4000),@p1848 nvarchar(4000),@p1849 nvarchar(4000),@p1850 nvarchar(4000),@p1851 nvarchar(4000),@p1852 nvarchar(4000),@p1853 nvarchar(4000),@p1854 nvarchar(4000),@p1855 nvarchar(4000),@p1856 nvarchar(4000),@p1857 nvarchar(4000),@p1858 nvarchar(4000),@p1859 datetime2(7),@p1860 nvarchar(4000),@p1861 nvarchar(4000),@p1862 int,@p1863 int,@p1864 int,@p1865 nvarchar(4000),@p1866 nvarchar(4000),@p1867 nvarchar(4000),@p1868 decimal(18,2),@p1869 decimal(18,2),@p1870 nvarchar(4000),@p1871 nvarchar(4000),@p1872 decimal(18,2),@p1873 nvarchar(4000),@p1874 nvarchar(4000),@p1875 nvarchar(4000),@p1876 nvarchar(4000),@p1877 int,@p1878 nvarchar(4000),@p1879 nvarchar(4000),@p1880 nvarchar(4000),@p1881 nvarchar(4000),@p1882 nvarchar(4000),@p1883 nvarchar(4000),@p1884 nvarchar(4000),@p1885 nvarchar(4000),@p1886 nvarchar(4000),@p1887 nvarchar(4000),@p1888 int,@p1889 nvarchar(4000),@p1890 nvarchar(4000),@p1891 nvarchar(4000),@p1892 nvarchar(4000),@p1893 nvarchar(4000),@p1894 int,@p1895 nvarchar(4000),@p1896 int,@p1897 int,@p1898 datetime2(7),@p1899 datetime2(7),@p1900 datetime2(7),@p1901 nvarchar(4000),@p1902 nvarchar(4000),@p1903 nvarchar(4000),@p1904 nvarchar(4000),@p1905 nvarchar(4000),@p1906 nvarchar(4000),@p1907 nvarchar(4000),@p1908 nvarchar(4000),@p1909 nvarchar(4000),@p1910 nvarchar(4000),@p1911 nvarchar(4000),@p1912 nvarchar(4000),@p1913 nvarchar(4000),@p1914 nvarchar(4000),@p1915 datetime2(7),@p1916 nvarchar(4000),@p1917 nvarchar(4000),@p1918 int,@p1919 int,@p1920 int,@p1921 nvarchar(4000),@p1922 nvarchar(4000),@p1923 nvarchar(4000),@p1924 decimal(18,2),@p1925 decimal(18,2),@p1926 nvarchar(4000),@p1927 nvarchar(4000),@p1928 decimal(18,2),@p1929 nvarchar(4000),@p1930 nvarchar(4000),@p1931 nvarchar(4000),@p1932 nvarchar(4000),@p1933 int,@p1934 nvarchar(4000),@p1935 nvarchar(4000),@p1936 nvarchar(4000),@p1937 nvarchar(4000),@p1938 nvarchar(4000),@p1939 nvarchar(4000),@p1940 nvarchar(4000),@p1941 nvarchar(4000),@p1942 nvarchar(4000),@p1943 nvarchar(4000),@p1944 int,@p1945 nvarchar(4000),@p1946 nvarchar(4000),@p1947 nvarchar(4000),@p1948 nvarchar(4000),@p1949 nvarchar(4000),@p1950 int,@p1951 nvarchar(4000),@p1952 int,@p1953 int,@p1954 datetime2(7),@p1955 datetime2(7),@p1956 datetime2(7),@p1957 nvarchar(4000),@p1958 nvarchar(4000),@p1959 nvarchar(4000),@p1960 nvarchar(4000),@p1961 nvarchar(4000),@p1962 nvarchar(4000),@p1963 nvarchar(4000),@p1964 nvarchar(4000),@p1965 nvarchar(4000),@p1966 nvarchar(4000),@p1967 nvarchar(4000),@p1968 nvarchar(4000),@p1969 nvarchar(4000),@p1970 nvarchar(4000),@p1971 datetime2(7),@p1972 nvarchar(4000),@p1973 nvarchar(4000),@p1974 int,@p1975 int,@p1976 int,@p1977 nvarchar(4000),@p1978 nvarchar(4000),@p1979 nvarchar(4000),@p1980 decimal(18,2),@p1981 decimal(18,2),@p1982 nvarchar(4000),@p1983 nvarchar(4000),@p1984 decimal(18,2),@p1985 nvarchar(4000),@p1986 nvarchar(4000),@p1987 nvarchar(4000),@p1988 nvarchar(4000),@p1989 int,@p1990 nvarchar(4000),@p1991 nvarchar(4000),@p1992 nvarchar(4000),@p1993 nvarchar(4000),@p1994 nvarchar(4000),@p1995 nvarchar(4000),@p1996 nvarchar(4000),@p1997 nvarchar(4000),@p1998 nvarchar(4000),@p1999 nvarchar(4000),@p2000 int,@p2001 nvarchar(4000),@p2002 nvarchar(4000),@p2003 nvarchar(4000),@p2004 nvarchar(4000),@p2005 nvarchar(4000),@p2006 int,@p2007 nvarchar(4000),@p2008 int,@p2009 int,@p2010 datetime2(7),@p2011 datetime2(7),@p2012 datetime2(7),@p2013 nvarchar(4000),@p2014 nvarchar(4000),@p2015 nvarchar(4000),@p2016 nvarchar(4000),@p2017 nvarchar(4000),@p2018 nvarchar(4000),@p2019 nvarchar(4000),@p2020 nvarchar(4000),@p2021 nvarchar(4000),@p2022 nvarchar(4000),@p2023 nvarchar(4000),@p2024 nvarchar(4000),@p2025 nvarchar(4000),@p2026 nvarchar(4000),@p2027 datetime2(7),@p2028 nvarchar(4000),@p2029 nvarchar(4000),@p2030 int,@p2031 int,@p2032 int,@p2033 nvarchar(4000),@p2034 nvarchar(4000),@p2035 nvarchar(4000),@p2036 decimal(18,2),@p2037 decimal(18,2),@p2038 nvarchar(4000),@p2039 nvarchar(4000),@p2040 decimal(18,2),@p2041 nvarchar(4000),@p2042 nvarchar(4000),@p2043 nvarchar(4000),@p2044 nvarchar(4000),@p2045 int,@p2046 nvarchar(4000),@p2047 nvarchar(4000),@p2048 nvarchar(4000),@p2049 nvarchar(4000),@p2050 nvarchar(4000),@p2051 nvarchar(4000),@p2052 nvarchar(4000),@p2053 nvarchar(4000),@p2054 nvarchar(4000),@p2055 nvarchar(4000),@p2056 int,@p2057 nvarchar(4000),@p2058 nvarchar(4000),@p2059 nvarchar(4000),@p2060 nvarchar(4000),@p2061 nvarchar(4000),@p2062 int,@p2063 nvarchar(4000),@p2064 int,@p2065 int,@p2066 datetime2(7),@p2067 datetime2(7),@p2068 datetime2(7),@p2069 nvarchar(4000),@p2070 nvarchar(4000),@p2071 nvarchar(4000))SET NOCOUNT ON; DECLARE @inserted0 TABLE ([item_id] int, [_Position] [int]); MERGE [raw_data] USING ( VALUES (@p0, @p1, @p2, @p3, @p4, @p5, @p6, @p7, @p8, @p9, @p10, @p11, @p12, @p13, @p14, @p15, @p16, @p17, @p18, @p19, @p20, @p21, @p22, @p23, @p24, @p25, @p26, @p27, @p28, @p29, @p30, @p31, @p32, @p33, @p34, @p35, @p36, @p37, @p38, @p39, @p40, @p41, @p42, @p43, @p44, @p45, @p46, @p47, @p48, @p49, @p50, @p51, @p52, @p53, @p54, @p55, 0), (@p56, @p57, @p58, @p59, @p60, @p61, @p62, @p63, @p64, @p65, @p66, @p67, @p68, @p69, @p70, @p71, @p72, @p73, @p74, @p75, @p76, @p77, @p78, @p79, @p80, @p81, @p82, @p83, @p84, @p85, @p86, @p87, @p88, @p89, @p90, @p91, @p92, @p93, @p94, @p95, @p96, @p97, @p98, @p99, @p100, @p101, @p102, @p103, @p104, @p105, @p106, @p107, @p108, @p109, @p110, @p111, 1), (@p112, @p113, @p114, @p115, @p116, @p117, @p118, @p119, @p120, @p121, @p122, @p123, @p124, @p125, @p126, @p127, @p128, @p129, @p130, @p131, @p132, @p133, @p134, @p135, @p136, @p137, @p138, @p139, @p140, @p141, @p142, @p143, @p144, @p145, @p146, @p147, @p148, @p149, @p150, @p151, @p152, @p153, @p154, @p155, @p156, @p157, @p158, @p159, @p160, @p161, @p162, @p163, @p164, @p165, @p166, @p167, 2), (@p168, @p169, @p170, @p171, @p172, @p173, @p174, @p175, @p176, @p177, @p178, @p179, @p180, @p181, @p182, @p183, @p184, @p185, @p186, @p187, @p188, @p189, @p190, @p191, @p192, @p193, @p194, @p195, @p196, @p197, @p198, @p199, @p200, @p201, @p202, @p203, @p204, @p205, @p206, @p207, @p208, @p209, @p210, @p211, @p212, @p213, @p214, @p215, @p216, @p217, @p218, @p219, @p220, @p221, @p222, @p223, 3), (@p224, @p225, @p226, @p227, @p228, @p229, @p230, @p231, @p232, @p233, @p234, @p235, @p236, @p237, @p238, @p239, @p240, @p241, @p242, @p243, @p244, @p245, @p246, @p247, @p248, @p249, @p250, @p251, @p252, @p253, @p254, @p255, @p256, @p257, @p258, @p259, @p260, @p261, @p262, @p263, @p264, @p265, @p266, @p267, @p268, @p269, @p270, @p271, @p272, @p273, @p274, @p275, @p276, @p277, @p278, @p279, 4), (@p280, @p281, @p282, @p283, @p284, @p285, @p286, @p287, @p288, @p289, @p290, @p291, @p292, @p293, @p294, @p295, @p296, @p297, @p298, @p299, @p300, @p301, @p302, @p303, @p304, @p305, @p306, @p307, @p308, @p309, @p310, @p311, @p312, @p313, @p314, @p315, @p316, @p317, @p318, @p319, @p320, @p321, @p322, @p323, @p324, @p325, @p326, @p327, @p328, @p329, @p330, @p331, @p332, @p333, @p334, @p335, 5), (@p336, @p337, @p338, @p339, @p340, @p341, @p342, @p343, @p344, @p345, @p346, @p347, @p348, @p349, @p350, @p351, @p352, @p353, @p354, @p355, @p356, @p357, @p358, @p359, @p360, @p361, @p362, @p363, @p364, @p365, @p366, @p367, @p368, @p369, @p370, @p371, @p372, @p373, @p374, @p375, @p376, @p377, @p378, @p379, @p380, @p381, @p382, @p383, @p384, @p385, @p386, @p387, @p388, @p389, @p390, @p391, 6), (@p392, @p393, @p394, @p395, @p396, @p397, @p398, @p399, @p400, @p401, @p402, @p403, @p404, @p405, @p406, @p407, @p408, @p409, @p410, @p411, @p412, @p413, @p414, @p415, @p416, @p417, @p418, @p419, @p420, @p421, @p422, @p423, @p424, @p425, @p426, @p427, @p428, @p429, @p430, @p431, @p432, @p433, @p434, @p435, @p436, @p437, @p438, @p439, @p440, @p441, @p442, @p443, @p444, @p445, @p446, @p447, 7), (@p448, @p449, @p450, @p451, @p452, @p453, @p454, @p455, @p456, @p457, @p458, @p459, @p460, @p461, @p462, @p463, @p464, @p465, @p466, @p467, @p468, @p469, @p470, @p471, @p472, @p473, @p474, @p475, @p476, @p477, @p478, @p479, @p480, @p481, @p482, @p483, @p484, @p485, @p486, @p487, @p488, @p489, @p490, @p491, @p492, @p493, @p494, @p495, @p496, @p497, @p498, @p499, @p500, @p501, @p502, @p503, 8), (@p504, @p505, @p506, @p507, @p508, @p509, @p510, @p511, @p512, @p513, @p514, @p515, @p516, @p517, @p518, @p519, @p520, @p521, @p522, @p523, @p524, @p525, @p526, @p527, @p528, @p529, @p530, @p531, @p532, @p533, @p534, @p535, @p536, @p537, @p538, @p539, @p540, @p541, @p542, @p543, @p544, @p545, @p546, @p547, @p548, @p549, @p550, @p551, @p552, @p553, @p554, @p555, @p556, @p557, @p558, @p559, 9), (@p560, @p561, @p562, @p563, @p564, @p565, @p566, @p567, @p568, @p569, @p570, @p571, @p572, @p573, @p574, @p575, @p576, @p577, @p578, @p579, @p580, @p581, @p582, @p583, @p584, @p585, @p586, @p587, @p588, @p589, @p590, @p591, @p592, @p593, @p594, @p595, @p596, @p597, @p598, @p599, @p600, @p601, @p602, @p603, @p604, @p605, @p606, @p607, @p608, @p609, @p610, @p611, @p612, @p613, @p614, @p615, 10), (@p616, @p617, @p618, @p619, @p620, @p621, @p622, @p623, @p624, @p625, @p626, @p627, @p628, @p629, @p630, @p631, @p632, @p633, @p634, @p635, @p636, @p637, @p638, @p639, @p640, @p641, @p642, @p643, @p644, @p645, @p646, @p647, @p648, @p649, @p650, @p651, @p652, @p653, @p654, @p655, @p656, @p657, @p658, @p659, @p660, @p661, @p662, @p663, @p664, @p665, @p666, @p667, @p668, @p669, @p670, @p671, 11), (@p672, @p673, @p674, @p675, @p676, @p677, @p678, @p679, @p680, @p681, @p682, @p683, @p684, @p685, @p686, @p687, @p688, @p689, @p690, @p691, @p692, @p693, @p694, @p695, @p696, @p697, @p698, @p699, @p700, @p701, @p702, @p703, @p704, @p705, @p706, @p707, @p708, @p709, @p710, @p711, @p712, @p713, @p714, @p715, @p716, @p717, @p718, @p719, @p720, @p721, @p722, @p723, @p724, @p725, @p726, @p727, 12), (@p728, @p729, @p730, @p731, @p732, @p733, @p734, @p735, @p736, @p737, @p738, @p739, @p740, @p741, @p742, @p743, @p744, @p745, @p746, @p747, @p748, @p749, @p750, @p751, @p752, @p753, @p754, @p755, @p756, @p757, @p758, @p759, @p760, @p761, @p762, @p763, @p764, @p765, @p766, @p767, @p768, @p769, @p770, @p771, @p772, @p773, @p774, @p775, @p776, @p777, @p778, @p779, @p780, @p781, @p782, @p783, 13), (@p784, @p785, @p786, @p787, @p788, @p789, @p790, @p791, @p792, @p793, @p794, @p795, @p796, @p797, @p798, @p799, @p800, @p801, @p802, @p803, @p804, @p805, @p806, @p807, @p808, @p809, @p810, @p811, @p812, @p813, @p814, @p815, @p816, @p817, @p818, @p819, @p820, @p821, @p822, @p823, @p824, @p825, @p826, @p827, @p828, @p829, @p830, @p831, @p832, @p833, @p834, @p835, @p836, @p837, @p838, @p839, 14), (@p840, @p841, @p842, @p843, @p844, @p845, @p846, @p847, @p848, @p849, @p850, @p851, @p852, @p853, @p854, @p855, @p856, @p857, @p858, @p859, @p860, @p861, @p862, @p863, @p864, @p865, @p866, @p867, @p868, @p869, @p870, @p871, @p872, @p873, @p874, @p875, @p876, @p877, @p878, @p879, @p880, @p881, @p882, @p883, @p884, @p885, @p886, @p887, @p888, @p889, @p890, @p891, @p892, @p893, @p894, @p895, 15), (@p896, @p897, @p898, @p899, @p900, @p901, @p902, @p903, @p904, @p905, @p906, @p907, @p908, @p909, @p910, @p911, @p912, @p913, @p914, @p915, @p916, @p917, @p918, @p919, @p920, @p921, @p922, @p923, @p924, @p925, @p926, @p927, @p928, @p929, @p930, @p931, @p932, @p933, @p934, @p935, @p936, @p937, @p938, @p939, @p940, @p941, @p942, @p943, @p944, @p945, @p946, @p947, @p948, @p949, @p950, @p951, 16), (@p952, @p953, @p954, @p955, @p956, @p957, @p958, @p959, @p960, @p961, @p962, @p963, @p964, @p965, @p966, @p967, @p968, @p969, @p970, @p971, @p972, @p973, @p974, @p975, @p976, @p977, @p978, @p979, @p980, @p981, @p982, @p983, @p984, @p985, @p986, @p987, @p988, @p989, @p990, @p991, @p992, @p993, @p994, @p995, @p996, @p997, @p998, @p999, @p1000, @p1001, @p1002, @p1003, @p1004, @p1005, @p1006, @p1007, 17), (@p1008, @p1009, @p1010, @p1011, @p1012, @p1013, @p1014, @p1015, @p1016, @p1017, @p1018, @p1019, @p1020, @p1021, @p1022, @p1023, @p1024, @p1025, @p1026, @p1027, @p1028, @p1029, @p1030, @p1031, @p1032, @p1033, @p1034, @p1035, @p1036, @p1037, @p1038, @p1039, @p1040, @p1041, @p1042, @p1043, @p1044, @p1045, @p1046, @p1047, @p1048, @p1049, @p1050, @p1051, @p1052, @p1053, @p1054, @p1055, @p1056, @p1057, @p1058, @p1059, @p1060, @p1061, @p1062, @p1063, 18), (@p1064, @p1065, @p1066, @p1067, @p1068, @p1069, @p1070, @p1071, @p1072, @p1073, @p1074, @p1075, @p1076, @p1077, @p1078, @p1079, @p1080, @p1081, @p1082, @p1083, @p1084, @p1085, @p1086, @p1087, @p1088, @p1089, @p1090, @p1091, @p1092, @p1093, @p1094, @p1095, @p1096, @p1097, @p1098, @p1099, @p1100, @p1101, @p1102, @p1103, @p1104, @p1105, @p1106, @p1107, @p1108, @p1109, @p1110, @p1111, @p1112, @p1113, @p1114, @p1115, @p1116, @p1117, @p1118, @p1119, 19), (@p1120, @p1121, @p1122, @p1123, @p1124, @p1125, @p1126, @p1127, @p1128, @p1129, @p1130, @p1131, @p1132, @p1133, @p1134, @p1135, @p1136, @p1137, @p1138, @p1139, @p1140, @p1141, @p1142, @p1143, @p1144, @p1145, @p1146, @p1147, @p1148, @p1149, @p1150, @p1151, @p1152, @p1153, @p1154, @p1155, @p1156, @p1157, @p1158, @p1159, @p1160, @p1161, @p1162, @p1163, @p1164, @p1165, @p1166, @p1167, @p1168, @p1169, @p1170, @p1171, @p1172, @p1173, @p1174, @p1175, 20), (@p1176, @p1177, @p1178, @p1179, @p1180, @p1181, @p1182, @p1183, @p1184, @p1185, @p1186, @p1187, @p1188, @p1189, @p1190, @p1191, @p1192, @p1193, @p1194, @p1195, @p1196, @p1197, @p1198, @p1199, @p1200, @p1201, @p1202, @p1203, @p1204, @p1205, @p1206, @p1207, @p1208, @p1209, @p1210, @p1211, @p1212, @p1213, @p1214, @p1215, @p1216, @p1217, @p1218, @p1219, @p1220, @p1221, @p1222, @p1223, @p1224, @p1225, @p1226, @p1227, @p1228, @p1229, @p1230, @p1231, 21), (@p1232, @p1233, @p1234, @p1235, @p1236, @p1237, @p1238, @p1239, @p1240, @p1241, @p1242, @p1243, @p1244, @p1245, @p1246, @p1247, @p1248, @p1249, @p1250, @p1251, @p1252, @p1253, @p1254, @p1255, @p1256, @p1257, @p1258, @p1259, @p1260, @p1261, @p1262, @p1263, @p1264, @p1265, @p1266, @p1267, @p1268, @p1269, @p1270, @p1271, @p1272, @p1273, @p1274, @p1275, @p1276, @p1277, @p1278, @p1279, @p1280, @p1281, @p1282, @p1283, @p1284, @p1285, @p1286, @p1287, 22), (@p1288, @p1289, @p1290, @p1291, @p1292, @p1293, @p1294, @p1295, @p1296, @p1297, @p1298, @p1299, @p1300, @p1301, @p1302, @p1303, @p1304, @p1305, @p1306, @p1307, @p1308, @p1309, @p1310, @p1311, @p1312, @p1313, @p1314, @p1315, @p1316, @p1317, @p1318, @p1319, @p1320, @p1321, @p1322, @p1323, @p1324, @p1325, @p1326, @p1327, @p1328, @p1329, @p1330, @p1331, @p1332, @p1333, @p1334, @p1335, @p1336, @p1337, @p1338, @p1339, @p1340, @p1341, @p1342, @p1343, 23), (@p1344, @p1345, @p1346, @p1347, @p1348, @p1349, @p1350, @p1351, @p1352, @p1353, @p1354, @p1355, @p1356, @p1357, @p1358, @p1359, @p1360, @p1361, @p1362, @p1363, @p1364, @p1365, @p1366, @p1367, @p1368, @p1369, @p1370, @p1371, @p1372, @p1373, @p1374, @p1375, @p1376, @p1377, @p1378, @p1379, @p1380, @p1381, @p1382, @p1383, @p1384, @p1385, @p1386, @p1387, @p1388, @p1389, @p1390, @p1391, @p1392, @p1393, @p1394, @p1395, @p1396, @p1397, @p1398, @p1399, 24), (@p1400, @p1401, @p1402, @p1403, @p1404, @p1405, @p1406, @p1407, @p1408, @p1409, @p1410, @p1411, @p1412, @p1413, @p1414, @p1415, @p1416, @p1417, @p1418, @p1419, @p1420, @p1421, @p1422, @p1423, @p1424, @p1425, @p1426, @p1427, @p1428, @p1429, @p1430, @p1431, @p1432, @p1433, @p1434, @p1435, @p1436, @p1437, @p1438, @p1439, @p1440, @p1441, @p1442, @p1443, @p1444, @p1445, @p1446, @p1447, @p1448, @p1449, @p1450, @p1451, @p1452, @p1453, @p1454, @p1455, 25), (@p1456, @p1457, @p1458, @p1459, @p1460, @p1461, @p1462, @p1463, @p1464, @p1465, @p1466, @p1467, @p1468, @p1469, @p1470, @p1471, @p1472, @p1473, @p1474, @p1475, @p1476, @p1477, @p1478, @p1479, @p1480, @p1481, @p1482, @p1483, @p1484, @p1485, @p1486, @p1487, @p1488, @p1489, @p1490, @p1491, @p1492, @p1493, @p1494, @p1495, @p1496, @p1497, @p1498, @p1499, @p1500, @p1501, @p1502, @p1503, @p1504, @p1505, @p1506, @p1507, @p1508, @p1509, @p1510, @p1511, 26), (@p1512, @p1513, @p1514, @p1515, @p1516, @p1517, @p1518, @p1519, @p1520, @p1521, @p1522, @p1523, @p1524, @p1525, @p1526, @p1527, @p1528, @p1529, @p1530, @p1531, @p1532, @p1533, @p1534, @p1535, @p1536, @p1537, @p1538, @p1539, @p1540, @p1541, @p1542, @p1543, @p1544, @p1545, @p1546, @p1547, @p1548, @p1549, @p1550, @p1551, @p1552, @p1553, @p1554, @p1555, @p1556, @p1557, @p1558, @p1559, @p1560, @p1561, @p1562, @p1563, @p1564, @p1565, @p1566, @p1567, 27), (@p1568, @p1569, @p1570, @p1571, @p1572, @p1573, @p1574, @p1575, @p1576, @p1577, @p1578, @p1579, @p1580, @p1581, @p1582, @p1583, @p1584, @p1585, @p1586, @p1587, @p1588, @p1589, @p1590, @p1591, @p1592, @p1593, @p1594, @p1595, @p1596, @p1597, @p1598, @p1599, @p1600, @p1601, @p1602, @p1603, @p1604, @p1605, @p1606, @p1607, @p1608, @p1609, @p1610, @p1611, @p1612, @p1613, @p1614, @p1615, @p1616, @p1617, @p1618, @p1619, @p1620, @p1621, @p1622, @p1623, 28), (@p1624, @p1625, @p1626, @p1627, @p1628, @p1629, @p1630, @p1631, @p1632, @p1633, @p1634, @p1635, @p1636, @p1637, @p1638, @p1639, @p1640, @p1641, @p1642, @p1643, @p1644, @p1645, @p1646, @p1647, @p1648, @p1649, @p1650, @p1651, @p1652, @p1653, @p1654, @p1655, @p1656, @p1657, @p1658, @p1659, @p1660, @p1661, @p1662, @p1663, @p1664, @p1665, @p1666, @p1667, @p1668, @p1669, @p1670, @p1671, @p1672, @p1673, @p1674, @p1675, @p1676, @p1677, @p1678, @p1679, 29), (@p1680, @p1681, @p1682, @p1683, @p1684, @p1685, @p1686, @p1687, @p1688, @p1689, @p1690, @p1691, @p1692, @p1693, @p1694, @p1695, @p1696, @p1697, @p1698, @p1699, @p1700, @p1701, @p1702, @p1703, @p1704, @p1705, @p1706, @p1707, @p1708, @p1709, @p1710, @p1711, @p1712, @p1713, @p1714, @p1715, @p1716, @p1717, @p1718, @p1719, @p1720, @p1721, @p1722, @p1723, @p1724, @p1725, @p1726, @p1727, @p1728, @p1729, @p1730, @p1731, @p1732, @p1733, @p1734, @p1735, 30), (@p1736, @p1737, @p1738, @p1739, @p1740, @p1741, @p1742, @p1743, @p1744, @p1745, @p1746, @p1747, @p1748, @p1749, @p1750, @p1751, @p1752, @p1753, @p1754, @p1755, @p1756, @p1757, @p1758, @p1759, @p1760, @p1761, @p1762, @p1763, @p1764, @p1765, @p1766, @p1767, @p1768, @p1769, @p1770, @p1771, @p1772, @p1773, @p1774, @p1775, @p1776, @p1777, @p1778, @p1779, @p1780, @p1781, @p1782, @p1783, @p1784, @p1785, @p1786, @p1787, @p1788, @p1789, @p1790, @p1791, 31), (@p1792, @p1793, @p1794, @p1795, @p1796, @p1797, @p1798, @p1799, @p1800, @p1801, @p1802, @p1803, @p1804, @p1805, @p1806, @p1807, @p1808, @p1809, @p1810, @p1811, @p1812, @p1813, @p1814, @p1815, @p1816, @p1817, @p1818, @p1819, @p1820, @p1821, @p1822, @p1823, @p1824, @p1825, @p1826, @p1827, @p1828, @p1829, @p1830, @p1831, @p1832, @p1833, @p1834, @p1835, @p1836, @p1837, @p1838, @p1839, @p1840, @p1841, @p1842, @p1843, @p1844, @p1845, @p1846, @p1847, 32), (@p1848, @p1849, @p1850, @p1851, @p1852, @p1853, @p1854, @p1855, @p1856, @p1857, @p1858, @p1859, @p1860, @p1861, @p1862, @p1863, @p1864, @p1865, @p1866, @p1867, @p1868, @p1869, @p1870, @p1871, @p1872, @p1873, @p1874, @p1875, @p1876, @p1877, @p1878, @p1879, @p1880, @p1881, @p1882, @p1883, @p1884, @p1885, @p1886, @p1887, @p1888, @p1889, @p1890, @p1891, @p1892, @p1893, @p1894, @p1895, @p1896, @p1897, @p1898, @p1899, @p1900, @p1901, @p1902, @p1903, 33), (@p1904, @p1905, @p1906, @p1907, @p1908, @p1909, @p1910, @p1911, @p1912, @p1913, @p1914, @p1915, @p1916, @p1917, @p1918, @p1919, @p1920, @p1921, @p1922, @p1923, @p1924, @p1925, @p1926, @p1927, @p1928, @p1929, @p1930, @p1931, @p1932, @p1933, @p1934, @p1935, @p1936, @p1937, @p1938, @p1939, @p1940, @p1941, @p1942, @p1943, @p1944, @p1945, @p1946, @p1947, @p1948, @p1949, @p1950, @p1951, @p1952, @p1953, @p1954, @p1955, @p1956, @p1957, @p1958, @p1959, 34), (@p1960, @p1961, @p1962, @p1963, @p1964, @p1965, @p1966, @p1967, @p1968, @p1969, @p1970, @p1971, @p1972, @p1973, @p1974, @p1975, @p1976, @p1977, @p1978, @p1979, @p1980, @p1981, @p1982, @p1983, @p1984, @p1985, @p1986, @p1987, @p1988, @p1989, @p1990, @p1991, @p1992, @p1993, @p1994, @p1995, @p1996, @p1997, @p1998, @p1999, @p2000, @p2001, @p2002, @p2003, @p2004, @p2005, @p2006, @p2007, @p2008, @p2009, @p2010, @p2011, @p2012, @p2013, @p2014, @p2015, 35), (@p2016, @p2017, @p2018, @p2019, @p2020, @p2021, @p2022, @p2023, @p2024, @p2025, @p2026, @p2027, @p2028, @p2029, @p2030, @p2031, @p2032, @p2033, @p2034, @p2035, @p2036, @p2037, @p2038, @p2039, @p2040, @p2041, @p2042, @p2043, @p2044, @p2045, @p2046, @p2047, @p2048, @p2049, @p2050, @p2051, @p2052, @p2053, @p2054, @p2055, @p2056, @p2057, @p2058, @p2059, @p2060, @p2061, @p2062, @p2063, @p2064, @p2065, @p2066, @p2067, @p2068, @p2069, @p2070, @p2071, 36)) AS i ([addressee_cntry_cd], [addressee_city], [addressee_district], [addressee_email], [addressee_full_address], [addressee_home_address], [addressee_name], [addressee_postcode], [addressee_province], [addressee_subdistrict], [addressee_tel], [create_table], [delivery_code], [delivery_recipient_name], [delivery_relation_id], [delivery_status_id], [dest_outlet_id], [dest_outlet_port], [document_number], [item_barcode], [item_cod], [item_gross_weight], [item_height], [item_length], [item_price], [item_width], [lat], [log_id], [long], [outlet_id], [outlet_port], [podUrl], [remark], [scan_cntry_cd], [scan_cntry_postcode], [sender_cntry_cd], [sender_district], [sender_email], [sender_full_address], [sender_home_address], [member_id], [sender_name], [sender_postcode], [sender_province], [sender_subdistrict], [sender_tel], [server_id], [signatureUrl], [state], [status_code], [status_dtm], [timestamp], [transmit_dtm], [user_id], [wckt_id], [wkstn_no], _Position) ON 1=0 WHEN NOT MATCHED THEN INSERT ([addressee_cntry_cd], [addressee_city], [addressee_district], [addressee_email], [addressee_full_address], [addressee_home_address], [addressee_name], [addressee_postcode], [addressee_province], [addressee_subdistrict], [addressee_tel], [create_table], [delivery_code], [delivery_recipient_name], [delivery_relation_id], [delivery_status_id], [dest_outlet_id], [dest_outlet_port], [document_number], [item_barcode], [item_cod], [item_gross_weight], [item_height], [item_length], [item_price], [item_width], [lat], [log_id], [long], [outlet_id], [outlet_port], [podUrl], [remark], [scan_cntry_cd], [scan_cntry_postcode], [sender_cntry_cd], [sender_district], [sender_email], [sender_full_address], [sender_home_address], [member_id], [sender_name], [sender_postcode], [sender_province], [sender_subdistrict], [sender_tel], [server_id], [signatureUrl], [state], [status_code], [status_dtm], [timestamp], [transmit_dtm], [user_id], [wckt_id], [wkstn_no]) VALUES (i.[addressee_cntry_cd], i.[addressee_city], i.[addressee_district], i.[addressee_email], i.[addressee_full_address], i.[addressee_home_address], i.[addressee_name], i.[addressee_postcode], i.[addressee_province], i.[addressee_subdistrict], i.[addressee_tel], i.[create_table], i.[delivery_code], i.[delivery_recipient_name], i.[delivery_relation_id], i.[delivery_status_id], i.[dest_outlet_id], i.[dest_outlet_port], i.[document_number], i.[item_barcode], i.[item_cod], i.[item_gross_weight], i.[item_height], i.[item_length], i.[item_price], i.[item_width], i.[lat], i.[log_id], i.[long], i.[outlet_id], i.[outlet_port], i.[podUrl], i.[remark], i.[scan_cntry_cd], i.[scan_cntry_postcode], i.[sender_cntry_cd], i.[sender_district], i.[sender_email], i.[sender_full_address], i.[sender_home_address], i.[member_id], i.[sender_name], i.[sender_postcode], i.[sender_province], i.[sender_subdistrict], i.[sender_tel], i.[server_id], i.[signatureUrl], i.[state], i.[status_code], i.[status_dtm], i.[timestamp], i.[transmit_dtm], i.[user_id], i.[wckt_id], i.[wkstn_no]) OUTPUT INSERTED.[item_id], i._Position INTO @inserted0;  SELECT [t].[item_id] FROM [raw_data] t INNER JOIN @inserted0 i ON ([t].[item_id] = [i].[item_id]) ORDER BY [i].[_Position];  ",7,7,0,441,6,7
"(@_msparam_0 nvarchar(4000),@_msparam_1 nvarchar(4000),@_msparam_2 nvarchar(4000))SELECT clmns.name AS [Name], clmns.column_id AS [ID], clmns.is_nullable AS [Nullable], clmns.is_computed AS [Computed], CAST(ISNULL(cik.index_column_id, 0) AS bit) AS [InPrimaryKey], clmns.is_ansi_padded AS [AnsiPaddingStatus], CAST(clmns.is_rowguidcol AS bit) AS [RowGuidCol], CAST(ISNULL(cc.is_persisted, 0) AS bit) AS [IsPersisted], ISNULL(clmns.collation_name, N'') AS [Collation], CAST(ISNULL((select TOP 1 1 from sys.foreign_key_columns AS colfk where colfk.parent_column_id = clmns.column_id and colfk.parent_object_id = clmns.object_id), 0) AS bit) AS [IsForeignKey], clmns.is_identity AS [Identity], CAST(ISNULL(ic.seed_value,0) AS numeric(38)) AS [IdentitySeedAsDecimal], CAST(ISNULL(ic.increment_value,0) AS numeric(38)) AS [IdentityIncrementAsDecimal], (case when clmns.default_object_id = 0 then N'' when d.parent_object_id > 0 then N'' else d.name end) AS [Default], (case when clmns.default_object_id = 0 then N'' when d.parent_object_id > 0 then N'' else schema_name(d.schema_id) end) AS [DefaultSchema], ISNULL(dc.Name, N'') AS [DefaultConstraintName], (case when clmns.rule_object_id = 0 then N'' else r.name end) AS [Rule], (case when clmns.rule_object_id = 0 then N'' else schema_name(r.schema_id) end) AS [RuleSchema], CAST(ISNULL(COLUMNPROPERTY(clmns.object_id, clmns.name, N'IsDeterministic'),0) AS bit) AS [IsDeterministic], CAST(ISNULL(COLUMNPROPERTY(clmns.object_id, clmns.name, N'IsPrecise'),0) AS bit) AS [IsPrecise], ISNULL(ic.is_not_for_replication, 0) AS [NotForReplication], CAST(COLUMNPROPERTY(clmns.object_id, clmns.name, N'IsFulltextIndexed') AS bit) AS [IsFullTextIndexed], CAST(COLUMNPROPERTY(clmns.object_id, clmns.name, N'StatisticalSemantics') AS int) AS [StatisticalSemantics], CAST(clmns.encryption_type AS int) AS [EncryptionType], clmns.encryption_algorithm_name AS [EncryptionAlgorithm], clmns.column_encryption_key_id AS [ColumnEncryptionKeyID], ceks.name AS [ColumnEncryptionKeyName], CAST(clmns.is_filestream AS bit) AS [IsFileStream], CAST(clmns.is_sparse AS bit) AS [IsSparse], CAST(clmns.is_column_set AS bit) AS [IsColumnSet], usrt.name AS [DataType], s1clmns.name AS [DataTypeSchema], ISNULL(baset.name, N'') AS [SystemType], CAST(CASE WHEN baset.name IN (N'nchar', N'nvarchar') AND clmns.max_length <> -1 THEN clmns.max_length/2 ELSE clmns.max_length END AS int) AS [Length], CAST(clmns.precision AS int) AS [NumericPrecision], CAST(clmns.scale AS int) AS [NumericScale], ISNULL(xscclmns.name, N'') AS [XmlSchemaNamespace], ISNULL(s2clmns.name, N'') AS [XmlSchemaNamespaceSchema], ISNULL( (case clmns.is_xml_document when 1 then 2 else 1 end), 0) AS [XmlDocumentConstraint], CASE WHEN usrt.is_table_type = 1 THEN N'structured' ELSE N'' END AS [UserType], clmns.generated_always_type AS [GeneratedAlwaysType], CAST(clmns.is_hidden AS bit) AS [IsHidden], CAST(clmns.is_masked AS bit) AS [IsMasked], CAST(         CASE         WHEN [sc].[label] IS NOT NULL or [sc].[label_id] IS NOT NULL or [sc].[information_type] IS NOT NULL or [sc].[information_type_id] IS NOT NULL or [sc].[rank] IS NOT NULL THEN 1         ELSE 0         END        AS bit) AS [IsClassified], ISNULL(clmns.graph_type, 0) AS [GraphType] FROM sys.tables AS tbl INNER JOIN sys.all_columns AS clmns ON clmns.object_id=tbl.object_id LEFT OUTER JOIN sys.indexes AS ik ON ik.object_id = clmns.object_id and 1=ik.is_primary_key LEFT OUTER JOIN sys.index_columns AS cik ON cik.index_id = ik.index_id and cik.column_id = clmns.column_id and cik.object_id = clmns.object_id and 0 = cik.is_included_column LEFT OUTER JOIN sys.computed_columns AS cc ON cc.object_id = clmns.object_id and cc.column_id = clmns.column_id LEFT OUTER JOIN sys.identity_columns AS ic ON ic.object_id = clmns.object_id and ic.column_id = clmns.column_id LEFT OUTER JOIN sys.objects AS d ON d.object_id = clmns.default_object_id LEFT OUTER JOIN sys.default_constraints as dc ON clmns.default_object_id = dc.object_id LEFT OUTER JOIN sys.objects AS r ON r.object_id = clmns.rule_object_id LEFT OUTER JOIN sys.column_encryption_keys AS ceks ON (ceks.column_encryption_key_id = clmns.column_encryption_key_id) LEFT OUTER JOIN sys.types AS usrt ON usrt.user_type_id = clmns.user_type_id LEFT OUTER JOIN sys.schemas AS s1clmns ON s1clmns.schema_id = usrt.schema_id LEFT OUTER JOIN sys.types AS baset ON (baset.user_type_id = clmns.system_type_id and baset.user_type_id = baset.system_type_id) or ((baset.system_type_id = clmns.system_type_id) and (baset.user_type_id = clmns.user_type_id) and (baset.is_user_defined = 0) and (baset.is_assembly_type = 1))  LEFT OUTER JOIN sys.xml_schema_collections AS xscclmns ON xscclmns.xml_collection_id = clmns.xml_collection_id LEFT OUTER JOIN sys.schemas AS s2clmns ON s2clmns.schema_id = xscclmns.schema_id LEFT OUTER JOIN sys.sensitivity_classifications AS sc ON sc.major_id = clmns.object_id and sc.minor_id = clmns.column_id WHERE (clmns.name=@_msparam_0)and((tbl.name=@_msparam_1 and SCHEMA_NAME(tbl.schema_id)=@_msparam_2))",6,6,0,90,0,27
"SELECT SCHEMA_NAME(s.schema_id) AS [Schema], s.name AS [Name], s.object_id AS [ID], N'' AS [BaseDatabase], N'' AS [BaseObject], N'' AS [BaseSchema], N'' AS [BaseServer],  			CASE OBJECTPROPERTYEX(s.object_id,'BaseType')  				WHEN N'U' THEN 1  				WHEN N'V' THEN 2  				WHEN N'P' THEN 3  				WHEN N'FN' THEN 4  				WHEN N'TF' THEN 5  				WHEN N'IF' THEN 6  				WHEN N'X' THEN 7  				WHEN N'RF' THEN 8  				WHEN N'PC' THEN 9  				WHEN N'FS' THEN 10  				WHEN N'FT' THEN 11  				WHEN N'AF' THEN 12 ELSE 0 END 		 AS [BaseType], s.base_object_name AS [BaseObjectName] FROM sys.synonyms AS s ORDER BY [Schema] ASC,[Name] ASC",6,6,0,1138,0,6
"CREATE PROCEDURE sp_sqlagent_has_server_access   @login_name         sysname = NULL,   @job_id             uniqueidentifier = NULL, -- if this is not null, @login_name will be ignored!   @is_sysadmin_member INT     = NULL OUTPUT AS BEGIN   DECLARE @has_server_access BIT   DECLARE @is_sysadmin       BIT   DECLARE @actual_login_name sysname   -- Set only when login_name is actually found. It will be zero when @actual_login_name is (unknown).   DECLARE @login_found BIT   DECLARE @cachedate         DATETIME    SET NOCOUNT ON    SELECT @cachedate = NULL    -- remove expired entries from the cache   DELETE msdb.dbo.syscachedcredentials   WHERE  DATEDIFF(MINUTE, cachedate, GETDATE()) >= 29    -- query the cache   SELECT  @is_sysadmin = is_sysadmin_member,           @has_server_access = has_server_access,           @cachedate = cachedate   FROM    msdb.dbo.syscachedcredentials   WHERE   login_name = @login_name   AND     DATEDIFF(MINUTE, cachedate, GETDATE()) < 29    IF (@cachedate IS NOT NULL)   BEGIN     -- no output variable     IF (@is_sysadmin_member IS NULL)     BEGIN       -- Return result row       SELECT has_server_access = @has_server_access,              is_sysadmin       = @is_sysadmin,              actual_login_name = @login_name       RETURN     END     ELSE     BEGIN       SELECT @is_sysadmin_member = @is_sysadmin       RETURN     END   END -- select from cache    -- Set defaults   SELECT @has_server_access = 0   SELECT @is_sysadmin = 0   SELECT @actual_login_name = FORMATMESSAGE(14205)   SELECT @login_found = 0      -- If @job_id was set, get the current name associated with the job owner sid.   if (@job_id IS NOT NULL)   BEGIN 	SELECT @login_name = dbo.SQLAGENT_SUSER_SNAME(owner_sid) 	FROM msdb.dbo.sysjobs_view 	WHERE @job_id = job_id      -- If the job_id is invalid, return error     IF (@login_name IS NULL)     BEGIN       RETURN 1;     END    END   IF (@login_name IS NULL)   BEGIN     SELECT has_server_access = 1,            is_sysadmin       = IS_SRVROLEMEMBER(N'sysadmin'),            actual_login_name = SUSER_SNAME()     RETURN   END    IF (@login_name LIKE '%\%')   BEGIN     -- Handle the LocalSystem account ('NT AUTHORITY\SYSTEM') as a special case     IF (UPPER(@login_name collate SQL_Latin1_General_CP1_CS_AS) = N'NT AUTHORITY\SYSTEM')     BEGIN       IF (EXISTS (SELECT *                   FROM master.dbo.syslogins                   WHERE (UPPER(loginname collate SQL_Latin1_General_CP1_CS_AS) = N'NT AUTHORITY\SYSTEM')))       BEGIN         SELECT @has_server_access = hasaccess,                @is_sysadmin = sysadmin,                @actual_login_name = loginname         FROM master.dbo.syslogins         WHERE (UPPER(loginname collate SQL_Latin1_General_CP1_CS_AS) = N'NT AUTHORITY\SYSTEM')          SET @login_found = 1       END       ELSE       IF (EXISTS (SELECT *                   FROM master.dbo.syslogins                   WHERE (UPPER(loginname collate SQL_Latin1_General_CP1_CS_AS) = N'BUILTIN\ADMINISTRATORS')))       BEGIN         SELECT @has_server_access = hasaccess,                @is_sysadmin = sysadmin,                @actual_login_name = loginname         FROM master.dbo.syslogins         WHERE (UPPER(loginname collate SQL_Latin1_General_CP1_CS_AS) = N'BUILTIN\ADMINISTRATORS')          SET @login_found = 1       END     END     ELSE     BEGIN       -- Check if the NT login has been explicitly denied access       IF (EXISTS (SELECT *                   FROM master.dbo.syslogins                   WHERE (loginname = @login_name)                     AND (denylogin = 1)))       BEGIN         SELECT @has_server_access = 0,                @is_sysadmin = sysadmin,                @actual_login_name = loginname         FROM master.dbo.syslogins         WHERE (loginname = @login_name)          SET @login_found = 1       END       ELSE       BEGIN         -- declare table variable for storing results         DECLARE @xp_results TABLE         (         account_name      sysname      COLLATE database_default NOT NULL PRIMARY KEY,         type              NVARCHAR(10) COLLATE database_default NOT NULL,         privilege         NVARCHAR(10) COLLATE database_default NOT NULL,         mapped_login_name sysname      COLLATE database_default NOT NULL,         permission_path   sysname      COLLATE database_default NULL         )          -- Call xp_logininfo to determine server access         INSERT INTO @xp_results         EXECUTE master.dbo.xp_logininfo @login_name          IF (SELECT COUNT(*) FROM @xp_results) > 0         BEGIN           SET @has_server_access = 1           SET @login_found = 1         END          SELECT @actual_login_name = mapped_login_name,                @is_sysadmin = CASE UPPER(privilege collate SQL_Latin1_General_CP1_CS_AS)                                 WHEN 'ADMIN' THEN 1                                 ELSE 0                              END         FROM @xp_results       END     END     -- Only cache the NT logins to approximate the behavior of Sql Server and Windows (see bug 323287)     -- update the cache only if something is found     IF  (UPPER(@actual_login_name collate SQL_Latin1_General_CP1_CS_AS) <> '(UNKNOWN)')     BEGIN       -- Procedure starts its own transaction.       BEGIN TRANSACTION;        -- Modify database.       -- use a try catch login to prevent any error when trying       -- to insert/update syscachedcredentials table       -- no need to fail since the job owner has been validated       BEGIN TRY         IF EXISTS (SELECT * FROM msdb.dbo.syscachedcredentials WITH (TABLOCKX) WHERE login_name = @login_name)         BEGIN           UPDATE msdb.dbo.syscachedcredentials           SET    has_server_access = @has_server_access,                 is_sysadmin_member = @is_sysadmin,                 cachedate = GETDATE()           WHERE  login_name = @login_name         END         ELSE         BEGIN           INSERT INTO msdb.dbo.syscachedcredentials(login_name, has_server_access, is_sysadmin_member)           VALUES(@login_name, @has_server_access, @is_sysadmin)         END         END TRY         BEGIN CATCH             -- If an error occurred we want to ignore it         END CATCH          -- The procedure must commit the transaction it started.         COMMIT TRANSACTION;     END    END   ELSE   BEGIN     -- Standard login     IF (EXISTS (SELECT *                 FROM master.dbo.syslogins                 WHERE (loginname = @login_name)))     BEGIN       SELECT @has_server_access = hasaccess,              @is_sysadmin = sysadmin,              @actual_login_name = loginname       FROM master.dbo.syslogins       WHERE (loginname = @login_name)        SET @login_found = 1     END   END    IF (@is_sysadmin_member IS NULL)     -- Return result row     SELECT has_server_access = @has_server_access,            is_sysadmin       = @is_sysadmin,            actual_login_name = @actual_login_name,            login_found       = @login_found   ELSE     -- output variable only     SELECT @is_sysadmin_member = @is_sysadmin END ",6,6,0,140,0,4750
"(@p0 nvarchar(4000),@p1 nvarchar(4000),@p2 nvarchar(4000),@p3 nvarchar(4000),@p4 nvarchar(4000),@p5 nvarchar(4000),@p6 nvarchar(4000),@p7 nvarchar(4000),@p8 nvarchar(4000),@p9 nvarchar(4000),@p10 nvarchar(4000),@p11 datetime2(7),@p12 nvarchar(4000),@p13 nvarchar(4000),@p14 int,@p15 int,@p16 int,@p17 nvarchar(4000),@p18 nvarchar(4000),@p19 nvarchar(4000),@p20 nvarchar(4000),@p21 decimal(18,2),@p22 nvarchar(4000),@p23 nvarchar(4000),@p24 decimal(18,2),@p25 nvarchar(4000),@p26 nvarchar(4000),@p27 nvarchar(4000),@p28 nvarchar(4000),@p29 int,@p30 nvarchar(4000),@p31 nvarchar(4000),@p32 nvarchar(4000),@p33 nvarchar(4000),@p34 nvarchar(4000),@p35 nvarchar(4000),@p36 nvarchar(4000),@p37 nvarchar(4000),@p38 nvarchar(4000),@p39 nvarchar(4000),@p40 int,@p41 nvarchar(4000),@p42 nvarchar(4000),@p43 nvarchar(4000),@p44 nvarchar(4000),@p45 nvarchar(4000),@p46 int,@p47 nvarchar(4000),@p48 int,@p49 int,@p50 datetime2(7),@p51 datetime2(7),@p52 datetime2(7),@p53 nvarchar(4000),@p54 nvarchar(4000),@p55 nvarchar(4000),@p56 nvarchar(4000),@p57 nvarchar(4000),@p58 nvarchar(4000),@p59 nvarchar(4000),@p60 nvarchar(4000),@p61 nvarchar(4000),@p62 nvarchar(4000),@p63 nvarchar(4000),@p64 nvarchar(4000),@p65 nvarchar(4000),@p66 nvarchar(4000),@p67 datetime2(7),@p68 nvarchar(4000),@p69 nvarchar(4000),@p70 int,@p71 int,@p72 int,@p73 nvarchar(4000),@p74 nvarchar(4000),@p75 nvarchar(4000),@p76 nvarchar(4000),@p77 decimal(18,2),@p78 nvarchar(4000),@p79 nvarchar(4000),@p80 decimal(18,2),@p81 nvarchar(4000),@p82 nvarchar(4000),@p83 nvarchar(4000),@p84 nvarchar(4000),@p85 int,@p86 nvarchar(4000),@p87 nvarchar(4000),@p88 nvarchar(4000),@p89 nvarchar(4000),@p90 nvarchar(4000),@p91 nvarchar(4000),@p92 nvarchar(4000),@p93 nvarchar(4000),@p94 nvarchar(4000),@p95 nvarchar(4000),@p96 int,@p97 nvarchar(4000),@p98 nvarchar(4000),@p99 nvarchar(4000),@p100 nvarchar(4000),@p101 nvarchar(4000),@p102 int,@p103 nvarchar(4000),@p104 int,@p105 int,@p106 datetime2(7),@p107 datetime2(7),@p108 datetime2(7),@p109 nvarchar(4000),@p110 nvarchar(4000),@p111 nvarchar(4000),@p112 nvarchar(4000),@p113 nvarchar(4000),@p114 nvarchar(4000),@p115 nvarchar(4000),@p116 nvarchar(4000),@p117 nvarchar(4000),@p118 nvarchar(4000),@p119 nvarchar(4000),@p120 nvarchar(4000),@p121 nvarchar(4000),@p122 nvarchar(4000),@p123 datetime2(7),@p124 nvarchar(4000),@p125 nvarchar(4000),@p126 int,@p127 int,@p128 int,@p129 nvarchar(4000),@p130 nvarchar(4000),@p131 nvarchar(4000),@p132 nvarchar(4000),@p133 decimal(18,2),@p134 nvarchar(4000),@p135 nvarchar(4000),@p136 decimal(18,2),@p137 nvarchar(4000),@p138 nvarchar(4000),@p139 nvarchar(4000),@p140 nvarchar(4000),@p141 int,@p142 nvarchar(4000),@p143 nvarchar(4000),@p144 nvarchar(4000),@p145 nvarchar(4000),@p146 nvarchar(4000),@p147 nvarchar(4000),@p148 nvarchar(4000),@p149 nvarchar(4000),@p150 nvarchar(4000),@p151 nvarchar(4000),@p152 int,@p153 nvarchar(4000),@p154 nvarchar(4000),@p155 nvarchar(4000),@p156 nvarchar(4000),@p157 nvarchar(4000),@p158 int,@p159 nvarchar(4000),@p160 int,@p161 int,@p162 datetime2(7),@p163 datetime2(7),@p164 datetime2(7),@p165 nvarchar(4000),@p166 nvarchar(4000),@p167 nvarchar(4000),@p168 nvarchar(4000),@p169 nvarchar(4000),@p170 nvarchar(4000),@p171 nvarchar(4000),@p172 nvarchar(4000),@p173 nvarchar(4000),@p174 nvarchar(4000),@p175 nvarchar(4000),@p176 nvarchar(4000),@p177 nvarchar(4000),@p178 nvarchar(4000),@p179 datetime2(7),@p180 nvarchar(4000),@p181 nvarchar(4000),@p182 int,@p183 int,@p184 int,@p185 nvarchar(4000),@p186 nvarchar(4000),@p187 nvarchar(4000),@p188 nvarchar(4000),@p189 decimal(18,2),@p190 nvarchar(4000),@p191 nvarchar(4000),@p192 decimal(18,2),@p193 nvarchar(4000),@p194 nvarchar(4000),@p195 nvarchar(4000),@p196 nvarchar(4000),@p197 int,@p198 nvarchar(4000),@p199 nvarchar(4000),@p200 nvarchar(4000),@p201 nvarchar(4000),@p202 nvarchar(4000),@p203 nvarchar(4000),@p204 nvarchar(4000),@p205 nvarchar(4000),@p206 nvarchar(4000),@p207 nvarchar(4000),@p208 int,@p209 nvarchar(4000),@p210 nvarchar(4000),@p211 nvarchar(4000),@p212 nvarchar(4000),@p213 nvarchar(4000),@p214 int,@p215 nvarchar(4000),@p216 int,@p217 int,@p218 datetime2(7),@p219 datetime2(7),@p220 datetime2(7),@p221 nvarchar(4000),@p222 nvarchar(4000),@p223 nvarchar(4000),@p224 nvarchar(4000),@p225 nvarchar(4000),@p226 nvarchar(4000),@p227 nvarchar(4000),@p228 nvarchar(4000),@p229 nvarchar(4000),@p230 nvarchar(4000),@p231 nvarchar(4000),@p232 nvarchar(4000),@p233 nvarchar(4000),@p234 nvarchar(4000),@p235 datetime2(7),@p236 nvarchar(4000),@p237 nvarchar(4000),@p238 int,@p239 int,@p240 int,@p241 nvarchar(4000),@p242 nvarchar(4000),@p243 nvarchar(4000),@p244 nvarchar(4000),@p245 decimal(18,2),@p246 nvarchar(4000),@p247 nvarchar(4000),@p248 decimal(18,2),@p249 nvarchar(4000),@p250 nvarchar(4000),@p251 nvarchar(4000),@p252 nvarchar(4000),@p253 int,@p254 nvarchar(4000),@p255 nvarchar(4000),@p256 nvarchar(4000),@p257 nvarchar(4000),@p258 nvarchar(4000),@p259 nvarchar(4000),@p260 nvarchar(4000),@p261 nvarchar(4000),@p262 nvarchar(4000),@p263 nvarchar(4000),@p264 int,@p265 nvarchar(4000),@p266 nvarchar(4000),@p267 nvarchar(4000),@p268 nvarchar(4000),@p269 nvarchar(4000),@p270 int,@p271 nvarchar(4000),@p272 int,@p273 int,@p274 datetime2(7),@p275 datetime2(7),@p276 datetime2(7),@p277 nvarchar(4000),@p278 nvarchar(4000),@p279 nvarchar(4000),@p280 nvarchar(4000),@p281 nvarchar(4000),@p282 nvarchar(4000),@p283 nvarchar(4000),@p284 nvarchar(4000),@p285 nvarchar(4000),@p286 nvarchar(4000),@p287 nvarchar(4000),@p288 nvarchar(4000),@p289 nvarchar(4000),@p290 nvarchar(4000),@p291 datetime2(7),@p292 nvarchar(4000),@p293 nvarchar(4000),@p294 int,@p295 int,@p296 int,@p297 nvarchar(4000),@p298 nvarchar(4000),@p299 nvarchar(4000),@p300 nvarchar(4000),@p301 decimal(18,2),@p302 nvarchar(4000),@p303 nvarchar(4000),@p304 decimal(18,2),@p305 nvarchar(4000),@p306 nvarchar(4000),@p307 nvarchar(4000),@p308 nvarchar(4000),@p309 int,@p310 nvarchar(4000),@p311 nvarchar(4000),@p312 nvarchar(4000),@p313 nvarchar(4000),@p314 nvarchar(4000),@p315 nvarchar(4000),@p316 nvarchar(4000),@p317 nvarchar(4000),@p318 nvarchar(4000),@p319 nvarchar(4000),@p320 int,@p321 nvarchar(4000),@p322 nvarchar(4000),@p323 nvarchar(4000),@p324 nvarchar(4000),@p325 nvarchar(4000),@p326 int,@p327 nvarchar(4000),@p328 int,@p329 int,@p330 datetime2(7),@p331 datetime2(7),@p332 datetime2(7),@p333 nvarchar(4000),@p334 nvarchar(4000),@p335 nvarchar(4000),@p336 nvarchar(4000),@p337 nvarchar(4000),@p338 nvarchar(4000),@p339 nvarchar(4000),@p340 nvarchar(4000),@p341 nvarchar(4000),@p342 nvarchar(4000),@p343 nvarchar(4000),@p344 nvarchar(4000),@p345 nvarchar(4000),@p346 nvarchar(4000),@p347 datetime2(7),@p348 nvarchar(4000),@p349 nvarchar(4000),@p350 int,@p351 int,@p352 int,@p353 nvarchar(4000),@p354 nvarchar(4000),@p355 nvarchar(4000),@p356 nvarchar(4000),@p357 decimal(18,2),@p358 nvarchar(4000),@p359 nvarchar(4000),@p360 decimal(18,2),@p361 nvarchar(4000),@p362 nvarchar(4000),@p363 nvarchar(4000),@p364 nvarchar(4000),@p365 int,@p366 nvarchar(4000),@p367 nvarchar(4000),@p368 nvarchar(4000),@p369 nvarchar(4000),@p370 nvarchar(4000),@p371 nvarchar(4000),@p372 nvarchar(4000),@p373 nvarchar(4000),@p374 nvarchar(4000),@p375 nvarchar(4000),@p376 int,@p377 nvarchar(4000),@p378 nvarchar(4000),@p379 nvarchar(4000),@p380 nvarchar(4000),@p381 nvarchar(4000),@p382 int,@p383 nvarchar(4000),@p384 int,@p385 int,@p386 datetime2(7),@p387 datetime2(7),@p388 datetime2(7),@p389 nvarchar(4000),@p390 nvarchar(4000),@p391 nvarchar(4000),@p392 nvarchar(4000),@p393 nvarchar(4000),@p394 nvarchar(4000),@p395 nvarchar(4000),@p396 nvarchar(4000),@p397 nvarchar(4000),@p398 nvarchar(4000),@p399 nvarchar(4000),@p400 nvarchar(4000),@p401 nvarchar(4000),@p402 nvarchar(4000),@p403 datetime2(7),@p404 nvarchar(4000),@p405 nvarchar(4000),@p406 int,@p407 int,@p408 int,@p409 nvarchar(4000),@p410 nvarchar(4000),@p411 nvarchar(4000),@p412 nvarchar(4000),@p413 decimal(18,2),@p414 nvarchar(4000),@p415 nvarchar(4000),@p416 decimal(18,2),@p417 nvarchar(4000),@p418 nvarchar(4000),@p419 nvarchar(4000),@p420 nvarchar(4000),@p421 int,@p422 nvarchar(4000),@p423 nvarchar(4000),@p424 nvarchar(4000),@p425 nvarchar(4000),@p426 nvarchar(4000),@p427 nvarchar(4000),@p428 nvarchar(4000),@p429 nvarchar(4000),@p430 nvarchar(4000),@p431 nvarchar(4000),@p432 int,@p433 nvarchar(4000),@p434 nvarchar(4000),@p435 nvarchar(4000),@p436 nvarchar(4000),@p437 nvarchar(4000),@p438 int,@p439 nvarchar(4000),@p440 int,@p441 int,@p442 datetime2(7),@p443 datetime2(7),@p444 datetime2(7),@p445 nvarchar(4000),@p446 nvarchar(4000),@p447 nvarchar(4000),@p448 nvarchar(4000),@p449 nvarchar(4000),@p450 nvarchar(4000),@p451 nvarchar(4000),@p452 nvarchar(4000),@p453 nvarchar(4000),@p454 nvarchar(4000),@p455 nvarchar(4000),@p456 nvarchar(4000),@p457 nvarchar(4000),@p458 nvarchar(4000),@p459 datetime2(7),@p460 nvarchar(4000),@p461 nvarchar(4000),@p462 int,@p463 int,@p464 int,@p465 nvarchar(4000),@p466 nvarchar(4000),@p467 nvarchar(4000),@p468 nvarchar(4000),@p469 decimal(18,2),@p470 nvarchar(4000),@p471 nvarchar(4000),@p472 decimal(18,2),@p473 nvarchar(4000),@p474 nvarchar(4000),@p475 nvarchar(4000),@p476 nvarchar(4000),@p477 int,@p478 nvarchar(4000),@p479 nvarchar(4000),@p480 nvarchar(4000),@p481 nvarchar(4000),@p482 nvarchar(4000),@p483 nvarchar(4000),@p484 nvarchar(4000),@p485 nvarchar(4000),@p486 nvarchar(4000),@p487 nvarchar(4000),@p488 int,@p489 nvarchar(4000),@p490 nvarchar(4000),@p491 nvarchar(4000),@p492 nvarchar(4000),@p493 nvarchar(4000),@p494 int,@p495 nvarchar(4000),@p496 int,@p497 int,@p498 datetime2(7),@p499 datetime2(7),@p500 datetime2(7),@p501 nvarchar(4000),@p502 nvarchar(4000),@p503 nvarchar(4000),@p504 nvarchar(4000),@p505 nvarchar(4000),@p506 nvarchar(4000),@p507 nvarchar(4000),@p508 nvarchar(4000),@p509 nvarchar(4000),@p510 nvarchar(4000),@p511 nvarchar(4000),@p512 nvarchar(4000),@p513 nvarchar(4000),@p514 nvarchar(4000),@p515 datetime2(7),@p516 nvarchar(4000),@p517 nvarchar(4000),@p518 int,@p519 int,@p520 int,@p521 nvarchar(4000),@p522 nvarchar(4000),@p523 nvarchar(4000),@p524 nvarchar(4000),@p525 decimal(18,2),@p526 nvarchar(4000),@p527 nvarchar(4000),@p528 decimal(18,2),@p529 nvarchar(4000),@p530 nvarchar(4000),@p531 nvarchar(4000),@p532 nvarchar(4000),@p533 int,@p534 nvarchar(4000),@p535 nvarchar(4000),@p536 nvarchar(4000),@p537 nvarchar(4000),@p538 nvarchar(4000),@p539 nvarchar(4000),@p540 nvarchar(4000),@p541 nvarchar(4000),@p542 nvarchar(4000),@p543 nvarchar(4000),@p544 int,@p545 nvarchar(4000),@p546 nvarchar(4000),@p547 nvarchar(4000),@p548 nvarchar(4000),@p549 nvarchar(4000),@p550 int,@p551 nvarchar(4000),@p552 int,@p553 int,@p554 datetime2(7),@p555 datetime2(7),@p556 datetime2(7),@p557 nvarchar(4000),@p558 nvarchar(4000),@p559 nvarchar(4000),@p560 nvarchar(4000),@p561 nvarchar(4000),@p562 nvarchar(4000),@p563 nvarchar(4000),@p564 nvarchar(4000),@p565 nvarchar(4000),@p566 nvarchar(4000),@p567 nvarchar(4000),@p568 nvarchar(4000),@p569 nvarchar(4000),@p570 nvarchar(4000),@p571 datetime2(7),@p572 nvarchar(4000),@p573 nvarchar(4000),@p574 int,@p575 int,@p576 int,@p577 nvarchar(4000),@p578 nvarchar(4000),@p579 nvarchar(4000),@p580 nvarchar(4000),@p581 decimal(18,2),@p582 nvarchar(4000),@p583 nvarchar(4000),@p584 decimal(18,2),@p585 nvarchar(4000),@p586 nvarchar(4000),@p587 nvarchar(4000),@p588 nvarchar(4000),@p589 int,@p590 nvarchar(4000),@p591 nvarchar(4000),@p592 nvarchar(4000),@p593 nvarchar(4000),@p594 nvarchar(4000),@p595 nvarchar(4000),@p596 nvarchar(4000),@p597 nvarchar(4000),@p598 nvarchar(4000),@p599 nvarchar(4000),@p600 int,@p601 nvarchar(4000),@p602 nvarchar(4000),@p603 nvarchar(4000),@p604 nvarchar(4000),@p605 nvarchar(4000),@p606 int,@p607 nvarchar(4000),@p608 int,@p609 int,@p610 datetime2(7),@p611 datetime2(7),@p612 datetime2(7),@p613 nvarchar(4000),@p614 nvarchar(4000),@p615 nvarchar(4000),@p616 nvarchar(4000),@p617 nvarchar(4000),@p618 nvarchar(4000),@p619 nvarchar(4000),@p620 nvarchar(4000),@p621 nvarchar(4000),@p622 nvarchar(4000),@p623 nvarchar(4000),@p624 nvarchar(4000),@p625 nvarchar(4000),@p626 nvarchar(4000),@p627 datetime2(7),@p628 nvarchar(4000),@p629 nvarchar(4000),@p630 int,@p631 int,@p632 int,@p633 nvarchar(4000),@p634 nvarchar(4000),@p635 nvarchar(4000),@p636 nvarchar(4000),@p637 decimal(18,2),@p638 nvarchar(4000),@p639 nvarchar(4000),@p640 decimal(18,2),@p641 nvarchar(4000),@p642 nvarchar(4000),@p643 nvarchar(4000),@p644 nvarchar(4000),@p645 int,@p646 nvarchar(4000),@p647 nvarchar(4000),@p648 nvarchar(4000),@p649 nvarchar(4000),@p650 nvarchar(4000),@p651 nvarchar(4000),@p652 nvarchar(4000),@p653 nvarchar(4000),@p654 nvarchar(4000),@p655 nvarchar(4000),@p656 int,@p657 nvarchar(4000),@p658 nvarchar(4000),@p659 nvarchar(4000),@p660 nvarchar(4000),@p661 nvarchar(4000),@p662 int,@p663 nvarchar(4000),@p664 int,@p665 int,@p666 datetime2(7),@p667 datetime2(7),@p668 datetime2(7),@p669 nvarchar(4000),@p670 nvarchar(4000),@p671 nvarchar(4000),@p672 nvarchar(4000),@p673 nvarchar(4000),@p674 nvarchar(4000),@p675 nvarchar(4000),@p676 nvarchar(4000),@p677 nvarchar(4000),@p678 nvarchar(4000),@p679 nvarchar(4000),@p680 nvarchar(4000),@p681 nvarchar(4000),@p682 nvarchar(4000),@p683 datetime2(7),@p684 nvarchar(4000),@p685 nvarchar(4000),@p686 int,@p687 int,@p688 int,@p689 nvarchar(4000),@p690 nvarchar(4000),@p691 nvarchar(4000),@p692 nvarchar(4000),@p693 decimal(18,2),@p694 nvarchar(4000),@p695 nvarchar(4000),@p696 decimal(18,2),@p697 nvarchar(4000),@p698 nvarchar(4000),@p699 nvarchar(4000),@p700 nvarchar(4000),@p701 int,@p702 nvarchar(4000),@p703 nvarchar(4000),@p704 nvarchar(4000),@p705 nvarchar(4000),@p706 nvarchar(4000),@p707 nvarchar(4000),@p708 nvarchar(4000),@p709 nvarchar(4000),@p710 nvarchar(4000),@p711 nvarchar(4000),@p712 int,@p713 nvarchar(4000),@p714 nvarchar(4000),@p715 nvarchar(4000),@p716 nvarchar(4000),@p717 nvarchar(4000),@p718 int,@p719 nvarchar(4000),@p720 int,@p721 int,@p722 datetime2(7),@p723 datetime2(7),@p724 datetime2(7),@p725 nvarchar(4000),@p726 nvarchar(4000),@p727 nvarchar(4000),@p728 nvarchar(4000),@p729 nvarchar(4000),@p730 nvarchar(4000),@p731 nvarchar(4000),@p732 nvarchar(4000),@p733 nvarchar(4000),@p734 nvarchar(4000),@p735 nvarchar(4000),@p736 nvarchar(4000),@p737 nvarchar(4000),@p738 nvarchar(4000),@p739 datetime2(7),@p740 nvarchar(4000),@p741 nvarchar(4000),@p742 int,@p743 int,@p744 int,@p745 nvarchar(4000),@p746 nvarchar(4000),@p747 nvarchar(4000),@p748 nvarchar(4000),@p749 decimal(18,2),@p750 nvarchar(4000),@p751 nvarchar(4000),@p752 decimal(18,2),@p753 nvarchar(4000),@p754 nvarchar(4000),@p755 nvarchar(4000),@p756 nvarchar(4000),@p757 int,@p758 nvarchar(4000),@p759 nvarchar(4000),@p760 nvarchar(4000),@p761 nvarchar(4000),@p762 nvarchar(4000),@p763 nvarchar(4000),@p764 nvarchar(4000),@p765 nvarchar(4000),@p766 nvarchar(4000),@p767 nvarchar(4000),@p768 int,@p769 nvarchar(4000),@p770 nvarchar(4000),@p771 nvarchar(4000),@p772 nvarchar(4000),@p773 nvarchar(4000),@p774 int,@p775 nvarchar(4000),@p776 int,@p777 int,@p778 datetime2(7),@p779 datetime2(7),@p780 datetime2(7),@p781 nvarchar(4000),@p782 nvarchar(4000),@p783 nvarchar(4000),@p784 nvarchar(4000),@p785 nvarchar(4000),@p786 nvarchar(4000),@p787 nvarchar(4000),@p788 nvarchar(4000),@p789 nvarchar(4000),@p790 nvarchar(4000),@p791 nvarchar(4000),@p792 nvarchar(4000),@p793 nvarchar(4000),@p794 nvarchar(4000),@p795 datetime2(7),@p796 nvarchar(4000),@p797 nvarchar(4000),@p798 int,@p799 int,@p800 int,@p801 nvarchar(4000),@p802 nvarchar(4000),@p803 nvarchar(4000),@p804 nvarchar(4000),@p805 decimal(18,2),@p806 nvarchar(4000),@p807 nvarchar(4000),@p808 decimal(18,2),@p809 nvarchar(4000),@p810 nvarchar(4000),@p811 nvarchar(4000),@p812 nvarchar(4000),@p813 int,@p814 nvarchar(4000),@p815 nvarchar(4000),@p816 nvarchar(4000),@p817 nvarchar(4000),@p818 nvarchar(4000),@p819 nvarchar(4000),@p820 nvarchar(4000),@p821 nvarchar(4000),@p822 nvarchar(4000),@p823 nvarchar(4000),@p824 int,@p825 nvarchar(4000),@p826 nvarchar(4000),@p827 nvarchar(4000),@p828 nvarchar(4000),@p829 nvarchar(4000),@p830 int,@p831 nvarchar(4000),@p832 int,@p833 int,@p834 datetime2(7),@p835 datetime2(7),@p836 datetime2(7),@p837 nvarchar(4000),@p838 nvarchar(4000),@p839 nvarchar(4000),@p840 nvarchar(4000),@p841 nvarchar(4000),@p842 nvarchar(4000),@p843 nvarchar(4000),@p844 nvarchar(4000),@p845 nvarchar(4000),@p846 nvarchar(4000),@p847 nvarchar(4000),@p848 nvarchar(4000),@p849 nvarchar(4000),@p850 nvarchar(4000),@p851 datetime2(7),@p852 nvarchar(4000),@p853 nvarchar(4000),@p854 int,@p855 int,@p856 int,@p857 nvarchar(4000),@p858 nvarchar(4000),@p859 nvarchar(4000),@p860 nvarchar(4000),@p861 decimal(18,2),@p862 nvarchar(4000),@p863 nvarchar(4000),@p864 decimal(18,2),@p865 nvarchar(4000),@p866 nvarchar(4000),@p867 nvarchar(4000),@p868 nvarchar(4000),@p869 int,@p870 nvarchar(4000),@p871 nvarchar(4000),@p872 nvarchar(4000),@p873 nvarchar(4000),@p874 nvarchar(4000),@p875 nvarchar(4000),@p876 nvarchar(4000),@p877 nvarchar(4000),@p878 nvarchar(4000),@p879 nvarchar(4000),@p880 int,@p881 nvarchar(4000),@p882 nvarchar(4000),@p883 nvarchar(4000),@p884 nvarchar(4000),@p885 nvarchar(4000),@p886 int,@p887 nvarchar(4000),@p888 int,@p889 int,@p890 datetime2(7),@p891 datetime2(7),@p892 datetime2(7),@p893 nvarchar(4000),@p894 nvarchar(4000),@p895 nvarchar(4000),@p896 nvarchar(4000),@p897 nvarchar(4000),@p898 nvarchar(4000),@p899 nvarchar(4000),@p900 nvarchar(4000),@p901 nvarchar(4000),@p902 nvarchar(4000),@p903 nvarchar(4000),@p904 nvarchar(4000),@p905 nvarchar(4000),@p906 nvarchar(4000),@p907 datetime2(7),@p908 nvarchar(4000),@p909 nvarchar(4000),@p910 int,@p911 int,@p912 int,@p913 nvarchar(4000),@p914 nvarchar(4000),@p915 nvarchar(4000),@p916 nvarchar(4000),@p917 decimal(18,2),@p918 nvarchar(4000),@p919 nvarchar(4000),@p920 decimal(18,2),@p921 nvarchar(4000),@p922 nvarchar(4000),@p923 nvarchar(4000),@p924 nvarchar(4000),@p925 int,@p926 nvarchar(4000),@p927 nvarchar(4000),@p928 nvarchar(4000),@p929 nvarchar(4000),@p930 nvarchar(4000),@p931 nvarchar(4000),@p932 nvarchar(4000),@p933 nvarchar(4000),@p934 nvarchar(4000),@p935 nvarchar(4000),@p936 int,@p937 nvarchar(4000),@p938 nvarchar(4000),@p939 nvarchar(4000),@p940 nvarchar(4000),@p941 nvarchar(4000),@p942 int,@p943 nvarchar(4000),@p944 int,@p945 int,@p946 datetime2(7),@p947 datetime2(7),@p948 datetime2(7),@p949 nvarchar(4000),@p950 nvarchar(4000),@p951 nvarchar(4000),@p952 nvarchar(4000),@p953 nvarchar(4000),@p954 nvarchar(4000),@p955 nvarchar(4000),@p956 nvarchar(4000),@p957 nvarchar(4000),@p958 nvarchar(4000),@p959 nvarchar(4000),@p960 nvarchar(4000),@p961 nvarchar(4000),@p962 nvarchar(4000),@p963 datetime2(7),@p964 nvarchar(4000),@p965 nvarchar(4000),@p966 int,@p967 int,@p968 int,@p969 nvarchar(4000),@p970 nvarchar(4000),@p971 nvarchar(4000),@p972 nvarchar(4000),@p973 decimal(18,2),@p974 nvarchar(4000),@p975 nvarchar(4000),@p976 decimal(18,2),@p977 nvarchar(4000),@p978 nvarchar(4000),@p979 nvarchar(4000),@p980 nvarchar(4000),@p981 int,@p982 nvarchar(4000),@p983 nvarchar(4000),@p984 nvarchar(4000),@p985 nvarchar(4000),@p986 nvarchar(4000),@p987 nvarchar(4000),@p988 nvarchar(4000),@p989 nvarchar(4000),@p990 nvarchar(4000),@p991 nvarchar(4000),@p992 int,@p993 nvarchar(4000),@p994 nvarchar(4000),@p995 nvarchar(4000),@p996 nvarchar(4000),@p997 nvarchar(4000),@p998 int,@p999 nvarchar(4000),@p1000 int,@p1001 int,@p1002 datetime2(7),@p1003 datetime2(7),@p1004 datetime2(7),@p1005 nvarchar(4000),@p1006 nvarchar(4000),@p1007 nvarchar(4000),@p1008 nvarchar(4000),@p1009 nvarchar(4000),@p1010 nvarchar(4000),@p1011 nvarchar(4000),@p1012 nvarchar(4000),@p1013 nvarchar(4000),@p1014 nvarchar(4000),@p1015 nvarchar(4000),@p1016 nvarchar(4000),@p1017 nvarchar(4000),@p1018 nvarchar(4000),@p1019 datetime2(7),@p1020 nvarchar(4000),@p1021 nvarchar(4000),@p1022 int,@p1023 int,@p1024 int,@p1025 nvarchar(4000),@p1026 nvarchar(4000),@p1027 nvarchar(4000),@p1028 nvarchar(4000),@p1029 decimal(18,2),@p1030 nvarchar(4000),@p1031 nvarchar(4000),@p1032 decimal(18,2),@p1033 nvarchar(4000),@p1034 nvarchar(4000),@p1035 nvarchar(4000),@p1036 nvarchar(4000),@p1037 int,@p1038 nvarchar(4000),@p1039 nvarchar(4000),@p1040 nvarchar(4000),@p1041 nvarchar(4000),@p1042 nvarchar(4000),@p1043 nvarchar(4000),@p1044 nvarchar(4000),@p1045 nvarchar(4000),@p1046 nvarchar(4000),@p1047 nvarchar(4000),@p1048 int,@p1049 nvarchar(4000),@p1050 nvarchar(4000),@p1051 nvarchar(4000),@p1052 nvarchar(4000),@p1053 nvarchar(4000),@p1054 int,@p1055 nvarchar(4000),@p1056 int,@p1057 int,@p1058 datetime2(7),@p1059 datetime2(7),@p1060 datetime2(7),@p1061 nvarchar(4000),@p1062 nvarchar(4000),@p1063 nvarchar(4000),@p1064 nvarchar(4000),@p1065 nvarchar(4000),@p1066 nvarchar(4000),@p1067 nvarchar(4000),@p1068 nvarchar(4000),@p1069 nvarchar(4000),@p1070 nvarchar(4000),@p1071 nvarchar(4000),@p1072 nvarchar(4000),@p1073 nvarchar(4000),@p1074 nvarchar(4000),@p1075 datetime2(7),@p1076 nvarchar(4000),@p1077 nvarchar(4000),@p1078 int,@p1079 int,@p1080 int,@p1081 nvarchar(4000),@p1082 nvarchar(4000),@p1083 nvarchar(4000),@p1084 nvarchar(4000),@p1085 decimal(18,2),@p1086 nvarchar(4000),@p1087 nvarchar(4000),@p1088 decimal(18,2),@p1089 nvarchar(4000),@p1090 nvarchar(4000),@p1091 nvarchar(4000),@p1092 nvarchar(4000),@p1093 int,@p1094 nvarchar(4000),@p1095 nvarchar(4000),@p1096 nvarchar(4000),@p1097 nvarchar(4000),@p1098 nvarchar(4000),@p1099 nvarchar(4000),@p1100 nvarchar(4000),@p1101 nvarchar(4000),@p1102 nvarchar(4000),@p1103 nvarchar(4000),@p1104 int,@p1105 nvarchar(4000),@p1106 nvarchar(4000),@p1107 nvarchar(4000),@p1108 nvarchar(4000),@p1109 nvarchar(4000),@p1110 int,@p1111 nvarchar(4000),@p1112 int,@p1113 int,@p1114 datetime2(7),@p1115 datetime2(7),@p1116 datetime2(7),@p1117 nvarchar(4000),@p1118 nvarchar(4000),@p1119 nvarchar(4000),@p1120 nvarchar(4000),@p1121 nvarchar(4000),@p1122 nvarchar(4000),@p1123 nvarchar(4000),@p1124 nvarchar(4000),@p1125 nvarchar(4000),@p1126 nvarchar(4000),@p1127 nvarchar(4000),@p1128 nvarchar(4000),@p1129 nvarchar(4000),@p1130 nvarchar(4000),@p1131 datetime2(7),@p1132 nvarchar(4000),@p1133 nvarchar(4000),@p1134 int,@p1135 int,@p1136 int,@p1137 nvarchar(4000),@p1138 nvarchar(4000),@p1139 nvarchar(4000),@p1140 nvarchar(4000),@p1141 decimal(18,2),@p1142 nvarchar(4000),@p1143 nvarchar(4000),@p1144 decimal(18,2),@p1145 nvarchar(4000),@p1146 nvarchar(4000),@p1147 nvarchar(4000),@p1148 nvarchar(4000),@p1149 int,@p1150 nvarchar(4000),@p1151 nvarchar(4000),@p1152 nvarchar(4000),@p1153 nvarchar(4000),@p1154 nvarchar(4000),@p1155 nvarchar(4000),@p1156 nvarchar(4000),@p1157 nvarchar(4000),@p1158 nvarchar(4000),@p1159 nvarchar(4000),@p1160 int,@p1161 nvarchar(4000),@p1162 nvarchar(4000),@p1163 nvarchar(4000),@p1164 nvarchar(4000),@p1165 nvarchar(4000),@p1166 int,@p1167 nvarchar(4000),@p1168 int,@p1169 int,@p1170 datetime2(7),@p1171 datetime2(7),@p1172 datetime2(7),@p1173 nvarchar(4000),@p1174 nvarchar(4000),@p1175 nvarchar(4000),@p1176 nvarchar(4000),@p1177 nvarchar(4000),@p1178 nvarchar(4000),@p1179 nvarchar(4000),@p1180 nvarchar(4000),@p1181 nvarchar(4000),@p1182 nvarchar(4000),@p1183 nvarchar(4000),@p1184 nvarchar(4000),@p1185 nvarchar(4000),@p1186 nvarchar(4000),@p1187 datetime2(7),@p1188 nvarchar(4000),@p1189 nvarchar(4000),@p1190 int,@p1191 int,@p1192 int,@p1193 nvarchar(4000),@p1194 nvarchar(4000),@p1195 nvarchar(4000),@p1196 nvarchar(4000),@p1197 decimal(18,2),@p1198 nvarchar(4000),@p1199 nvarchar(4000),@p1200 decimal(18,2),@p1201 nvarchar(4000),@p1202 nvarchar(4000),@p1203 nvarchar(4000),@p1204 nvarchar(4000),@p1205 int,@p1206 nvarchar(4000),@p1207 nvarchar(4000),@p1208 nvarchar(4000),@p1209 nvarchar(4000),@p1210 nvarchar(4000),@p1211 nvarchar(4000),@p1212 nvarchar(4000),@p1213 nvarchar(4000),@p1214 nvarchar(4000),@p1215 nvarchar(4000),@p1216 int,@p1217 nvarchar(4000),@p1218 nvarchar(4000),@p1219 nvarchar(4000),@p1220 nvarchar(4000),@p1221 nvarchar(4000),@p1222 int,@p1223 nvarchar(4000),@p1224 int,@p1225 int,@p1226 datetime2(7),@p1227 datetime2(7),@p1228 datetime2(7),@p1229 nvarchar(4000),@p1230 nvarchar(4000),@p1231 nvarchar(4000),@p1232 nvarchar(4000),@p1233 nvarchar(4000),@p1234 nvarchar(4000),@p1235 nvarchar(4000),@p1236 nvarchar(4000),@p1237 nvarchar(4000),@p1238 nvarchar(4000),@p1239 nvarchar(4000),@p1240 nvarchar(4000),@p1241 nvarchar(4000),@p1242 nvarchar(4000),@p1243 datetime2(7),@p1244 nvarchar(4000),@p1245 nvarchar(4000),@p1246 int,@p1247 int,@p1248 int,@p1249 nvarchar(4000),@p1250 nvarchar(4000),@p1251 nvarchar(4000),@p1252 nvarchar(4000),@p1253 decimal(18,2),@p1254 nvarchar(4000),@p1255 nvarchar(4000),@p1256 decimal(18,2),@p1257 nvarchar(4000),@p1258 nvarchar(4000),@p1259 nvarchar(4000),@p1260 nvarchar(4000),@p1261 int,@p1262 nvarchar(4000),@p1263 nvarchar(4000),@p1264 nvarchar(4000),@p1265 nvarchar(4000),@p1266 nvarchar(4000),@p1267 nvarchar(4000),@p1268 nvarchar(4000),@p1269 nvarchar(4000),@p1270 nvarchar(4000),@p1271 nvarchar(4000),@p1272 int,@p1273 nvarchar(4000),@p1274 nvarchar(4000),@p1275 nvarchar(4000),@p1276 nvarchar(4000),@p1277 nvarchar(4000),@p1278 int,@p1279 nvarchar(4000),@p1280 int,@p1281 int,@p1282 datetime2(7),@p1283 datetime2(7),@p1284 datetime2(7),@p1285 nvarchar(4000),@p1286 nvarchar(4000),@p1287 nvarchar(4000),@p1288 nvarchar(4000),@p1289 nvarchar(4000),@p1290 nvarchar(4000),@p1291 nvarchar(4000),@p1292 nvarchar(4000),@p1293 nvarchar(4000),@p1294 nvarchar(4000),@p1295 nvarchar(4000),@p1296 nvarchar(4000),@p1297 nvarchar(4000),@p1298 nvarchar(4000),@p1299 datetime2(7),@p1300 nvarchar(4000),@p1301 nvarchar(4000),@p1302 int,@p1303 int,@p1304 int,@p1305 nvarchar(4000),@p1306 nvarchar(4000),@p1307 nvarchar(4000),@p1308 nvarchar(4000),@p1309 decimal(18,2),@p1310 nvarchar(4000),@p1311 nvarchar(4000),@p1312 decimal(18,2),@p1313 nvarchar(4000),@p1314 nvarchar(4000),@p1315 nvarchar(4000),@p1316 nvarchar(4000),@p1317 int,@p1318 nvarchar(4000),@p1319 nvarchar(4000),@p1320 nvarchar(4000),@p1321 nvarchar(4000),@p1322 nvarchar(4000),@p1323 nvarchar(4000),@p1324 nvarchar(4000),@p1325 nvarchar(4000),@p1326 nvarchar(4000),@p1327 nvarchar(4000),@p1328 int,@p1329 nvarchar(4000),@p1330 nvarchar(4000),@p1331 nvarchar(4000),@p1332 nvarchar(4000),@p1333 nvarchar(4000),@p1334 int,@p1335 nvarchar(4000),@p1336 int,@p1337 int,@p1338 datetime2(7),@p1339 datetime2(7),@p1340 datetime2(7),@p1341 nvarchar(4000),@p1342 nvarchar(4000),@p1343 nvarchar(4000),@p1344 nvarchar(4000),@p1345 nvarchar(4000),@p1346 nvarchar(4000),@p1347 nvarchar(4000),@p1348 nvarchar(4000),@p1349 nvarchar(4000),@p1350 nvarchar(4000),@p1351 nvarchar(4000),@p1352 nvarchar(4000),@p1353 nvarchar(4000),@p1354 nvarchar(4000),@p1355 datetime2(7),@p1356 nvarchar(4000),@p1357 nvarchar(4000),@p1358 int,@p1359 int,@p1360 int,@p1361 nvarchar(4000),@p1362 nvarchar(4000),@p1363 nvarchar(4000),@p1364 nvarchar(4000),@p1365 decimal(18,2),@p1366 nvarchar(4000),@p1367 nvarchar(4000),@p1368 decimal(18,2),@p1369 nvarchar(4000),@p1370 nvarchar(4000),@p1371 nvarchar(4000),@p1372 nvarchar(4000),@p1373 int,@p1374 nvarchar(4000),@p1375 nvarchar(4000),@p1376 nvarchar(4000),@p1377 nvarchar(4000),@p1378 nvarchar(4000),@p1379 nvarchar(4000),@p1380 nvarchar(4000),@p1381 nvarchar(4000),@p1382 nvarchar(4000),@p1383 nvarchar(4000),@p1384 int,@p1385 nvarchar(4000),@p1386 nvarchar(4000),@p1387 nvarchar(4000),@p1388 nvarchar(4000),@p1389 nvarchar(4000),@p1390 int,@p1391 nvarchar(4000),@p1392 int,@p1393 int,@p1394 datetime2(7),@p1395 datetime2(7),@p1396 datetime2(7),@p1397 nvarchar(4000),@p1398 nvarchar(4000),@p1399 nvarchar(4000),@p1400 nvarchar(4000),@p1401 nvarchar(4000),@p1402 nvarchar(4000),@p1403 nvarchar(4000),@p1404 nvarchar(4000),@p1405 nvarchar(4000),@p1406 nvarchar(4000),@p1407 nvarchar(4000),@p1408 nvarchar(4000),@p1409 nvarchar(4000),@p1410 nvarchar(4000),@p1411 datetime2(7),@p1412 nvarchar(4000),@p1413 nvarchar(4000),@p1414 int,@p1415 int,@p1416 int,@p1417 nvarchar(4000),@p1418 nvarchar(4000),@p1419 nvarchar(4000),@p1420 nvarchar(4000),@p1421 decimal(18,2),@p1422 nvarchar(4000),@p1423 nvarchar(4000),@p1424 decimal(18,2),@p1425 nvarchar(4000),@p1426 nvarchar(4000),@p1427 nvarchar(4000),@p1428 nvarchar(4000),@p1429 int,@p1430 nvarchar(4000),@p1431 nvarchar(4000),@p1432 nvarchar(4000),@p1433 nvarchar(4000),@p1434 nvarchar(4000),@p1435 nvarchar(4000),@p1436 nvarchar(4000),@p1437 nvarchar(4000),@p1438 nvarchar(4000),@p1439 nvarchar(4000),@p1440 int,@p1441 nvarchar(4000),@p1442 nvarchar(4000),@p1443 nvarchar(4000),@p1444 nvarchar(4000),@p1445 nvarchar(4000),@p1446 int,@p1447 nvarchar(4000),@p1448 int,@p1449 int,@p1450 datetime2(7),@p1451 datetime2(7),@p1452 datetime2(7),@p1453 nvarchar(4000),@p1454 nvarchar(4000),@p1455 nvarchar(4000),@p1456 nvarchar(4000),@p1457 nvarchar(4000),@p1458 nvarchar(4000),@p1459 nvarchar(4000),@p1460 nvarchar(4000),@p1461 nvarchar(4000),@p1462 nvarchar(4000),@p1463 nvarchar(4000),@p1464 nvarchar(4000),@p1465 nvarchar(4000),@p1466 nvarchar(4000),@p1467 datetime2(7),@p1468 nvarchar(4000),@p1469 nvarchar(4000),@p1470 int,@p1471 int,@p1472 int,@p1473 nvarchar(4000),@p1474 nvarchar(4000),@p1475 nvarchar(4000),@p1476 nvarchar(4000),@p1477 decimal(18,2),@p1478 nvarchar(4000),@p1479 nvarchar(4000),@p1480 decimal(18,2),@p1481 nvarchar(4000),@p1482 nvarchar(4000),@p1483 nvarchar(4000),@p1484 nvarchar(4000),@p1485 int,@p1486 nvarchar(4000),@p1487 nvarchar(4000),@p1488 nvarchar(4000),@p1489 nvarchar(4000),@p1490 nvarchar(4000),@p1491 nvarchar(4000),@p1492 nvarchar(4000),@p1493 nvarchar(4000),@p1494 nvarchar(4000),@p1495 nvarchar(4000),@p1496 int,@p1497 nvarchar(4000),@p1498 nvarchar(4000),@p1499 nvarchar(4000),@p1500 nvarchar(4000),@p1501 nvarchar(4000),@p1502 int,@p1503 nvarchar(4000),@p1504 int,@p1505 int,@p1506 datetime2(7),@p1507 datetime2(7),@p1508 datetime2(7),@p1509 nvarchar(4000),@p1510 nvarchar(4000),@p1511 nvarchar(4000),@p1512 nvarchar(4000),@p1513 nvarchar(4000),@p1514 nvarchar(4000),@p1515 nvarchar(4000),@p1516 nvarchar(4000),@p1517 nvarchar(4000),@p1518 nvarchar(4000),@p1519 nvarchar(4000),@p1520 nvarchar(4000),@p1521 nvarchar(4000),@p1522 nvarchar(4000),@p1523 datetime2(7),@p1524 nvarchar(4000),@p1525 nvarchar(4000),@p1526 int,@p1527 int,@p1528 int,@p1529 nvarchar(4000),@p1530 nvarchar(4000),@p1531 nvarchar(4000),@p1532 nvarchar(4000),@p1533 decimal(18,2),@p1534 nvarchar(4000),@p1535 nvarchar(4000),@p1536 decimal(18,2),@p1537 nvarchar(4000),@p1538 nvarchar(4000),@p1539 nvarchar(4000),@p1540 nvarchar(4000),@p1541 int,@p1542 nvarchar(4000),@p1543 nvarchar(4000),@p1544 nvarchar(4000),@p1545 nvarchar(4000),@p1546 nvarchar(4000),@p1547 nvarchar(4000),@p1548 nvarchar(4000),@p1549 nvarchar(4000),@p1550 nvarchar(4000),@p1551 nvarchar(4000),@p1552 int,@p1553 nvarchar(4000),@p1554 nvarchar(4000),@p1555 nvarchar(4000),@p1556 nvarchar(4000),@p1557 nvarchar(4000),@p1558 int,@p1559 nvarchar(4000),@p1560 int,@p1561 int,@p1562 datetime2(7),@p1563 datetime2(7),@p1564 datetime2(7),@p1565 nvarchar(4000),@p1566 nvarchar(4000),@p1567 nvarchar(4000),@p1568 nvarchar(4000),@p1569 nvarchar(4000),@p1570 nvarchar(4000),@p1571 nvarchar(4000),@p1572 nvarchar(4000),@p1573 nvarchar(4000),@p1574 nvarchar(4000),@p1575 nvarchar(4000),@p1576 nvarchar(4000),@p1577 nvarchar(4000),@p1578 nvarchar(4000),@p1579 datetime2(7),@p1580 nvarchar(4000),@p1581 nvarchar(4000),@p1582 int,@p1583 int,@p1584 int,@p1585 nvarchar(4000),@p1586 nvarchar(4000),@p1587 nvarchar(4000),@p1588 nvarchar(4000),@p1589 decimal(18,2),@p1590 nvarchar(4000),@p1591 nvarchar(4000),@p1592 decimal(18,2),@p1593 nvarchar(4000),@p1594 nvarchar(4000),@p1595 nvarchar(4000),@p1596 nvarchar(4000),@p1597 int,@p1598 nvarchar(4000),@p1599 nvarchar(4000),@p1600 nvarchar(4000),@p1601 nvarchar(4000),@p1602 nvarchar(4000),@p1603 nvarchar(4000),@p1604 nvarchar(4000),@p1605 nvarchar(4000),@p1606 nvarchar(4000),@p1607 nvarchar(4000),@p1608 int,@p1609 nvarchar(4000),@p1610 nvarchar(4000),@p1611 nvarchar(4000),@p1612 nvarchar(4000),@p1613 nvarchar(4000),@p1614 int,@p1615 nvarchar(4000),@p1616 int,@p1617 int,@p1618 datetime2(7),@p1619 datetime2(7),@p1620 datetime2(7),@p1621 nvarchar(4000),@p1622 nvarchar(4000),@p1623 nvarchar(4000),@p1624 nvarchar(4000),@p1625 nvarchar(4000),@p1626 nvarchar(4000),@p1627 nvarchar(4000),@p1628 nvarchar(4000),@p1629 nvarchar(4000),@p1630 nvarchar(4000),@p1631 nvarchar(4000),@p1632 nvarchar(4000),@p1633 nvarchar(4000),@p1634 nvarchar(4000),@p1635 datetime2(7),@p1636 nvarchar(4000),@p1637 nvarchar(4000),@p1638 int,@p1639 int,@p1640 int,@p1641 nvarchar(4000),@p1642 nvarchar(4000),@p1643 nvarchar(4000),@p1644 nvarchar(4000),@p1645 decimal(18,2),@p1646 nvarchar(4000),@p1647 nvarchar(4000),@p1648 decimal(18,2),@p1649 nvarchar(4000),@p1650 nvarchar(4000),@p1651 nvarchar(4000),@p1652 nvarchar(4000),@p1653 int,@p1654 nvarchar(4000),@p1655 nvarchar(4000),@p1656 nvarchar(4000),@p1657 nvarchar(4000),@p1658 nvarchar(4000),@p1659 nvarchar(4000),@p1660 nvarchar(4000),@p1661 nvarchar(4000),@p1662 nvarchar(4000),@p1663 nvarchar(4000),@p1664 int,@p1665 nvarchar(4000),@p1666 nvarchar(4000),@p1667 nvarchar(4000),@p1668 nvarchar(4000),@p1669 nvarchar(4000),@p1670 int,@p1671 nvarchar(4000),@p1672 int,@p1673 int,@p1674 datetime2(7),@p1675 datetime2(7),@p1676 datetime2(7),@p1677 nvarchar(4000),@p1678 nvarchar(4000),@p1679 nvarchar(4000),@p1680 nvarchar(4000),@p1681 nvarchar(4000),@p1682 nvarchar(4000),@p1683 nvarchar(4000),@p1684 nvarchar(4000),@p1685 nvarchar(4000),@p1686 nvarchar(4000),@p1687 nvarchar(4000),@p1688 nvarchar(4000),@p1689 nvarchar(4000),@p1690 nvarchar(4000),@p1691 datetime2(7),@p1692 nvarchar(4000),@p1693 nvarchar(4000),@p1694 int,@p1695 int,@p1696 int,@p1697 nvarchar(4000),@p1698 nvarchar(4000),@p1699 nvarchar(4000),@p1700 nvarchar(4000),@p1701 decimal(18,2),@p1702 nvarchar(4000),@p1703 nvarchar(4000),@p1704 decimal(18,2),@p1705 nvarchar(4000),@p1706 nvarchar(4000),@p1707 nvarchar(4000),@p1708 nvarchar(4000),@p1709 int,@p1710 nvarchar(4000),@p1711 nvarchar(4000),@p1712 nvarchar(4000),@p1713 nvarchar(4000),@p1714 nvarchar(4000),@p1715 nvarchar(4000),@p1716 nvarchar(4000),@p1717 nvarchar(4000),@p1718 nvarchar(4000),@p1719 nvarchar(4000),@p1720 int,@p1721 nvarchar(4000),@p1722 nvarchar(4000),@p1723 nvarchar(4000),@p1724 nvarchar(4000),@p1725 nvarchar(4000),@p1726 int,@p1727 nvarchar(4000),@p1728 int,@p1729 int,@p1730 datetime2(7),@p1731 datetime2(7),@p1732 datetime2(7),@p1733 nvarchar(4000),@p1734 nvarchar(4000),@p1735 nvarchar(4000),@p1736 nvarchar(4000),@p1737 nvarchar(4000),@p1738 nvarchar(4000),@p1739 nvarchar(4000),@p1740 nvarchar(4000),@p1741 nvarchar(4000),@p1742 nvarchar(4000),@p1743 nvarchar(4000),@p1744 nvarchar(4000),@p1745 nvarchar(4000),@p1746 nvarchar(4000),@p1747 datetime2(7),@p1748 nvarchar(4000),@p1749 nvarchar(4000),@p1750 int,@p1751 int,@p1752 int,@p1753 nvarchar(4000),@p1754 nvarchar(4000),@p1755 nvarchar(4000),@p1756 decimal(18,2),@p1757 decimal(18,2),@p1758 nvarchar(4000),@p1759 nvarchar(4000),@p1760 decimal(18,2),@p1761 nvarchar(4000),@p1762 nvarchar(4000),@p1763 nvarchar(4000),@p1764 nvarchar(4000),@p1765 int,@p1766 nvarchar(4000),@p1767 nvarchar(4000),@p1768 nvarchar(4000),@p1769 nvarchar(4000),@p1770 nvarchar(4000),@p1771 nvarchar(4000),@p1772 nvarchar(4000),@p1773 nvarchar(4000),@p1774 nvarchar(4000),@p1775 nvarchar(4000),@p1776 int,@p1777 nvarchar(4000),@p1778 nvarchar(4000),@p1779 nvarchar(4000),@p1780 nvarchar(4000),@p1781 nvarchar(4000),@p1782 int,@p1783 nvarchar(4000),@p1784 int,@p1785 int,@p1786 datetime2(7),@p1787 datetime2(7),@p1788 datetime2(7),@p1789 nvarchar(4000),@p1790 nvarchar(4000),@p1791 nvarchar(4000),@p1792 nvarchar(4000),@p1793 nvarchar(4000),@p1794 nvarchar(4000),@p1795 nvarchar(4000),@p1796 nvarchar(4000),@p1797 nvarchar(4000),@p1798 nvarchar(4000),@p1799 nvarchar(4000),@p1800 nvarchar(4000),@p1801 nvarchar(4000),@p1802 nvarchar(4000),@p1803 datetime2(7),@p1804 nvarchar(4000),@p1805 nvarchar(4000),@p1806 int,@p1807 int,@p1808 int,@p1809 nvarchar(4000),@p1810 nvarchar(4000),@p1811 nvarchar(4000),@p1812 nvarchar(4000),@p1813 decimal(18,2),@p1814 nvarchar(4000),@p1815 nvarchar(4000),@p1816 decimal(18,2),@p1817 nvarchar(4000),@p1818 nvarchar(4000),@p1819 nvarchar(4000),@p1820 nvarchar(4000),@p1821 int,@p1822 nvarchar(4000),@p1823 nvarchar(4000),@p1824 nvarchar(4000),@p1825 nvarchar(4000),@p1826 nvarchar(4000),@p1827 nvarchar(4000),@p1828 nvarchar(4000),@p1829 nvarchar(4000),@p1830 nvarchar(4000),@p1831 nvarchar(4000),@p1832 int,@p1833 nvarchar(4000),@p1834 nvarchar(4000),@p1835 nvarchar(4000),@p1836 nvarchar(4000),@p1837 nvarchar(4000),@p1838 int,@p1839 nvarchar(4000),@p1840 int,@p1841 int,@p1842 datetime2(7),@p1843 datetime2(7),@p1844 datetime2(7),@p1845 nvarchar(4000),@p1846 nvarchar(4000),@p1847 nvarchar(4000),@p1848 nvarchar(4000),@p1849 nvarchar(4000),@p1850 nvarchar(4000),@p1851 nvarchar(4000),@p1852 nvarchar(4000),@p1853 nvarchar(4000),@p1854 nvarchar(4000),@p1855 nvarchar(4000),@p1856 nvarchar(4000),@p1857 nvarchar(4000),@p1858 nvarchar(4000),@p1859 datetime2(7),@p1860 nvarchar(4000),@p1861 nvarchar(4000),@p1862 int,@p1863 int,@p1864 int,@p1865 nvarchar(4000),@p1866 nvarchar(4000),@p1867 nvarchar(4000),@p1868 decimal(18,2),@p1869 decimal(18,2),@p1870 nvarchar(4000),@p1871 nvarchar(4000),@p1872 decimal(18,2),@p1873 nvarchar(4000),@p1874 nvarchar(4000),@p1875 nvarchar(4000),@p1876 nvarchar(4000),@p1877 int,@p1878 nvarchar(4000),@p1879 nvarchar(4000),@p1880 nvarchar(4000),@p1881 nvarchar(4000),@p1882 nvarchar(4000),@p1883 nvarchar(4000),@p1884 nvarchar(4000),@p1885 nvarchar(4000),@p1886 nvarchar(4000),@p1887 nvarchar(4000),@p1888 int,@p1889 nvarchar(4000),@p1890 nvarchar(4000),@p1891 nvarchar(4000),@p1892 nvarchar(4000),@p1893 nvarchar(4000),@p1894 int,@p1895 nvarchar(4000),@p1896 int,@p1897 int,@p1898 datetime2(7),@p1899 datetime2(7),@p1900 datetime2(7),@p1901 nvarchar(4000),@p1902 nvarchar(4000),@p1903 nvarchar(4000),@p1904 nvarchar(4000),@p1905 nvarchar(4000),@p1906 nvarchar(4000),@p1907 nvarchar(4000),@p1908 nvarchar(4000),@p1909 nvarchar(4000),@p1910 nvarchar(4000),@p1911 nvarchar(4000),@p1912 nvarchar(4000),@p1913 nvarchar(4000),@p1914 nvarchar(4000),@p1915 datetime2(7),@p1916 nvarchar(4000),@p1917 nvarchar(4000),@p1918 int,@p1919 int,@p1920 int,@p1921 nvarchar(4000),@p1922 nvarchar(4000),@p1923 nvarchar(4000),@p1924 decimal(18,2),@p1925 decimal(18,2),@p1926 nvarchar(4000),@p1927 nvarchar(4000),@p1928 decimal(18,2),@p1929 nvarchar(4000),@p1930 nvarchar(4000),@p1931 nvarchar(4000),@p1932 nvarchar(4000),@p1933 int,@p1934 nvarchar(4000),@p1935 nvarchar(4000),@p1936 nvarchar(4000),@p1937 nvarchar(4000),@p1938 nvarchar(4000),@p1939 nvarchar(4000),@p1940 nvarchar(4000),@p1941 nvarchar(4000),@p1942 nvarchar(4000),@p1943 nvarchar(4000),@p1944 int,@p1945 nvarchar(4000),@p1946 nvarchar(4000),@p1947 nvarchar(4000),@p1948 nvarchar(4000),@p1949 nvarchar(4000),@p1950 int,@p1951 nvarchar(4000),@p1952 int,@p1953 int,@p1954 datetime2(7),@p1955 datetime2(7),@p1956 datetime2(7),@p1957 nvarchar(4000),@p1958 nvarchar(4000),@p1959 nvarchar(4000),@p1960 nvarchar(4000),@p1961 nvarchar(4000),@p1962 nvarchar(4000),@p1963 nvarchar(4000),@p1964 nvarchar(4000),@p1965 nvarchar(4000),@p1966 nvarchar(4000),@p1967 nvarchar(4000),@p1968 nvarchar(4000),@p1969 nvarchar(4000),@p1970 nvarchar(4000),@p1971 datetime2(7),@p1972 nvarchar(4000),@p1973 nvarchar(4000),@p1974 int,@p1975 int,@p1976 int,@p1977 nvarchar(4000),@p1978 nvarchar(4000),@p1979 nvarchar(4000),@p1980 decimal(18,2),@p1981 decimal(18,2),@p1982 nvarchar(4000),@p1983 nvarchar(4000),@p1984 decimal(18,2),@p1985 nvarchar(4000),@p1986 nvarchar(4000),@p1987 nvarchar(4000),@p1988 nvarchar(4000),@p1989 int,@p1990 nvarchar(4000),@p1991 nvarchar(4000),@p1992 nvarchar(4000),@p1993 nvarchar(4000),@p1994 nvarchar(4000),@p1995 nvarchar(4000),@p1996 nvarchar(4000),@p1997 nvarchar(4000),@p1998 nvarchar(4000),@p1999 nvarchar(4000),@p2000 int,@p2001 nvarchar(4000),@p2002 nvarchar(4000),@p2003 nvarchar(4000),@p2004 nvarchar(4000),@p2005 nvarchar(4000),@p2006 int,@p2007 nvarchar(4000),@p2008 int,@p2009 int,@p2010 datetime2(7),@p2011 datetime2(7),@p2012 datetime2(7),@p2013 nvarchar(4000),@p2014 nvarchar(4000),@p2015 nvarchar(4000),@p2016 nvarchar(4000),@p2017 nvarchar(4000),@p2018 nvarchar(4000),@p2019 nvarchar(4000),@p2020 nvarchar(4000),@p2021 nvarchar(4000),@p2022 nvarchar(4000),@p2023 nvarchar(4000),@p2024 nvarchar(4000),@p2025 nvarchar(4000),@p2026 nvarchar(4000),@p2027 datetime2(7),@p2028 nvarchar(4000),@p2029 nvarchar(4000),@p2030 int,@p2031 int,@p2032 int,@p2033 nvarchar(4000),@p2034 nvarchar(4000),@p2035 nvarchar(4000),@p2036 decimal(18,2),@p2037 decimal(18,2),@p2038 nvarchar(4000),@p2039 nvarchar(4000),@p2040 decimal(18,2),@p2041 nvarchar(4000),@p2042 nvarchar(4000),@p2043 nvarchar(4000),@p2044 nvarchar(4000),@p2045 int,@p2046 nvarchar(4000),@p2047 nvarchar(4000),@p2048 nvarchar(4000),@p2049 nvarchar(4000),@p2050 nvarchar(4000),@p2051 nvarchar(4000),@p2052 nvarchar(4000),@p2053 nvarchar(4000),@p2054 nvarchar(4000),@p2055 nvarchar(4000),@p2056 int,@p2057 nvarchar(4000),@p2058 nvarchar(4000),@p2059 nvarchar(4000),@p2060 nvarchar(4000),@p2061 nvarchar(4000),@p2062 int,@p2063 nvarchar(4000),@p2064 int,@p2065 int,@p2066 datetime2(7),@p2067 datetime2(7),@p2068 datetime2(7),@p2069 nvarchar(4000),@p2070 nvarchar(4000),@p2071 nvarchar(4000))SET NOCOUNT ON; DECLARE @inserted0 TABLE ([item_id] int, [_Position] [int]); MERGE [raw_data] USING ( VALUES (@p0, @p1, @p2, @p3, @p4, @p5, @p6, @p7, @p8, @p9, @p10, @p11, @p12, @p13, @p14, @p15, @p16, @p17, @p18, @p19, @p20, @p21, @p22, @p23, @p24, @p25, @p26, @p27, @p28, @p29, @p30, @p31, @p32, @p33, @p34, @p35, @p36, @p37, @p38, @p39, @p40, @p41, @p42, @p43, @p44, @p45, @p46, @p47, @p48, @p49, @p50, @p51, @p52, @p53, @p54, @p55, 0), (@p56, @p57, @p58, @p59, @p60, @p61, @p62, @p63, @p64, @p65, @p66, @p67, @p68, @p69, @p70, @p71, @p72, @p73, @p74, @p75, @p76, @p77, @p78, @p79, @p80, @p81, @p82, @p83, @p84, @p85, @p86, @p87, @p88, @p89, @p90, @p91, @p92, @p93, @p94, @p95, @p96, @p97, @p98, @p99, @p100, @p101, @p102, @p103, @p104, @p105, @p106, @p107, @p108, @p109, @p110, @p111, 1), (@p112, @p113, @p114, @p115, @p116, @p117, @p118, @p119, @p120, @p121, @p122, @p123, @p124, @p125, @p126, @p127, @p128, @p129, @p130, @p131, @p132, @p133, @p134, @p135, @p136, @p137, @p138, @p139, @p140, @p141, @p142, @p143, @p144, @p145, @p146, @p147, @p148, @p149, @p150, @p151, @p152, @p153, @p154, @p155, @p156, @p157, @p158, @p159, @p160, @p161, @p162, @p163, @p164, @p165, @p166, @p167, 2), (@p168, @p169, @p170, @p171, @p172, @p173, @p174, @p175, @p176, @p177, @p178, @p179, @p180, @p181, @p182, @p183, @p184, @p185, @p186, @p187, @p188, @p189, @p190, @p191, @p192, @p193, @p194, @p195, @p196, @p197, @p198, @p199, @p200, @p201, @p202, @p203, @p204, @p205, @p206, @p207, @p208, @p209, @p210, @p211, @p212, @p213, @p214, @p215, @p216, @p217, @p218, @p219, @p220, @p221, @p222, @p223, 3), (@p224, @p225, @p226, @p227, @p228, @p229, @p230, @p231, @p232, @p233, @p234, @p235, @p236, @p237, @p238, @p239, @p240, @p241, @p242, @p243, @p244, @p245, @p246, @p247, @p248, @p249, @p250, @p251, @p252, @p253, @p254, @p255, @p256, @p257, @p258, @p259, @p260, @p261, @p262, @p263, @p264, @p265, @p266, @p267, @p268, @p269, @p270, @p271, @p272, @p273, @p274, @p275, @p276, @p277, @p278, @p279, 4), (@p280, @p281, @p282, @p283, @p284, @p285, @p286, @p287, @p288, @p289, @p290, @p291, @p292, @p293, @p294, @p295, @p296, @p297, @p298, @p299, @p300, @p301, @p302, @p303, @p304, @p305, @p306, @p307, @p308, @p309, @p310, @p311, @p312, @p313, @p314, @p315, @p316, @p317, @p318, @p319, @p320, @p321, @p322, @p323, @p324, @p325, @p326, @p327, @p328, @p329, @p330, @p331, @p332, @p333, @p334, @p335, 5), (@p336, @p337, @p338, @p339, @p340, @p341, @p342, @p343, @p344, @p345, @p346, @p347, @p348, @p349, @p350, @p351, @p352, @p353, @p354, @p355, @p356, @p357, @p358, @p359, @p360, @p361, @p362, @p363, @p364, @p365, @p366, @p367, @p368, @p369, @p370, @p371, @p372, @p373, @p374, @p375, @p376, @p377, @p378, @p379, @p380, @p381, @p382, @p383, @p384, @p385, @p386, @p387, @p388, @p389, @p390, @p391, 6), (@p392, @p393, @p394, @p395, @p396, @p397, @p398, @p399, @p400, @p401, @p402, @p403, @p404, @p405, @p406, @p407, @p408, @p409, @p410, @p411, @p412, @p413, @p414, @p415, @p416, @p417, @p418, @p419, @p420, @p421, @p422, @p423, @p424, @p425, @p426, @p427, @p428, @p429, @p430, @p431, @p432, @p433, @p434, @p435, @p436, @p437, @p438, @p439, @p440, @p441, @p442, @p443, @p444, @p445, @p446, @p447, 7), (@p448, @p449, @p450, @p451, @p452, @p453, @p454, @p455, @p456, @p457, @p458, @p459, @p460, @p461, @p462, @p463, @p464, @p465, @p466, @p467, @p468, @p469, @p470, @p471, @p472, @p473, @p474, @p475, @p476, @p477, @p478, @p479, @p480, @p481, @p482, @p483, @p484, @p485, @p486, @p487, @p488, @p489, @p490, @p491, @p492, @p493, @p494, @p495, @p496, @p497, @p498, @p499, @p500, @p501, @p502, @p503, 8), (@p504, @p505, @p506, @p507, @p508, @p509, @p510, @p511, @p512, @p513, @p514, @p515, @p516, @p517, @p518, @p519, @p520, @p521, @p522, @p523, @p524, @p525, @p526, @p527, @p528, @p529, @p530, @p531, @p532, @p533, @p534, @p535, @p536, @p537, @p538, @p539, @p540, @p541, @p542, @p543, @p544, @p545, @p546, @p547, @p548, @p549, @p550, @p551, @p552, @p553, @p554, @p555, @p556, @p557, @p558, @p559, 9), (@p560, @p561, @p562, @p563, @p564, @p565, @p566, @p567, @p568, @p569, @p570, @p571, @p572, @p573, @p574, @p575, @p576, @p577, @p578, @p579, @p580, @p581, @p582, @p583, @p584, @p585, @p586, @p587, @p588, @p589, @p590, @p591, @p592, @p593, @p594, @p595, @p596, @p597, @p598, @p599, @p600, @p601, @p602, @p603, @p604, @p605, @p606, @p607, @p608, @p609, @p610, @p611, @p612, @p613, @p614, @p615, 10), (@p616, @p617, @p618, @p619, @p620, @p621, @p622, @p623, @p624, @p625, @p626, @p627, @p628, @p629, @p630, @p631, @p632, @p633, @p634, @p635, @p636, @p637, @p638, @p639, @p640, @p641, @p642, @p643, @p644, @p645, @p646, @p647, @p648, @p649, @p650, @p651, @p652, @p653, @p654, @p655, @p656, @p657, @p658, @p659, @p660, @p661, @p662, @p663, @p664, @p665, @p666, @p667, @p668, @p669, @p670, @p671, 11), (@p672, @p673, @p674, @p675, @p676, @p677, @p678, @p679, @p680, @p681, @p682, @p683, @p684, @p685, @p686, @p687, @p688, @p689, @p690, @p691, @p692, @p693, @p694, @p695, @p696, @p697, @p698, @p699, @p700, @p701, @p702, @p703, @p704, @p705, @p706, @p707, @p708, @p709, @p710, @p711, @p712, @p713, @p714, @p715, @p716, @p717, @p718, @p719, @p720, @p721, @p722, @p723, @p724, @p725, @p726, @p727, 12), (@p728, @p729, @p730, @p731, @p732, @p733, @p734, @p735, @p736, @p737, @p738, @p739, @p740, @p741, @p742, @p743, @p744, @p745, @p746, @p747, @p748, @p749, @p750, @p751, @p752, @p753, @p754, @p755, @p756, @p757, @p758, @p759, @p760, @p761, @p762, @p763, @p764, @p765, @p766, @p767, @p768, @p769, @p770, @p771, @p772, @p773, @p774, @p775, @p776, @p777, @p778, @p779, @p780, @p781, @p782, @p783, 13), (@p784, @p785, @p786, @p787, @p788, @p789, @p790, @p791, @p792, @p793, @p794, @p795, @p796, @p797, @p798, @p799, @p800, @p801, @p802, @p803, @p804, @p805, @p806, @p807, @p808, @p809, @p810, @p811, @p812, @p813, @p814, @p815, @p816, @p817, @p818, @p819, @p820, @p821, @p822, @p823, @p824, @p825, @p826, @p827, @p828, @p829, @p830, @p831, @p832, @p833, @p834, @p835, @p836, @p837, @p838, @p839, 14), (@p840, @p841, @p842, @p843, @p844, @p845, @p846, @p847, @p848, @p849, @p850, @p851, @p852, @p853, @p854, @p855, @p856, @p857, @p858, @p859, @p860, @p861, @p862, @p863, @p864, @p865, @p866, @p867, @p868, @p869, @p870, @p871, @p872, @p873, @p874, @p875, @p876, @p877, @p878, @p879, @p880, @p881, @p882, @p883, @p884, @p885, @p886, @p887, @p888, @p889, @p890, @p891, @p892, @p893, @p894, @p895, 15), (@p896, @p897, @p898, @p899, @p900, @p901, @p902, @p903, @p904, @p905, @p906, @p907, @p908, @p909, @p910, @p911, @p912, @p913, @p914, @p915, @p916, @p917, @p918, @p919, @p920, @p921, @p922, @p923, @p924, @p925, @p926, @p927, @p928, @p929, @p930, @p931, @p932, @p933, @p934, @p935, @p936, @p937, @p938, @p939, @p940, @p941, @p942, @p943, @p944, @p945, @p946, @p947, @p948, @p949, @p950, @p951, 16), (@p952, @p953, @p954, @p955, @p956, @p957, @p958, @p959, @p960, @p961, @p962, @p963, @p964, @p965, @p966, @p967, @p968, @p969, @p970, @p971, @p972, @p973, @p974, @p975, @p976, @p977, @p978, @p979, @p980, @p981, @p982, @p983, @p984, @p985, @p986, @p987, @p988, @p989, @p990, @p991, @p992, @p993, @p994, @p995, @p996, @p997, @p998, @p999, @p1000, @p1001, @p1002, @p1003, @p1004, @p1005, @p1006, @p1007, 17), (@p1008, @p1009, @p1010, @p1011, @p1012, @p1013, @p1014, @p1015, @p1016, @p1017, @p1018, @p1019, @p1020, @p1021, @p1022, @p1023, @p1024, @p1025, @p1026, @p1027, @p1028, @p1029, @p1030, @p1031, @p1032, @p1033, @p1034, @p1035, @p1036, @p1037, @p1038, @p1039, @p1040, @p1041, @p1042, @p1043, @p1044, @p1045, @p1046, @p1047, @p1048, @p1049, @p1050, @p1051, @p1052, @p1053, @p1054, @p1055, @p1056, @p1057, @p1058, @p1059, @p1060, @p1061, @p1062, @p1063, 18), (@p1064, @p1065, @p1066, @p1067, @p1068, @p1069, @p1070, @p1071, @p1072, @p1073, @p1074, @p1075, @p1076, @p1077, @p1078, @p1079, @p1080, @p1081, @p1082, @p1083, @p1084, @p1085, @p1086, @p1087, @p1088, @p1089, @p1090, @p1091, @p1092, @p1093, @p1094, @p1095, @p1096, @p1097, @p1098, @p1099, @p1100, @p1101, @p1102, @p1103, @p1104, @p1105, @p1106, @p1107, @p1108, @p1109, @p1110, @p1111, @p1112, @p1113, @p1114, @p1115, @p1116, @p1117, @p1118, @p1119, 19), (@p1120, @p1121, @p1122, @p1123, @p1124, @p1125, @p1126, @p1127, @p1128, @p1129, @p1130, @p1131, @p1132, @p1133, @p1134, @p1135, @p1136, @p1137, @p1138, @p1139, @p1140, @p1141, @p1142, @p1143, @p1144, @p1145, @p1146, @p1147, @p1148, @p1149, @p1150, @p1151, @p1152, @p1153, @p1154, @p1155, @p1156, @p1157, @p1158, @p1159, @p1160, @p1161, @p1162, @p1163, @p1164, @p1165, @p1166, @p1167, @p1168, @p1169, @p1170, @p1171, @p1172, @p1173, @p1174, @p1175, 20), (@p1176, @p1177, @p1178, @p1179, @p1180, @p1181, @p1182, @p1183, @p1184, @p1185, @p1186, @p1187, @p1188, @p1189, @p1190, @p1191, @p1192, @p1193, @p1194, @p1195, @p1196, @p1197, @p1198, @p1199, @p1200, @p1201, @p1202, @p1203, @p1204, @p1205, @p1206, @p1207, @p1208, @p1209, @p1210, @p1211, @p1212, @p1213, @p1214, @p1215, @p1216, @p1217, @p1218, @p1219, @p1220, @p1221, @p1222, @p1223, @p1224, @p1225, @p1226, @p1227, @p1228, @p1229, @p1230, @p1231, 21), (@p1232, @p1233, @p1234, @p1235, @p1236, @p1237, @p1238, @p1239, @p1240, @p1241, @p1242, @p1243, @p1244, @p1245, @p1246, @p1247, @p1248, @p1249, @p1250, @p1251, @p1252, @p1253, @p1254, @p1255, @p1256, @p1257, @p1258, @p1259, @p1260, @p1261, @p1262, @p1263, @p1264, @p1265, @p1266, @p1267, @p1268, @p1269, @p1270, @p1271, @p1272, @p1273, @p1274, @p1275, @p1276, @p1277, @p1278, @p1279, @p1280, @p1281, @p1282, @p1283, @p1284, @p1285, @p1286, @p1287, 22), (@p1288, @p1289, @p1290, @p1291, @p1292, @p1293, @p1294, @p1295, @p1296, @p1297, @p1298, @p1299, @p1300, @p1301, @p1302, @p1303, @p1304, @p1305, @p1306, @p1307, @p1308, @p1309, @p1310, @p1311, @p1312, @p1313, @p1314, @p1315, @p1316, @p1317, @p1318, @p1319, @p1320, @p1321, @p1322, @p1323, @p1324, @p1325, @p1326, @p1327, @p1328, @p1329, @p1330, @p1331, @p1332, @p1333, @p1334, @p1335, @p1336, @p1337, @p1338, @p1339, @p1340, @p1341, @p1342, @p1343, 23), (@p1344, @p1345, @p1346, @p1347, @p1348, @p1349, @p1350, @p1351, @p1352, @p1353, @p1354, @p1355, @p1356, @p1357, @p1358, @p1359, @p1360, @p1361, @p1362, @p1363, @p1364, @p1365, @p1366, @p1367, @p1368, @p1369, @p1370, @p1371, @p1372, @p1373, @p1374, @p1375, @p1376, @p1377, @p1378, @p1379, @p1380, @p1381, @p1382, @p1383, @p1384, @p1385, @p1386, @p1387, @p1388, @p1389, @p1390, @p1391, @p1392, @p1393, @p1394, @p1395, @p1396, @p1397, @p1398, @p1399, 24), (@p1400, @p1401, @p1402, @p1403, @p1404, @p1405, @p1406, @p1407, @p1408, @p1409, @p1410, @p1411, @p1412, @p1413, @p1414, @p1415, @p1416, @p1417, @p1418, @p1419, @p1420, @p1421, @p1422, @p1423, @p1424, @p1425, @p1426, @p1427, @p1428, @p1429, @p1430, @p1431, @p1432, @p1433, @p1434, @p1435, @p1436, @p1437, @p1438, @p1439, @p1440, @p1441, @p1442, @p1443, @p1444, @p1445, @p1446, @p1447, @p1448, @p1449, @p1450, @p1451, @p1452, @p1453, @p1454, @p1455, 25), (@p1456, @p1457, @p1458, @p1459, @p1460, @p1461, @p1462, @p1463, @p1464, @p1465, @p1466, @p1467, @p1468, @p1469, @p1470, @p1471, @p1472, @p1473, @p1474, @p1475, @p1476, @p1477, @p1478, @p1479, @p1480, @p1481, @p1482, @p1483, @p1484, @p1485, @p1486, @p1487, @p1488, @p1489, @p1490, @p1491, @p1492, @p1493, @p1494, @p1495, @p1496, @p1497, @p1498, @p1499, @p1500, @p1501, @p1502, @p1503, @p1504, @p1505, @p1506, @p1507, @p1508, @p1509, @p1510, @p1511, 26), (@p1512, @p1513, @p1514, @p1515, @p1516, @p1517, @p1518, @p1519, @p1520, @p1521, @p1522, @p1523, @p1524, @p1525, @p1526, @p1527, @p1528, @p1529, @p1530, @p1531, @p1532, @p1533, @p1534, @p1535, @p1536, @p1537, @p1538, @p1539, @p1540, @p1541, @p1542, @p1543, @p1544, @p1545, @p1546, @p1547, @p1548, @p1549, @p1550, @p1551, @p1552, @p1553, @p1554, @p1555, @p1556, @p1557, @p1558, @p1559, @p1560, @p1561, @p1562, @p1563, @p1564, @p1565, @p1566, @p1567, 27), (@p1568, @p1569, @p1570, @p1571, @p1572, @p1573, @p1574, @p1575, @p1576, @p1577, @p1578, @p1579, @p1580, @p1581, @p1582, @p1583, @p1584, @p1585, @p1586, @p1587, @p1588, @p1589, @p1590, @p1591, @p1592, @p1593, @p1594, @p1595, @p1596, @p1597, @p1598, @p1599, @p1600, @p1601, @p1602, @p1603, @p1604, @p1605, @p1606, @p1607, @p1608, @p1609, @p1610, @p1611, @p1612, @p1613, @p1614, @p1615, @p1616, @p1617, @p1618, @p1619, @p1620, @p1621, @p1622, @p1623, 28), (@p1624, @p1625, @p1626, @p1627, @p1628, @p1629, @p1630, @p1631, @p1632, @p1633, @p1634, @p1635, @p1636, @p1637, @p1638, @p1639, @p1640, @p1641, @p1642, @p1643, @p1644, @p1645, @p1646, @p1647, @p1648, @p1649, @p1650, @p1651, @p1652, @p1653, @p1654, @p1655, @p1656, @p1657, @p1658, @p1659, @p1660, @p1661, @p1662, @p1663, @p1664, @p1665, @p1666, @p1667, @p1668, @p1669, @p1670, @p1671, @p1672, @p1673, @p1674, @p1675, @p1676, @p1677, @p1678, @p1679, 29), (@p1680, @p1681, @p1682, @p1683, @p1684, @p1685, @p1686, @p1687, @p1688, @p1689, @p1690, @p1691, @p1692, @p1693, @p1694, @p1695, @p1696, @p1697, @p1698, @p1699, @p1700, @p1701, @p1702, @p1703, @p1704, @p1705, @p1706, @p1707, @p1708, @p1709, @p1710, @p1711, @p1712, @p1713, @p1714, @p1715, @p1716, @p1717, @p1718, @p1719, @p1720, @p1721, @p1722, @p1723, @p1724, @p1725, @p1726, @p1727, @p1728, @p1729, @p1730, @p1731, @p1732, @p1733, @p1734, @p1735, 30), (@p1736, @p1737, @p1738, @p1739, @p1740, @p1741, @p1742, @p1743, @p1744, @p1745, @p1746, @p1747, @p1748, @p1749, @p1750, @p1751, @p1752, @p1753, @p1754, @p1755, @p1756, @p1757, @p1758, @p1759, @p1760, @p1761, @p1762, @p1763, @p1764, @p1765, @p1766, @p1767, @p1768, @p1769, @p1770, @p1771, @p1772, @p1773, @p1774, @p1775, @p1776, @p1777, @p1778, @p1779, @p1780, @p1781, @p1782, @p1783, @p1784, @p1785, @p1786, @p1787, @p1788, @p1789, @p1790, @p1791, 31), (@p1792, @p1793, @p1794, @p1795, @p1796, @p1797, @p1798, @p1799, @p1800, @p1801, @p1802, @p1803, @p1804, @p1805, @p1806, @p1807, @p1808, @p1809, @p1810, @p1811, @p1812, @p1813, @p1814, @p1815, @p1816, @p1817, @p1818, @p1819, @p1820, @p1821, @p1822, @p1823, @p1824, @p1825, @p1826, @p1827, @p1828, @p1829, @p1830, @p1831, @p1832, @p1833, @p1834, @p1835, @p1836, @p1837, @p1838, @p1839, @p1840, @p1841, @p1842, @p1843, @p1844, @p1845, @p1846, @p1847, 32), (@p1848, @p1849, @p1850, @p1851, @p1852, @p1853, @p1854, @p1855, @p1856, @p1857, @p1858, @p1859, @p1860, @p1861, @p1862, @p1863, @p1864, @p1865, @p1866, @p1867, @p1868, @p1869, @p1870, @p1871, @p1872, @p1873, @p1874, @p1875, @p1876, @p1877, @p1878, @p1879, @p1880, @p1881, @p1882, @p1883, @p1884, @p1885, @p1886, @p1887, @p1888, @p1889, @p1890, @p1891, @p1892, @p1893, @p1894, @p1895, @p1896, @p1897, @p1898, @p1899, @p1900, @p1901, @p1902, @p1903, 33), (@p1904, @p1905, @p1906, @p1907, @p1908, @p1909, @p1910, @p1911, @p1912, @p1913, @p1914, @p1915, @p1916, @p1917, @p1918, @p1919, @p1920, @p1921, @p1922, @p1923, @p1924, @p1925, @p1926, @p1927, @p1928, @p1929, @p1930, @p1931, @p1932, @p1933, @p1934, @p1935, @p1936, @p1937, @p1938, @p1939, @p1940, @p1941, @p1942, @p1943, @p1944, @p1945, @p1946, @p1947, @p1948, @p1949, @p1950, @p1951, @p1952, @p1953, @p1954, @p1955, @p1956, @p1957, @p1958, @p1959, 34), (@p1960, @p1961, @p1962, @p1963, @p1964, @p1965, @p1966, @p1967, @p1968, @p1969, @p1970, @p1971, @p1972, @p1973, @p1974, @p1975, @p1976, @p1977, @p1978, @p1979, @p1980, @p1981, @p1982, @p1983, @p1984, @p1985, @p1986, @p1987, @p1988, @p1989, @p1990, @p1991, @p1992, @p1993, @p1994, @p1995, @p1996, @p1997, @p1998, @p1999, @p2000, @p2001, @p2002, @p2003, @p2004, @p2005, @p2006, @p2007, @p2008, @p2009, @p2010, @p2011, @p2012, @p2013, @p2014, @p2015, 35), (@p2016, @p2017, @p2018, @p2019, @p2020, @p2021, @p2022, @p2023, @p2024, @p2025, @p2026, @p2027, @p2028, @p2029, @p2030, @p2031, @p2032, @p2033, @p2034, @p2035, @p2036, @p2037, @p2038, @p2039, @p2040, @p2041, @p2042, @p2043, @p2044, @p2045, @p2046, @p2047, @p2048, @p2049, @p2050, @p2051, @p2052, @p2053, @p2054, @p2055, @p2056, @p2057, @p2058, @p2059, @p2060, @p2061, @p2062, @p2063, @p2064, @p2065, @p2066, @p2067, @p2068, @p2069, @p2070, @p2071, 36)) AS i ([addressee_cntry_cd], [addressee_city], [addressee_district], [addressee_email], [addressee_full_address], [addressee_home_address], [addressee_name], [addressee_postcode], [addressee_province], [addressee_subdistrict], [addressee_tel], [create_table], [delivery_code], [delivery_recipient_name], [delivery_relation_id], [delivery_status_id], [dest_outlet_id], [dest_outlet_port], [document_number], [item_barcode], [item_cod], [item_gross_weight], [item_height], [item_length], [item_price], [item_width], [lat], [log_id], [long], [outlet_id], [outlet_port], [podUrl], [remark], [scan_cntry_cd], [scan_cntry_postcode], [sender_cntry_cd], [sender_district], [sender_email], [sender_full_address], [sender_home_address], [member_id], [sender_name], [sender_postcode], [sender_province], [sender_subdistrict], [sender_tel], [server_id], [signatureUrl], [state], [status_code], [status_dtm], [timestamp], [transmit_dtm], [user_id], [wckt_id], [wkstn_no], _Position) ON 1=0 WHEN NOT MATCHED THEN INSERT ([addressee_cntry_cd], [addressee_city], [addressee_district], [addressee_email], [addressee_full_address], [addressee_home_address], [addressee_name], [addressee_postcode], [addressee_province], [addressee_subdistrict], [addressee_tel], [create_table], [delivery_code], [delivery_recipient_name], [delivery_relation_id], [delivery_status_id], [dest_outlet_id], [dest_outlet_port], [document_number], [item_barcode], [item_cod], [item_gross_weight], [item_height], [item_length], [item_price], [item_width], [lat], [log_id], [long], [outlet_id], [outlet_port], [podUrl], [remark], [scan_cntry_cd], [scan_cntry_postcode], [sender_cntry_cd], [sender_district], [sender_email], [sender_full_address], [sender_home_address], [member_id], [sender_name], [sender_postcode], [sender_province], [sender_subdistrict], [sender_tel], [server_id], [signatureUrl], [state], [status_code], [status_dtm], [timestamp], [transmit_dtm], [user_id], [wckt_id], [wkstn_no]) VALUES (i.[addressee_cntry_cd], i.[addressee_city], i.[addressee_district], i.[addressee_email], i.[addressee_full_address], i.[addressee_home_address], i.[addressee_name], i.[addressee_postcode], i.[addressee_province], i.[addressee_subdistrict], i.[addressee_tel], i.[create_table], i.[delivery_code], i.[delivery_recipient_name], i.[delivery_relation_id], i.[delivery_status_id], i.[dest_outlet_id], i.[dest_outlet_port], i.[document_number], i.[item_barcode], i.[item_cod], i.[item_gross_weight], i.[item_height], i.[item_length], i.[item_price], i.[item_width], i.[lat], i.[log_id], i.[long], i.[outlet_id], i.[outlet_port], i.[podUrl], i.[remark], i.[scan_cntry_cd], i.[scan_cntry_postcode], i.[sender_cntry_cd], i.[sender_district], i.[sender_email], i.[sender_full_address], i.[sender_home_address], i.[member_id], i.[sender_name], i.[sender_postcode], i.[sender_province], i.[sender_subdistrict], i.[sender_tel], i.[server_id], i.[signatureUrl], i.[state], i.[status_code], i.[status_dtm], i.[timestamp], i.[transmit_dtm], i.[user_id], i.[wckt_id], i.[wkstn_no]) OUTPUT INSERTED.[item_id], i._Position INTO @inserted0;  SELECT [t].[item_id] FROM [raw_data] t INNER JOIN @inserted0 i ON ([t].[item_id] = [i].[item_id]) ORDER BY [i].[_Position];  ",6,6,0,438,5,6
"(@p0 nvarchar(4000),@p1 nvarchar(4000),@p2 nvarchar(4000),@p3 nvarchar(4000),@p4 nvarchar(4000),@p5 nvarchar(4000),@p6 nvarchar(4000),@p7 nvarchar(4000),@p8 nvarchar(4000),@p9 nvarchar(4000),@p10 nvarchar(4000),@p11 datetime2(7),@p12 nvarchar(4000),@p13 nvarchar(4000),@p14 int,@p15 int,@p16 int,@p17 nvarchar(4000),@p18 nvarchar(4000),@p19 nvarchar(4000),@p20 nvarchar(4000),@p21 decimal(18,2),@p22 nvarchar(4000),@p23 nvarchar(4000),@p24 decimal(18,2),@p25 nvarchar(4000),@p26 nvarchar(4000),@p27 nvarchar(4000),@p28 nvarchar(4000),@p29 int,@p30 nvarchar(4000),@p31 nvarchar(4000),@p32 nvarchar(4000),@p33 nvarchar(4000),@p34 nvarchar(4000),@p35 nvarchar(4000),@p36 nvarchar(4000),@p37 nvarchar(4000),@p38 nvarchar(4000),@p39 nvarchar(4000),@p40 int,@p41 nvarchar(4000),@p42 nvarchar(4000),@p43 nvarchar(4000),@p44 nvarchar(4000),@p45 nvarchar(4000),@p46 int,@p47 nvarchar(4000),@p48 int,@p49 int,@p50 datetime2(7),@p51 datetime2(7),@p52 datetime2(7),@p53 nvarchar(4000),@p54 nvarchar(4000),@p55 nvarchar(4000),@p56 nvarchar(4000),@p57 nvarchar(4000),@p58 nvarchar(4000),@p59 nvarchar(4000),@p60 nvarchar(4000),@p61 nvarchar(4000),@p62 nvarchar(4000),@p63 nvarchar(4000),@p64 nvarchar(4000),@p65 nvarchar(4000),@p66 nvarchar(4000),@p67 datetime2(7),@p68 nvarchar(4000),@p69 nvarchar(4000),@p70 int,@p71 int,@p72 int,@p73 nvarchar(4000),@p74 nvarchar(4000),@p75 nvarchar(4000),@p76 nvarchar(4000),@p77 decimal(18,2),@p78 nvarchar(4000),@p79 nvarchar(4000),@p80 decimal(18,2),@p81 nvarchar(4000),@p82 nvarchar(4000),@p83 nvarchar(4000),@p84 nvarchar(4000),@p85 int,@p86 nvarchar(4000),@p87 nvarchar(4000),@p88 nvarchar(4000),@p89 nvarchar(4000),@p90 nvarchar(4000),@p91 nvarchar(4000),@p92 nvarchar(4000),@p93 nvarchar(4000),@p94 nvarchar(4000),@p95 nvarchar(4000),@p96 int,@p97 nvarchar(4000),@p98 nvarchar(4000),@p99 nvarchar(4000),@p100 nvarchar(4000),@p101 nvarchar(4000),@p102 int,@p103 nvarchar(4000),@p104 int,@p105 int,@p106 datetime2(7),@p107 datetime2(7),@p108 datetime2(7),@p109 nvarchar(4000),@p110 nvarchar(4000),@p111 nvarchar(4000),@p112 nvarchar(4000),@p113 nvarchar(4000),@p114 nvarchar(4000),@p115 nvarchar(4000),@p116 nvarchar(4000),@p117 nvarchar(4000),@p118 nvarchar(4000),@p119 nvarchar(4000),@p120 nvarchar(4000),@p121 nvarchar(4000),@p122 nvarchar(4000),@p123 datetime2(7),@p124 nvarchar(4000),@p125 nvarchar(4000),@p126 int,@p127 int,@p128 int,@p129 nvarchar(4000),@p130 nvarchar(4000),@p131 nvarchar(4000),@p132 nvarchar(4000),@p133 decimal(18,2),@p134 nvarchar(4000),@p135 nvarchar(4000),@p136 decimal(18,2),@p137 nvarchar(4000),@p138 nvarchar(4000),@p139 nvarchar(4000),@p140 nvarchar(4000),@p141 int,@p142 nvarchar(4000),@p143 nvarchar(4000),@p144 nvarchar(4000),@p145 nvarchar(4000),@p146 nvarchar(4000),@p147 nvarchar(4000),@p148 nvarchar(4000),@p149 nvarchar(4000),@p150 nvarchar(4000),@p151 nvarchar(4000),@p152 int,@p153 nvarchar(4000),@p154 nvarchar(4000),@p155 nvarchar(4000),@p156 nvarchar(4000),@p157 nvarchar(4000),@p158 int,@p159 nvarchar(4000),@p160 int,@p161 int,@p162 datetime2(7),@p163 datetime2(7),@p164 datetime2(7),@p165 nvarchar(4000),@p166 nvarchar(4000),@p167 nvarchar(4000),@p168 nvarchar(4000),@p169 nvarchar(4000),@p170 nvarchar(4000),@p171 nvarchar(4000),@p172 nvarchar(4000),@p173 nvarchar(4000),@p174 nvarchar(4000),@p175 nvarchar(4000),@p176 nvarchar(4000),@p177 nvarchar(4000),@p178 nvarchar(4000),@p179 datetime2(7),@p180 nvarchar(4000),@p181 nvarchar(4000),@p182 int,@p183 int,@p184 int,@p185 nvarchar(4000),@p186 nvarchar(4000),@p187 nvarchar(4000),@p188 nvarchar(4000),@p189 decimal(18,2),@p190 nvarchar(4000),@p191 nvarchar(4000),@p192 decimal(18,2),@p193 nvarchar(4000),@p194 nvarchar(4000),@p195 nvarchar(4000),@p196 nvarchar(4000),@p197 int,@p198 nvarchar(4000),@p199 nvarchar(4000),@p200 nvarchar(4000),@p201 nvarchar(4000),@p202 nvarchar(4000),@p203 nvarchar(4000),@p204 nvarchar(4000),@p205 nvarchar(4000),@p206 nvarchar(4000),@p207 nvarchar(4000),@p208 int,@p209 nvarchar(4000),@p210 nvarchar(4000),@p211 nvarchar(4000),@p212 nvarchar(4000),@p213 nvarchar(4000),@p214 int,@p215 nvarchar(4000),@p216 int,@p217 int,@p218 datetime2(7),@p219 datetime2(7),@p220 datetime2(7),@p221 nvarchar(4000),@p222 nvarchar(4000),@p223 nvarchar(4000),@p224 nvarchar(4000),@p225 nvarchar(4000),@p226 nvarchar(4000),@p227 nvarchar(4000),@p228 nvarchar(4000),@p229 nvarchar(4000),@p230 nvarchar(4000),@p231 nvarchar(4000),@p232 nvarchar(4000),@p233 nvarchar(4000),@p234 nvarchar(4000),@p235 datetime2(7),@p236 nvarchar(4000),@p237 nvarchar(4000),@p238 int,@p239 int,@p240 int,@p241 nvarchar(4000),@p242 nvarchar(4000),@p243 nvarchar(4000),@p244 nvarchar(4000),@p245 decimal(18,2),@p246 nvarchar(4000),@p247 nvarchar(4000),@p248 decimal(18,2),@p249 nvarchar(4000),@p250 nvarchar(4000),@p251 nvarchar(4000),@p252 nvarchar(4000),@p253 int,@p254 nvarchar(4000),@p255 nvarchar(4000),@p256 nvarchar(4000),@p257 nvarchar(4000),@p258 nvarchar(4000),@p259 nvarchar(4000),@p260 nvarchar(4000),@p261 nvarchar(4000),@p262 nvarchar(4000),@p263 nvarchar(4000),@p264 int,@p265 nvarchar(4000),@p266 nvarchar(4000),@p267 nvarchar(4000),@p268 nvarchar(4000),@p269 nvarchar(4000),@p270 int,@p271 nvarchar(4000),@p272 int,@p273 int,@p274 datetime2(7),@p275 datetime2(7),@p276 datetime2(7),@p277 nvarchar(4000),@p278 nvarchar(4000),@p279 nvarchar(4000),@p280 nvarchar(4000),@p281 nvarchar(4000),@p282 nvarchar(4000),@p283 nvarchar(4000),@p284 nvarchar(4000),@p285 nvarchar(4000),@p286 nvarchar(4000),@p287 nvarchar(4000),@p288 nvarchar(4000),@p289 nvarchar(4000),@p290 nvarchar(4000),@p291 datetime2(7),@p292 nvarchar(4000),@p293 nvarchar(4000),@p294 int,@p295 int,@p296 int,@p297 nvarchar(4000),@p298 nvarchar(4000),@p299 nvarchar(4000),@p300 nvarchar(4000),@p301 decimal(18,2),@p302 nvarchar(4000),@p303 nvarchar(4000),@p304 decimal(18,2),@p305 nvarchar(4000),@p306 nvarchar(4000),@p307 nvarchar(4000),@p308 nvarchar(4000),@p309 int,@p310 nvarchar(4000),@p311 nvarchar(4000),@p312 nvarchar(4000),@p313 nvarchar(4000),@p314 nvarchar(4000),@p315 nvarchar(4000),@p316 nvarchar(4000),@p317 nvarchar(4000),@p318 nvarchar(4000),@p319 nvarchar(4000),@p320 int,@p321 nvarchar(4000),@p322 nvarchar(4000),@p323 nvarchar(4000),@p324 nvarchar(4000),@p325 nvarchar(4000),@p326 int,@p327 nvarchar(4000),@p328 int,@p329 int,@p330 datetime2(7),@p331 datetime2(7),@p332 datetime2(7),@p333 nvarchar(4000),@p334 nvarchar(4000),@p335 nvarchar(4000),@p336 nvarchar(4000),@p337 nvarchar(4000),@p338 nvarchar(4000),@p339 nvarchar(4000),@p340 nvarchar(4000),@p341 nvarchar(4000),@p342 nvarchar(4000),@p343 nvarchar(4000),@p344 nvarchar(4000),@p345 nvarchar(4000),@p346 nvarchar(4000),@p347 datetime2(7),@p348 nvarchar(4000),@p349 nvarchar(4000),@p350 int,@p351 int,@p352 int,@p353 nvarchar(4000),@p354 nvarchar(4000),@p355 nvarchar(4000),@p356 nvarchar(4000),@p357 decimal(18,2),@p358 nvarchar(4000),@p359 nvarchar(4000),@p360 decimal(18,2),@p361 nvarchar(4000),@p362 nvarchar(4000),@p363 nvarchar(4000),@p364 nvarchar(4000),@p365 int,@p366 nvarchar(4000),@p367 nvarchar(4000),@p368 nvarchar(4000),@p369 nvarchar(4000),@p370 nvarchar(4000),@p371 nvarchar(4000),@p372 nvarchar(4000),@p373 nvarchar(4000),@p374 nvarchar(4000),@p375 nvarchar(4000),@p376 int,@p377 nvarchar(4000),@p378 nvarchar(4000),@p379 nvarchar(4000),@p380 nvarchar(4000),@p381 nvarchar(4000),@p382 int,@p383 nvarchar(4000),@p384 int,@p385 int,@p386 datetime2(7),@p387 datetime2(7),@p388 datetime2(7),@p389 nvarchar(4000),@p390 nvarchar(4000),@p391 nvarchar(4000),@p392 nvarchar(4000),@p393 nvarchar(4000),@p394 nvarchar(4000),@p395 nvarchar(4000),@p396 nvarchar(4000),@p397 nvarchar(4000),@p398 nvarchar(4000),@p399 nvarchar(4000),@p400 nvarchar(4000),@p401 nvarchar(4000),@p402 nvarchar(4000),@p403 datetime2(7),@p404 nvarchar(4000),@p405 nvarchar(4000),@p406 int,@p407 int,@p408 int,@p409 nvarchar(4000),@p410 nvarchar(4000),@p411 nvarchar(4000),@p412 nvarchar(4000),@p413 decimal(18,2),@p414 nvarchar(4000),@p415 nvarchar(4000),@p416 decimal(18,2),@p417 nvarchar(4000),@p418 nvarchar(4000),@p419 nvarchar(4000),@p420 nvarchar(4000),@p421 int,@p422 nvarchar(4000),@p423 nvarchar(4000),@p424 nvarchar(4000),@p425 nvarchar(4000),@p426 nvarchar(4000),@p427 nvarchar(4000),@p428 nvarchar(4000),@p429 nvarchar(4000),@p430 nvarchar(4000),@p431 nvarchar(4000),@p432 int,@p433 nvarchar(4000),@p434 nvarchar(4000),@p435 nvarchar(4000),@p436 nvarchar(4000),@p437 nvarchar(4000),@p438 int,@p439 nvarchar(4000),@p440 int,@p441 int,@p442 datetime2(7),@p443 datetime2(7),@p444 datetime2(7),@p445 nvarchar(4000),@p446 nvarchar(4000),@p447 nvarchar(4000),@p448 nvarchar(4000),@p449 nvarchar(4000),@p450 nvarchar(4000),@p451 nvarchar(4000),@p452 nvarchar(4000),@p453 nvarchar(4000),@p454 nvarchar(4000),@p455 nvarchar(4000),@p456 nvarchar(4000),@p457 nvarchar(4000),@p458 nvarchar(4000),@p459 datetime2(7),@p460 nvarchar(4000),@p461 nvarchar(4000),@p462 int,@p463 int,@p464 int,@p465 nvarchar(4000),@p466 nvarchar(4000),@p467 nvarchar(4000),@p468 nvarchar(4000),@p469 decimal(18,2),@p470 nvarchar(4000),@p471 nvarchar(4000),@p472 decimal(18,2),@p473 nvarchar(4000),@p474 nvarchar(4000),@p475 nvarchar(4000),@p476 nvarchar(4000),@p477 int,@p478 nvarchar(4000),@p479 nvarchar(4000),@p480 nvarchar(4000),@p481 nvarchar(4000),@p482 nvarchar(4000),@p483 nvarchar(4000),@p484 nvarchar(4000),@p485 nvarchar(4000),@p486 nvarchar(4000),@p487 nvarchar(4000),@p488 int,@p489 nvarchar(4000),@p490 nvarchar(4000),@p491 nvarchar(4000),@p492 nvarchar(4000),@p493 nvarchar(4000),@p494 int,@p495 nvarchar(4000),@p496 int,@p497 int,@p498 datetime2(7),@p499 datetime2(7),@p500 datetime2(7),@p501 nvarchar(4000),@p502 nvarchar(4000),@p503 nvarchar(4000),@p504 nvarchar(4000),@p505 nvarchar(4000),@p506 nvarchar(4000),@p507 nvarchar(4000),@p508 nvarchar(4000),@p509 nvarchar(4000),@p510 nvarchar(4000),@p511 nvarchar(4000),@p512 nvarchar(4000),@p513 nvarchar(4000),@p514 nvarchar(4000),@p515 datetime2(7),@p516 nvarchar(4000),@p517 nvarchar(4000),@p518 int,@p519 int,@p520 int,@p521 nvarchar(4000),@p522 nvarchar(4000),@p523 nvarchar(4000),@p524 nvarchar(4000),@p525 decimal(18,2),@p526 nvarchar(4000),@p527 nvarchar(4000),@p528 decimal(18,2),@p529 nvarchar(4000),@p530 nvarchar(4000),@p531 nvarchar(4000),@p532 nvarchar(4000),@p533 int,@p534 nvarchar(4000),@p535 nvarchar(4000),@p536 nvarchar(4000),@p537 nvarchar(4000),@p538 nvarchar(4000),@p539 nvarchar(4000),@p540 nvarchar(4000),@p541 nvarchar(4000),@p542 nvarchar(4000),@p543 nvarchar(4000),@p544 int,@p545 nvarchar(4000),@p546 nvarchar(4000),@p547 nvarchar(4000),@p548 nvarchar(4000),@p549 nvarchar(4000),@p550 int,@p551 nvarchar(4000),@p552 int,@p553 int,@p554 datetime2(7),@p555 datetime2(7),@p556 datetime2(7),@p557 nvarchar(4000),@p558 nvarchar(4000),@p559 nvarchar(4000),@p560 nvarchar(4000),@p561 nvarchar(4000),@p562 nvarchar(4000),@p563 nvarchar(4000),@p564 nvarchar(4000),@p565 nvarchar(4000),@p566 nvarchar(4000),@p567 nvarchar(4000),@p568 nvarchar(4000),@p569 nvarchar(4000),@p570 nvarchar(4000),@p571 datetime2(7),@p572 nvarchar(4000),@p573 nvarchar(4000),@p574 int,@p575 int,@p576 int,@p577 nvarchar(4000),@p578 nvarchar(4000),@p579 nvarchar(4000),@p580 nvarchar(4000),@p581 decimal(18,2),@p582 nvarchar(4000),@p583 nvarchar(4000),@p584 decimal(18,2),@p585 nvarchar(4000),@p586 nvarchar(4000),@p587 nvarchar(4000),@p588 nvarchar(4000),@p589 int,@p590 nvarchar(4000),@p591 nvarchar(4000),@p592 nvarchar(4000),@p593 nvarchar(4000),@p594 nvarchar(4000),@p595 nvarchar(4000),@p596 nvarchar(4000),@p597 nvarchar(4000),@p598 nvarchar(4000),@p599 nvarchar(4000),@p600 int,@p601 nvarchar(4000),@p602 nvarchar(4000),@p603 nvarchar(4000),@p604 nvarchar(4000),@p605 nvarchar(4000),@p606 int,@p607 nvarchar(4000),@p608 int,@p609 int,@p610 datetime2(7),@p611 datetime2(7),@p612 datetime2(7),@p613 nvarchar(4000),@p614 nvarchar(4000),@p615 nvarchar(4000),@p616 nvarchar(4000),@p617 nvarchar(4000),@p618 nvarchar(4000),@p619 nvarchar(4000),@p620 nvarchar(4000),@p621 nvarchar(4000),@p622 nvarchar(4000),@p623 nvarchar(4000),@p624 nvarchar(4000),@p625 nvarchar(4000),@p626 nvarchar(4000),@p627 datetime2(7),@p628 nvarchar(4000),@p629 nvarchar(4000),@p630 int,@p631 int,@p632 int,@p633 nvarchar(4000),@p634 nvarchar(4000),@p635 nvarchar(4000),@p636 nvarchar(4000),@p637 decimal(18,2),@p638 nvarchar(4000),@p639 nvarchar(4000),@p640 decimal(18,2),@p641 nvarchar(4000),@p642 nvarchar(4000),@p643 nvarchar(4000),@p644 nvarchar(4000),@p645 int,@p646 nvarchar(4000),@p647 nvarchar(4000),@p648 nvarchar(4000),@p649 nvarchar(4000),@p650 nvarchar(4000),@p651 nvarchar(4000),@p652 nvarchar(4000),@p653 nvarchar(4000),@p654 nvarchar(4000),@p655 nvarchar(4000),@p656 int,@p657 nvarchar(4000),@p658 nvarchar(4000),@p659 nvarchar(4000),@p660 nvarchar(4000),@p661 nvarchar(4000),@p662 int,@p663 nvarchar(4000),@p664 int,@p665 int,@p666 datetime2(7),@p667 datetime2(7),@p668 datetime2(7),@p669 nvarchar(4000),@p670 nvarchar(4000),@p671 nvarchar(4000),@p672 nvarchar(4000),@p673 nvarchar(4000),@p674 nvarchar(4000),@p675 nvarchar(4000),@p676 nvarchar(4000),@p677 nvarchar(4000),@p678 nvarchar(4000),@p679 nvarchar(4000),@p680 nvarchar(4000),@p681 nvarchar(4000),@p682 nvarchar(4000),@p683 datetime2(7),@p684 nvarchar(4000),@p685 nvarchar(4000),@p686 int,@p687 int,@p688 int,@p689 nvarchar(4000),@p690 nvarchar(4000),@p691 nvarchar(4000),@p692 nvarchar(4000),@p693 decimal(18,2),@p694 nvarchar(4000),@p695 nvarchar(4000),@p696 decimal(18,2),@p697 nvarchar(4000),@p698 nvarchar(4000),@p699 nvarchar(4000),@p700 nvarchar(4000),@p701 int,@p702 nvarchar(4000),@p703 nvarchar(4000),@p704 nvarchar(4000),@p705 nvarchar(4000),@p706 nvarchar(4000),@p707 nvarchar(4000),@p708 nvarchar(4000),@p709 nvarchar(4000),@p710 nvarchar(4000),@p711 nvarchar(4000),@p712 int,@p713 nvarchar(4000),@p714 nvarchar(4000),@p715 nvarchar(4000),@p716 nvarchar(4000),@p717 nvarchar(4000),@p718 int,@p719 nvarchar(4000),@p720 int,@p721 int,@p722 datetime2(7),@p723 datetime2(7),@p724 datetime2(7),@p725 nvarchar(4000),@p726 nvarchar(4000),@p727 nvarchar(4000),@p728 nvarchar(4000),@p729 nvarchar(4000),@p730 nvarchar(4000),@p731 nvarchar(4000),@p732 nvarchar(4000),@p733 nvarchar(4000),@p734 nvarchar(4000),@p735 nvarchar(4000),@p736 nvarchar(4000),@p737 nvarchar(4000),@p738 nvarchar(4000),@p739 datetime2(7),@p740 nvarchar(4000),@p741 nvarchar(4000),@p742 int,@p743 int,@p744 int,@p745 nvarchar(4000),@p746 nvarchar(4000),@p747 nvarchar(4000),@p748 nvarchar(4000),@p749 decimal(18,2),@p750 nvarchar(4000),@p751 nvarchar(4000),@p752 decimal(18,2),@p753 nvarchar(4000),@p754 nvarchar(4000),@p755 nvarchar(4000),@p756 nvarchar(4000),@p757 int,@p758 nvarchar(4000),@p759 nvarchar(4000),@p760 nvarchar(4000),@p761 nvarchar(4000),@p762 nvarchar(4000),@p763 nvarchar(4000),@p764 nvarchar(4000),@p765 nvarchar(4000),@p766 nvarchar(4000),@p767 nvarchar(4000),@p768 int,@p769 nvarchar(4000),@p770 nvarchar(4000),@p771 nvarchar(4000),@p772 nvarchar(4000),@p773 nvarchar(4000),@p774 int,@p775 nvarchar(4000),@p776 int,@p777 int,@p778 datetime2(7),@p779 datetime2(7),@p780 datetime2(7),@p781 nvarchar(4000),@p782 nvarchar(4000),@p783 nvarchar(4000),@p784 nvarchar(4000),@p785 nvarchar(4000),@p786 nvarchar(4000),@p787 nvarchar(4000),@p788 nvarchar(4000),@p789 nvarchar(4000),@p790 nvarchar(4000),@p791 nvarchar(4000),@p792 nvarchar(4000),@p793 nvarchar(4000),@p794 nvarchar(4000),@p795 datetime2(7),@p796 nvarchar(4000),@p797 nvarchar(4000),@p798 int,@p799 int,@p800 int,@p801 nvarchar(4000),@p802 nvarchar(4000),@p803 nvarchar(4000),@p804 nvarchar(4000),@p805 decimal(18,2),@p806 nvarchar(4000),@p807 nvarchar(4000),@p808 decimal(18,2),@p809 nvarchar(4000),@p810 nvarchar(4000),@p811 nvarchar(4000),@p812 nvarchar(4000),@p813 int,@p814 nvarchar(4000),@p815 nvarchar(4000),@p816 nvarchar(4000),@p817 nvarchar(4000),@p818 nvarchar(4000),@p819 nvarchar(4000),@p820 nvarchar(4000),@p821 nvarchar(4000),@p822 nvarchar(4000),@p823 nvarchar(4000),@p824 int,@p825 nvarchar(4000),@p826 nvarchar(4000),@p827 nvarchar(4000),@p828 nvarchar(4000),@p829 nvarchar(4000),@p830 int,@p831 nvarchar(4000),@p832 int,@p833 int,@p834 datetime2(7),@p835 datetime2(7),@p836 datetime2(7),@p837 nvarchar(4000),@p838 nvarchar(4000),@p839 nvarchar(4000),@p840 nvarchar(4000),@p841 nvarchar(4000),@p842 nvarchar(4000),@p843 nvarchar(4000),@p844 nvarchar(4000),@p845 nvarchar(4000),@p846 nvarchar(4000),@p847 nvarchar(4000),@p848 nvarchar(4000),@p849 nvarchar(4000),@p850 nvarchar(4000),@p851 datetime2(7),@p852 nvarchar(4000),@p853 nvarchar(4000),@p854 int,@p855 int,@p856 int,@p857 nvarchar(4000),@p858 nvarchar(4000),@p859 nvarchar(4000),@p860 nvarchar(4000),@p861 decimal(18,2),@p862 nvarchar(4000),@p863 nvarchar(4000),@p864 decimal(18,2),@p865 nvarchar(4000),@p866 nvarchar(4000),@p867 nvarchar(4000),@p868 nvarchar(4000),@p869 int,@p870 nvarchar(4000),@p871 nvarchar(4000),@p872 nvarchar(4000),@p873 nvarchar(4000),@p874 nvarchar(4000),@p875 nvarchar(4000),@p876 nvarchar(4000),@p877 nvarchar(4000),@p878 nvarchar(4000),@p879 nvarchar(4000),@p880 int,@p881 nvarchar(4000),@p882 nvarchar(4000),@p883 nvarchar(4000),@p884 nvarchar(4000),@p885 nvarchar(4000),@p886 int,@p887 nvarchar(4000),@p888 int,@p889 int,@p890 datetime2(7),@p891 datetime2(7),@p892 datetime2(7),@p893 nvarchar(4000),@p894 nvarchar(4000),@p895 nvarchar(4000),@p896 nvarchar(4000),@p897 nvarchar(4000),@p898 nvarchar(4000),@p899 nvarchar(4000),@p900 nvarchar(4000),@p901 nvarchar(4000),@p902 nvarchar(4000),@p903 nvarchar(4000),@p904 nvarchar(4000),@p905 nvarchar(4000),@p906 nvarchar(4000),@p907 datetime2(7),@p908 nvarchar(4000),@p909 nvarchar(4000),@p910 int,@p911 int,@p912 int,@p913 nvarchar(4000),@p914 nvarchar(4000),@p915 nvarchar(4000),@p916 nvarchar(4000),@p917 decimal(18,2),@p918 nvarchar(4000),@p919 nvarchar(4000),@p920 decimal(18,2),@p921 nvarchar(4000),@p922 nvarchar(4000),@p923 nvarchar(4000),@p924 nvarchar(4000),@p925 int,@p926 nvarchar(4000),@p927 nvarchar(4000),@p928 nvarchar(4000),@p929 nvarchar(4000),@p930 nvarchar(4000),@p931 nvarchar(4000),@p932 nvarchar(4000),@p933 nvarchar(4000),@p934 nvarchar(4000),@p935 nvarchar(4000),@p936 int,@p937 nvarchar(4000),@p938 nvarchar(4000),@p939 nvarchar(4000),@p940 nvarchar(4000),@p941 nvarchar(4000),@p942 int,@p943 nvarchar(4000),@p944 int,@p945 int,@p946 datetime2(7),@p947 datetime2(7),@p948 datetime2(7),@p949 nvarchar(4000),@p950 nvarchar(4000),@p951 nvarchar(4000),@p952 nvarchar(4000),@p953 nvarchar(4000),@p954 nvarchar(4000),@p955 nvarchar(4000),@p956 nvarchar(4000),@p957 nvarchar(4000),@p958 nvarchar(4000),@p959 nvarchar(4000),@p960 nvarchar(4000),@p961 nvarchar(4000),@p962 nvarchar(4000),@p963 datetime2(7),@p964 nvarchar(4000),@p965 nvarchar(4000),@p966 int,@p967 int,@p968 int,@p969 nvarchar(4000),@p970 nvarchar(4000),@p971 nvarchar(4000),@p972 nvarchar(4000),@p973 decimal(18,2),@p974 nvarchar(4000),@p975 nvarchar(4000),@p976 decimal(18,2),@p977 nvarchar(4000),@p978 nvarchar(4000),@p979 nvarchar(4000),@p980 nvarchar(4000),@p981 int,@p982 nvarchar(4000),@p983 nvarchar(4000),@p984 nvarchar(4000),@p985 nvarchar(4000),@p986 nvarchar(4000),@p987 nvarchar(4000),@p988 nvarchar(4000),@p989 nvarchar(4000),@p990 nvarchar(4000),@p991 nvarchar(4000),@p992 int,@p993 nvarchar(4000),@p994 nvarchar(4000),@p995 nvarchar(4000),@p996 nvarchar(4000),@p997 nvarchar(4000),@p998 int,@p999 nvarchar(4000),@p1000 int,@p1001 int,@p1002 datetime2(7),@p1003 datetime2(7),@p1004 datetime2(7),@p1005 nvarchar(4000),@p1006 nvarchar(4000),@p1007 nvarchar(4000),@p1008 nvarchar(4000),@p1009 nvarchar(4000),@p1010 nvarchar(4000),@p1011 nvarchar(4000),@p1012 nvarchar(4000),@p1013 nvarchar(4000),@p1014 nvarchar(4000),@p1015 nvarchar(4000),@p1016 nvarchar(4000),@p1017 nvarchar(4000),@p1018 nvarchar(4000),@p1019 datetime2(7),@p1020 nvarchar(4000),@p1021 nvarchar(4000),@p1022 int,@p1023 int,@p1024 int,@p1025 nvarchar(4000),@p1026 nvarchar(4000),@p1027 nvarchar(4000),@p1028 nvarchar(4000),@p1029 decimal(18,2),@p1030 nvarchar(4000),@p1031 nvarchar(4000),@p1032 decimal(18,2),@p1033 nvarchar(4000),@p1034 nvarchar(4000),@p1035 nvarchar(4000),@p1036 nvarchar(4000),@p1037 int,@p1038 nvarchar(4000),@p1039 nvarchar(4000),@p1040 nvarchar(4000),@p1041 nvarchar(4000),@p1042 nvarchar(4000),@p1043 nvarchar(4000),@p1044 nvarchar(4000),@p1045 nvarchar(4000),@p1046 nvarchar(4000),@p1047 nvarchar(4000),@p1048 int,@p1049 nvarchar(4000),@p1050 nvarchar(4000),@p1051 nvarchar(4000),@p1052 nvarchar(4000),@p1053 nvarchar(4000),@p1054 int,@p1055 nvarchar(4000),@p1056 int,@p1057 int,@p1058 datetime2(7),@p1059 datetime2(7),@p1060 datetime2(7),@p1061 nvarchar(4000),@p1062 nvarchar(4000),@p1063 nvarchar(4000),@p1064 nvarchar(4000),@p1065 nvarchar(4000),@p1066 nvarchar(4000),@p1067 nvarchar(4000),@p1068 nvarchar(4000),@p1069 nvarchar(4000),@p1070 nvarchar(4000),@p1071 nvarchar(4000),@p1072 nvarchar(4000),@p1073 nvarchar(4000),@p1074 nvarchar(4000),@p1075 datetime2(7),@p1076 nvarchar(4000),@p1077 nvarchar(4000),@p1078 int,@p1079 int,@p1080 int,@p1081 nvarchar(4000),@p1082 nvarchar(4000),@p1083 nvarchar(4000),@p1084 nvarchar(4000),@p1085 decimal(18,2),@p1086 nvarchar(4000),@p1087 nvarchar(4000),@p1088 decimal(18,2),@p1089 nvarchar(4000),@p1090 nvarchar(4000),@p1091 nvarchar(4000),@p1092 nvarchar(4000),@p1093 int,@p1094 nvarchar(4000),@p1095 nvarchar(4000),@p1096 nvarchar(4000),@p1097 nvarchar(4000),@p1098 nvarchar(4000),@p1099 nvarchar(4000),@p1100 nvarchar(4000),@p1101 nvarchar(4000),@p1102 nvarchar(4000),@p1103 nvarchar(4000),@p1104 int,@p1105 nvarchar(4000),@p1106 nvarchar(4000),@p1107 nvarchar(4000),@p1108 nvarchar(4000),@p1109 nvarchar(4000),@p1110 int,@p1111 nvarchar(4000),@p1112 int,@p1113 int,@p1114 datetime2(7),@p1115 datetime2(7),@p1116 datetime2(7),@p1117 nvarchar(4000),@p1118 nvarchar(4000),@p1119 nvarchar(4000),@p1120 nvarchar(4000),@p1121 nvarchar(4000),@p1122 nvarchar(4000),@p1123 nvarchar(4000),@p1124 nvarchar(4000),@p1125 nvarchar(4000),@p1126 nvarchar(4000),@p1127 nvarchar(4000),@p1128 nvarchar(4000),@p1129 nvarchar(4000),@p1130 nvarchar(4000),@p1131 datetime2(7),@p1132 nvarchar(4000),@p1133 nvarchar(4000),@p1134 int,@p1135 int,@p1136 int,@p1137 nvarchar(4000),@p1138 nvarchar(4000),@p1139 nvarchar(4000),@p1140 nvarchar(4000),@p1141 decimal(18,2),@p1142 nvarchar(4000),@p1143 nvarchar(4000),@p1144 decimal(18,2),@p1145 nvarchar(4000),@p1146 nvarchar(4000),@p1147 nvarchar(4000),@p1148 nvarchar(4000),@p1149 int,@p1150 nvarchar(4000),@p1151 nvarchar(4000),@p1152 nvarchar(4000),@p1153 nvarchar(4000),@p1154 nvarchar(4000),@p1155 nvarchar(4000),@p1156 nvarchar(4000),@p1157 nvarchar(4000),@p1158 nvarchar(4000),@p1159 nvarchar(4000),@p1160 int,@p1161 nvarchar(4000),@p1162 nvarchar(4000),@p1163 nvarchar(4000),@p1164 nvarchar(4000),@p1165 nvarchar(4000),@p1166 int,@p1167 nvarchar(4000),@p1168 int,@p1169 int,@p1170 datetime2(7),@p1171 datetime2(7),@p1172 datetime2(7),@p1173 nvarchar(4000),@p1174 nvarchar(4000),@p1175 nvarchar(4000),@p1176 nvarchar(4000),@p1177 nvarchar(4000),@p1178 nvarchar(4000),@p1179 nvarchar(4000),@p1180 nvarchar(4000),@p1181 nvarchar(4000),@p1182 nvarchar(4000),@p1183 nvarchar(4000),@p1184 nvarchar(4000),@p1185 nvarchar(4000),@p1186 nvarchar(4000),@p1187 datetime2(7),@p1188 nvarchar(4000),@p1189 nvarchar(4000),@p1190 int,@p1191 int,@p1192 int,@p1193 nvarchar(4000),@p1194 nvarchar(4000),@p1195 nvarchar(4000),@p1196 nvarchar(4000),@p1197 decimal(18,2),@p1198 nvarchar(4000),@p1199 nvarchar(4000),@p1200 decimal(18,2),@p1201 nvarchar(4000),@p1202 nvarchar(4000),@p1203 nvarchar(4000),@p1204 nvarchar(4000),@p1205 int,@p1206 nvarchar(4000),@p1207 nvarchar(4000),@p1208 nvarchar(4000),@p1209 nvarchar(4000),@p1210 nvarchar(4000),@p1211 nvarchar(4000),@p1212 nvarchar(4000),@p1213 nvarchar(4000),@p1214 nvarchar(4000),@p1215 nvarchar(4000),@p1216 int,@p1217 nvarchar(4000),@p1218 nvarchar(4000),@p1219 nvarchar(4000),@p1220 nvarchar(4000),@p1221 nvarchar(4000),@p1222 int,@p1223 nvarchar(4000),@p1224 int,@p1225 int,@p1226 datetime2(7),@p1227 datetime2(7),@p1228 datetime2(7),@p1229 nvarchar(4000),@p1230 nvarchar(4000),@p1231 nvarchar(4000),@p1232 nvarchar(4000),@p1233 nvarchar(4000),@p1234 nvarchar(4000),@p1235 nvarchar(4000),@p1236 nvarchar(4000),@p1237 nvarchar(4000),@p1238 nvarchar(4000),@p1239 nvarchar(4000),@p1240 nvarchar(4000),@p1241 nvarchar(4000),@p1242 nvarchar(4000),@p1243 datetime2(7),@p1244 nvarchar(4000),@p1245 nvarchar(4000),@p1246 int,@p1247 int,@p1248 int,@p1249 nvarchar(4000),@p1250 nvarchar(4000),@p1251 nvarchar(4000),@p1252 nvarchar(4000),@p1253 decimal(18,2),@p1254 nvarchar(4000),@p1255 nvarchar(4000),@p1256 decimal(18,2),@p1257 nvarchar(4000),@p1258 nvarchar(4000),@p1259 nvarchar(4000),@p1260 nvarchar(4000),@p1261 int,@p1262 nvarchar(4000),@p1263 nvarchar(4000),@p1264 nvarchar(4000),@p1265 nvarchar(4000),@p1266 nvarchar(4000),@p1267 nvarchar(4000),@p1268 nvarchar(4000),@p1269 nvarchar(4000),@p1270 nvarchar(4000),@p1271 nvarchar(4000),@p1272 int,@p1273 nvarchar(4000),@p1274 nvarchar(4000),@p1275 nvarchar(4000),@p1276 nvarchar(4000),@p1277 nvarchar(4000),@p1278 int,@p1279 nvarchar(4000),@p1280 int,@p1281 int,@p1282 datetime2(7),@p1283 datetime2(7),@p1284 datetime2(7),@p1285 nvarchar(4000),@p1286 nvarchar(4000),@p1287 nvarchar(4000),@p1288 nvarchar(4000),@p1289 nvarchar(4000),@p1290 nvarchar(4000),@p1291 nvarchar(4000),@p1292 nvarchar(4000),@p1293 nvarchar(4000),@p1294 nvarchar(4000),@p1295 nvarchar(4000),@p1296 nvarchar(4000),@p1297 nvarchar(4000),@p1298 nvarchar(4000),@p1299 datetime2(7),@p1300 nvarchar(4000),@p1301 nvarchar(4000),@p1302 int,@p1303 int,@p1304 int,@p1305 nvarchar(4000),@p1306 nvarchar(4000),@p1307 nvarchar(4000),@p1308 nvarchar(4000),@p1309 decimal(18,2),@p1310 nvarchar(4000),@p1311 nvarchar(4000),@p1312 decimal(18,2),@p1313 nvarchar(4000),@p1314 nvarchar(4000),@p1315 nvarchar(4000),@p1316 nvarchar(4000),@p1317 int,@p1318 nvarchar(4000),@p1319 nvarchar(4000),@p1320 nvarchar(4000),@p1321 nvarchar(4000),@p1322 nvarchar(4000),@p1323 nvarchar(4000),@p1324 nvarchar(4000),@p1325 nvarchar(4000),@p1326 nvarchar(4000),@p1327 nvarchar(4000),@p1328 int,@p1329 nvarchar(4000),@p1330 nvarchar(4000),@p1331 nvarchar(4000),@p1332 nvarchar(4000),@p1333 nvarchar(4000),@p1334 int,@p1335 nvarchar(4000),@p1336 int,@p1337 int,@p1338 datetime2(7),@p1339 datetime2(7),@p1340 datetime2(7),@p1341 nvarchar(4000),@p1342 nvarchar(4000),@p1343 nvarchar(4000),@p1344 nvarchar(4000),@p1345 nvarchar(4000),@p1346 nvarchar(4000),@p1347 nvarchar(4000),@p1348 nvarchar(4000),@p1349 nvarchar(4000),@p1350 nvarchar(4000),@p1351 nvarchar(4000),@p1352 nvarchar(4000),@p1353 nvarchar(4000),@p1354 nvarchar(4000),@p1355 datetime2(7),@p1356 nvarchar(4000),@p1357 nvarchar(4000),@p1358 int,@p1359 int,@p1360 int,@p1361 nvarchar(4000),@p1362 nvarchar(4000),@p1363 nvarchar(4000),@p1364 decimal(18,2),@p1365 decimal(18,2),@p1366 nvarchar(4000),@p1367 nvarchar(4000),@p1368 decimal(18,2),@p1369 nvarchar(4000),@p1370 nvarchar(4000),@p1371 nvarchar(4000),@p1372 nvarchar(4000),@p1373 int,@p1374 nvarchar(4000),@p1375 nvarchar(4000),@p1376 nvarchar(4000),@p1377 nvarchar(4000),@p1378 nvarchar(4000),@p1379 nvarchar(4000),@p1380 nvarchar(4000),@p1381 nvarchar(4000),@p1382 nvarchar(4000),@p1383 nvarchar(4000),@p1384 int,@p1385 nvarchar(4000),@p1386 nvarchar(4000),@p1387 nvarchar(4000),@p1388 nvarchar(4000),@p1389 nvarchar(4000),@p1390 int,@p1391 nvarchar(4000),@p1392 int,@p1393 int,@p1394 datetime2(7),@p1395 datetime2(7),@p1396 datetime2(7),@p1397 nvarchar(4000),@p1398 nvarchar(4000),@p1399 nvarchar(4000),@p1400 nvarchar(4000),@p1401 nvarchar(4000),@p1402 nvarchar(4000),@p1403 nvarchar(4000),@p1404 nvarchar(4000),@p1405 nvarchar(4000),@p1406 nvarchar(4000),@p1407 nvarchar(4000),@p1408 nvarchar(4000),@p1409 nvarchar(4000),@p1410 nvarchar(4000),@p1411 datetime2(7),@p1412 nvarchar(4000),@p1413 nvarchar(4000),@p1414 int,@p1415 int,@p1416 int,@p1417 nvarchar(4000),@p1418 nvarchar(4000),@p1419 nvarchar(4000),@p1420 nvarchar(4000),@p1421 decimal(18,2),@p1422 nvarchar(4000),@p1423 nvarchar(4000),@p1424 decimal(18,2),@p1425 nvarchar(4000),@p1426 nvarchar(4000),@p1427 nvarchar(4000),@p1428 nvarchar(4000),@p1429 int,@p1430 nvarchar(4000),@p1431 nvarchar(4000),@p1432 nvarchar(4000),@p1433 nvarchar(4000),@p1434 nvarchar(4000),@p1435 nvarchar(4000),@p1436 nvarchar(4000),@p1437 nvarchar(4000),@p1438 nvarchar(4000),@p1439 nvarchar(4000),@p1440 int,@p1441 nvarchar(4000),@p1442 nvarchar(4000),@p1443 nvarchar(4000),@p1444 nvarchar(4000),@p1445 nvarchar(4000),@p1446 int,@p1447 nvarchar(4000),@p1448 int,@p1449 int,@p1450 datetime2(7),@p1451 datetime2(7),@p1452 datetime2(7),@p1453 nvarchar(4000),@p1454 nvarchar(4000),@p1455 nvarchar(4000),@p1456 nvarchar(4000),@p1457 nvarchar(4000),@p1458 nvarchar(4000),@p1459 nvarchar(4000),@p1460 nvarchar(4000),@p1461 nvarchar(4000),@p1462 nvarchar(4000),@p1463 nvarchar(4000),@p1464 nvarchar(4000),@p1465 nvarchar(4000),@p1466 nvarchar(4000),@p1467 datetime2(7),@p1468 nvarchar(4000),@p1469 nvarchar(4000),@p1470 int,@p1471 int,@p1472 int,@p1473 nvarchar(4000),@p1474 nvarchar(4000),@p1475 nvarchar(4000),@p1476 decimal(18,2),@p1477 decimal(18,2),@p1478 nvarchar(4000),@p1479 nvarchar(4000),@p1480 decimal(18,2),@p1481 nvarchar(4000),@p1482 nvarchar(4000),@p1483 nvarchar(4000),@p1484 nvarchar(4000),@p1485 int,@p1486 nvarchar(4000),@p1487 nvarchar(4000),@p1488 nvarchar(4000),@p1489 nvarchar(4000),@p1490 nvarchar(4000),@p1491 nvarchar(4000),@p1492 nvarchar(4000),@p1493 nvarchar(4000),@p1494 nvarchar(4000),@p1495 nvarchar(4000),@p1496 int,@p1497 nvarchar(4000),@p1498 nvarchar(4000),@p1499 nvarchar(4000),@p1500 nvarchar(4000),@p1501 nvarchar(4000),@p1502 int,@p1503 nvarchar(4000),@p1504 int,@p1505 int,@p1506 datetime2(7),@p1507 datetime2(7),@p1508 datetime2(7),@p1509 nvarchar(4000),@p1510 nvarchar(4000),@p1511 nvarchar(4000),@p1512 nvarchar(4000),@p1513 nvarchar(4000),@p1514 nvarchar(4000),@p1515 nvarchar(4000),@p1516 nvarchar(4000),@p1517 nvarchar(4000),@p1518 nvarchar(4000),@p1519 nvarchar(4000),@p1520 nvarchar(4000),@p1521 nvarchar(4000),@p1522 nvarchar(4000),@p1523 datetime2(7),@p1524 nvarchar(4000),@p1525 nvarchar(4000),@p1526 int,@p1527 int,@p1528 int,@p1529 nvarchar(4000),@p1530 nvarchar(4000),@p1531 nvarchar(4000),@p1532 nvarchar(4000),@p1533 decimal(18,2),@p1534 nvarchar(4000),@p1535 nvarchar(4000),@p1536 decimal(18,2),@p1537 nvarchar(4000),@p1538 nvarchar(4000),@p1539 nvarchar(4000),@p1540 nvarchar(4000),@p1541 int,@p1542 nvarchar(4000),@p1543 nvarchar(4000),@p1544 nvarchar(4000),@p1545 nvarchar(4000),@p1546 nvarchar(4000),@p1547 nvarchar(4000),@p1548 nvarchar(4000),@p1549 nvarchar(4000),@p1550 nvarchar(4000),@p1551 nvarchar(4000),@p1552 int,@p1553 nvarchar(4000),@p1554 nvarchar(4000),@p1555 nvarchar(4000),@p1556 nvarchar(4000),@p1557 nvarchar(4000),@p1558 int,@p1559 nvarchar(4000),@p1560 int,@p1561 int,@p1562 datetime2(7),@p1563 datetime2(7),@p1564 datetime2(7),@p1565 nvarchar(4000),@p1566 nvarchar(4000),@p1567 nvarchar(4000),@p1568 nvarchar(4000),@p1569 nvarchar(4000),@p1570 nvarchar(4000),@p1571 nvarchar(4000),@p1572 nvarchar(4000),@p1573 nvarchar(4000),@p1574 nvarchar(4000),@p1575 nvarchar(4000),@p1576 nvarchar(4000),@p1577 nvarchar(4000),@p1578 nvarchar(4000),@p1579 datetime2(7),@p1580 nvarchar(4000),@p1581 nvarchar(4000),@p1582 int,@p1583 int,@p1584 int,@p1585 nvarchar(4000),@p1586 nvarchar(4000),@p1587 nvarchar(4000),@p1588 decimal(18,2),@p1589 decimal(18,2),@p1590 nvarchar(4000),@p1591 nvarchar(4000),@p1592 decimal(18,2),@p1593 nvarchar(4000),@p1594 nvarchar(4000),@p1595 nvarchar(4000),@p1596 nvarchar(4000),@p1597 int,@p1598 nvarchar(4000),@p1599 nvarchar(4000),@p1600 nvarchar(4000),@p1601 nvarchar(4000),@p1602 nvarchar(4000),@p1603 nvarchar(4000),@p1604 nvarchar(4000),@p1605 nvarchar(4000),@p1606 nvarchar(4000),@p1607 nvarchar(4000),@p1608 int,@p1609 nvarchar(4000),@p1610 nvarchar(4000),@p1611 nvarchar(4000),@p1612 nvarchar(4000),@p1613 nvarchar(4000),@p1614 int,@p1615 nvarchar(4000),@p1616 int,@p1617 int,@p1618 datetime2(7),@p1619 datetime2(7),@p1620 datetime2(7),@p1621 nvarchar(4000),@p1622 nvarchar(4000),@p1623 nvarchar(4000),@p1624 nvarchar(4000),@p1625 nvarchar(4000),@p1626 nvarchar(4000),@p1627 nvarchar(4000),@p1628 nvarchar(4000),@p1629 nvarchar(4000),@p1630 nvarchar(4000),@p1631 nvarchar(4000),@p1632 nvarchar(4000),@p1633 nvarchar(4000),@p1634 nvarchar(4000),@p1635 datetime2(7),@p1636 nvarchar(4000),@p1637 nvarchar(4000),@p1638 int,@p1639 int,@p1640 int,@p1641 nvarchar(4000),@p1642 nvarchar(4000),@p1643 nvarchar(4000),@p1644 nvarchar(4000),@p1645 decimal(18,2),@p1646 nvarchar(4000),@p1647 nvarchar(4000),@p1648 decimal(18,2),@p1649 nvarchar(4000),@p1650 nvarchar(4000),@p1651 nvarchar(4000),@p1652 nvarchar(4000),@p1653 int,@p1654 nvarchar(4000),@p1655 nvarchar(4000),@p1656 nvarchar(4000),@p1657 nvarchar(4000),@p1658 nvarchar(4000),@p1659 nvarchar(4000),@p1660 nvarchar(4000),@p1661 nvarchar(4000),@p1662 nvarchar(4000),@p1663 nvarchar(4000),@p1664 int,@p1665 nvarchar(4000),@p1666 nvarchar(4000),@p1667 nvarchar(4000),@p1668 nvarchar(4000),@p1669 nvarchar(4000),@p1670 int,@p1671 nvarchar(4000),@p1672 int,@p1673 int,@p1674 datetime2(7),@p1675 datetime2(7),@p1676 datetime2(7),@p1677 nvarchar(4000),@p1678 nvarchar(4000),@p1679 nvarchar(4000),@p1680 nvarchar(4000),@p1681 nvarchar(4000),@p1682 nvarchar(4000),@p1683 nvarchar(4000),@p1684 nvarchar(4000),@p1685 nvarchar(4000),@p1686 nvarchar(4000),@p1687 nvarchar(4000),@p1688 nvarchar(4000),@p1689 nvarchar(4000),@p1690 nvarchar(4000),@p1691 datetime2(7),@p1692 nvarchar(4000),@p1693 nvarchar(4000),@p1694 int,@p1695 int,@p1696 int,@p1697 nvarchar(4000),@p1698 nvarchar(4000),@p1699 nvarchar(4000),@p1700 nvarchar(4000),@p1701 decimal(18,2),@p1702 nvarchar(4000),@p1703 nvarchar(4000),@p1704 decimal(18,2),@p1705 nvarchar(4000),@p1706 nvarchar(4000),@p1707 nvarchar(4000),@p1708 nvarchar(4000),@p1709 int,@p1710 nvarchar(4000),@p1711 nvarchar(4000),@p1712 nvarchar(4000),@p1713 nvarchar(4000),@p1714 nvarchar(4000),@p1715 nvarchar(4000),@p1716 nvarchar(4000),@p1717 nvarchar(4000),@p1718 nvarchar(4000),@p1719 nvarchar(4000),@p1720 int,@p1721 nvarchar(4000),@p1722 nvarchar(4000),@p1723 nvarchar(4000),@p1724 nvarchar(4000),@p1725 nvarchar(4000),@p1726 int,@p1727 nvarchar(4000),@p1728 int,@p1729 int,@p1730 datetime2(7),@p1731 datetime2(7),@p1732 datetime2(7),@p1733 nvarchar(4000),@p1734 nvarchar(4000),@p1735 nvarchar(4000),@p1736 nvarchar(4000),@p1737 nvarchar(4000),@p1738 nvarchar(4000),@p1739 nvarchar(4000),@p1740 nvarchar(4000),@p1741 nvarchar(4000),@p1742 nvarchar(4000),@p1743 nvarchar(4000),@p1744 nvarchar(4000),@p1745 nvarchar(4000),@p1746 nvarchar(4000),@p1747 datetime2(7),@p1748 nvarchar(4000),@p1749 nvarchar(4000),@p1750 int,@p1751 int,@p1752 int,@p1753 nvarchar(4000),@p1754 nvarchar(4000),@p1755 nvarchar(4000),@p1756 decimal(18,2),@p1757 decimal(18,2),@p1758 nvarchar(4000),@p1759 nvarchar(4000),@p1760 decimal(18,2),@p1761 nvarchar(4000),@p1762 nvarchar(4000),@p1763 nvarchar(4000),@p1764 nvarchar(4000),@p1765 int,@p1766 nvarchar(4000),@p1767 nvarchar(4000),@p1768 nvarchar(4000),@p1769 nvarchar(4000),@p1770 nvarchar(4000),@p1771 nvarchar(4000),@p1772 nvarchar(4000),@p1773 nvarchar(4000),@p1774 nvarchar(4000),@p1775 nvarchar(4000),@p1776 int,@p1777 nvarchar(4000),@p1778 nvarchar(4000),@p1779 nvarchar(4000),@p1780 nvarchar(4000),@p1781 nvarchar(4000),@p1782 int,@p1783 nvarchar(4000),@p1784 int,@p1785 int,@p1786 datetime2(7),@p1787 datetime2(7),@p1788 datetime2(7),@p1789 nvarchar(4000),@p1790 nvarchar(4000),@p1791 nvarchar(4000),@p1792 nvarchar(4000),@p1793 nvarchar(4000),@p1794 nvarchar(4000),@p1795 nvarchar(4000),@p1796 nvarchar(4000),@p1797 nvarchar(4000),@p1798 nvarchar(4000),@p1799 nvarchar(4000),@p1800 nvarchar(4000),@p1801 nvarchar(4000),@p1802 nvarchar(4000),@p1803 datetime2(7),@p1804 nvarchar(4000),@p1805 nvarchar(4000),@p1806 int,@p1807 int,@p1808 int,@p1809 nvarchar(4000),@p1810 nvarchar(4000),@p1811 nvarchar(4000),@p1812 nvarchar(4000),@p1813 decimal(18,2),@p1814 nvarchar(4000),@p1815 nvarchar(4000),@p1816 decimal(18,2),@p1817 nvarchar(4000),@p1818 nvarchar(4000),@p1819 nvarchar(4000),@p1820 nvarchar(4000),@p1821 int,@p1822 nvarchar(4000),@p1823 nvarchar(4000),@p1824 nvarchar(4000),@p1825 nvarchar(4000),@p1826 nvarchar(4000),@p1827 nvarchar(4000),@p1828 nvarchar(4000),@p1829 nvarchar(4000),@p1830 nvarchar(4000),@p1831 nvarchar(4000),@p1832 int,@p1833 nvarchar(4000),@p1834 nvarchar(4000),@p1835 nvarchar(4000),@p1836 nvarchar(4000),@p1837 nvarchar(4000),@p1838 int,@p1839 nvarchar(4000),@p1840 int,@p1841 int,@p1842 datetime2(7),@p1843 datetime2(7),@p1844 datetime2(7),@p1845 nvarchar(4000),@p1846 nvarchar(4000),@p1847 nvarchar(4000),@p1848 nvarchar(4000),@p1849 nvarchar(4000),@p1850 nvarchar(4000),@p1851 nvarchar(4000),@p1852 nvarchar(4000),@p1853 nvarchar(4000),@p1854 nvarchar(4000),@p1855 nvarchar(4000),@p1856 nvarchar(4000),@p1857 nvarchar(4000),@p1858 nvarchar(4000),@p1859 datetime2(7),@p1860 nvarchar(4000),@p1861 nvarchar(4000),@p1862 int,@p1863 int,@p1864 int,@p1865 nvarchar(4000),@p1866 nvarchar(4000),@p1867 nvarchar(4000),@p1868 decimal(18,2),@p1869 decimal(18,2),@p1870 nvarchar(4000),@p1871 nvarchar(4000),@p1872 decimal(18,2),@p1873 nvarchar(4000),@p1874 nvarchar(4000),@p1875 nvarchar(4000),@p1876 nvarchar(4000),@p1877 int,@p1878 nvarchar(4000),@p1879 nvarchar(4000),@p1880 nvarchar(4000),@p1881 nvarchar(4000),@p1882 nvarchar(4000),@p1883 nvarchar(4000),@p1884 nvarchar(4000),@p1885 nvarchar(4000),@p1886 nvarchar(4000),@p1887 nvarchar(4000),@p1888 int,@p1889 nvarchar(4000),@p1890 nvarchar(4000),@p1891 nvarchar(4000),@p1892 nvarchar(4000),@p1893 nvarchar(4000),@p1894 int,@p1895 nvarchar(4000),@p1896 int,@p1897 int,@p1898 datetime2(7),@p1899 datetime2(7),@p1900 datetime2(7),@p1901 nvarchar(4000),@p1902 nvarchar(4000),@p1903 nvarchar(4000),@p1904 nvarchar(4000),@p1905 nvarchar(4000),@p1906 nvarchar(4000),@p1907 nvarchar(4000),@p1908 nvarchar(4000),@p1909 nvarchar(4000),@p1910 nvarchar(4000),@p1911 nvarchar(4000),@p1912 nvarchar(4000),@p1913 nvarchar(4000),@p1914 nvarchar(4000),@p1915 datetime2(7),@p1916 nvarchar(4000),@p1917 nvarchar(4000),@p1918 int,@p1919 int,@p1920 int,@p1921 nvarchar(4000),@p1922 nvarchar(4000),@p1923 nvarchar(4000),@p1924 nvarchar(4000),@p1925 decimal(18,2),@p1926 nvarchar(4000),@p1927 nvarchar(4000),@p1928 decimal(18,2),@p1929 nvarchar(4000),@p1930 nvarchar(4000),@p1931 nvarchar(4000),@p1932 nvarchar(4000),@p1933 int,@p1934 nvarchar(4000),@p1935 nvarchar(4000),@p1936 nvarchar(4000),@p1937 nvarchar(4000),@p1938 nvarchar(4000),@p1939 nvarchar(4000),@p1940 nvarchar(4000),@p1941 nvarchar(4000),@p1942 nvarchar(4000),@p1943 nvarchar(4000),@p1944 int,@p1945 nvarchar(4000),@p1946 nvarchar(4000),@p1947 nvarchar(4000),@p1948 nvarchar(4000),@p1949 nvarchar(4000),@p1950 int,@p1951 nvarchar(4000),@p1952 int,@p1953 int,@p1954 datetime2(7),@p1955 datetime2(7),@p1956 datetime2(7),@p1957 nvarchar(4000),@p1958 nvarchar(4000),@p1959 nvarchar(4000),@p1960 nvarchar(4000),@p1961 nvarchar(4000),@p1962 nvarchar(4000),@p1963 nvarchar(4000),@p1964 nvarchar(4000),@p1965 nvarchar(4000),@p1966 nvarchar(4000),@p1967 nvarchar(4000),@p1968 nvarchar(4000),@p1969 nvarchar(4000),@p1970 nvarchar(4000),@p1971 datetime2(7),@p1972 nvarchar(4000),@p1973 nvarchar(4000),@p1974 int,@p1975 int,@p1976 int,@p1977 nvarchar(4000),@p1978 nvarchar(4000),@p1979 nvarchar(4000),@p1980 nvarchar(4000),@p1981 decimal(18,2),@p1982 nvarchar(4000),@p1983 nvarchar(4000),@p1984 decimal(18,2),@p1985 nvarchar(4000),@p1986 nvarchar(4000),@p1987 nvarchar(4000),@p1988 nvarchar(4000),@p1989 int,@p1990 nvarchar(4000),@p1991 nvarchar(4000),@p1992 nvarchar(4000),@p1993 nvarchar(4000),@p1994 nvarchar(4000),@p1995 nvarchar(4000),@p1996 nvarchar(4000),@p1997 nvarchar(4000),@p1998 nvarchar(4000),@p1999 nvarchar(4000),@p2000 int,@p2001 nvarchar(4000),@p2002 nvarchar(4000),@p2003 nvarchar(4000),@p2004 nvarchar(4000),@p2005 nvarchar(4000),@p2006 int,@p2007 nvarchar(4000),@p2008 int,@p2009 int,@p2010 datetime2(7),@p2011 datetime2(7),@p2012 datetime2(7),@p2013 nvarchar(4000),@p2014 nvarchar(4000),@p2015 nvarchar(4000),@p2016 nvarchar(4000),@p2017 nvarchar(4000),@p2018 nvarchar(4000),@p2019 nvarchar(4000),@p2020 nvarchar(4000),@p2021 nvarchar(4000),@p2022 nvarchar(4000),@p2023 nvarchar(4000),@p2024 nvarchar(4000),@p2025 nvarchar(4000),@p2026 nvarchar(4000),@p2027 datetime2(7),@p2028 nvarchar(4000),@p2029 nvarchar(4000),@p2030 int,@p2031 int,@p2032 int,@p2033 nvarchar(4000),@p2034 nvarchar(4000),@p2035 nvarchar(4000),@p2036 nvarchar(4000),@p2037 decimal(18,2),@p2038 nvarchar(4000),@p2039 nvarchar(4000),@p2040 decimal(18,2),@p2041 nvarchar(4000),@p2042 nvarchar(4000),@p2043 nvarchar(4000),@p2044 nvarchar(4000),@p2045 int,@p2046 nvarchar(4000),@p2047 nvarchar(4000),@p2048 nvarchar(4000),@p2049 nvarchar(4000),@p2050 nvarchar(4000),@p2051 nvarchar(4000),@p2052 nvarchar(4000),@p2053 nvarchar(4000),@p2054 nvarchar(4000),@p2055 nvarchar(4000),@p2056 int,@p2057 nvarchar(4000),@p2058 nvarchar(4000),@p2059 nvarchar(4000),@p2060 nvarchar(4000),@p2061 nvarchar(4000),@p2062 int,@p2063 nvarchar(4000),@p2064 int,@p2065 int,@p2066 datetime2(7),@p2067 datetime2(7),@p2068 datetime2(7),@p2069 nvarchar(4000),@p2070 nvarchar(4000),@p2071 nvarchar(4000))SET NOCOUNT ON; DECLARE @inserted0 TABLE ([item_id] int, [_Position] [int]); MERGE [raw_data] USING ( VALUES (@p0, @p1, @p2, @p3, @p4, @p5, @p6, @p7, @p8, @p9, @p10, @p11, @p12, @p13, @p14, @p15, @p16, @p17, @p18, @p19, @p20, @p21, @p22, @p23, @p24, @p25, @p26, @p27, @p28, @p29, @p30, @p31, @p32, @p33, @p34, @p35, @p36, @p37, @p38, @p39, @p40, @p41, @p42, @p43, @p44, @p45, @p46, @p47, @p48, @p49, @p50, @p51, @p52, @p53, @p54, @p55, 0), (@p56, @p57, @p58, @p59, @p60, @p61, @p62, @p63, @p64, @p65, @p66, @p67, @p68, @p69, @p70, @p71, @p72, @p73, @p74, @p75, @p76, @p77, @p78, @p79, @p80, @p81, @p82, @p83, @p84, @p85, @p86, @p87, @p88, @p89, @p90, @p91, @p92, @p93, @p94, @p95, @p96, @p97, @p98, @p99, @p100, @p101, @p102, @p103, @p104, @p105, @p106, @p107, @p108, @p109, @p110, @p111, 1), (@p112, @p113, @p114, @p115, @p116, @p117, @p118, @p119, @p120, @p121, @p122, @p123, @p124, @p125, @p126, @p127, @p128, @p129, @p130, @p131, @p132, @p133, @p134, @p135, @p136, @p137, @p138, @p139, @p140, @p141, @p142, @p143, @p144, @p145, @p146, @p147, @p148, @p149, @p150, @p151, @p152, @p153, @p154, @p155, @p156, @p157, @p158, @p159, @p160, @p161, @p162, @p163, @p164, @p165, @p166, @p167, 2), (@p168, @p169, @p170, @p171, @p172, @p173, @p174, @p175, @p176, @p177, @p178, @p179, @p180, @p181, @p182, @p183, @p184, @p185, @p186, @p187, @p188, @p189, @p190, @p191, @p192, @p193, @p194, @p195, @p196, @p197, @p198, @p199, @p200, @p201, @p202, @p203, @p204, @p205, @p206, @p207, @p208, @p209, @p210, @p211, @p212, @p213, @p214, @p215, @p216, @p217, @p218, @p219, @p220, @p221, @p222, @p223, 3), (@p224, @p225, @p226, @p227, @p228, @p229, @p230, @p231, @p232, @p233, @p234, @p235, @p236, @p237, @p238, @p239, @p240, @p241, @p242, @p243, @p244, @p245, @p246, @p247, @p248, @p249, @p250, @p251, @p252, @p253, @p254, @p255, @p256, @p257, @p258, @p259, @p260, @p261, @p262, @p263, @p264, @p265, @p266, @p267, @p268, @p269, @p270, @p271, @p272, @p273, @p274, @p275, @p276, @p277, @p278, @p279, 4), (@p280, @p281, @p282, @p283, @p284, @p285, @p286, @p287, @p288, @p289, @p290, @p291, @p292, @p293, @p294, @p295, @p296, @p297, @p298, @p299, @p300, @p301, @p302, @p303, @p304, @p305, @p306, @p307, @p308, @p309, @p310, @p311, @p312, @p313, @p314, @p315, @p316, @p317, @p318, @p319, @p320, @p321, @p322, @p323, @p324, @p325, @p326, @p327, @p328, @p329, @p330, @p331, @p332, @p333, @p334, @p335, 5), (@p336, @p337, @p338, @p339, @p340, @p341, @p342, @p343, @p344, @p345, @p346, @p347, @p348, @p349, @p350, @p351, @p352, @p353, @p354, @p355, @p356, @p357, @p358, @p359, @p360, @p361, @p362, @p363, @p364, @p365, @p366, @p367, @p368, @p369, @p370, @p371, @p372, @p373, @p374, @p375, @p376, @p377, @p378, @p379, @p380, @p381, @p382, @p383, @p384, @p385, @p386, @p387, @p388, @p389, @p390, @p391, 6), (@p392, @p393, @p394, @p395, @p396, @p397, @p398, @p399, @p400, @p401, @p402, @p403, @p404, @p405, @p406, @p407, @p408, @p409, @p410, @p411, @p412, @p413, @p414, @p415, @p416, @p417, @p418, @p419, @p420, @p421, @p422, @p423, @p424, @p425, @p426, @p427, @p428, @p429, @p430, @p431, @p432, @p433, @p434, @p435, @p436, @p437, @p438, @p439, @p440, @p441, @p442, @p443, @p444, @p445, @p446, @p447, 7), (@p448, @p449, @p450, @p451, @p452, @p453, @p454, @p455, @p456, @p457, @p458, @p459, @p460, @p461, @p462, @p463, @p464, @p465, @p466, @p467, @p468, @p469, @p470, @p471, @p472, @p473, @p474, @p475, @p476, @p477, @p478, @p479, @p480, @p481, @p482, @p483, @p484, @p485, @p486, @p487, @p488, @p489, @p490, @p491, @p492, @p493, @p494, @p495, @p496, @p497, @p498, @p499, @p500, @p501, @p502, @p503, 8), (@p504, @p505, @p506, @p507, @p508, @p509, @p510, @p511, @p512, @p513, @p514, @p515, @p516, @p517, @p518, @p519, @p520, @p521, @p522, @p523, @p524, @p525, @p526, @p527, @p528, @p529, @p530, @p531, @p532, @p533, @p534, @p535, @p536, @p537, @p538, @p539, @p540, @p541, @p542, @p543, @p544, @p545, @p546, @p547, @p548, @p549, @p550, @p551, @p552, @p553, @p554, @p555, @p556, @p557, @p558, @p559, 9), (@p560, @p561, @p562, @p563, @p564, @p565, @p566, @p567, @p568, @p569, @p570, @p571, @p572, @p573, @p574, @p575, @p576, @p577, @p578, @p579, @p580, @p581, @p582, @p583, @p584, @p585, @p586, @p587, @p588, @p589, @p590, @p591, @p592, @p593, @p594, @p595, @p596, @p597, @p598, @p599, @p600, @p601, @p602, @p603, @p604, @p605, @p606, @p607, @p608, @p609, @p610, @p611, @p612, @p613, @p614, @p615, 10), (@p616, @p617, @p618, @p619, @p620, @p621, @p622, @p623, @p624, @p625, @p626, @p627, @p628, @p629, @p630, @p631, @p632, @p633, @p634, @p635, @p636, @p637, @p638, @p639, @p640, @p641, @p642, @p643, @p644, @p645, @p646, @p647, @p648, @p649, @p650, @p651, @p652, @p653, @p654, @p655, @p656, @p657, @p658, @p659, @p660, @p661, @p662, @p663, @p664, @p665, @p666, @p667, @p668, @p669, @p670, @p671, 11), (@p672, @p673, @p674, @p675, @p676, @p677, @p678, @p679, @p680, @p681, @p682, @p683, @p684, @p685, @p686, @p687, @p688, @p689, @p690, @p691, @p692, @p693, @p694, @p695, @p696, @p697, @p698, @p699, @p700, @p701, @p702, @p703, @p704, @p705, @p706, @p707, @p708, @p709, @p710, @p711, @p712, @p713, @p714, @p715, @p716, @p717, @p718, @p719, @p720, @p721, @p722, @p723, @p724, @p725, @p726, @p727, 12), (@p728, @p729, @p730, @p731, @p732, @p733, @p734, @p735, @p736, @p737, @p738, @p739, @p740, @p741, @p742, @p743, @p744, @p745, @p746, @p747, @p748, @p749, @p750, @p751, @p752, @p753, @p754, @p755, @p756, @p757, @p758, @p759, @p760, @p761, @p762, @p763, @p764, @p765, @p766, @p767, @p768, @p769, @p770, @p771, @p772, @p773, @p774, @p775, @p776, @p777, @p778, @p779, @p780, @p781, @p782, @p783, 13), (@p784, @p785, @p786, @p787, @p788, @p789, @p790, @p791, @p792, @p793, @p794, @p795, @p796, @p797, @p798, @p799, @p800, @p801, @p802, @p803, @p804, @p805, @p806, @p807, @p808, @p809, @p810, @p811, @p812, @p813, @p814, @p815, @p816, @p817, @p818, @p819, @p820, @p821, @p822, @p823, @p824, @p825, @p826, @p827, @p828, @p829, @p830, @p831, @p832, @p833, @p834, @p835, @p836, @p837, @p838, @p839, 14), (@p840, @p841, @p842, @p843, @p844, @p845, @p846, @p847, @p848, @p849, @p850, @p851, @p852, @p853, @p854, @p855, @p856, @p857, @p858, @p859, @p860, @p861, @p862, @p863, @p864, @p865, @p866, @p867, @p868, @p869, @p870, @p871, @p872, @p873, @p874, @p875, @p876, @p877, @p878, @p879, @p880, @p881, @p882, @p883, @p884, @p885, @p886, @p887, @p888, @p889, @p890, @p891, @p892, @p893, @p894, @p895, 15), (@p896, @p897, @p898, @p899, @p900, @p901, @p902, @p903, @p904, @p905, @p906, @p907, @p908, @p909, @p910, @p911, @p912, @p913, @p914, @p915, @p916, @p917, @p918, @p919, @p920, @p921, @p922, @p923, @p924, @p925, @p926, @p927, @p928, @p929, @p930, @p931, @p932, @p933, @p934, @p935, @p936, @p937, @p938, @p939, @p940, @p941, @p942, @p943, @p944, @p945, @p946, @p947, @p948, @p949, @p950, @p951, 16), (@p952, @p953, @p954, @p955, @p956, @p957, @p958, @p959, @p960, @p961, @p962, @p963, @p964, @p965, @p966, @p967, @p968, @p969, @p970, @p971, @p972, @p973, @p974, @p975, @p976, @p977, @p978, @p979, @p980, @p981, @p982, @p983, @p984, @p985, @p986, @p987, @p988, @p989, @p990, @p991, @p992, @p993, @p994, @p995, @p996, @p997, @p998, @p999, @p1000, @p1001, @p1002, @p1003, @p1004, @p1005, @p1006, @p1007, 17), (@p1008, @p1009, @p1010, @p1011, @p1012, @p1013, @p1014, @p1015, @p1016, @p1017, @p1018, @p1019, @p1020, @p1021, @p1022, @p1023, @p1024, @p1025, @p1026, @p1027, @p1028, @p1029, @p1030, @p1031, @p1032, @p1033, @p1034, @p1035, @p1036, @p1037, @p1038, @p1039, @p1040, @p1041, @p1042, @p1043, @p1044, @p1045, @p1046, @p1047, @p1048, @p1049, @p1050, @p1051, @p1052, @p1053, @p1054, @p1055, @p1056, @p1057, @p1058, @p1059, @p1060, @p1061, @p1062, @p1063, 18), (@p1064, @p1065, @p1066, @p1067, @p1068, @p1069, @p1070, @p1071, @p1072, @p1073, @p1074, @p1075, @p1076, @p1077, @p1078, @p1079, @p1080, @p1081, @p1082, @p1083, @p1084, @p1085, @p1086, @p1087, @p1088, @p1089, @p1090, @p1091, @p1092, @p1093, @p1094, @p1095, @p1096, @p1097, @p1098, @p1099, @p1100, @p1101, @p1102, @p1103, @p1104, @p1105, @p1106, @p1107, @p1108, @p1109, @p1110, @p1111, @p1112, @p1113, @p1114, @p1115, @p1116, @p1117, @p1118, @p1119, 19), (@p1120, @p1121, @p1122, @p1123, @p1124, @p1125, @p1126, @p1127, @p1128, @p1129, @p1130, @p1131, @p1132, @p1133, @p1134, @p1135, @p1136, @p1137, @p1138, @p1139, @p1140, @p1141, @p1142, @p1143, @p1144, @p1145, @p1146, @p1147, @p1148, @p1149, @p1150, @p1151, @p1152, @p1153, @p1154, @p1155, @p1156, @p1157, @p1158, @p1159, @p1160, @p1161, @p1162, @p1163, @p1164, @p1165, @p1166, @p1167, @p1168, @p1169, @p1170, @p1171, @p1172, @p1173, @p1174, @p1175, 20), (@p1176, @p1177, @p1178, @p1179, @p1180, @p1181, @p1182, @p1183, @p1184, @p1185, @p1186, @p1187, @p1188, @p1189, @p1190, @p1191, @p1192, @p1193, @p1194, @p1195, @p1196, @p1197, @p1198, @p1199, @p1200, @p1201, @p1202, @p1203, @p1204, @p1205, @p1206, @p1207, @p1208, @p1209, @p1210, @p1211, @p1212, @p1213, @p1214, @p1215, @p1216, @p1217, @p1218, @p1219, @p1220, @p1221, @p1222, @p1223, @p1224, @p1225, @p1226, @p1227, @p1228, @p1229, @p1230, @p1231, 21), (@p1232, @p1233, @p1234, @p1235, @p1236, @p1237, @p1238, @p1239, @p1240, @p1241, @p1242, @p1243, @p1244, @p1245, @p1246, @p1247, @p1248, @p1249, @p1250, @p1251, @p1252, @p1253, @p1254, @p1255, @p1256, @p1257, @p1258, @p1259, @p1260, @p1261, @p1262, @p1263, @p1264, @p1265, @p1266, @p1267, @p1268, @p1269, @p1270, @p1271, @p1272, @p1273, @p1274, @p1275, @p1276, @p1277, @p1278, @p1279, @p1280, @p1281, @p1282, @p1283, @p1284, @p1285, @p1286, @p1287, 22), (@p1288, @p1289, @p1290, @p1291, @p1292, @p1293, @p1294, @p1295, @p1296, @p1297, @p1298, @p1299, @p1300, @p1301, @p1302, @p1303, @p1304, @p1305, @p1306, @p1307, @p1308, @p1309, @p1310, @p1311, @p1312, @p1313, @p1314, @p1315, @p1316, @p1317, @p1318, @p1319, @p1320, @p1321, @p1322, @p1323, @p1324, @p1325, @p1326, @p1327, @p1328, @p1329, @p1330, @p1331, @p1332, @p1333, @p1334, @p1335, @p1336, @p1337, @p1338, @p1339, @p1340, @p1341, @p1342, @p1343, 23), (@p1344, @p1345, @p1346, @p1347, @p1348, @p1349, @p1350, @p1351, @p1352, @p1353, @p1354, @p1355, @p1356, @p1357, @p1358, @p1359, @p1360, @p1361, @p1362, @p1363, @p1364, @p1365, @p1366, @p1367, @p1368, @p1369, @p1370, @p1371, @p1372, @p1373, @p1374, @p1375, @p1376, @p1377, @p1378, @p1379, @p1380, @p1381, @p1382, @p1383, @p1384, @p1385, @p1386, @p1387, @p1388, @p1389, @p1390, @p1391, @p1392, @p1393, @p1394, @p1395, @p1396, @p1397, @p1398, @p1399, 24), (@p1400, @p1401, @p1402, @p1403, @p1404, @p1405, @p1406, @p1407, @p1408, @p1409, @p1410, @p1411, @p1412, @p1413, @p1414, @p1415, @p1416, @p1417, @p1418, @p1419, @p1420, @p1421, @p1422, @p1423, @p1424, @p1425, @p1426, @p1427, @p1428, @p1429, @p1430, @p1431, @p1432, @p1433, @p1434, @p1435, @p1436, @p1437, @p1438, @p1439, @p1440, @p1441, @p1442, @p1443, @p1444, @p1445, @p1446, @p1447, @p1448, @p1449, @p1450, @p1451, @p1452, @p1453, @p1454, @p1455, 25), (@p1456, @p1457, @p1458, @p1459, @p1460, @p1461, @p1462, @p1463, @p1464, @p1465, @p1466, @p1467, @p1468, @p1469, @p1470, @p1471, @p1472, @p1473, @p1474, @p1475, @p1476, @p1477, @p1478, @p1479, @p1480, @p1481, @p1482, @p1483, @p1484, @p1485, @p1486, @p1487, @p1488, @p1489, @p1490, @p1491, @p1492, @p1493, @p1494, @p1495, @p1496, @p1497, @p1498, @p1499, @p1500, @p1501, @p1502, @p1503, @p1504, @p1505, @p1506, @p1507, @p1508, @p1509, @p1510, @p1511, 26), (@p1512, @p1513, @p1514, @p1515, @p1516, @p1517, @p1518, @p1519, @p1520, @p1521, @p1522, @p1523, @p1524, @p1525, @p1526, @p1527, @p1528, @p1529, @p1530, @p1531, @p1532, @p1533, @p1534, @p1535, @p1536, @p1537, @p1538, @p1539, @p1540, @p1541, @p1542, @p1543, @p1544, @p1545, @p1546, @p1547, @p1548, @p1549, @p1550, @p1551, @p1552, @p1553, @p1554, @p1555, @p1556, @p1557, @p1558, @p1559, @p1560, @p1561, @p1562, @p1563, @p1564, @p1565, @p1566, @p1567, 27), (@p1568, @p1569, @p1570, @p1571, @p1572, @p1573, @p1574, @p1575, @p1576, @p1577, @p1578, @p1579, @p1580, @p1581, @p1582, @p1583, @p1584, @p1585, @p1586, @p1587, @p1588, @p1589, @p1590, @p1591, @p1592, @p1593, @p1594, @p1595, @p1596, @p1597, @p1598, @p1599, @p1600, @p1601, @p1602, @p1603, @p1604, @p1605, @p1606, @p1607, @p1608, @p1609, @p1610, @p1611, @p1612, @p1613, @p1614, @p1615, @p1616, @p1617, @p1618, @p1619, @p1620, @p1621, @p1622, @p1623, 28), (@p1624, @p1625, @p1626, @p1627, @p1628, @p1629, @p1630, @p1631, @p1632, @p1633, @p1634, @p1635, @p1636, @p1637, @p1638, @p1639, @p1640, @p1641, @p1642, @p1643, @p1644, @p1645, @p1646, @p1647, @p1648, @p1649, @p1650, @p1651, @p1652, @p1653, @p1654, @p1655, @p1656, @p1657, @p1658, @p1659, @p1660, @p1661, @p1662, @p1663, @p1664, @p1665, @p1666, @p1667, @p1668, @p1669, @p1670, @p1671, @p1672, @p1673, @p1674, @p1675, @p1676, @p1677, @p1678, @p1679, 29), (@p1680, @p1681, @p1682, @p1683, @p1684, @p1685, @p1686, @p1687, @p1688, @p1689, @p1690, @p1691, @p1692, @p1693, @p1694, @p1695, @p1696, @p1697, @p1698, @p1699, @p1700, @p1701, @p1702, @p1703, @p1704, @p1705, @p1706, @p1707, @p1708, @p1709, @p1710, @p1711, @p1712, @p1713, @p1714, @p1715, @p1716, @p1717, @p1718, @p1719, @p1720, @p1721, @p1722, @p1723, @p1724, @p1725, @p1726, @p1727, @p1728, @p1729, @p1730, @p1731, @p1732, @p1733, @p1734, @p1735, 30), (@p1736, @p1737, @p1738, @p1739, @p1740, @p1741, @p1742, @p1743, @p1744, @p1745, @p1746, @p1747, @p1748, @p1749, @p1750, @p1751, @p1752, @p1753, @p1754, @p1755, @p1756, @p1757, @p1758, @p1759, @p1760, @p1761, @p1762, @p1763, @p1764, @p1765, @p1766, @p1767, @p1768, @p1769, @p1770, @p1771, @p1772, @p1773, @p1774, @p1775, @p1776, @p1777, @p1778, @p1779, @p1780, @p1781, @p1782, @p1783, @p1784, @p1785, @p1786, @p1787, @p1788, @p1789, @p1790, @p1791, 31), (@p1792, @p1793, @p1794, @p1795, @p1796, @p1797, @p1798, @p1799, @p1800, @p1801, @p1802, @p1803, @p1804, @p1805, @p1806, @p1807, @p1808, @p1809, @p1810, @p1811, @p1812, @p1813, @p1814, @p1815, @p1816, @p1817, @p1818, @p1819, @p1820, @p1821, @p1822, @p1823, @p1824, @p1825, @p1826, @p1827, @p1828, @p1829, @p1830, @p1831, @p1832, @p1833, @p1834, @p1835, @p1836, @p1837, @p1838, @p1839, @p1840, @p1841, @p1842, @p1843, @p1844, @p1845, @p1846, @p1847, 32), (@p1848, @p1849, @p1850, @p1851, @p1852, @p1853, @p1854, @p1855, @p1856, @p1857, @p1858, @p1859, @p1860, @p1861, @p1862, @p1863, @p1864, @p1865, @p1866, @p1867, @p1868, @p1869, @p1870, @p1871, @p1872, @p1873, @p1874, @p1875, @p1876, @p1877, @p1878, @p1879, @p1880, @p1881, @p1882, @p1883, @p1884, @p1885, @p1886, @p1887, @p1888, @p1889, @p1890, @p1891, @p1892, @p1893, @p1894, @p1895, @p1896, @p1897, @p1898, @p1899, @p1900, @p1901, @p1902, @p1903, 33), (@p1904, @p1905, @p1906, @p1907, @p1908, @p1909, @p1910, @p1911, @p1912, @p1913, @p1914, @p1915, @p1916, @p1917, @p1918, @p1919, @p1920, @p1921, @p1922, @p1923, @p1924, @p1925, @p1926, @p1927, @p1928, @p1929, @p1930, @p1931, @p1932, @p1933, @p1934, @p1935, @p1936, @p1937, @p1938, @p1939, @p1940, @p1941, @p1942, @p1943, @p1944, @p1945, @p1946, @p1947, @p1948, @p1949, @p1950, @p1951, @p1952, @p1953, @p1954, @p1955, @p1956, @p1957, @p1958, @p1959, 34), (@p1960, @p1961, @p1962, @p1963, @p1964, @p1965, @p1966, @p1967, @p1968, @p1969, @p1970, @p1971, @p1972, @p1973, @p1974, @p1975, @p1976, @p1977, @p1978, @p1979, @p1980, @p1981, @p1982, @p1983, @p1984, @p1985, @p1986, @p1987, @p1988, @p1989, @p1990, @p1991, @p1992, @p1993, @p1994, @p1995, @p1996, @p1997, @p1998, @p1999, @p2000, @p2001, @p2002, @p2003, @p2004, @p2005, @p2006, @p2007, @p2008, @p2009, @p2010, @p2011, @p2012, @p2013, @p2014, @p2015, 35), (@p2016, @p2017, @p2018, @p2019, @p2020, @p2021, @p2022, @p2023, @p2024, @p2025, @p2026, @p2027, @p2028, @p2029, @p2030, @p2031, @p2032, @p2033, @p2034, @p2035, @p2036, @p2037, @p2038, @p2039, @p2040, @p2041, @p2042, @p2043, @p2044, @p2045, @p2046, @p2047, @p2048, @p2049, @p2050, @p2051, @p2052, @p2053, @p2054, @p2055, @p2056, @p2057, @p2058, @p2059, @p2060, @p2061, @p2062, @p2063, @p2064, @p2065, @p2066, @p2067, @p2068, @p2069, @p2070, @p2071, 36)) AS i ([addressee_cntry_cd], [addressee_city], [addressee_district], [addressee_email], [addressee_full_address], [addressee_home_address], [addressee_name], [addressee_postcode], [addressee_province], [addressee_subdistrict], [addressee_tel], [create_table], [delivery_code], [delivery_recipient_name], [delivery_relation_id], [delivery_status_id], [dest_outlet_id], [dest_outlet_port], [document_number], [item_barcode], [item_cod], [item_gross_weight], [item_height], [item_length], [item_price], [item_width], [lat], [log_id], [long], [outlet_id], [outlet_port], [podUrl], [remark], [scan_cntry_cd], [scan_cntry_postcode], [sender_cntry_cd], [sender_district], [sender_email], [sender_full_address], [sender_home_address], [member_id], [sender_name], [sender_postcode], [sender_province], [sender_subdistrict], [sender_tel], [server_id], [signatureUrl], [state], [status_code], [status_dtm], [timestamp], [transmit_dtm], [user_id], [wckt_id], [wkstn_no], _Position) ON 1=0 WHEN NOT MATCHED THEN INSERT ([addressee_cntry_cd], [addressee_city], [addressee_district], [addressee_email], [addressee_full_address], [addressee_home_address], [addressee_name], [addressee_postcode], [addressee_province], [addressee_subdistrict], [addressee_tel], [create_table], [delivery_code], [delivery_recipient_name], [delivery_relation_id], [delivery_status_id], [dest_outlet_id], [dest_outlet_port], [document_number], [item_barcode], [item_cod], [item_gross_weight], [item_height], [item_length], [item_price], [item_width], [lat], [log_id], [long], [outlet_id], [outlet_port], [podUrl], [remark], [scan_cntry_cd], [scan_cntry_postcode], [sender_cntry_cd], [sender_district], [sender_email], [sender_full_address], [sender_home_address], [member_id], [sender_name], [sender_postcode], [sender_province], [sender_subdistrict], [sender_tel], [server_id], [signatureUrl], [state], [status_code], [status_dtm], [timestamp], [transmit_dtm], [user_id], [wckt_id], [wkstn_no]) VALUES (i.[addressee_cntry_cd], i.[addressee_city], i.[addressee_district], i.[addressee_email], i.[addressee_full_address], i.[addressee_home_address], i.[addressee_name], i.[addressee_postcode], i.[addressee_province], i.[addressee_subdistrict], i.[addressee_tel], i.[create_table], i.[delivery_code], i.[delivery_recipient_name], i.[delivery_relation_id], i.[delivery_status_id], i.[dest_outlet_id], i.[dest_outlet_port], i.[document_number], i.[item_barcode], i.[item_cod], i.[item_gross_weight], i.[item_height], i.[item_length], i.[item_price], i.[item_width], i.[lat], i.[log_id], i.[long], i.[outlet_id], i.[outlet_port], i.[podUrl], i.[remark], i.[scan_cntry_cd], i.[scan_cntry_postcode], i.[sender_cntry_cd], i.[sender_district], i.[sender_email], i.[sender_full_address], i.[sender_home_address], i.[member_id], i.[sender_name], i.[sender_postcode], i.[sender_province], i.[sender_subdistrict], i.[sender_tel], i.[server_id], i.[signatureUrl], i.[state], i.[status_code], i.[status_dtm], i.[timestamp], i.[transmit_dtm], i.[user_id], i.[wckt_id], i.[wkstn_no]) OUTPUT INSERTED.[item_id], i._Position INTO @inserted0;  SELECT [t].[item_id] FROM [raw_data] t INNER JOIN @inserted0 i ON ([t].[item_id] = [i].[item_id]) ORDER BY [i].[_Position];  ",6,6,0,438,2,6
"SELECT SCHEMA_NAME(tbl.schema_id) AS [Schema], tbl.name AS [Name], tbl.object_id AS [ID] FROM sys.tables AS tbl ORDER BY [Schema] ASC,[Name] ASC",6,5,1,379,0,6
"(@p0 nvarchar(4000),@p1 nvarchar(4000),@p2 nvarchar(4000),@p3 nvarchar(4000),@p4 nvarchar(4000),@p5 nvarchar(4000),@p6 nvarchar(4000),@p7 nvarchar(4000),@p8 nvarchar(4000),@p9 nvarchar(4000),@p10 nvarchar(4000),@p11 datetime2(7),@p12 nvarchar(4000),@p13 nvarchar(4000),@p14 int,@p15 int,@p16 int,@p17 nvarchar(4000),@p18 nvarchar(4000),@p19 nvarchar(4000),@p20 decimal(18,2),@p21 decimal(18,2),@p22 nvarchar(4000),@p23 nvarchar(4000),@p24 decimal(18,2),@p25 nvarchar(4000),@p26 nvarchar(4000),@p27 nvarchar(4000),@p28 nvarchar(4000),@p29 int,@p30 nvarchar(4000),@p31 nvarchar(4000),@p32 nvarchar(4000),@p33 nvarchar(4000),@p34 nvarchar(4000),@p35 nvarchar(4000),@p36 nvarchar(4000),@p37 nvarchar(4000),@p38 nvarchar(4000),@p39 nvarchar(4000),@p40 int,@p41 nvarchar(4000),@p42 nvarchar(4000),@p43 nvarchar(4000),@p44 nvarchar(4000),@p45 nvarchar(4000),@p46 int,@p47 nvarchar(4000),@p48 int,@p49 int,@p50 datetime2(7),@p51 datetime2(7),@p52 datetime2(7),@p53 nvarchar(4000),@p54 nvarchar(4000),@p55 nvarchar(4000),@p56 nvarchar(4000),@p57 nvarchar(4000),@p58 nvarchar(4000),@p59 nvarchar(4000),@p60 nvarchar(4000),@p61 nvarchar(4000),@p62 nvarchar(4000),@p63 nvarchar(4000),@p64 nvarchar(4000),@p65 nvarchar(4000),@p66 nvarchar(4000),@p67 datetime2(7),@p68 nvarchar(4000),@p69 nvarchar(4000),@p70 int,@p71 int,@p72 int,@p73 nvarchar(4000),@p74 nvarchar(4000),@p75 nvarchar(4000),@p76 decimal(18,2),@p77 decimal(18,2),@p78 nvarchar(4000),@p79 nvarchar(4000),@p80 decimal(18,2),@p81 nvarchar(4000),@p82 nvarchar(4000),@p83 nvarchar(4000),@p84 nvarchar(4000),@p85 int,@p86 nvarchar(4000),@p87 nvarchar(4000),@p88 nvarchar(4000),@p89 nvarchar(4000),@p90 nvarchar(4000),@p91 nvarchar(4000),@p92 nvarchar(4000),@p93 nvarchar(4000),@p94 nvarchar(4000),@p95 nvarchar(4000),@p96 int,@p97 nvarchar(4000),@p98 nvarchar(4000),@p99 nvarchar(4000),@p100 nvarchar(4000),@p101 nvarchar(4000),@p102 int,@p103 nvarchar(4000),@p104 int,@p105 int,@p106 datetime2(7),@p107 datetime2(7),@p108 datetime2(7),@p109 nvarchar(4000),@p110 nvarchar(4000),@p111 nvarchar(4000),@p112 nvarchar(4000),@p113 nvarchar(4000),@p114 nvarchar(4000),@p115 nvarchar(4000),@p116 nvarchar(4000),@p117 nvarchar(4000),@p118 nvarchar(4000),@p119 nvarchar(4000),@p120 nvarchar(4000),@p121 nvarchar(4000),@p122 nvarchar(4000),@p123 datetime2(7),@p124 nvarchar(4000),@p125 nvarchar(4000),@p126 int,@p127 int,@p128 int,@p129 nvarchar(4000),@p130 nvarchar(4000),@p131 nvarchar(4000),@p132 decimal(18,2),@p133 decimal(18,2),@p134 nvarchar(4000),@p135 nvarchar(4000),@p136 decimal(18,2),@p137 nvarchar(4000),@p138 nvarchar(4000),@p139 nvarchar(4000),@p140 nvarchar(4000),@p141 int,@p142 nvarchar(4000),@p143 nvarchar(4000),@p144 nvarchar(4000),@p145 nvarchar(4000),@p146 nvarchar(4000),@p147 nvarchar(4000),@p148 nvarchar(4000),@p149 nvarchar(4000),@p150 nvarchar(4000),@p151 nvarchar(4000),@p152 int,@p153 nvarchar(4000),@p154 nvarchar(4000),@p155 nvarchar(4000),@p156 nvarchar(4000),@p157 nvarchar(4000),@p158 int,@p159 nvarchar(4000),@p160 int,@p161 int,@p162 datetime2(7),@p163 datetime2(7),@p164 datetime2(7),@p165 nvarchar(4000),@p166 nvarchar(4000),@p167 nvarchar(4000),@p168 nvarchar(4000),@p169 nvarchar(4000),@p170 nvarchar(4000),@p171 nvarchar(4000),@p172 nvarchar(4000),@p173 nvarchar(4000),@p174 nvarchar(4000),@p175 nvarchar(4000),@p176 nvarchar(4000),@p177 nvarchar(4000),@p178 nvarchar(4000),@p179 datetime2(7),@p180 nvarchar(4000),@p181 nvarchar(4000),@p182 int,@p183 int,@p184 int,@p185 nvarchar(4000),@p186 nvarchar(4000),@p187 nvarchar(4000),@p188 decimal(18,2),@p189 decimal(18,2),@p190 nvarchar(4000),@p191 nvarchar(4000),@p192 decimal(18,2),@p193 nvarchar(4000),@p194 nvarchar(4000),@p195 nvarchar(4000),@p196 nvarchar(4000),@p197 int,@p198 nvarchar(4000),@p199 nvarchar(4000),@p200 nvarchar(4000),@p201 nvarchar(4000),@p202 nvarchar(4000),@p203 nvarchar(4000),@p204 nvarchar(4000),@p205 nvarchar(4000),@p206 nvarchar(4000),@p207 nvarchar(4000),@p208 int,@p209 nvarchar(4000),@p210 nvarchar(4000),@p211 nvarchar(4000),@p212 nvarchar(4000),@p213 nvarchar(4000),@p214 int,@p215 nvarchar(4000),@p216 int,@p217 int,@p218 datetime2(7),@p219 datetime2(7),@p220 datetime2(7),@p221 nvarchar(4000),@p222 nvarchar(4000),@p223 nvarchar(4000),@p224 nvarchar(4000),@p225 nvarchar(4000),@p226 nvarchar(4000),@p227 nvarchar(4000),@p228 nvarchar(4000),@p229 nvarchar(4000),@p230 nvarchar(4000),@p231 nvarchar(4000),@p232 nvarchar(4000),@p233 nvarchar(4000),@p234 nvarchar(4000),@p235 datetime2(7),@p236 nvarchar(4000),@p237 nvarchar(4000),@p238 int,@p239 int,@p240 int,@p241 nvarchar(4000),@p242 nvarchar(4000),@p243 nvarchar(4000),@p244 decimal(18,2),@p245 decimal(18,2),@p246 nvarchar(4000),@p247 nvarchar(4000),@p248 decimal(18,2),@p249 nvarchar(4000),@p250 nvarchar(4000),@p251 nvarchar(4000),@p252 nvarchar(4000),@p253 int,@p254 nvarchar(4000),@p255 nvarchar(4000),@p256 nvarchar(4000),@p257 nvarchar(4000),@p258 nvarchar(4000),@p259 nvarchar(4000),@p260 nvarchar(4000),@p261 nvarchar(4000),@p262 nvarchar(4000),@p263 nvarchar(4000),@p264 int,@p265 nvarchar(4000),@p266 nvarchar(4000),@p267 nvarchar(4000),@p268 nvarchar(4000),@p269 nvarchar(4000),@p270 int,@p271 nvarchar(4000),@p272 int,@p273 int,@p274 datetime2(7),@p275 datetime2(7),@p276 datetime2(7),@p277 nvarchar(4000),@p278 nvarchar(4000),@p279 nvarchar(4000),@p280 nvarchar(4000),@p281 nvarchar(4000),@p282 nvarchar(4000),@p283 nvarchar(4000),@p284 nvarchar(4000),@p285 nvarchar(4000),@p286 nvarchar(4000),@p287 nvarchar(4000),@p288 nvarchar(4000),@p289 nvarchar(4000),@p290 nvarchar(4000),@p291 datetime2(7),@p292 nvarchar(4000),@p293 nvarchar(4000),@p294 int,@p295 int,@p296 int,@p297 nvarchar(4000),@p298 nvarchar(4000),@p299 nvarchar(4000),@p300 decimal(18,2),@p301 decimal(18,2),@p302 nvarchar(4000),@p303 nvarchar(4000),@p304 decimal(18,2),@p305 nvarchar(4000),@p306 nvarchar(4000),@p307 nvarchar(4000),@p308 nvarchar(4000),@p309 int,@p310 nvarchar(4000),@p311 nvarchar(4000),@p312 nvarchar(4000),@p313 nvarchar(4000),@p314 nvarchar(4000),@p315 nvarchar(4000),@p316 nvarchar(4000),@p317 nvarchar(4000),@p318 nvarchar(4000),@p319 nvarchar(4000),@p320 int,@p321 nvarchar(4000),@p322 nvarchar(4000),@p323 nvarchar(4000),@p324 nvarchar(4000),@p325 nvarchar(4000),@p326 int,@p327 nvarchar(4000),@p328 int,@p329 int,@p330 datetime2(7),@p331 datetime2(7),@p332 datetime2(7),@p333 nvarchar(4000),@p334 nvarchar(4000),@p335 nvarchar(4000),@p336 nvarchar(4000),@p337 nvarchar(4000),@p338 nvarchar(4000),@p339 nvarchar(4000),@p340 nvarchar(4000),@p341 nvarchar(4000),@p342 nvarchar(4000),@p343 nvarchar(4000),@p344 nvarchar(4000),@p345 nvarchar(4000),@p346 nvarchar(4000),@p347 datetime2(7),@p348 nvarchar(4000),@p349 nvarchar(4000),@p350 int,@p351 int,@p352 int,@p353 nvarchar(4000),@p354 nvarchar(4000),@p355 nvarchar(4000),@p356 decimal(18,2),@p357 decimal(18,2),@p358 nvarchar(4000),@p359 nvarchar(4000),@p360 decimal(18,2),@p361 nvarchar(4000),@p362 nvarchar(4000),@p363 nvarchar(4000),@p364 nvarchar(4000),@p365 int,@p366 nvarchar(4000),@p367 nvarchar(4000),@p368 nvarchar(4000),@p369 nvarchar(4000),@p370 nvarchar(4000),@p371 nvarchar(4000),@p372 nvarchar(4000),@p373 nvarchar(4000),@p374 nvarchar(4000),@p375 nvarchar(4000),@p376 int,@p377 nvarchar(4000),@p378 nvarchar(4000),@p379 nvarchar(4000),@p380 nvarchar(4000),@p381 nvarchar(4000),@p382 int,@p383 nvarchar(4000),@p384 int,@p385 int,@p386 datetime2(7),@p387 datetime2(7),@p388 datetime2(7),@p389 nvarchar(4000),@p390 nvarchar(4000),@p391 nvarchar(4000),@p392 nvarchar(4000),@p393 nvarchar(4000),@p394 nvarchar(4000),@p395 nvarchar(4000),@p396 nvarchar(4000),@p397 nvarchar(4000),@p398 nvarchar(4000),@p399 nvarchar(4000),@p400 nvarchar(4000),@p401 nvarchar(4000),@p402 nvarchar(4000),@p403 datetime2(7),@p404 nvarchar(4000),@p405 nvarchar(4000),@p406 int,@p407 int,@p408 int,@p409 nvarchar(4000),@p410 nvarchar(4000),@p411 nvarchar(4000),@p412 decimal(18,2),@p413 decimal(18,2),@p414 nvarchar(4000),@p415 nvarchar(4000),@p416 decimal(18,2),@p417 nvarchar(4000),@p418 nvarchar(4000),@p419 nvarchar(4000),@p420 nvarchar(4000),@p421 int,@p422 nvarchar(4000),@p423 nvarchar(4000),@p424 nvarchar(4000),@p425 nvarchar(4000),@p426 nvarchar(4000),@p427 nvarchar(4000),@p428 nvarchar(4000),@p429 nvarchar(4000),@p430 nvarchar(4000),@p431 nvarchar(4000),@p432 int,@p433 nvarchar(4000),@p434 nvarchar(4000),@p435 nvarchar(4000),@p436 nvarchar(4000),@p437 nvarchar(4000),@p438 int,@p439 nvarchar(4000),@p440 int,@p441 int,@p442 datetime2(7),@p443 datetime2(7),@p444 datetime2(7),@p445 nvarchar(4000),@p446 nvarchar(4000),@p447 nvarchar(4000),@p448 nvarchar(4000),@p449 nvarchar(4000),@p450 nvarchar(4000),@p451 nvarchar(4000),@p452 nvarchar(4000),@p453 nvarchar(4000),@p454 nvarchar(4000),@p455 nvarchar(4000),@p456 nvarchar(4000),@p457 nvarchar(4000),@p458 nvarchar(4000),@p459 datetime2(7),@p460 nvarchar(4000),@p461 nvarchar(4000),@p462 int,@p463 int,@p464 int,@p465 nvarchar(4000),@p466 nvarchar(4000),@p467 nvarchar(4000),@p468 decimal(18,2),@p469 decimal(18,2),@p470 nvarchar(4000),@p471 nvarchar(4000),@p472 decimal(18,2),@p473 nvarchar(4000),@p474 nvarchar(4000),@p475 nvarchar(4000),@p476 nvarchar(4000),@p477 int,@p478 nvarchar(4000),@p479 nvarchar(4000),@p480 nvarchar(4000),@p481 nvarchar(4000),@p482 nvarchar(4000),@p483 nvarchar(4000),@p484 nvarchar(4000),@p485 nvarchar(4000),@p486 nvarchar(4000),@p487 nvarchar(4000),@p488 int,@p489 nvarchar(4000),@p490 nvarchar(4000),@p491 nvarchar(4000),@p492 nvarchar(4000),@p493 nvarchar(4000),@p494 int,@p495 nvarchar(4000),@p496 int,@p497 int,@p498 datetime2(7),@p499 datetime2(7),@p500 datetime2(7),@p501 nvarchar(4000),@p502 nvarchar(4000),@p503 nvarchar(4000),@p504 nvarchar(4000),@p505 nvarchar(4000),@p506 nvarchar(4000),@p507 nvarchar(4000),@p508 nvarchar(4000),@p509 nvarchar(4000),@p510 nvarchar(4000),@p511 nvarchar(4000),@p512 nvarchar(4000),@p513 nvarchar(4000),@p514 nvarchar(4000),@p515 datetime2(7),@p516 nvarchar(4000),@p517 nvarchar(4000),@p518 int,@p519 int,@p520 int,@p521 nvarchar(4000),@p522 nvarchar(4000),@p523 nvarchar(4000),@p524 decimal(18,2),@p525 decimal(18,2),@p526 nvarchar(4000),@p527 nvarchar(4000),@p528 decimal(18,2),@p529 nvarchar(4000),@p530 nvarchar(4000),@p531 nvarchar(4000),@p532 nvarchar(4000),@p533 int,@p534 nvarchar(4000),@p535 nvarchar(4000),@p536 nvarchar(4000),@p537 nvarchar(4000),@p538 nvarchar(4000),@p539 nvarchar(4000),@p540 nvarchar(4000),@p541 nvarchar(4000),@p542 nvarchar(4000),@p543 nvarchar(4000),@p544 int,@p545 nvarchar(4000),@p546 nvarchar(4000),@p547 nvarchar(4000),@p548 nvarchar(4000),@p549 nvarchar(4000),@p550 int,@p551 nvarchar(4000),@p552 int,@p553 int,@p554 datetime2(7),@p555 datetime2(7),@p556 datetime2(7),@p557 nvarchar(4000),@p558 nvarchar(4000),@p559 nvarchar(4000),@p560 nvarchar(4000),@p561 nvarchar(4000),@p562 nvarchar(4000),@p563 nvarchar(4000),@p564 nvarchar(4000),@p565 nvarchar(4000),@p566 nvarchar(4000),@p567 nvarchar(4000),@p568 nvarchar(4000),@p569 nvarchar(4000),@p570 nvarchar(4000),@p571 datetime2(7),@p572 nvarchar(4000),@p573 nvarchar(4000),@p574 int,@p575 int,@p576 int,@p577 nvarchar(4000),@p578 nvarchar(4000),@p579 nvarchar(4000),@p580 decimal(18,2),@p581 decimal(18,2),@p582 nvarchar(4000),@p583 nvarchar(4000),@p584 decimal(18,2),@p585 nvarchar(4000),@p586 nvarchar(4000),@p587 nvarchar(4000),@p588 nvarchar(4000),@p589 int,@p590 nvarchar(4000),@p591 nvarchar(4000),@p592 nvarchar(4000),@p593 nvarchar(4000),@p594 nvarchar(4000),@p595 nvarchar(4000),@p596 nvarchar(4000),@p597 nvarchar(4000),@p598 nvarchar(4000),@p599 nvarchar(4000),@p600 int,@p601 nvarchar(4000),@p602 nvarchar(4000),@p603 nvarchar(4000),@p604 nvarchar(4000),@p605 nvarchar(4000),@p606 int,@p607 nvarchar(4000),@p608 int,@p609 int,@p610 datetime2(7),@p611 datetime2(7),@p612 datetime2(7),@p613 nvarchar(4000),@p614 nvarchar(4000),@p615 nvarchar(4000),@p616 nvarchar(4000),@p617 nvarchar(4000),@p618 nvarchar(4000),@p619 nvarchar(4000),@p620 nvarchar(4000),@p621 nvarchar(4000),@p622 nvarchar(4000),@p623 nvarchar(4000),@p624 nvarchar(4000),@p625 nvarchar(4000),@p626 nvarchar(4000),@p627 datetime2(7),@p628 nvarchar(4000),@p629 nvarchar(4000),@p630 int,@p631 int,@p632 int,@p633 nvarchar(4000),@p634 nvarchar(4000),@p635 nvarchar(4000),@p636 nvarchar(4000),@p637 decimal(18,2),@p638 nvarchar(4000),@p639 nvarchar(4000),@p640 decimal(18,2),@p641 nvarchar(4000),@p642 nvarchar(4000),@p643 nvarchar(4000),@p644 nvarchar(4000),@p645 int,@p646 nvarchar(4000),@p647 nvarchar(4000),@p648 nvarchar(4000),@p649 nvarchar(4000),@p650 nvarchar(4000),@p651 nvarchar(4000),@p652 nvarchar(4000),@p653 nvarchar(4000),@p654 nvarchar(4000),@p655 nvarchar(4000),@p656 int,@p657 nvarchar(4000),@p658 nvarchar(4000),@p659 nvarchar(4000),@p660 nvarchar(4000),@p661 nvarchar(4000),@p662 int,@p663 nvarchar(4000),@p664 int,@p665 int,@p666 datetime2(7),@p667 datetime2(7),@p668 datetime2(7),@p669 nvarchar(4000),@p670 nvarchar(4000),@p671 nvarchar(4000),@p672 nvarchar(4000),@p673 nvarchar(4000),@p674 nvarchar(4000),@p675 nvarchar(4000),@p676 nvarchar(4000),@p677 nvarchar(4000),@p678 nvarchar(4000),@p679 nvarchar(4000),@p680 nvarchar(4000),@p681 nvarchar(4000),@p682 nvarchar(4000),@p683 datetime2(7),@p684 nvarchar(4000),@p685 nvarchar(4000),@p686 int,@p687 int,@p688 int,@p689 nvarchar(4000),@p690 nvarchar(4000),@p691 nvarchar(4000),@p692 decimal(18,2),@p693 decimal(18,2),@p694 nvarchar(4000),@p695 nvarchar(4000),@p696 decimal(18,2),@p697 nvarchar(4000),@p698 nvarchar(4000),@p699 nvarchar(4000),@p700 nvarchar(4000),@p701 int,@p702 nvarchar(4000),@p703 nvarchar(4000),@p704 nvarchar(4000),@p705 nvarchar(4000),@p706 nvarchar(4000),@p707 nvarchar(4000),@p708 nvarchar(4000),@p709 nvarchar(4000),@p710 nvarchar(4000),@p711 nvarchar(4000),@p712 int,@p713 nvarchar(4000),@p714 nvarchar(4000),@p715 nvarchar(4000),@p716 nvarchar(4000),@p717 nvarchar(4000),@p718 int,@p719 nvarchar(4000),@p720 int,@p721 int,@p722 datetime2(7),@p723 datetime2(7),@p724 datetime2(7),@p725 nvarchar(4000),@p726 nvarchar(4000),@p727 nvarchar(4000),@p728 nvarchar(4000),@p729 nvarchar(4000),@p730 nvarchar(4000),@p731 nvarchar(4000),@p732 nvarchar(4000),@p733 nvarchar(4000),@p734 nvarchar(4000),@p735 nvarchar(4000),@p736 nvarchar(4000),@p737 nvarchar(4000),@p738 nvarchar(4000),@p739 datetime2(7),@p740 nvarchar(4000),@p741 nvarchar(4000),@p742 int,@p743 int,@p744 int,@p745 nvarchar(4000),@p746 nvarchar(4000),@p747 nvarchar(4000),@p748 decimal(18,2),@p749 decimal(18,2),@p750 nvarchar(4000),@p751 nvarchar(4000),@p752 decimal(18,2),@p753 nvarchar(4000),@p754 nvarchar(4000),@p755 nvarchar(4000),@p756 nvarchar(4000),@p757 int,@p758 nvarchar(4000),@p759 nvarchar(4000),@p760 nvarchar(4000),@p761 nvarchar(4000),@p762 nvarchar(4000),@p763 nvarchar(4000),@p764 nvarchar(4000),@p765 nvarchar(4000),@p766 nvarchar(4000),@p767 nvarchar(4000),@p768 int,@p769 nvarchar(4000),@p770 nvarchar(4000),@p771 nvarchar(4000),@p772 nvarchar(4000),@p773 nvarchar(4000),@p774 int,@p775 nvarchar(4000),@p776 int,@p777 int,@p778 datetime2(7),@p779 datetime2(7),@p780 datetime2(7),@p781 nvarchar(4000),@p782 nvarchar(4000),@p783 nvarchar(4000),@p784 nvarchar(4000),@p785 nvarchar(4000),@p786 nvarchar(4000),@p787 nvarchar(4000),@p788 nvarchar(4000),@p789 nvarchar(4000),@p790 nvarchar(4000),@p791 nvarchar(4000),@p792 nvarchar(4000),@p793 nvarchar(4000),@p794 nvarchar(4000),@p795 datetime2(7),@p796 nvarchar(4000),@p797 nvarchar(4000),@p798 int,@p799 int,@p800 int,@p801 nvarchar(4000),@p802 nvarchar(4000),@p803 nvarchar(4000),@p804 decimal(18,2),@p805 decimal(18,2),@p806 nvarchar(4000),@p807 nvarchar(4000),@p808 decimal(18,2),@p809 nvarchar(4000),@p810 nvarchar(4000),@p811 nvarchar(4000),@p812 nvarchar(4000),@p813 int,@p814 nvarchar(4000),@p815 nvarchar(4000),@p816 nvarchar(4000),@p817 nvarchar(4000),@p818 nvarchar(4000),@p819 nvarchar(4000),@p820 nvarchar(4000),@p821 nvarchar(4000),@p822 nvarchar(4000),@p823 nvarchar(4000),@p824 int,@p825 nvarchar(4000),@p826 nvarchar(4000),@p827 nvarchar(4000),@p828 nvarchar(4000),@p829 nvarchar(4000),@p830 int,@p831 nvarchar(4000),@p832 int,@p833 int,@p834 datetime2(7),@p835 datetime2(7),@p836 datetime2(7),@p837 nvarchar(4000),@p838 nvarchar(4000),@p839 nvarchar(4000),@p840 nvarchar(4000),@p841 nvarchar(4000),@p842 nvarchar(4000),@p843 nvarchar(4000),@p844 nvarchar(4000),@p845 nvarchar(4000),@p846 nvarchar(4000),@p847 nvarchar(4000),@p848 nvarchar(4000),@p849 nvarchar(4000),@p850 nvarchar(4000),@p851 datetime2(7),@p852 nvarchar(4000),@p853 nvarchar(4000),@p854 int,@p855 int,@p856 int,@p857 nvarchar(4000),@p858 nvarchar(4000),@p859 nvarchar(4000),@p860 decimal(18,2),@p861 decimal(18,2),@p862 nvarchar(4000),@p863 nvarchar(4000),@p864 decimal(18,2),@p865 nvarchar(4000),@p866 nvarchar(4000),@p867 nvarchar(4000),@p868 nvarchar(4000),@p869 int,@p870 nvarchar(4000),@p871 nvarchar(4000),@p872 nvarchar(4000),@p873 nvarchar(4000),@p874 nvarchar(4000),@p875 nvarchar(4000),@p876 nvarchar(4000),@p877 nvarchar(4000),@p878 nvarchar(4000),@p879 nvarchar(4000),@p880 int,@p881 nvarchar(4000),@p882 nvarchar(4000),@p883 nvarchar(4000),@p884 nvarchar(4000),@p885 nvarchar(4000),@p886 int,@p887 nvarchar(4000),@p888 int,@p889 int,@p890 datetime2(7),@p891 datetime2(7),@p892 datetime2(7),@p893 nvarchar(4000),@p894 nvarchar(4000),@p895 nvarchar(4000),@p896 nvarchar(4000),@p897 nvarchar(4000),@p898 nvarchar(4000),@p899 nvarchar(4000),@p900 nvarchar(4000),@p901 nvarchar(4000),@p902 nvarchar(4000),@p903 nvarchar(4000),@p904 nvarchar(4000),@p905 nvarchar(4000),@p906 nvarchar(4000),@p907 datetime2(7),@p908 nvarchar(4000),@p909 nvarchar(4000),@p910 int,@p911 int,@p912 int,@p913 nvarchar(4000),@p914 nvarchar(4000),@p915 nvarchar(4000),@p916 decimal(18,2),@p917 decimal(18,2),@p918 nvarchar(4000),@p919 nvarchar(4000),@p920 decimal(18,2),@p921 nvarchar(4000),@p922 nvarchar(4000),@p923 nvarchar(4000),@p924 nvarchar(4000),@p925 int,@p926 nvarchar(4000),@p927 nvarchar(4000),@p928 nvarchar(4000),@p929 nvarchar(4000),@p930 nvarchar(4000),@p931 nvarchar(4000),@p932 nvarchar(4000),@p933 nvarchar(4000),@p934 nvarchar(4000),@p935 nvarchar(4000),@p936 int,@p937 nvarchar(4000),@p938 nvarchar(4000),@p939 nvarchar(4000),@p940 nvarchar(4000),@p941 nvarchar(4000),@p942 int,@p943 nvarchar(4000),@p944 int,@p945 int,@p946 datetime2(7),@p947 datetime2(7),@p948 datetime2(7),@p949 nvarchar(4000),@p950 nvarchar(4000),@p951 nvarchar(4000),@p952 nvarchar(4000),@p953 nvarchar(4000),@p954 nvarchar(4000),@p955 nvarchar(4000),@p956 nvarchar(4000),@p957 nvarchar(4000),@p958 nvarchar(4000),@p959 nvarchar(4000),@p960 nvarchar(4000),@p961 nvarchar(4000),@p962 nvarchar(4000),@p963 datetime2(7),@p964 nvarchar(4000),@p965 nvarchar(4000),@p966 int,@p967 int,@p968 int,@p969 nvarchar(4000),@p970 nvarchar(4000),@p971 nvarchar(4000),@p972 decimal(18,2),@p973 decimal(18,2),@p974 nvarchar(4000),@p975 nvarchar(4000),@p976 decimal(18,2),@p977 nvarchar(4000),@p978 nvarchar(4000),@p979 nvarchar(4000),@p980 nvarchar(4000),@p981 int,@p982 nvarchar(4000),@p983 nvarchar(4000),@p984 nvarchar(4000),@p985 nvarchar(4000),@p986 nvarchar(4000),@p987 nvarchar(4000),@p988 nvarchar(4000),@p989 nvarchar(4000),@p990 nvarchar(4000),@p991 nvarchar(4000),@p992 int,@p993 nvarchar(4000),@p994 nvarchar(4000),@p995 nvarchar(4000),@p996 nvarchar(4000),@p997 nvarchar(4000),@p998 int,@p999 nvarchar(4000),@p1000 int,@p1001 int,@p1002 datetime2(7),@p1003 datetime2(7),@p1004 datetime2(7),@p1005 nvarchar(4000),@p1006 nvarchar(4000),@p1007 nvarchar(4000),@p1008 nvarchar(4000),@p1009 nvarchar(4000),@p1010 nvarchar(4000),@p1011 nvarchar(4000),@p1012 nvarchar(4000),@p1013 nvarchar(4000),@p1014 nvarchar(4000),@p1015 nvarchar(4000),@p1016 nvarchar(4000),@p1017 nvarchar(4000),@p1018 nvarchar(4000),@p1019 datetime2(7),@p1020 nvarchar(4000),@p1021 nvarchar(4000),@p1022 int,@p1023 int,@p1024 int,@p1025 nvarchar(4000),@p1026 nvarchar(4000),@p1027 nvarchar(4000),@p1028 decimal(18,2),@p1029 decimal(18,2),@p1030 nvarchar(4000),@p1031 nvarchar(4000),@p1032 decimal(18,2),@p1033 nvarchar(4000),@p1034 nvarchar(4000),@p1035 nvarchar(4000),@p1036 nvarchar(4000),@p1037 int,@p1038 nvarchar(4000),@p1039 nvarchar(4000),@p1040 nvarchar(4000),@p1041 nvarchar(4000),@p1042 nvarchar(4000),@p1043 nvarchar(4000),@p1044 nvarchar(4000),@p1045 nvarchar(4000),@p1046 nvarchar(4000),@p1047 nvarchar(4000),@p1048 int,@p1049 nvarchar(4000),@p1050 nvarchar(4000),@p1051 nvarchar(4000),@p1052 nvarchar(4000),@p1053 nvarchar(4000),@p1054 int,@p1055 nvarchar(4000),@p1056 int,@p1057 int,@p1058 datetime2(7),@p1059 datetime2(7),@p1060 datetime2(7),@p1061 nvarchar(4000),@p1062 nvarchar(4000),@p1063 nvarchar(4000),@p1064 nvarchar(4000),@p1065 nvarchar(4000),@p1066 nvarchar(4000),@p1067 nvarchar(4000),@p1068 nvarchar(4000),@p1069 nvarchar(4000),@p1070 nvarchar(4000),@p1071 nvarchar(4000),@p1072 nvarchar(4000),@p1073 nvarchar(4000),@p1074 nvarchar(4000),@p1075 datetime2(7),@p1076 nvarchar(4000),@p1077 nvarchar(4000),@p1078 int,@p1079 int,@p1080 int,@p1081 nvarchar(4000),@p1082 nvarchar(4000),@p1083 nvarchar(4000),@p1084 decimal(18,2),@p1085 decimal(18,2),@p1086 nvarchar(4000),@p1087 nvarchar(4000),@p1088 decimal(18,2),@p1089 nvarchar(4000),@p1090 nvarchar(4000),@p1091 nvarchar(4000),@p1092 nvarchar(4000),@p1093 int,@p1094 nvarchar(4000),@p1095 nvarchar(4000),@p1096 nvarchar(4000),@p1097 nvarchar(4000),@p1098 nvarchar(4000),@p1099 nvarchar(4000),@p1100 nvarchar(4000),@p1101 nvarchar(4000),@p1102 nvarchar(4000),@p1103 nvarchar(4000),@p1104 int,@p1105 nvarchar(4000),@p1106 nvarchar(4000),@p1107 nvarchar(4000),@p1108 nvarchar(4000),@p1109 nvarchar(4000),@p1110 int,@p1111 nvarchar(4000),@p1112 int,@p1113 int,@p1114 datetime2(7),@p1115 datetime2(7),@p1116 datetime2(7),@p1117 nvarchar(4000),@p1118 nvarchar(4000),@p1119 nvarchar(4000),@p1120 nvarchar(4000),@p1121 nvarchar(4000),@p1122 nvarchar(4000),@p1123 nvarchar(4000),@p1124 nvarchar(4000),@p1125 nvarchar(4000),@p1126 nvarchar(4000),@p1127 nvarchar(4000),@p1128 nvarchar(4000),@p1129 nvarchar(4000),@p1130 nvarchar(4000),@p1131 datetime2(7),@p1132 nvarchar(4000),@p1133 nvarchar(4000),@p1134 int,@p1135 int,@p1136 int,@p1137 nvarchar(4000),@p1138 nvarchar(4000),@p1139 nvarchar(4000),@p1140 decimal(18,2),@p1141 decimal(18,2),@p1142 nvarchar(4000),@p1143 nvarchar(4000),@p1144 decimal(18,2),@p1145 nvarchar(4000),@p1146 nvarchar(4000),@p1147 nvarchar(4000),@p1148 nvarchar(4000),@p1149 int,@p1150 nvarchar(4000),@p1151 nvarchar(4000),@p1152 nvarchar(4000),@p1153 nvarchar(4000),@p1154 nvarchar(4000),@p1155 nvarchar(4000),@p1156 nvarchar(4000),@p1157 nvarchar(4000),@p1158 nvarchar(4000),@p1159 nvarchar(4000),@p1160 int,@p1161 nvarchar(4000),@p1162 nvarchar(4000),@p1163 nvarchar(4000),@p1164 nvarchar(4000),@p1165 nvarchar(4000),@p1166 int,@p1167 nvarchar(4000),@p1168 int,@p1169 int,@p1170 datetime2(7),@p1171 datetime2(7),@p1172 datetime2(7),@p1173 nvarchar(4000),@p1174 nvarchar(4000),@p1175 nvarchar(4000),@p1176 nvarchar(4000),@p1177 nvarchar(4000),@p1178 nvarchar(4000),@p1179 nvarchar(4000),@p1180 nvarchar(4000),@p1181 nvarchar(4000),@p1182 nvarchar(4000),@p1183 nvarchar(4000),@p1184 nvarchar(4000),@p1185 nvarchar(4000),@p1186 nvarchar(4000),@p1187 datetime2(7),@p1188 nvarchar(4000),@p1189 nvarchar(4000),@p1190 int,@p1191 int,@p1192 int,@p1193 nvarchar(4000),@p1194 nvarchar(4000),@p1195 nvarchar(4000),@p1196 decimal(18,2),@p1197 decimal(18,2),@p1198 nvarchar(4000),@p1199 nvarchar(4000),@p1200 decimal(18,2),@p1201 nvarchar(4000),@p1202 nvarchar(4000),@p1203 nvarchar(4000),@p1204 nvarchar(4000),@p1205 int,@p1206 nvarchar(4000),@p1207 nvarchar(4000),@p1208 nvarchar(4000),@p1209 nvarchar(4000),@p1210 nvarchar(4000),@p1211 nvarchar(4000),@p1212 nvarchar(4000),@p1213 nvarchar(4000),@p1214 nvarchar(4000),@p1215 nvarchar(4000),@p1216 int,@p1217 nvarchar(4000),@p1218 nvarchar(4000),@p1219 nvarchar(4000),@p1220 nvarchar(4000),@p1221 nvarchar(4000),@p1222 int,@p1223 nvarchar(4000),@p1224 int,@p1225 int,@p1226 datetime2(7),@p1227 datetime2(7),@p1228 datetime2(7),@p1229 nvarchar(4000),@p1230 nvarchar(4000),@p1231 nvarchar(4000),@p1232 nvarchar(4000),@p1233 nvarchar(4000),@p1234 nvarchar(4000),@p1235 nvarchar(4000),@p1236 nvarchar(4000),@p1237 nvarchar(4000),@p1238 nvarchar(4000),@p1239 nvarchar(4000),@p1240 nvarchar(4000),@p1241 nvarchar(4000),@p1242 nvarchar(4000),@p1243 datetime2(7),@p1244 nvarchar(4000),@p1245 nvarchar(4000),@p1246 int,@p1247 int,@p1248 int,@p1249 nvarchar(4000),@p1250 nvarchar(4000),@p1251 nvarchar(4000),@p1252 decimal(18,2),@p1253 decimal(18,2),@p1254 nvarchar(4000),@p1255 nvarchar(4000),@p1256 decimal(18,2),@p1257 nvarchar(4000),@p1258 nvarchar(4000),@p1259 nvarchar(4000),@p1260 nvarchar(4000),@p1261 int,@p1262 nvarchar(4000),@p1263 nvarchar(4000),@p1264 nvarchar(4000),@p1265 nvarchar(4000),@p1266 nvarchar(4000),@p1267 nvarchar(4000),@p1268 nvarchar(4000),@p1269 nvarchar(4000),@p1270 nvarchar(4000),@p1271 nvarchar(4000),@p1272 int,@p1273 nvarchar(4000),@p1274 nvarchar(4000),@p1275 nvarchar(4000),@p1276 nvarchar(4000),@p1277 nvarchar(4000),@p1278 int,@p1279 nvarchar(4000),@p1280 int,@p1281 int,@p1282 datetime2(7),@p1283 datetime2(7),@p1284 datetime2(7),@p1285 nvarchar(4000),@p1286 nvarchar(4000),@p1287 nvarchar(4000),@p1288 nvarchar(4000),@p1289 nvarchar(4000),@p1290 nvarchar(4000),@p1291 nvarchar(4000),@p1292 nvarchar(4000),@p1293 nvarchar(4000),@p1294 nvarchar(4000),@p1295 nvarchar(4000),@p1296 nvarchar(4000),@p1297 nvarchar(4000),@p1298 nvarchar(4000),@p1299 datetime2(7),@p1300 nvarchar(4000),@p1301 nvarchar(4000),@p1302 int,@p1303 int,@p1304 int,@p1305 nvarchar(4000),@p1306 nvarchar(4000),@p1307 nvarchar(4000),@p1308 decimal(18,2),@p1309 decimal(18,2),@p1310 nvarchar(4000),@p1311 nvarchar(4000),@p1312 decimal(18,2),@p1313 nvarchar(4000),@p1314 nvarchar(4000),@p1315 nvarchar(4000),@p1316 nvarchar(4000),@p1317 int,@p1318 nvarchar(4000),@p1319 nvarchar(4000),@p1320 nvarchar(4000),@p1321 nvarchar(4000),@p1322 nvarchar(4000),@p1323 nvarchar(4000),@p1324 nvarchar(4000),@p1325 nvarchar(4000),@p1326 nvarchar(4000),@p1327 nvarchar(4000),@p1328 int,@p1329 nvarchar(4000),@p1330 nvarchar(4000),@p1331 nvarchar(4000),@p1332 nvarchar(4000),@p1333 nvarchar(4000),@p1334 int,@p1335 nvarchar(4000),@p1336 int,@p1337 int,@p1338 datetime2(7),@p1339 datetime2(7),@p1340 datetime2(7),@p1341 nvarchar(4000),@p1342 nvarchar(4000),@p1343 nvarchar(4000),@p1344 nvarchar(4000),@p1345 nvarchar(4000),@p1346 nvarchar(4000),@p1347 nvarchar(4000),@p1348 nvarchar(4000),@p1349 nvarchar(4000),@p1350 nvarchar(4000),@p1351 nvarchar(4000),@p1352 nvarchar(4000),@p1353 nvarchar(4000),@p1354 nvarchar(4000),@p1355 datetime2(7),@p1356 nvarchar(4000),@p1357 nvarchar(4000),@p1358 int,@p1359 int,@p1360 int,@p1361 nvarchar(4000),@p1362 nvarchar(4000),@p1363 nvarchar(4000),@p1364 decimal(18,2),@p1365 decimal(18,2),@p1366 nvarchar(4000),@p1367 nvarchar(4000),@p1368 decimal(18,2),@p1369 nvarchar(4000),@p1370 nvarchar(4000),@p1371 nvarchar(4000),@p1372 nvarchar(4000),@p1373 int,@p1374 nvarchar(4000),@p1375 nvarchar(4000),@p1376 nvarchar(4000),@p1377 nvarchar(4000),@p1378 nvarchar(4000),@p1379 nvarchar(4000),@p1380 nvarchar(4000),@p1381 nvarchar(4000),@p1382 nvarchar(4000),@p1383 nvarchar(4000),@p1384 int,@p1385 nvarchar(4000),@p1386 nvarchar(4000),@p1387 nvarchar(4000),@p1388 nvarchar(4000),@p1389 nvarchar(4000),@p1390 int,@p1391 nvarchar(4000),@p1392 int,@p1393 int,@p1394 datetime2(7),@p1395 datetime2(7),@p1396 datetime2(7),@p1397 nvarchar(4000),@p1398 nvarchar(4000),@p1399 nvarchar(4000),@p1400 nvarchar(4000),@p1401 nvarchar(4000),@p1402 nvarchar(4000),@p1403 nvarchar(4000),@p1404 nvarchar(4000),@p1405 nvarchar(4000),@p1406 nvarchar(4000),@p1407 nvarchar(4000),@p1408 nvarchar(4000),@p1409 nvarchar(4000),@p1410 nvarchar(4000),@p1411 datetime2(7),@p1412 nvarchar(4000),@p1413 nvarchar(4000),@p1414 int,@p1415 int,@p1416 int,@p1417 nvarchar(4000),@p1418 nvarchar(4000),@p1419 nvarchar(4000),@p1420 decimal(18,2),@p1421 decimal(18,2),@p1422 nvarchar(4000),@p1423 nvarchar(4000),@p1424 decimal(18,2),@p1425 nvarchar(4000),@p1426 nvarchar(4000),@p1427 nvarchar(4000),@p1428 nvarchar(4000),@p1429 int,@p1430 nvarchar(4000),@p1431 nvarchar(4000),@p1432 nvarchar(4000),@p1433 nvarchar(4000),@p1434 nvarchar(4000),@p1435 nvarchar(4000),@p1436 nvarchar(4000),@p1437 nvarchar(4000),@p1438 nvarchar(4000),@p1439 nvarchar(4000),@p1440 int,@p1441 nvarchar(4000),@p1442 nvarchar(4000),@p1443 nvarchar(4000),@p1444 nvarchar(4000),@p1445 nvarchar(4000),@p1446 int,@p1447 nvarchar(4000),@p1448 int,@p1449 int,@p1450 datetime2(7),@p1451 datetime2(7),@p1452 datetime2(7),@p1453 nvarchar(4000),@p1454 nvarchar(4000),@p1455 nvarchar(4000),@p1456 nvarchar(4000),@p1457 nvarchar(4000),@p1458 nvarchar(4000),@p1459 nvarchar(4000),@p1460 nvarchar(4000),@p1461 nvarchar(4000),@p1462 nvarchar(4000),@p1463 nvarchar(4000),@p1464 nvarchar(4000),@p1465 nvarchar(4000),@p1466 nvarchar(4000),@p1467 datetime2(7),@p1468 nvarchar(4000),@p1469 nvarchar(4000),@p1470 int,@p1471 int,@p1472 int,@p1473 nvarchar(4000),@p1474 nvarchar(4000),@p1475 nvarchar(4000),@p1476 decimal(18,2),@p1477 decimal(18,2),@p1478 nvarchar(4000),@p1479 nvarchar(4000),@p1480 decimal(18,2),@p1481 nvarchar(4000),@p1482 nvarchar(4000),@p1483 nvarchar(4000),@p1484 nvarchar(4000),@p1485 int,@p1486 nvarchar(4000),@p1487 nvarchar(4000),@p1488 nvarchar(4000),@p1489 nvarchar(4000),@p1490 nvarchar(4000),@p1491 nvarchar(4000),@p1492 nvarchar(4000),@p1493 nvarchar(4000),@p1494 nvarchar(4000),@p1495 nvarchar(4000),@p1496 int,@p1497 nvarchar(4000),@p1498 nvarchar(4000),@p1499 nvarchar(4000),@p1500 nvarchar(4000),@p1501 nvarchar(4000),@p1502 int,@p1503 nvarchar(4000),@p1504 int,@p1505 int,@p1506 datetime2(7),@p1507 datetime2(7),@p1508 datetime2(7),@p1509 nvarchar(4000),@p1510 nvarchar(4000),@p1511 nvarchar(4000),@p1512 nvarchar(4000),@p1513 nvarchar(4000),@p1514 nvarchar(4000),@p1515 nvarchar(4000),@p1516 nvarchar(4000),@p1517 nvarchar(4000),@p1518 nvarchar(4000),@p1519 nvarchar(4000),@p1520 nvarchar(4000),@p1521 nvarchar(4000),@p1522 nvarchar(4000),@p1523 datetime2(7),@p1524 nvarchar(4000),@p1525 nvarchar(4000),@p1526 int,@p1527 int,@p1528 int,@p1529 nvarchar(4000),@p1530 nvarchar(4000),@p1531 nvarchar(4000),@p1532 decimal(18,2),@p1533 decimal(18,2),@p1534 nvarchar(4000),@p1535 nvarchar(4000),@p1536 decimal(18,2),@p1537 nvarchar(4000),@p1538 nvarchar(4000),@p1539 nvarchar(4000),@p1540 nvarchar(4000),@p1541 int,@p1542 nvarchar(4000),@p1543 nvarchar(4000),@p1544 nvarchar(4000),@p1545 nvarchar(4000),@p1546 nvarchar(4000),@p1547 nvarchar(4000),@p1548 nvarchar(4000),@p1549 nvarchar(4000),@p1550 nvarchar(4000),@p1551 nvarchar(4000),@p1552 int,@p1553 nvarchar(4000),@p1554 nvarchar(4000),@p1555 nvarchar(4000),@p1556 nvarchar(4000),@p1557 nvarchar(4000),@p1558 int,@p1559 nvarchar(4000),@p1560 int,@p1561 int,@p1562 datetime2(7),@p1563 datetime2(7),@p1564 datetime2(7),@p1565 nvarchar(4000),@p1566 nvarchar(4000),@p1567 nvarchar(4000),@p1568 nvarchar(4000),@p1569 nvarchar(4000),@p1570 nvarchar(4000),@p1571 nvarchar(4000),@p1572 nvarchar(4000),@p1573 nvarchar(4000),@p1574 nvarchar(4000),@p1575 nvarchar(4000),@p1576 nvarchar(4000),@p1577 nvarchar(4000),@p1578 nvarchar(4000),@p1579 datetime2(7),@p1580 nvarchar(4000),@p1581 nvarchar(4000),@p1582 int,@p1583 int,@p1584 int,@p1585 nvarchar(4000),@p1586 nvarchar(4000),@p1587 nvarchar(4000),@p1588 nvarchar(4000),@p1589 decimal(18,2),@p1590 nvarchar(4000),@p1591 nvarchar(4000),@p1592 decimal(18,2),@p1593 nvarchar(4000),@p1594 nvarchar(4000),@p1595 nvarchar(4000),@p1596 nvarchar(4000),@p1597 int,@p1598 nvarchar(4000),@p1599 nvarchar(4000),@p1600 nvarchar(4000),@p1601 nvarchar(4000),@p1602 nvarchar(4000),@p1603 nvarchar(4000),@p1604 nvarchar(4000),@p1605 nvarchar(4000),@p1606 nvarchar(4000),@p1607 nvarchar(4000),@p1608 int,@p1609 nvarchar(4000),@p1610 nvarchar(4000),@p1611 nvarchar(4000),@p1612 nvarchar(4000),@p1613 nvarchar(4000),@p1614 int,@p1615 nvarchar(4000),@p1616 int,@p1617 int,@p1618 datetime2(7),@p1619 datetime2(7),@p1620 datetime2(7),@p1621 nvarchar(4000),@p1622 nvarchar(4000),@p1623 nvarchar(4000))SET NOCOUNT ON; DECLARE @inserted0 TABLE ([item_id] int, [_Position] [int]); MERGE [raw_data] USING ( VALUES (@p0, @p1, @p2, @p3, @p4, @p5, @p6, @p7, @p8, @p9, @p10, @p11, @p12, @p13, @p14, @p15, @p16, @p17, @p18, @p19, @p20, @p21, @p22, @p23, @p24, @p25, @p26, @p27, @p28, @p29, @p30, @p31, @p32, @p33, @p34, @p35, @p36, @p37, @p38, @p39, @p40, @p41, @p42, @p43, @p44, @p45, @p46, @p47, @p48, @p49, @p50, @p51, @p52, @p53, @p54, @p55, 0), (@p56, @p57, @p58, @p59, @p60, @p61, @p62, @p63, @p64, @p65, @p66, @p67, @p68, @p69, @p70, @p71, @p72, @p73, @p74, @p75, @p76, @p77, @p78, @p79, @p80, @p81, @p82, @p83, @p84, @p85, @p86, @p87, @p88, @p89, @p90, @p91, @p92, @p93, @p94, @p95, @p96, @p97, @p98, @p99, @p100, @p101, @p102, @p103, @p104, @p105, @p106, @p107, @p108, @p109, @p110, @p111, 1), (@p112, @p113, @p114, @p115, @p116, @p117, @p118, @p119, @p120, @p121, @p122, @p123, @p124, @p125, @p126, @p127, @p128, @p129, @p130, @p131, @p132, @p133, @p134, @p135, @p136, @p137, @p138, @p139, @p140, @p141, @p142, @p143, @p144, @p145, @p146, @p147, @p148, @p149, @p150, @p151, @p152, @p153, @p154, @p155, @p156, @p157, @p158, @p159, @p160, @p161, @p162, @p163, @p164, @p165, @p166, @p167, 2), (@p168, @p169, @p170, @p171, @p172, @p173, @p174, @p175, @p176, @p177, @p178, @p179, @p180, @p181, @p182, @p183, @p184, @p185, @p186, @p187, @p188, @p189, @p190, @p191, @p192, @p193, @p194, @p195, @p196, @p197, @p198, @p199, @p200, @p201, @p202, @p203, @p204, @p205, @p206, @p207, @p208, @p209, @p210, @p211, @p212, @p213, @p214, @p215, @p216, @p217, @p218, @p219, @p220, @p221, @p222, @p223, 3), (@p224, @p225, @p226, @p227, @p228, @p229, @p230, @p231, @p232, @p233, @p234, @p235, @p236, @p237, @p238, @p239, @p240, @p241, @p242, @p243, @p244, @p245, @p246, @p247, @p248, @p249, @p250, @p251, @p252, @p253, @p254, @p255, @p256, @p257, @p258, @p259, @p260, @p261, @p262, @p263, @p264, @p265, @p266, @p267, @p268, @p269, @p270, @p271, @p272, @p273, @p274, @p275, @p276, @p277, @p278, @p279, 4), (@p280, @p281, @p282, @p283, @p284, @p285, @p286, @p287, @p288, @p289, @p290, @p291, @p292, @p293, @p294, @p295, @p296, @p297, @p298, @p299, @p300, @p301, @p302, @p303, @p304, @p305, @p306, @p307, @p308, @p309, @p310, @p311, @p312, @p313, @p314, @p315, @p316, @p317, @p318, @p319, @p320, @p321, @p322, @p323, @p324, @p325, @p326, @p327, @p328, @p329, @p330, @p331, @p332, @p333, @p334, @p335, 5), (@p336, @p337, @p338, @p339, @p340, @p341, @p342, @p343, @p344, @p345, @p346, @p347, @p348, @p349, @p350, @p351, @p352, @p353, @p354, @p355, @p356, @p357, @p358, @p359, @p360, @p361, @p362, @p363, @p364, @p365, @p366, @p367, @p368, @p369, @p370, @p371, @p372, @p373, @p374, @p375, @p376, @p377, @p378, @p379, @p380, @p381, @p382, @p383, @p384, @p385, @p386, @p387, @p388, @p389, @p390, @p391, 6), (@p392, @p393, @p394, @p395, @p396, @p397, @p398, @p399, @p400, @p401, @p402, @p403, @p404, @p405, @p406, @p407, @p408, @p409, @p410, @p411, @p412, @p413, @p414, @p415, @p416, @p417, @p418, @p419, @p420, @p421, @p422, @p423, @p424, @p425, @p426, @p427, @p428, @p429, @p430, @p431, @p432, @p433, @p434, @p435, @p436, @p437, @p438, @p439, @p440, @p441, @p442, @p443, @p444, @p445, @p446, @p447, 7), (@p448, @p449, @p450, @p451, @p452, @p453, @p454, @p455, @p456, @p457, @p458, @p459, @p460, @p461, @p462, @p463, @p464, @p465, @p466, @p467, @p468, @p469, @p470, @p471, @p472, @p473, @p474, @p475, @p476, @p477, @p478, @p479, @p480, @p481, @p482, @p483, @p484, @p485, @p486, @p487, @p488, @p489, @p490, @p491, @p492, @p493, @p494, @p495, @p496, @p497, @p498, @p499, @p500, @p501, @p502, @p503, 8), (@p504, @p505, @p506, @p507, @p508, @p509, @p510, @p511, @p512, @p513, @p514, @p515, @p516, @p517, @p518, @p519, @p520, @p521, @p522, @p523, @p524, @p525, @p526, @p527, @p528, @p529, @p530, @p531, @p532, @p533, @p534, @p535, @p536, @p537, @p538, @p539, @p540, @p541, @p542, @p543, @p544, @p545, @p546, @p547, @p548, @p549, @p550, @p551, @p552, @p553, @p554, @p555, @p556, @p557, @p558, @p559, 9), (@p560, @p561, @p562, @p563, @p564, @p565, @p566, @p567, @p568, @p569, @p570, @p571, @p572, @p573, @p574, @p575, @p576, @p577, @p578, @p579, @p580, @p581, @p582, @p583, @p584, @p585, @p586, @p587, @p588, @p589, @p590, @p591, @p592, @p593, @p594, @p595, @p596, @p597, @p598, @p599, @p600, @p601, @p602, @p603, @p604, @p605, @p606, @p607, @p608, @p609, @p610, @p611, @p612, @p613, @p614, @p615, 10), (@p616, @p617, @p618, @p619, @p620, @p621, @p622, @p623, @p624, @p625, @p626, @p627, @p628, @p629, @p630, @p631, @p632, @p633, @p634, @p635, @p636, @p637, @p638, @p639, @p640, @p641, @p642, @p643, @p644, @p645, @p646, @p647, @p648, @p649, @p650, @p651, @p652, @p653, @p654, @p655, @p656, @p657, @p658, @p659, @p660, @p661, @p662, @p663, @p664, @p665, @p666, @p667, @p668, @p669, @p670, @p671, 11), (@p672, @p673, @p674, @p675, @p676, @p677, @p678, @p679, @p680, @p681, @p682, @p683, @p684, @p685, @p686, @p687, @p688, @p689, @p690, @p691, @p692, @p693, @p694, @p695, @p696, @p697, @p698, @p699, @p700, @p701, @p702, @p703, @p704, @p705, @p706, @p707, @p708, @p709, @p710, @p711, @p712, @p713, @p714, @p715, @p716, @p717, @p718, @p719, @p720, @p721, @p722, @p723, @p724, @p725, @p726, @p727, 12), (@p728, @p729, @p730, @p731, @p732, @p733, @p734, @p735, @p736, @p737, @p738, @p739, @p740, @p741, @p742, @p743, @p744, @p745, @p746, @p747, @p748, @p749, @p750, @p751, @p752, @p753, @p754, @p755, @p756, @p757, @p758, @p759, @p760, @p761, @p762, @p763, @p764, @p765, @p766, @p767, @p768, @p769, @p770, @p771, @p772, @p773, @p774, @p775, @p776, @p777, @p778, @p779, @p780, @p781, @p782, @p783, 13), (@p784, @p785, @p786, @p787, @p788, @p789, @p790, @p791, @p792, @p793, @p794, @p795, @p796, @p797, @p798, @p799, @p800, @p801, @p802, @p803, @p804, @p805, @p806, @p807, @p808, @p809, @p810, @p811, @p812, @p813, @p814, @p815, @p816, @p817, @p818, @p819, @p820, @p821, @p822, @p823, @p824, @p825, @p826, @p827, @p828, @p829, @p830, @p831, @p832, @p833, @p834, @p835, @p836, @p837, @p838, @p839, 14), (@p840, @p841, @p842, @p843, @p844, @p845, @p846, @p847, @p848, @p849, @p850, @p851, @p852, @p853, @p854, @p855, @p856, @p857, @p858, @p859, @p860, @p861, @p862, @p863, @p864, @p865, @p866, @p867, @p868, @p869, @p870, @p871, @p872, @p873, @p874, @p875, @p876, @p877, @p878, @p879, @p880, @p881, @p882, @p883, @p884, @p885, @p886, @p887, @p888, @p889, @p890, @p891, @p892, @p893, @p894, @p895, 15), (@p896, @p897, @p898, @p899, @p900, @p901, @p902, @p903, @p904, @p905, @p906, @p907, @p908, @p909, @p910, @p911, @p912, @p913, @p914, @p915, @p916, @p917, @p918, @p919, @p920, @p921, @p922, @p923, @p924, @p925, @p926, @p927, @p928, @p929, @p930, @p931, @p932, @p933, @p934, @p935, @p936, @p937, @p938, @p939, @p940, @p941, @p942, @p943, @p944, @p945, @p946, @p947, @p948, @p949, @p950, @p951, 16), (@p952, @p953, @p954, @p955, @p956, @p957, @p958, @p959, @p960, @p961, @p962, @p963, @p964, @p965, @p966, @p967, @p968, @p969, @p970, @p971, @p972, @p973, @p974, @p975, @p976, @p977, @p978, @p979, @p980, @p981, @p982, @p983, @p984, @p985, @p986, @p987, @p988, @p989, @p990, @p991, @p992, @p993, @p994, @p995, @p996, @p997, @p998, @p999, @p1000, @p1001, @p1002, @p1003, @p1004, @p1005, @p1006, @p1007, 17), (@p1008, @p1009, @p1010, @p1011, @p1012, @p1013, @p1014, @p1015, @p1016, @p1017, @p1018, @p1019, @p1020, @p1021, @p1022, @p1023, @p1024, @p1025, @p1026, @p1027, @p1028, @p1029, @p1030, @p1031, @p1032, @p1033, @p1034, @p1035, @p1036, @p1037, @p1038, @p1039, @p1040, @p1041, @p1042, @p1043, @p1044, @p1045, @p1046, @p1047, @p1048, @p1049, @p1050, @p1051, @p1052, @p1053, @p1054, @p1055, @p1056, @p1057, @p1058, @p1059, @p1060, @p1061, @p1062, @p1063, 18), (@p1064, @p1065, @p1066, @p1067, @p1068, @p1069, @p1070, @p1071, @p1072, @p1073, @p1074, @p1075, @p1076, @p1077, @p1078, @p1079, @p1080, @p1081, @p1082, @p1083, @p1084, @p1085, @p1086, @p1087, @p1088, @p1089, @p1090, @p1091, @p1092, @p1093, @p1094, @p1095, @p1096, @p1097, @p1098, @p1099, @p1100, @p1101, @p1102, @p1103, @p1104, @p1105, @p1106, @p1107, @p1108, @p1109, @p1110, @p1111, @p1112, @p1113, @p1114, @p1115, @p1116, @p1117, @p1118, @p1119, 19), (@p1120, @p1121, @p1122, @p1123, @p1124, @p1125, @p1126, @p1127, @p1128, @p1129, @p1130, @p1131, @p1132, @p1133, @p1134, @p1135, @p1136, @p1137, @p1138, @p1139, @p1140, @p1141, @p1142, @p1143, @p1144, @p1145, @p1146, @p1147, @p1148, @p1149, @p1150, @p1151, @p1152, @p1153, @p1154, @p1155, @p1156, @p1157, @p1158, @p1159, @p1160, @p1161, @p1162, @p1163, @p1164, @p1165, @p1166, @p1167, @p1168, @p1169, @p1170, @p1171, @p1172, @p1173, @p1174, @p1175, 20), (@p1176, @p1177, @p1178, @p1179, @p1180, @p1181, @p1182, @p1183, @p1184, @p1185, @p1186, @p1187, @p1188, @p1189, @p1190, @p1191, @p1192, @p1193, @p1194, @p1195, @p1196, @p1197, @p1198, @p1199, @p1200, @p1201, @p1202, @p1203, @p1204, @p1205, @p1206, @p1207, @p1208, @p1209, @p1210, @p1211, @p1212, @p1213, @p1214, @p1215, @p1216, @p1217, @p1218, @p1219, @p1220, @p1221, @p1222, @p1223, @p1224, @p1225, @p1226, @p1227, @p1228, @p1229, @p1230, @p1231, 21), (@p1232, @p1233, @p1234, @p1235, @p1236, @p1237, @p1238, @p1239, @p1240, @p1241, @p1242, @p1243, @p1244, @p1245, @p1246, @p1247, @p1248, @p1249, @p1250, @p1251, @p1252, @p1253, @p1254, @p1255, @p1256, @p1257, @p1258, @p1259, @p1260, @p1261, @p1262, @p1263, @p1264, @p1265, @p1266, @p1267, @p1268, @p1269, @p1270, @p1271, @p1272, @p1273, @p1274, @p1275, @p1276, @p1277, @p1278, @p1279, @p1280, @p1281, @p1282, @p1283, @p1284, @p1285, @p1286, @p1287, 22), (@p1288, @p1289, @p1290, @p1291, @p1292, @p1293, @p1294, @p1295, @p1296, @p1297, @p1298, @p1299, @p1300, @p1301, @p1302, @p1303, @p1304, @p1305, @p1306, @p1307, @p1308, @p1309, @p1310, @p1311, @p1312, @p1313, @p1314, @p1315, @p1316, @p1317, @p1318, @p1319, @p1320, @p1321, @p1322, @p1323, @p1324, @p1325, @p1326, @p1327, @p1328, @p1329, @p1330, @p1331, @p1332, @p1333, @p1334, @p1335, @p1336, @p1337, @p1338, @p1339, @p1340, @p1341, @p1342, @p1343, 23), (@p1344, @p1345, @p1346, @p1347, @p1348, @p1349, @p1350, @p1351, @p1352, @p1353, @p1354, @p1355, @p1356, @p1357, @p1358, @p1359, @p1360, @p1361, @p1362, @p1363, @p1364, @p1365, @p1366, @p1367, @p1368, @p1369, @p1370, @p1371, @p1372, @p1373, @p1374, @p1375, @p1376, @p1377, @p1378, @p1379, @p1380, @p1381, @p1382, @p1383, @p1384, @p1385, @p1386, @p1387, @p1388, @p1389, @p1390, @p1391, @p1392, @p1393, @p1394, @p1395, @p1396, @p1397, @p1398, @p1399, 24), (@p1400, @p1401, @p1402, @p1403, @p1404, @p1405, @p1406, @p1407, @p1408, @p1409, @p1410, @p1411, @p1412, @p1413, @p1414, @p1415, @p1416, @p1417, @p1418, @p1419, @p1420, @p1421, @p1422, @p1423, @p1424, @p1425, @p1426, @p1427, @p1428, @p1429, @p1430, @p1431, @p1432, @p1433, @p1434, @p1435, @p1436, @p1437, @p1438, @p1439, @p1440, @p1441, @p1442, @p1443, @p1444, @p1445, @p1446, @p1447, @p1448, @p1449, @p1450, @p1451, @p1452, @p1453, @p1454, @p1455, 25), (@p1456, @p1457, @p1458, @p1459, @p1460, @p1461, @p1462, @p1463, @p1464, @p1465, @p1466, @p1467, @p1468, @p1469, @p1470, @p1471, @p1472, @p1473, @p1474, @p1475, @p1476, @p1477, @p1478, @p1479, @p1480, @p1481, @p1482, @p1483, @p1484, @p1485, @p1486, @p1487, @p1488, @p1489, @p1490, @p1491, @p1492, @p1493, @p1494, @p1495, @p1496, @p1497, @p1498, @p1499, @p1500, @p1501, @p1502, @p1503, @p1504, @p1505, @p1506, @p1507, @p1508, @p1509, @p1510, @p1511, 26), (@p1512, @p1513, @p1514, @p1515, @p1516, @p1517, @p1518, @p1519, @p1520, @p1521, @p1522, @p1523, @p1524, @p1525, @p1526, @p1527, @p1528, @p1529, @p1530, @p1531, @p1532, @p1533, @p1534, @p1535, @p1536, @p1537, @p1538, @p1539, @p1540, @p1541, @p1542, @p1543, @p1544, @p1545, @p1546, @p1547, @p1548, @p1549, @p1550, @p1551, @p1552, @p1553, @p1554, @p1555, @p1556, @p1557, @p1558, @p1559, @p1560, @p1561, @p1562, @p1563, @p1564, @p1565, @p1566, @p1567, 27), (@p1568, @p1569, @p1570, @p1571, @p1572, @p1573, @p1574, @p1575, @p1576, @p1577, @p1578, @p1579, @p1580, @p1581, @p1582, @p1583, @p1584, @p1585, @p1586, @p1587, @p1588, @p1589, @p1590, @p1591, @p1592, @p1593, @p1594, @p1595, @p1596, @p1597, @p1598, @p1599, @p1600, @p1601, @p1602, @p1603, @p1604, @p1605, @p1606, @p1607, @p1608, @p1609, @p1610, @p1611, @p1612, @p1613, @p1614, @p1615, @p1616, @p1617, @p1618, @p1619, @p1620, @p1621, @p1622, @p1623, 28)) AS i ([addressee_cntry_cd], [addressee_city], [addressee_district], [addressee_email], [addressee_full_address], [addressee_home_address], [addressee_name], [addressee_postcode], [addressee_province], [addressee_subdistrict], [addressee_tel], [create_table], [delivery_code], [delivery_recipient_name], [delivery_relation_id], [delivery_status_id], [dest_outlet_id], [dest_outlet_port], [document_number], [item_barcode], [item_cod], [item_gross_weight], [item_height], [item_length], [item_price], [item_width], [lat], [log_id], [long], [outlet_id], [outlet_port], [podUrl], [remark], [scan_cntry_cd], [scan_cntry_postcode], [sender_cntry_cd], [sender_district], [sender_email], [sender_full_address], [sender_home_address], [member_id], [sender_name], [sender_postcode], [sender_province], [sender_subdistrict], [sender_tel], [server_id], [signatureUrl], [state], [status_code], [status_dtm], [timestamp], [transmit_dtm], [user_id], [wckt_id], [wkstn_no], _Position) ON 1=0 WHEN NOT MATCHED THEN INSERT ([addressee_cntry_cd], [addressee_city], [addressee_district], [addressee_email], [addressee_full_address], [addressee_home_address], [addressee_name], [addressee_postcode], [addressee_province], [addressee_subdistrict], [addressee_tel], [create_table], [delivery_code], [delivery_recipient_name], [delivery_relation_id], [delivery_status_id], [dest_outlet_id], [dest_outlet_port], [document_number], [item_barcode], [item_cod], [item_gross_weight], [item_height], [item_length], [item_price], [item_width], [lat], [log_id], [long], [outlet_id], [outlet_port], [podUrl], [remark], [scan_cntry_cd], [scan_cntry_postcode], [sender_cntry_cd], [sender_district], [sender_email], [sender_full_address], [sender_home_address], [member_id], [sender_name], [sender_postcode], [sender_province], [sender_subdistrict], [sender_tel], [server_id], [signatureUrl], [state], [status_code], [status_dtm], [timestamp], [transmit_dtm], [user_id], [wckt_id], [wkstn_no]) VALUES (i.[addressee_cntry_cd], i.[addressee_city], i.[addressee_district], i.[addressee_email], i.[addressee_full_address], i.[addressee_home_address], i.[addressee_name], i.[addressee_postcode], i.[addressee_province], i.[addressee_subdistrict], i.[addressee_tel], i.[create_table], i.[delivery_code], i.[delivery_recipient_name], i.[delivery_relation_id], i.[delivery_status_id], i.[dest_outlet_id], i.[dest_outlet_port], i.[document_number], i.[item_barcode], i.[item_cod], i.[item_gross_weight], i.[item_height], i.[item_length], i.[item_price], i.[item_width], i.[lat], i.[log_id], i.[long], i.[outlet_id], i.[outlet_port], i.[podUrl], i.[remark], i.[scan_cntry_cd], i.[scan_cntry_postcode], i.[sender_cntry_cd], i.[sender_district], i.[sender_email], i.[sender_full_address], i.[sender_home_address], i.[member_id], i.[sender_name], i.[sender_postcode], i.[sender_province], i.[sender_subdistrict], i.[sender_tel], i.[server_id], i.[signatureUrl], i.[state], i.[status_code], i.[status_dtm], i.[timestamp], i.[transmit_dtm], i.[user_id], i.[wckt_id], i.[wkstn_no]) OUTPUT INSERTED.[item_id], i._Position INTO @inserted0;  SELECT [t].[item_id] FROM [raw_data] t INNER JOIN @inserted0 i ON ([t].[item_id] = [i].[item_id]) ORDER BY [i].[_Position];  ",6,6,0,356,1,6
"SELECT (SELECT SUM(CAST(df.size as float)) FROM sys.database_files AS df WHERE df.type in ( 0, 2, 4 ) ) AS [DbSize], (SUM(a.total_pages) + (SELECT ISNULL(SUM(CAST(df.size as bigint)), 0) FROM sys.database_files AS df WHERE df.type = 2 )) AS [SpaceUsed] FROM sys.partitions p join sys.allocation_units a on p.partition_id = a.container_id left join sys.internal_tables it on p.object_id = it.object_id",6,6,0,2780,0,6
"(@p0 nvarchar(4000),@p1 nvarchar(4000),@p2 nvarchar(4000),@p3 nvarchar(4000),@p4 nvarchar(4000),@p5 nvarchar(4000),@p6 nvarchar(4000),@p7 nvarchar(4000),@p8 nvarchar(4000),@p9 nvarchar(4000),@p10 nvarchar(4000),@p11 datetime2(7),@p12 nvarchar(4000),@p13 nvarchar(4000),@p14 int,@p15 int,@p16 int,@p17 nvarchar(4000),@p18 nvarchar(4000),@p19 nvarchar(4000),@p20 decimal(18,2),@p21 decimal(18,2),@p22 nvarchar(4000),@p23 nvarchar(4000),@p24 decimal(18,2),@p25 nvarchar(4000),@p26 nvarchar(4000),@p27 nvarchar(4000),@p28 nvarchar(4000),@p29 int,@p30 nvarchar(4000),@p31 nvarchar(4000),@p32 nvarchar(4000),@p33 nvarchar(4000),@p34 nvarchar(4000),@p35 nvarchar(4000),@p36 nvarchar(4000),@p37 nvarchar(4000),@p38 nvarchar(4000),@p39 nvarchar(4000),@p40 int,@p41 nvarchar(4000),@p42 nvarchar(4000),@p43 nvarchar(4000),@p44 nvarchar(4000),@p45 nvarchar(4000),@p46 int,@p47 nvarchar(4000),@p48 int,@p49 int,@p50 datetime2(7),@p51 datetime2(7),@p52 datetime2(7),@p53 nvarchar(4000),@p54 nvarchar(4000),@p55 nvarchar(4000),@p56 nvarchar(4000),@p57 nvarchar(4000),@p58 nvarchar(4000),@p59 nvarchar(4000),@p60 nvarchar(4000),@p61 nvarchar(4000),@p62 nvarchar(4000),@p63 nvarchar(4000),@p64 nvarchar(4000),@p65 nvarchar(4000),@p66 nvarchar(4000),@p67 datetime2(7),@p68 nvarchar(4000),@p69 nvarchar(4000),@p70 int,@p71 int,@p72 int,@p73 nvarchar(4000),@p74 nvarchar(4000),@p75 nvarchar(4000),@p76 decimal(18,2),@p77 decimal(18,2),@p78 nvarchar(4000),@p79 nvarchar(4000),@p80 decimal(18,2),@p81 nvarchar(4000),@p82 nvarchar(4000),@p83 nvarchar(4000),@p84 nvarchar(4000),@p85 int,@p86 nvarchar(4000),@p87 nvarchar(4000),@p88 nvarchar(4000),@p89 nvarchar(4000),@p90 nvarchar(4000),@p91 nvarchar(4000),@p92 nvarchar(4000),@p93 nvarchar(4000),@p94 nvarchar(4000),@p95 nvarchar(4000),@p96 int,@p97 nvarchar(4000),@p98 nvarchar(4000),@p99 nvarchar(4000),@p100 nvarchar(4000),@p101 nvarchar(4000),@p102 int,@p103 nvarchar(4000),@p104 int,@p105 int,@p106 datetime2(7),@p107 datetime2(7),@p108 datetime2(7),@p109 nvarchar(4000),@p110 nvarchar(4000),@p111 nvarchar(4000),@p112 nvarchar(4000),@p113 nvarchar(4000),@p114 nvarchar(4000),@p115 nvarchar(4000),@p116 nvarchar(4000),@p117 nvarchar(4000),@p118 nvarchar(4000),@p119 nvarchar(4000),@p120 nvarchar(4000),@p121 nvarchar(4000),@p122 nvarchar(4000),@p123 datetime2(7),@p124 nvarchar(4000),@p125 nvarchar(4000),@p126 int,@p127 int,@p128 int,@p129 nvarchar(4000),@p130 nvarchar(4000),@p131 nvarchar(4000),@p132 decimal(18,2),@p133 decimal(18,2),@p134 nvarchar(4000),@p135 nvarchar(4000),@p136 decimal(18,2),@p137 nvarchar(4000),@p138 nvarchar(4000),@p139 nvarchar(4000),@p140 nvarchar(4000),@p141 int,@p142 nvarchar(4000),@p143 nvarchar(4000),@p144 nvarchar(4000),@p145 nvarchar(4000),@p146 nvarchar(4000),@p147 nvarchar(4000),@p148 nvarchar(4000),@p149 nvarchar(4000),@p150 nvarchar(4000),@p151 nvarchar(4000),@p152 int,@p153 nvarchar(4000),@p154 nvarchar(4000),@p155 nvarchar(4000),@p156 nvarchar(4000),@p157 nvarchar(4000),@p158 int,@p159 nvarchar(4000),@p160 int,@p161 int,@p162 datetime2(7),@p163 datetime2(7),@p164 datetime2(7),@p165 nvarchar(4000),@p166 nvarchar(4000),@p167 nvarchar(4000),@p168 nvarchar(4000),@p169 nvarchar(4000),@p170 nvarchar(4000),@p171 nvarchar(4000),@p172 nvarchar(4000),@p173 nvarchar(4000),@p174 nvarchar(4000),@p175 nvarchar(4000),@p176 nvarchar(4000),@p177 nvarchar(4000),@p178 nvarchar(4000),@p179 datetime2(7),@p180 nvarchar(4000),@p181 nvarchar(4000),@p182 int,@p183 int,@p184 int,@p185 nvarchar(4000),@p186 nvarchar(4000),@p187 nvarchar(4000),@p188 decimal(18,2),@p189 decimal(18,2),@p190 nvarchar(4000),@p191 nvarchar(4000),@p192 decimal(18,2),@p193 nvarchar(4000),@p194 nvarchar(4000),@p195 nvarchar(4000),@p196 nvarchar(4000),@p197 int,@p198 nvarchar(4000),@p199 nvarchar(4000),@p200 nvarchar(4000),@p201 nvarchar(4000),@p202 nvarchar(4000),@p203 nvarchar(4000),@p204 nvarchar(4000),@p205 nvarchar(4000),@p206 nvarchar(4000),@p207 nvarchar(4000),@p208 int,@p209 nvarchar(4000),@p210 nvarchar(4000),@p211 nvarchar(4000),@p212 nvarchar(4000),@p213 nvarchar(4000),@p214 int,@p215 nvarchar(4000),@p216 int,@p217 int,@p218 datetime2(7),@p219 datetime2(7),@p220 datetime2(7),@p221 nvarchar(4000),@p222 nvarchar(4000),@p223 nvarchar(4000),@p224 nvarchar(4000),@p225 nvarchar(4000),@p226 nvarchar(4000),@p227 nvarchar(4000),@p228 nvarchar(4000),@p229 nvarchar(4000),@p230 nvarchar(4000),@p231 nvarchar(4000),@p232 nvarchar(4000),@p233 nvarchar(4000),@p234 nvarchar(4000),@p235 datetime2(7),@p236 nvarchar(4000),@p237 nvarchar(4000),@p238 int,@p239 int,@p240 int,@p241 nvarchar(4000),@p242 nvarchar(4000),@p243 nvarchar(4000),@p244 decimal(18,2),@p245 decimal(18,2),@p246 nvarchar(4000),@p247 nvarchar(4000),@p248 decimal(18,2),@p249 nvarchar(4000),@p250 nvarchar(4000),@p251 nvarchar(4000),@p252 nvarchar(4000),@p253 int,@p254 nvarchar(4000),@p255 nvarchar(4000),@p256 nvarchar(4000),@p257 nvarchar(4000),@p258 nvarchar(4000),@p259 nvarchar(4000),@p260 nvarchar(4000),@p261 nvarchar(4000),@p262 nvarchar(4000),@p263 nvarchar(4000),@p264 int,@p265 nvarchar(4000),@p266 nvarchar(4000),@p267 nvarchar(4000),@p268 nvarchar(4000),@p269 nvarchar(4000),@p270 int,@p271 nvarchar(4000),@p272 int,@p273 int,@p274 datetime2(7),@p275 datetime2(7),@p276 datetime2(7),@p277 nvarchar(4000),@p278 nvarchar(4000),@p279 nvarchar(4000),@p280 nvarchar(4000),@p281 nvarchar(4000),@p282 nvarchar(4000),@p283 nvarchar(4000),@p284 nvarchar(4000),@p285 nvarchar(4000),@p286 nvarchar(4000),@p287 nvarchar(4000),@p288 nvarchar(4000),@p289 nvarchar(4000),@p290 nvarchar(4000),@p291 datetime2(7),@p292 nvarchar(4000),@p293 nvarchar(4000),@p294 int,@p295 int,@p296 int,@p297 nvarchar(4000),@p298 nvarchar(4000),@p299 nvarchar(4000),@p300 decimal(18,2),@p301 decimal(18,2),@p302 nvarchar(4000),@p303 nvarchar(4000),@p304 decimal(18,2),@p305 nvarchar(4000),@p306 nvarchar(4000),@p307 nvarchar(4000),@p308 nvarchar(4000),@p309 int,@p310 nvarchar(4000),@p311 nvarchar(4000),@p312 nvarchar(4000),@p313 nvarchar(4000),@p314 nvarchar(4000),@p315 nvarchar(4000),@p316 nvarchar(4000),@p317 nvarchar(4000),@p318 nvarchar(4000),@p319 nvarchar(4000),@p320 int,@p321 nvarchar(4000),@p322 nvarchar(4000),@p323 nvarchar(4000),@p324 nvarchar(4000),@p325 nvarchar(4000),@p326 int,@p327 nvarchar(4000),@p328 int,@p329 int,@p330 datetime2(7),@p331 datetime2(7),@p332 datetime2(7),@p333 nvarchar(4000),@p334 nvarchar(4000),@p335 nvarchar(4000),@p336 nvarchar(4000),@p337 nvarchar(4000),@p338 nvarchar(4000),@p339 nvarchar(4000),@p340 nvarchar(4000),@p341 nvarchar(4000),@p342 nvarchar(4000),@p343 nvarchar(4000),@p344 nvarchar(4000),@p345 nvarchar(4000),@p346 nvarchar(4000),@p347 datetime2(7),@p348 nvarchar(4000),@p349 nvarchar(4000),@p350 int,@p351 int,@p352 int,@p353 nvarchar(4000),@p354 nvarchar(4000),@p355 nvarchar(4000),@p356 decimal(18,2),@p357 decimal(18,2),@p358 nvarchar(4000),@p359 nvarchar(4000),@p360 decimal(18,2),@p361 nvarchar(4000),@p362 nvarchar(4000),@p363 nvarchar(4000),@p364 nvarchar(4000),@p365 int,@p366 nvarchar(4000),@p367 nvarchar(4000),@p368 nvarchar(4000),@p369 nvarchar(4000),@p370 nvarchar(4000),@p371 nvarchar(4000),@p372 nvarchar(4000),@p373 nvarchar(4000),@p374 nvarchar(4000),@p375 nvarchar(4000),@p376 int,@p377 nvarchar(4000),@p378 nvarchar(4000),@p379 nvarchar(4000),@p380 nvarchar(4000),@p381 nvarchar(4000),@p382 int,@p383 nvarchar(4000),@p384 int,@p385 int,@p386 datetime2(7),@p387 datetime2(7),@p388 datetime2(7),@p389 nvarchar(4000),@p390 nvarchar(4000),@p391 nvarchar(4000),@p392 nvarchar(4000),@p393 nvarchar(4000),@p394 nvarchar(4000),@p395 nvarchar(4000),@p396 nvarchar(4000),@p397 nvarchar(4000),@p398 nvarchar(4000),@p399 nvarchar(4000),@p400 nvarchar(4000),@p401 nvarchar(4000),@p402 nvarchar(4000),@p403 datetime2(7),@p404 nvarchar(4000),@p405 nvarchar(4000),@p406 int,@p407 int,@p408 int,@p409 nvarchar(4000),@p410 nvarchar(4000),@p411 nvarchar(4000),@p412 decimal(18,2),@p413 decimal(18,2),@p414 nvarchar(4000),@p415 nvarchar(4000),@p416 decimal(18,2),@p417 nvarchar(4000),@p418 nvarchar(4000),@p419 nvarchar(4000),@p420 nvarchar(4000),@p421 int,@p422 nvarchar(4000),@p423 nvarchar(4000),@p424 nvarchar(4000),@p425 nvarchar(4000),@p426 nvarchar(4000),@p427 nvarchar(4000),@p428 nvarchar(4000),@p429 nvarchar(4000),@p430 nvarchar(4000),@p431 nvarchar(4000),@p432 int,@p433 nvarchar(4000),@p434 nvarchar(4000),@p435 nvarchar(4000),@p436 nvarchar(4000),@p437 nvarchar(4000),@p438 int,@p439 nvarchar(4000),@p440 int,@p441 int,@p442 datetime2(7),@p443 datetime2(7),@p444 datetime2(7),@p445 nvarchar(4000),@p446 nvarchar(4000),@p447 nvarchar(4000),@p448 nvarchar(4000),@p449 nvarchar(4000),@p450 nvarchar(4000),@p451 nvarchar(4000),@p452 nvarchar(4000),@p453 nvarchar(4000),@p454 nvarchar(4000),@p455 nvarchar(4000),@p456 nvarchar(4000),@p457 nvarchar(4000),@p458 nvarchar(4000),@p459 datetime2(7),@p460 nvarchar(4000),@p461 nvarchar(4000),@p462 int,@p463 int,@p464 int,@p465 nvarchar(4000),@p466 nvarchar(4000),@p467 nvarchar(4000),@p468 nvarchar(4000),@p469 decimal(18,2),@p470 nvarchar(4000),@p471 nvarchar(4000),@p472 decimal(18,2),@p473 nvarchar(4000),@p474 nvarchar(4000),@p475 nvarchar(4000),@p476 nvarchar(4000),@p477 int,@p478 nvarchar(4000),@p479 nvarchar(4000),@p480 nvarchar(4000),@p481 nvarchar(4000),@p482 nvarchar(4000),@p483 nvarchar(4000),@p484 nvarchar(4000),@p485 nvarchar(4000),@p486 nvarchar(4000),@p487 nvarchar(4000),@p488 int,@p489 nvarchar(4000),@p490 nvarchar(4000),@p491 nvarchar(4000),@p492 nvarchar(4000),@p493 nvarchar(4000),@p494 int,@p495 nvarchar(4000),@p496 int,@p497 int,@p498 datetime2(7),@p499 datetime2(7),@p500 datetime2(7),@p501 nvarchar(4000),@p502 nvarchar(4000),@p503 nvarchar(4000),@p504 nvarchar(4000),@p505 nvarchar(4000),@p506 nvarchar(4000),@p507 nvarchar(4000),@p508 nvarchar(4000),@p509 nvarchar(4000),@p510 nvarchar(4000),@p511 nvarchar(4000),@p512 nvarchar(4000),@p513 nvarchar(4000),@p514 nvarchar(4000),@p515 datetime2(7),@p516 nvarchar(4000),@p517 nvarchar(4000),@p518 int,@p519 int,@p520 int,@p521 nvarchar(4000),@p522 nvarchar(4000),@p523 nvarchar(4000),@p524 nvarchar(4000),@p525 decimal(18,2),@p526 nvarchar(4000),@p527 nvarchar(4000),@p528 decimal(18,2),@p529 nvarchar(4000),@p530 nvarchar(4000),@p531 nvarchar(4000),@p532 nvarchar(4000),@p533 int,@p534 nvarchar(4000),@p535 nvarchar(4000),@p536 nvarchar(4000),@p537 nvarchar(4000),@p538 nvarchar(4000),@p539 nvarchar(4000),@p540 nvarchar(4000),@p541 nvarchar(4000),@p542 nvarchar(4000),@p543 nvarchar(4000),@p544 int,@p545 nvarchar(4000),@p546 nvarchar(4000),@p547 nvarchar(4000),@p548 nvarchar(4000),@p549 nvarchar(4000),@p550 int,@p551 nvarchar(4000),@p552 int,@p553 int,@p554 datetime2(7),@p555 datetime2(7),@p556 datetime2(7),@p557 nvarchar(4000),@p558 nvarchar(4000),@p559 nvarchar(4000),@p560 nvarchar(4000),@p561 nvarchar(4000),@p562 nvarchar(4000),@p563 nvarchar(4000),@p564 nvarchar(4000),@p565 nvarchar(4000),@p566 nvarchar(4000),@p567 nvarchar(4000),@p568 nvarchar(4000),@p569 nvarchar(4000),@p570 nvarchar(4000),@p571 datetime2(7),@p572 nvarchar(4000),@p573 nvarchar(4000),@p574 int,@p575 int,@p576 int,@p577 nvarchar(4000),@p578 nvarchar(4000),@p579 nvarchar(4000),@p580 nvarchar(4000),@p581 decimal(18,2),@p582 nvarchar(4000),@p583 nvarchar(4000),@p584 decimal(18,2),@p585 nvarchar(4000),@p586 nvarchar(4000),@p587 nvarchar(4000),@p588 nvarchar(4000),@p589 int,@p590 nvarchar(4000),@p591 nvarchar(4000),@p592 nvarchar(4000),@p593 nvarchar(4000),@p594 nvarchar(4000),@p595 nvarchar(4000),@p596 nvarchar(4000),@p597 nvarchar(4000),@p598 nvarchar(4000),@p599 nvarchar(4000),@p600 int,@p601 nvarchar(4000),@p602 nvarchar(4000),@p603 nvarchar(4000),@p604 nvarchar(4000),@p605 nvarchar(4000),@p606 int,@p607 nvarchar(4000),@p608 int,@p609 int,@p610 datetime2(7),@p611 datetime2(7),@p612 datetime2(7),@p613 nvarchar(4000),@p614 nvarchar(4000),@p615 nvarchar(4000),@p616 nvarchar(4000),@p617 nvarchar(4000),@p618 nvarchar(4000),@p619 nvarchar(4000),@p620 nvarchar(4000),@p621 nvarchar(4000),@p622 nvarchar(4000),@p623 nvarchar(4000),@p624 nvarchar(4000),@p625 nvarchar(4000),@p626 nvarchar(4000),@p627 datetime2(7),@p628 nvarchar(4000),@p629 nvarchar(4000),@p630 int,@p631 int,@p632 int,@p633 nvarchar(4000),@p634 nvarchar(4000),@p635 nvarchar(4000),@p636 nvarchar(4000),@p637 decimal(18,2),@p638 nvarchar(4000),@p639 nvarchar(4000),@p640 decimal(18,2),@p641 nvarchar(4000),@p642 nvarchar(4000),@p643 nvarchar(4000),@p644 nvarchar(4000),@p645 int,@p646 nvarchar(4000),@p647 nvarchar(4000),@p648 nvarchar(4000),@p649 nvarchar(4000),@p650 nvarchar(4000),@p651 nvarchar(4000),@p652 nvarchar(4000),@p653 nvarchar(4000),@p654 nvarchar(4000),@p655 nvarchar(4000),@p656 int,@p657 nvarchar(4000),@p658 nvarchar(4000),@p659 nvarchar(4000),@p660 nvarchar(4000),@p661 nvarchar(4000),@p662 int,@p663 nvarchar(4000),@p664 int,@p665 int,@p666 datetime2(7),@p667 datetime2(7),@p668 datetime2(7),@p669 nvarchar(4000),@p670 nvarchar(4000),@p671 nvarchar(4000),@p672 nvarchar(4000),@p673 nvarchar(4000),@p674 nvarchar(4000),@p675 nvarchar(4000),@p676 nvarchar(4000),@p677 nvarchar(4000),@p678 nvarchar(4000),@p679 nvarchar(4000),@p680 nvarchar(4000),@p681 nvarchar(4000),@p682 nvarchar(4000),@p683 datetime2(7),@p684 nvarchar(4000),@p685 nvarchar(4000),@p686 int,@p687 int,@p688 int,@p689 nvarchar(4000),@p690 nvarchar(4000),@p691 nvarchar(4000),@p692 nvarchar(4000),@p693 decimal(18,2),@p694 nvarchar(4000),@p695 nvarchar(4000),@p696 decimal(18,2),@p697 nvarchar(4000),@p698 nvarchar(4000),@p699 nvarchar(4000),@p700 nvarchar(4000),@p701 int,@p702 nvarchar(4000),@p703 nvarchar(4000),@p704 nvarchar(4000),@p705 nvarchar(4000),@p706 nvarchar(4000),@p707 nvarchar(4000),@p708 nvarchar(4000),@p709 nvarchar(4000),@p710 nvarchar(4000),@p711 nvarchar(4000),@p712 int,@p713 nvarchar(4000),@p714 nvarchar(4000),@p715 nvarchar(4000),@p716 nvarchar(4000),@p717 nvarchar(4000),@p718 int,@p719 nvarchar(4000),@p720 int,@p721 int,@p722 datetime2(7),@p723 datetime2(7),@p724 datetime2(7),@p725 nvarchar(4000),@p726 nvarchar(4000),@p727 nvarchar(4000),@p728 nvarchar(4000),@p729 nvarchar(4000),@p730 nvarchar(4000),@p731 nvarchar(4000),@p732 nvarchar(4000),@p733 nvarchar(4000),@p734 nvarchar(4000),@p735 nvarchar(4000),@p736 nvarchar(4000),@p737 nvarchar(4000),@p738 nvarchar(4000),@p739 datetime2(7),@p740 nvarchar(4000),@p741 nvarchar(4000),@p742 int,@p743 int,@p744 int,@p745 nvarchar(4000),@p746 nvarchar(4000),@p747 nvarchar(4000),@p748 decimal(18,2),@p749 decimal(18,2),@p750 nvarchar(4000),@p751 nvarchar(4000),@p752 decimal(18,2),@p753 nvarchar(4000),@p754 nvarchar(4000),@p755 nvarchar(4000),@p756 nvarchar(4000),@p757 int,@p758 nvarchar(4000),@p759 nvarchar(4000),@p760 nvarchar(4000),@p761 nvarchar(4000),@p762 nvarchar(4000),@p763 nvarchar(4000),@p764 nvarchar(4000),@p765 nvarchar(4000),@p766 nvarchar(4000),@p767 nvarchar(4000),@p768 int,@p769 nvarchar(4000),@p770 nvarchar(4000),@p771 nvarchar(4000),@p772 nvarchar(4000),@p773 nvarchar(4000),@p774 int,@p775 nvarchar(4000),@p776 int,@p777 int,@p778 datetime2(7),@p779 datetime2(7),@p780 datetime2(7),@p781 nvarchar(4000),@p782 nvarchar(4000),@p783 nvarchar(4000),@p784 nvarchar(4000),@p785 nvarchar(4000),@p786 nvarchar(4000),@p787 nvarchar(4000),@p788 nvarchar(4000),@p789 nvarchar(4000),@p790 nvarchar(4000),@p791 nvarchar(4000),@p792 nvarchar(4000),@p793 nvarchar(4000),@p794 nvarchar(4000),@p795 datetime2(7),@p796 nvarchar(4000),@p797 nvarchar(4000),@p798 int,@p799 int,@p800 int,@p801 nvarchar(4000),@p802 nvarchar(4000),@p803 nvarchar(4000),@p804 nvarchar(4000),@p805 decimal(18,2),@p806 nvarchar(4000),@p807 nvarchar(4000),@p808 decimal(18,2),@p809 nvarchar(4000),@p810 nvarchar(4000),@p811 nvarchar(4000),@p812 nvarchar(4000),@p813 int,@p814 nvarchar(4000),@p815 nvarchar(4000),@p816 nvarchar(4000),@p817 nvarchar(4000),@p818 nvarchar(4000),@p819 nvarchar(4000),@p820 nvarchar(4000),@p821 nvarchar(4000),@p822 nvarchar(4000),@p823 nvarchar(4000),@p824 int,@p825 nvarchar(4000),@p826 nvarchar(4000),@p827 nvarchar(4000),@p828 nvarchar(4000),@p829 nvarchar(4000),@p830 int,@p831 nvarchar(4000),@p832 int,@p833 int,@p834 datetime2(7),@p835 datetime2(7),@p836 datetime2(7),@p837 nvarchar(4000),@p838 nvarchar(4000),@p839 nvarchar(4000),@p840 nvarchar(4000),@p841 nvarchar(4000),@p842 nvarchar(4000),@p843 nvarchar(4000),@p844 nvarchar(4000),@p845 nvarchar(4000),@p846 nvarchar(4000),@p847 nvarchar(4000),@p848 nvarchar(4000),@p849 nvarchar(4000),@p850 nvarchar(4000),@p851 datetime2(7),@p852 nvarchar(4000),@p853 nvarchar(4000),@p854 int,@p855 int,@p856 int,@p857 nvarchar(4000),@p858 nvarchar(4000),@p859 nvarchar(4000),@p860 decimal(18,2),@p861 decimal(18,2),@p862 nvarchar(4000),@p863 nvarchar(4000),@p864 decimal(18,2),@p865 nvarchar(4000),@p866 nvarchar(4000),@p867 nvarchar(4000),@p868 nvarchar(4000),@p869 int,@p870 nvarchar(4000),@p871 nvarchar(4000),@p872 nvarchar(4000),@p873 nvarchar(4000),@p874 nvarchar(4000),@p875 nvarchar(4000),@p876 nvarchar(4000),@p877 nvarchar(4000),@p878 nvarchar(4000),@p879 nvarchar(4000),@p880 int,@p881 nvarchar(4000),@p882 nvarchar(4000),@p883 nvarchar(4000),@p884 nvarchar(4000),@p885 nvarchar(4000),@p886 int,@p887 nvarchar(4000),@p888 int,@p889 int,@p890 datetime2(7),@p891 datetime2(7),@p892 datetime2(7),@p893 nvarchar(4000),@p894 nvarchar(4000),@p895 nvarchar(4000),@p896 nvarchar(4000),@p897 nvarchar(4000),@p898 nvarchar(4000),@p899 nvarchar(4000),@p900 nvarchar(4000),@p901 nvarchar(4000),@p902 nvarchar(4000),@p903 nvarchar(4000),@p904 nvarchar(4000),@p905 nvarchar(4000),@p906 nvarchar(4000),@p907 datetime2(7),@p908 nvarchar(4000),@p909 nvarchar(4000),@p910 int,@p911 int,@p912 int,@p913 nvarchar(4000),@p914 nvarchar(4000),@p915 nvarchar(4000),@p916 nvarchar(4000),@p917 decimal(18,2),@p918 nvarchar(4000),@p919 nvarchar(4000),@p920 decimal(18,2),@p921 nvarchar(4000),@p922 nvarchar(4000),@p923 nvarchar(4000),@p924 nvarchar(4000),@p925 int,@p926 nvarchar(4000),@p927 nvarchar(4000),@p928 nvarchar(4000),@p929 nvarchar(4000),@p930 nvarchar(4000),@p931 nvarchar(4000),@p932 nvarchar(4000),@p933 nvarchar(4000),@p934 nvarchar(4000),@p935 nvarchar(4000),@p936 int,@p937 nvarchar(4000),@p938 nvarchar(4000),@p939 nvarchar(4000),@p940 nvarchar(4000),@p941 nvarchar(4000),@p942 int,@p943 nvarchar(4000),@p944 int,@p945 int,@p946 datetime2(7),@p947 datetime2(7),@p948 datetime2(7),@p949 nvarchar(4000),@p950 nvarchar(4000),@p951 nvarchar(4000),@p952 nvarchar(4000),@p953 nvarchar(4000),@p954 nvarchar(4000),@p955 nvarchar(4000),@p956 nvarchar(4000),@p957 nvarchar(4000),@p958 nvarchar(4000),@p959 nvarchar(4000),@p960 nvarchar(4000),@p961 nvarchar(4000),@p962 nvarchar(4000),@p963 datetime2(7),@p964 nvarchar(4000),@p965 nvarchar(4000),@p966 int,@p967 int,@p968 int,@p969 nvarchar(4000),@p970 nvarchar(4000),@p971 nvarchar(4000),@p972 nvarchar(4000),@p973 decimal(18,2),@p974 nvarchar(4000),@p975 nvarchar(4000),@p976 decimal(18,2),@p977 nvarchar(4000),@p978 nvarchar(4000),@p979 nvarchar(4000),@p980 nvarchar(4000),@p981 int,@p982 nvarchar(4000),@p983 nvarchar(4000),@p984 nvarchar(4000),@p985 nvarchar(4000),@p986 nvarchar(4000),@p987 nvarchar(4000),@p988 nvarchar(4000),@p989 nvarchar(4000),@p990 nvarchar(4000),@p991 nvarchar(4000),@p992 int,@p993 nvarchar(4000),@p994 nvarchar(4000),@p995 nvarchar(4000),@p996 nvarchar(4000),@p997 nvarchar(4000),@p998 int,@p999 nvarchar(4000),@p1000 int,@p1001 int,@p1002 datetime2(7),@p1003 datetime2(7),@p1004 datetime2(7),@p1005 nvarchar(4000),@p1006 nvarchar(4000),@p1007 nvarchar(4000),@p1008 nvarchar(4000),@p1009 nvarchar(4000),@p1010 nvarchar(4000),@p1011 nvarchar(4000),@p1012 nvarchar(4000),@p1013 nvarchar(4000),@p1014 nvarchar(4000),@p1015 nvarchar(4000),@p1016 nvarchar(4000),@p1017 nvarchar(4000),@p1018 nvarchar(4000),@p1019 datetime2(7),@p1020 nvarchar(4000),@p1021 nvarchar(4000),@p1022 int,@p1023 int,@p1024 int,@p1025 nvarchar(4000),@p1026 nvarchar(4000),@p1027 nvarchar(4000),@p1028 decimal(18,2),@p1029 decimal(18,2),@p1030 nvarchar(4000),@p1031 nvarchar(4000),@p1032 decimal(18,2),@p1033 nvarchar(4000),@p1034 nvarchar(4000),@p1035 nvarchar(4000),@p1036 nvarchar(4000),@p1037 int,@p1038 nvarchar(4000),@p1039 nvarchar(4000),@p1040 nvarchar(4000),@p1041 nvarchar(4000),@p1042 nvarchar(4000),@p1043 nvarchar(4000),@p1044 nvarchar(4000),@p1045 nvarchar(4000),@p1046 nvarchar(4000),@p1047 nvarchar(4000),@p1048 int,@p1049 nvarchar(4000),@p1050 nvarchar(4000),@p1051 nvarchar(4000),@p1052 nvarchar(4000),@p1053 nvarchar(4000),@p1054 int,@p1055 nvarchar(4000),@p1056 int,@p1057 int,@p1058 datetime2(7),@p1059 datetime2(7),@p1060 datetime2(7),@p1061 nvarchar(4000),@p1062 nvarchar(4000),@p1063 nvarchar(4000),@p1064 nvarchar(4000),@p1065 nvarchar(4000),@p1066 nvarchar(4000),@p1067 nvarchar(4000),@p1068 nvarchar(4000),@p1069 nvarchar(4000),@p1070 nvarchar(4000),@p1071 nvarchar(4000),@p1072 nvarchar(4000),@p1073 nvarchar(4000),@p1074 nvarchar(4000),@p1075 datetime2(7),@p1076 nvarchar(4000),@p1077 nvarchar(4000),@p1078 int,@p1079 int,@p1080 int,@p1081 nvarchar(4000),@p1082 nvarchar(4000),@p1083 nvarchar(4000),@p1084 decimal(18,2),@p1085 decimal(18,2),@p1086 nvarchar(4000),@p1087 nvarchar(4000),@p1088 decimal(18,2),@p1089 nvarchar(4000),@p1090 nvarchar(4000),@p1091 nvarchar(4000),@p1092 nvarchar(4000),@p1093 int,@p1094 nvarchar(4000),@p1095 nvarchar(4000),@p1096 nvarchar(4000),@p1097 nvarchar(4000),@p1098 nvarchar(4000),@p1099 nvarchar(4000),@p1100 nvarchar(4000),@p1101 nvarchar(4000),@p1102 nvarchar(4000),@p1103 nvarchar(4000),@p1104 int,@p1105 nvarchar(4000),@p1106 nvarchar(4000),@p1107 nvarchar(4000),@p1108 nvarchar(4000),@p1109 nvarchar(4000),@p1110 int,@p1111 nvarchar(4000),@p1112 int,@p1113 int,@p1114 datetime2(7),@p1115 datetime2(7),@p1116 datetime2(7),@p1117 nvarchar(4000),@p1118 nvarchar(4000),@p1119 nvarchar(4000),@p1120 nvarchar(4000),@p1121 nvarchar(4000),@p1122 nvarchar(4000),@p1123 nvarchar(4000),@p1124 nvarchar(4000),@p1125 nvarchar(4000),@p1126 nvarchar(4000),@p1127 nvarchar(4000),@p1128 nvarchar(4000),@p1129 nvarchar(4000),@p1130 nvarchar(4000),@p1131 datetime2(7),@p1132 nvarchar(4000),@p1133 nvarchar(4000),@p1134 int,@p1135 int,@p1136 int,@p1137 nvarchar(4000),@p1138 nvarchar(4000),@p1139 nvarchar(4000),@p1140 decimal(18,2),@p1141 decimal(18,2),@p1142 nvarchar(4000),@p1143 nvarchar(4000),@p1144 decimal(18,2),@p1145 nvarchar(4000),@p1146 nvarchar(4000),@p1147 nvarchar(4000),@p1148 nvarchar(4000),@p1149 int,@p1150 nvarchar(4000),@p1151 nvarchar(4000),@p1152 nvarchar(4000),@p1153 nvarchar(4000),@p1154 nvarchar(4000),@p1155 nvarchar(4000),@p1156 nvarchar(4000),@p1157 nvarchar(4000),@p1158 nvarchar(4000),@p1159 nvarchar(4000),@p1160 int,@p1161 nvarchar(4000),@p1162 nvarchar(4000),@p1163 nvarchar(4000),@p1164 nvarchar(4000),@p1165 nvarchar(4000),@p1166 int,@p1167 nvarchar(4000),@p1168 int,@p1169 int,@p1170 datetime2(7),@p1171 datetime2(7),@p1172 datetime2(7),@p1173 nvarchar(4000),@p1174 nvarchar(4000),@p1175 nvarchar(4000),@p1176 nvarchar(4000),@p1177 nvarchar(4000),@p1178 nvarchar(4000),@p1179 nvarchar(4000),@p1180 nvarchar(4000),@p1181 nvarchar(4000),@p1182 nvarchar(4000),@p1183 nvarchar(4000),@p1184 nvarchar(4000),@p1185 nvarchar(4000),@p1186 nvarchar(4000),@p1187 datetime2(7),@p1188 nvarchar(4000),@p1189 nvarchar(4000),@p1190 int,@p1191 int,@p1192 int,@p1193 nvarchar(4000),@p1194 nvarchar(4000),@p1195 nvarchar(4000),@p1196 decimal(18,2),@p1197 decimal(18,2),@p1198 nvarchar(4000),@p1199 nvarchar(4000),@p1200 decimal(18,2),@p1201 nvarchar(4000),@p1202 nvarchar(4000),@p1203 nvarchar(4000),@p1204 nvarchar(4000),@p1205 int,@p1206 nvarchar(4000),@p1207 nvarchar(4000),@p1208 nvarchar(4000),@p1209 nvarchar(4000),@p1210 nvarchar(4000),@p1211 nvarchar(4000),@p1212 nvarchar(4000),@p1213 nvarchar(4000),@p1214 nvarchar(4000),@p1215 nvarchar(4000),@p1216 int,@p1217 nvarchar(4000),@p1218 nvarchar(4000),@p1219 nvarchar(4000),@p1220 nvarchar(4000),@p1221 nvarchar(4000),@p1222 int,@p1223 nvarchar(4000),@p1224 int,@p1225 int,@p1226 datetime2(7),@p1227 datetime2(7),@p1228 datetime2(7),@p1229 nvarchar(4000),@p1230 nvarchar(4000),@p1231 nvarchar(4000),@p1232 nvarchar(4000),@p1233 nvarchar(4000),@p1234 nvarchar(4000),@p1235 nvarchar(4000),@p1236 nvarchar(4000),@p1237 nvarchar(4000),@p1238 nvarchar(4000),@p1239 nvarchar(4000),@p1240 nvarchar(4000),@p1241 nvarchar(4000),@p1242 nvarchar(4000),@p1243 datetime2(7),@p1244 nvarchar(4000),@p1245 nvarchar(4000),@p1246 int,@p1247 int,@p1248 int,@p1249 nvarchar(4000),@p1250 nvarchar(4000),@p1251 nvarchar(4000),@p1252 nvarchar(4000),@p1253 decimal(18,2),@p1254 nvarchar(4000),@p1255 nvarchar(4000),@p1256 decimal(18,2),@p1257 nvarchar(4000),@p1258 nvarchar(4000),@p1259 nvarchar(4000),@p1260 nvarchar(4000),@p1261 int,@p1262 nvarchar(4000),@p1263 nvarchar(4000),@p1264 nvarchar(4000),@p1265 nvarchar(4000),@p1266 nvarchar(4000),@p1267 nvarchar(4000),@p1268 nvarchar(4000),@p1269 nvarchar(4000),@p1270 nvarchar(4000),@p1271 nvarchar(4000),@p1272 int,@p1273 nvarchar(4000),@p1274 nvarchar(4000),@p1275 nvarchar(4000),@p1276 nvarchar(4000),@p1277 nvarchar(4000),@p1278 int,@p1279 nvarchar(4000),@p1280 int,@p1281 int,@p1282 datetime2(7),@p1283 datetime2(7),@p1284 datetime2(7),@p1285 nvarchar(4000),@p1286 nvarchar(4000),@p1287 nvarchar(4000),@p1288 nvarchar(4000),@p1289 nvarchar(4000),@p1290 nvarchar(4000),@p1291 nvarchar(4000),@p1292 nvarchar(4000),@p1293 nvarchar(4000),@p1294 nvarchar(4000),@p1295 nvarchar(4000),@p1296 nvarchar(4000),@p1297 nvarchar(4000),@p1298 nvarchar(4000),@p1299 datetime2(7),@p1300 nvarchar(4000),@p1301 nvarchar(4000),@p1302 int,@p1303 int,@p1304 int,@p1305 nvarchar(4000),@p1306 nvarchar(4000),@p1307 nvarchar(4000),@p1308 nvarchar(4000),@p1309 decimal(18,2),@p1310 nvarchar(4000),@p1311 nvarchar(4000),@p1312 decimal(18,2),@p1313 nvarchar(4000),@p1314 nvarchar(4000),@p1315 nvarchar(4000),@p1316 nvarchar(4000),@p1317 int,@p1318 nvarchar(4000),@p1319 nvarchar(4000),@p1320 nvarchar(4000),@p1321 nvarchar(4000),@p1322 nvarchar(4000),@p1323 nvarchar(4000),@p1324 nvarchar(4000),@p1325 nvarchar(4000),@p1326 nvarchar(4000),@p1327 nvarchar(4000),@p1328 int,@p1329 nvarchar(4000),@p1330 nvarchar(4000),@p1331 nvarchar(4000),@p1332 nvarchar(4000),@p1333 nvarchar(4000),@p1334 int,@p1335 nvarchar(4000),@p1336 int,@p1337 int,@p1338 datetime2(7),@p1339 datetime2(7),@p1340 datetime2(7),@p1341 nvarchar(4000),@p1342 nvarchar(4000),@p1343 nvarchar(4000),@p1344 nvarchar(4000),@p1345 nvarchar(4000),@p1346 nvarchar(4000),@p1347 nvarchar(4000),@p1348 nvarchar(4000),@p1349 nvarchar(4000),@p1350 nvarchar(4000),@p1351 nvarchar(4000),@p1352 nvarchar(4000),@p1353 nvarchar(4000),@p1354 nvarchar(4000),@p1355 datetime2(7),@p1356 nvarchar(4000),@p1357 nvarchar(4000),@p1358 int,@p1359 int,@p1360 int,@p1361 nvarchar(4000),@p1362 nvarchar(4000),@p1363 nvarchar(4000),@p1364 nvarchar(4000),@p1365 decimal(18,2),@p1366 nvarchar(4000),@p1367 nvarchar(4000),@p1368 decimal(18,2),@p1369 nvarchar(4000),@p1370 nvarchar(4000),@p1371 nvarchar(4000),@p1372 nvarchar(4000),@p1373 int,@p1374 nvarchar(4000),@p1375 nvarchar(4000),@p1376 nvarchar(4000),@p1377 nvarchar(4000),@p1378 nvarchar(4000),@p1379 nvarchar(4000),@p1380 nvarchar(4000),@p1381 nvarchar(4000),@p1382 nvarchar(4000),@p1383 nvarchar(4000),@p1384 int,@p1385 nvarchar(4000),@p1386 nvarchar(4000),@p1387 nvarchar(4000),@p1388 nvarchar(4000),@p1389 nvarchar(4000),@p1390 int,@p1391 nvarchar(4000),@p1392 int,@p1393 int,@p1394 datetime2(7),@p1395 datetime2(7),@p1396 datetime2(7),@p1397 nvarchar(4000),@p1398 nvarchar(4000),@p1399 nvarchar(4000),@p1400 nvarchar(4000),@p1401 nvarchar(4000),@p1402 nvarchar(4000),@p1403 nvarchar(4000),@p1404 nvarchar(4000),@p1405 nvarchar(4000),@p1406 nvarchar(4000),@p1407 nvarchar(4000),@p1408 nvarchar(4000),@p1409 nvarchar(4000),@p1410 nvarchar(4000),@p1411 datetime2(7),@p1412 nvarchar(4000),@p1413 nvarchar(4000),@p1414 int,@p1415 int,@p1416 int,@p1417 nvarchar(4000),@p1418 nvarchar(4000),@p1419 nvarchar(4000),@p1420 nvarchar(4000),@p1421 decimal(18,2),@p1422 nvarchar(4000),@p1423 nvarchar(4000),@p1424 decimal(18,2),@p1425 nvarchar(4000),@p1426 nvarchar(4000),@p1427 nvarchar(4000),@p1428 nvarchar(4000),@p1429 int,@p1430 nvarchar(4000),@p1431 nvarchar(4000),@p1432 nvarchar(4000),@p1433 nvarchar(4000),@p1434 nvarchar(4000),@p1435 nvarchar(4000),@p1436 nvarchar(4000),@p1437 nvarchar(4000),@p1438 nvarchar(4000),@p1439 nvarchar(4000),@p1440 int,@p1441 nvarchar(4000),@p1442 nvarchar(4000),@p1443 nvarchar(4000),@p1444 nvarchar(4000),@p1445 nvarchar(4000),@p1446 int,@p1447 nvarchar(4000),@p1448 int,@p1449 int,@p1450 datetime2(7),@p1451 datetime2(7),@p1452 datetime2(7),@p1453 nvarchar(4000),@p1454 nvarchar(4000),@p1455 nvarchar(4000),@p1456 nvarchar(4000),@p1457 nvarchar(4000),@p1458 nvarchar(4000),@p1459 nvarchar(4000),@p1460 nvarchar(4000),@p1461 nvarchar(4000),@p1462 nvarchar(4000),@p1463 nvarchar(4000),@p1464 nvarchar(4000),@p1465 nvarchar(4000),@p1466 nvarchar(4000),@p1467 datetime2(7),@p1468 nvarchar(4000),@p1469 nvarchar(4000),@p1470 int,@p1471 int,@p1472 int,@p1473 nvarchar(4000),@p1474 nvarchar(4000),@p1475 nvarchar(4000),@p1476 decimal(18,2),@p1477 decimal(18,2),@p1478 nvarchar(4000),@p1479 nvarchar(4000),@p1480 decimal(18,2),@p1481 nvarchar(4000),@p1482 nvarchar(4000),@p1483 nvarchar(4000),@p1484 nvarchar(4000),@p1485 int,@p1486 nvarchar(4000),@p1487 nvarchar(4000),@p1488 nvarchar(4000),@p1489 nvarchar(4000),@p1490 nvarchar(4000),@p1491 nvarchar(4000),@p1492 nvarchar(4000),@p1493 nvarchar(4000),@p1494 nvarchar(4000),@p1495 nvarchar(4000),@p1496 int,@p1497 nvarchar(4000),@p1498 nvarchar(4000),@p1499 nvarchar(4000),@p1500 nvarchar(4000),@p1501 nvarchar(4000),@p1502 int,@p1503 nvarchar(4000),@p1504 int,@p1505 int,@p1506 datetime2(7),@p1507 datetime2(7),@p1508 datetime2(7),@p1509 nvarchar(4000),@p1510 nvarchar(4000),@p1511 nvarchar(4000),@p1512 nvarchar(4000),@p1513 nvarchar(4000),@p1514 nvarchar(4000),@p1515 nvarchar(4000),@p1516 nvarchar(4000),@p1517 nvarchar(4000),@p1518 nvarchar(4000),@p1519 nvarchar(4000),@p1520 nvarchar(4000),@p1521 nvarchar(4000),@p1522 nvarchar(4000),@p1523 datetime2(7),@p1524 nvarchar(4000),@p1525 nvarchar(4000),@p1526 int,@p1527 int,@p1528 int,@p1529 nvarchar(4000),@p1530 nvarchar(4000),@p1531 nvarchar(4000),@p1532 decimal(18,2),@p1533 decimal(18,2),@p1534 nvarchar(4000),@p1535 nvarchar(4000),@p1536 decimal(18,2),@p1537 nvarchar(4000),@p1538 nvarchar(4000),@p1539 nvarchar(4000),@p1540 nvarchar(4000),@p1541 int,@p1542 nvarchar(4000),@p1543 nvarchar(4000),@p1544 nvarchar(4000),@p1545 nvarchar(4000),@p1546 nvarchar(4000),@p1547 nvarchar(4000),@p1548 nvarchar(4000),@p1549 nvarchar(4000),@p1550 nvarchar(4000),@p1551 nvarchar(4000),@p1552 int,@p1553 nvarchar(4000),@p1554 nvarchar(4000),@p1555 nvarchar(4000),@p1556 nvarchar(4000),@p1557 nvarchar(4000),@p1558 int,@p1559 nvarchar(4000),@p1560 int,@p1561 int,@p1562 datetime2(7),@p1563 datetime2(7),@p1564 datetime2(7),@p1565 nvarchar(4000),@p1566 nvarchar(4000),@p1567 nvarchar(4000),@p1568 nvarchar(4000),@p1569 nvarchar(4000),@p1570 nvarchar(4000),@p1571 nvarchar(4000),@p1572 nvarchar(4000),@p1573 nvarchar(4000),@p1574 nvarchar(4000),@p1575 nvarchar(4000),@p1576 nvarchar(4000),@p1577 nvarchar(4000),@p1578 nvarchar(4000),@p1579 datetime2(7),@p1580 nvarchar(4000),@p1581 nvarchar(4000),@p1582 int,@p1583 int,@p1584 int,@p1585 nvarchar(4000),@p1586 nvarchar(4000),@p1587 nvarchar(4000),@p1588 decimal(18,2),@p1589 decimal(18,2),@p1590 nvarchar(4000),@p1591 nvarchar(4000),@p1592 decimal(18,2),@p1593 nvarchar(4000),@p1594 nvarchar(4000),@p1595 nvarchar(4000),@p1596 nvarchar(4000),@p1597 int,@p1598 nvarchar(4000),@p1599 nvarchar(4000),@p1600 nvarchar(4000),@p1601 nvarchar(4000),@p1602 nvarchar(4000),@p1603 nvarchar(4000),@p1604 nvarchar(4000),@p1605 nvarchar(4000),@p1606 nvarchar(4000),@p1607 nvarchar(4000),@p1608 int,@p1609 nvarchar(4000),@p1610 nvarchar(4000),@p1611 nvarchar(4000),@p1612 nvarchar(4000),@p1613 nvarchar(4000),@p1614 int,@p1615 nvarchar(4000),@p1616 int,@p1617 int,@p1618 datetime2(7),@p1619 datetime2(7),@p1620 datetime2(7),@p1621 nvarchar(4000),@p1622 nvarchar(4000),@p1623 nvarchar(4000),@p1624 nvarchar(4000),@p1625 nvarchar(4000),@p1626 nvarchar(4000),@p1627 nvarchar(4000),@p1628 nvarchar(4000),@p1629 nvarchar(4000),@p1630 nvarchar(4000),@p1631 nvarchar(4000),@p1632 nvarchar(4000),@p1633 nvarchar(4000),@p1634 nvarchar(4000),@p1635 datetime2(7),@p1636 nvarchar(4000),@p1637 nvarchar(4000),@p1638 int,@p1639 int,@p1640 int,@p1641 nvarchar(4000),@p1642 nvarchar(4000),@p1643 nvarchar(4000),@p1644 decimal(18,2),@p1645 decimal(18,2),@p1646 nvarchar(4000),@p1647 nvarchar(4000),@p1648 decimal(18,2),@p1649 nvarchar(4000),@p1650 nvarchar(4000),@p1651 nvarchar(4000),@p1652 nvarchar(4000),@p1653 int,@p1654 nvarchar(4000),@p1655 nvarchar(4000),@p1656 nvarchar(4000),@p1657 nvarchar(4000),@p1658 nvarchar(4000),@p1659 nvarchar(4000),@p1660 nvarchar(4000),@p1661 nvarchar(4000),@p1662 nvarchar(4000),@p1663 nvarchar(4000),@p1664 int,@p1665 nvarchar(4000),@p1666 nvarchar(4000),@p1667 nvarchar(4000),@p1668 nvarchar(4000),@p1669 nvarchar(4000),@p1670 int,@p1671 nvarchar(4000),@p1672 int,@p1673 int,@p1674 datetime2(7),@p1675 datetime2(7),@p1676 datetime2(7),@p1677 nvarchar(4000),@p1678 nvarchar(4000),@p1679 nvarchar(4000),@p1680 nvarchar(4000),@p1681 nvarchar(4000),@p1682 nvarchar(4000),@p1683 nvarchar(4000),@p1684 nvarchar(4000),@p1685 nvarchar(4000),@p1686 nvarchar(4000),@p1687 nvarchar(4000),@p1688 nvarchar(4000),@p1689 nvarchar(4000),@p1690 nvarchar(4000),@p1691 datetime2(7),@p1692 nvarchar(4000),@p1693 nvarchar(4000),@p1694 int,@p1695 int,@p1696 int,@p1697 nvarchar(4000),@p1698 nvarchar(4000),@p1699 nvarchar(4000),@p1700 decimal(18,2),@p1701 decimal(18,2),@p1702 nvarchar(4000),@p1703 nvarchar(4000),@p1704 decimal(18,2),@p1705 nvarchar(4000),@p1706 nvarchar(4000),@p1707 nvarchar(4000),@p1708 nvarchar(4000),@p1709 int,@p1710 nvarchar(4000),@p1711 nvarchar(4000),@p1712 nvarchar(4000),@p1713 nvarchar(4000),@p1714 nvarchar(4000),@p1715 nvarchar(4000),@p1716 nvarchar(4000),@p1717 nvarchar(4000),@p1718 nvarchar(4000),@p1719 nvarchar(4000),@p1720 int,@p1721 nvarchar(4000),@p1722 nvarchar(4000),@p1723 nvarchar(4000),@p1724 nvarchar(4000),@p1725 nvarchar(4000),@p1726 int,@p1727 nvarchar(4000),@p1728 int,@p1729 int,@p1730 datetime2(7),@p1731 datetime2(7),@p1732 datetime2(7),@p1733 nvarchar(4000),@p1734 nvarchar(4000),@p1735 nvarchar(4000),@p1736 nvarchar(4000),@p1737 nvarchar(4000),@p1738 nvarchar(4000),@p1739 nvarchar(4000),@p1740 nvarchar(4000),@p1741 nvarchar(4000),@p1742 nvarchar(4000),@p1743 nvarchar(4000),@p1744 nvarchar(4000),@p1745 nvarchar(4000),@p1746 nvarchar(4000),@p1747 datetime2(7),@p1748 nvarchar(4000),@p1749 nvarchar(4000),@p1750 int,@p1751 int,@p1752 int,@p1753 nvarchar(4000),@p1754 nvarchar(4000),@p1755 nvarchar(4000),@p1756 decimal(18,2),@p1757 decimal(18,2),@p1758 nvarchar(4000),@p1759 nvarchar(4000),@p1760 decimal(18,2),@p1761 nvarchar(4000),@p1762 nvarchar(4000),@p1763 nvarchar(4000),@p1764 nvarchar(4000),@p1765 int,@p1766 nvarchar(4000),@p1767 nvarchar(4000),@p1768 nvarchar(4000),@p1769 nvarchar(4000),@p1770 nvarchar(4000),@p1771 nvarchar(4000),@p1772 nvarchar(4000),@p1773 nvarchar(4000),@p1774 nvarchar(4000),@p1775 nvarchar(4000),@p1776 int,@p1777 nvarchar(4000),@p1778 nvarchar(4000),@p1779 nvarchar(4000),@p1780 nvarchar(4000),@p1781 nvarchar(4000),@p1782 int,@p1783 nvarchar(4000),@p1784 int,@p1785 int,@p1786 datetime2(7),@p1787 datetime2(7),@p1788 datetime2(7),@p1789 nvarchar(4000),@p1790 nvarchar(4000),@p1791 nvarchar(4000),@p1792 nvarchar(4000),@p1793 nvarchar(4000),@p1794 nvarchar(4000),@p1795 nvarchar(4000),@p1796 nvarchar(4000),@p1797 nvarchar(4000),@p1798 nvarchar(4000),@p1799 nvarchar(4000),@p1800 nvarchar(4000),@p1801 nvarchar(4000),@p1802 nvarchar(4000),@p1803 datetime2(7),@p1804 nvarchar(4000),@p1805 nvarchar(4000),@p1806 int,@p1807 int,@p1808 int,@p1809 nvarchar(4000),@p1810 nvarchar(4000),@p1811 nvarchar(4000),@p1812 nvarchar(4000),@p1813 decimal(18,2),@p1814 nvarchar(4000),@p1815 nvarchar(4000),@p1816 decimal(18,2),@p1817 nvarchar(4000),@p1818 nvarchar(4000),@p1819 nvarchar(4000),@p1820 nvarchar(4000),@p1821 int,@p1822 nvarchar(4000),@p1823 nvarchar(4000),@p1824 nvarchar(4000),@p1825 nvarchar(4000),@p1826 nvarchar(4000),@p1827 nvarchar(4000),@p1828 nvarchar(4000),@p1829 nvarchar(4000),@p1830 nvarchar(4000),@p1831 nvarchar(4000),@p1832 int,@p1833 nvarchar(4000),@p1834 nvarchar(4000),@p1835 nvarchar(4000),@p1836 nvarchar(4000),@p1837 nvarchar(4000),@p1838 int,@p1839 nvarchar(4000),@p1840 int,@p1841 int,@p1842 datetime2(7),@p1843 datetime2(7),@p1844 datetime2(7),@p1845 nvarchar(4000),@p1846 nvarchar(4000),@p1847 nvarchar(4000),@p1848 nvarchar(4000),@p1849 nvarchar(4000),@p1850 nvarchar(4000),@p1851 nvarchar(4000),@p1852 nvarchar(4000),@p1853 nvarchar(4000),@p1854 nvarchar(4000),@p1855 nvarchar(4000),@p1856 nvarchar(4000),@p1857 nvarchar(4000),@p1858 nvarchar(4000),@p1859 datetime2(7),@p1860 nvarchar(4000),@p1861 nvarchar(4000),@p1862 int,@p1863 int,@p1864 int,@p1865 nvarchar(4000),@p1866 nvarchar(4000),@p1867 nvarchar(4000),@p1868 nvarchar(4000),@p1869 decimal(18,2),@p1870 nvarchar(4000),@p1871 nvarchar(4000),@p1872 decimal(18,2),@p1873 nvarchar(4000),@p1874 nvarchar(4000),@p1875 nvarchar(4000),@p1876 nvarchar(4000),@p1877 int,@p1878 nvarchar(4000),@p1879 nvarchar(4000),@p1880 nvarchar(4000),@p1881 nvarchar(4000),@p1882 nvarchar(4000),@p1883 nvarchar(4000),@p1884 nvarchar(4000),@p1885 nvarchar(4000),@p1886 nvarchar(4000),@p1887 nvarchar(4000),@p1888 int,@p1889 nvarchar(4000),@p1890 nvarchar(4000),@p1891 nvarchar(4000),@p1892 nvarchar(4000),@p1893 nvarchar(4000),@p1894 int,@p1895 nvarchar(4000),@p1896 int,@p1897 int,@p1898 datetime2(7),@p1899 datetime2(7),@p1900 datetime2(7),@p1901 nvarchar(4000),@p1902 nvarchar(4000),@p1903 nvarchar(4000),@p1904 nvarchar(4000),@p1905 nvarchar(4000),@p1906 nvarchar(4000),@p1907 nvarchar(4000),@p1908 nvarchar(4000),@p1909 nvarchar(4000),@p1910 nvarchar(4000),@p1911 nvarchar(4000),@p1912 nvarchar(4000),@p1913 nvarchar(4000),@p1914 nvarchar(4000),@p1915 datetime2(7),@p1916 nvarchar(4000),@p1917 nvarchar(4000),@p1918 int,@p1919 int,@p1920 int,@p1921 nvarchar(4000),@p1922 nvarchar(4000),@p1923 nvarchar(4000),@p1924 nvarchar(4000),@p1925 decimal(18,2),@p1926 nvarchar(4000),@p1927 nvarchar(4000),@p1928 decimal(18,2),@p1929 nvarchar(4000),@p1930 nvarchar(4000),@p1931 nvarchar(4000),@p1932 nvarchar(4000),@p1933 int,@p1934 nvarchar(4000),@p1935 nvarchar(4000),@p1936 nvarchar(4000),@p1937 nvarchar(4000),@p1938 nvarchar(4000),@p1939 nvarchar(4000),@p1940 nvarchar(4000),@p1941 nvarchar(4000),@p1942 nvarchar(4000),@p1943 nvarchar(4000),@p1944 int,@p1945 nvarchar(4000),@p1946 nvarchar(4000),@p1947 nvarchar(4000),@p1948 nvarchar(4000),@p1949 nvarchar(4000),@p1950 int,@p1951 nvarchar(4000),@p1952 int,@p1953 int,@p1954 datetime2(7),@p1955 datetime2(7),@p1956 datetime2(7),@p1957 nvarchar(4000),@p1958 nvarchar(4000),@p1959 nvarchar(4000),@p1960 nvarchar(4000),@p1961 nvarchar(4000),@p1962 nvarchar(4000),@p1963 nvarchar(4000),@p1964 nvarchar(4000),@p1965 nvarchar(4000),@p1966 nvarchar(4000),@p1967 nvarchar(4000),@p1968 nvarchar(4000),@p1969 nvarchar(4000),@p1970 nvarchar(4000),@p1971 datetime2(7),@p1972 nvarchar(4000),@p1973 nvarchar(4000),@p1974 int,@p1975 int,@p1976 int,@p1977 nvarchar(4000),@p1978 nvarchar(4000),@p1979 nvarchar(4000),@p1980 nvarchar(4000),@p1981 decimal(18,2),@p1982 nvarchar(4000),@p1983 nvarchar(4000),@p1984 decimal(18,2),@p1985 nvarchar(4000),@p1986 nvarchar(4000),@p1987 nvarchar(4000),@p1988 nvarchar(4000),@p1989 int,@p1990 nvarchar(4000),@p1991 nvarchar(4000),@p1992 nvarchar(4000),@p1993 nvarchar(4000),@p1994 nvarchar(4000),@p1995 nvarchar(4000),@p1996 nvarchar(4000),@p1997 nvarchar(4000),@p1998 nvarchar(4000),@p1999 nvarchar(4000),@p2000 int,@p2001 nvarchar(4000),@p2002 nvarchar(4000),@p2003 nvarchar(4000),@p2004 nvarchar(4000),@p2005 nvarchar(4000),@p2006 int,@p2007 nvarchar(4000),@p2008 int,@p2009 int,@p2010 datetime2(7),@p2011 datetime2(7),@p2012 datetime2(7),@p2013 nvarchar(4000),@p2014 nvarchar(4000),@p2015 nvarchar(4000),@p2016 nvarchar(4000),@p2017 nvarchar(4000),@p2018 nvarchar(4000),@p2019 nvarchar(4000),@p2020 nvarchar(4000),@p2021 nvarchar(4000),@p2022 nvarchar(4000),@p2023 nvarchar(4000),@p2024 nvarchar(4000),@p2025 nvarchar(4000),@p2026 nvarchar(4000),@p2027 datetime2(7),@p2028 nvarchar(4000),@p2029 nvarchar(4000),@p2030 int,@p2031 int,@p2032 int,@p2033 nvarchar(4000),@p2034 nvarchar(4000),@p2035 nvarchar(4000),@p2036 decimal(18,2),@p2037 decimal(18,2),@p2038 nvarchar(4000),@p2039 nvarchar(4000),@p2040 decimal(18,2),@p2041 nvarchar(4000),@p2042 nvarchar(4000),@p2043 nvarchar(4000),@p2044 nvarchar(4000),@p2045 int,@p2046 nvarchar(4000),@p2047 nvarchar(4000),@p2048 nvarchar(4000),@p2049 nvarchar(4000),@p2050 nvarchar(4000),@p2051 nvarchar(4000),@p2052 nvarchar(4000),@p2053 nvarchar(4000),@p2054 nvarchar(4000),@p2055 nvarchar(4000),@p2056 int,@p2057 nvarchar(4000),@p2058 nvarchar(4000),@p2059 nvarchar(4000),@p2060 nvarchar(4000),@p2061 nvarchar(4000),@p2062 int,@p2063 nvarchar(4000),@p2064 int,@p2065 int,@p2066 datetime2(7),@p2067 datetime2(7),@p2068 datetime2(7),@p2069 nvarchar(4000),@p2070 nvarchar(4000),@p2071 nvarchar(4000))SET NOCOUNT ON; DECLARE @inserted0 TABLE ([item_id] int, [_Position] [int]); MERGE [raw_data] USING ( VALUES (@p0, @p1, @p2, @p3, @p4, @p5, @p6, @p7, @p8, @p9, @p10, @p11, @p12, @p13, @p14, @p15, @p16, @p17, @p18, @p19, @p20, @p21, @p22, @p23, @p24, @p25, @p26, @p27, @p28, @p29, @p30, @p31, @p32, @p33, @p34, @p35, @p36, @p37, @p38, @p39, @p40, @p41, @p42, @p43, @p44, @p45, @p46, @p47, @p48, @p49, @p50, @p51, @p52, @p53, @p54, @p55, 0), (@p56, @p57, @p58, @p59, @p60, @p61, @p62, @p63, @p64, @p65, @p66, @p67, @p68, @p69, @p70, @p71, @p72, @p73, @p74, @p75, @p76, @p77, @p78, @p79, @p80, @p81, @p82, @p83, @p84, @p85, @p86, @p87, @p88, @p89, @p90, @p91, @p92, @p93, @p94, @p95, @p96, @p97, @p98, @p99, @p100, @p101, @p102, @p103, @p104, @p105, @p106, @p107, @p108, @p109, @p110, @p111, 1), (@p112, @p113, @p114, @p115, @p116, @p117, @p118, @p119, @p120, @p121, @p122, @p123, @p124, @p125, @p126, @p127, @p128, @p129, @p130, @p131, @p132, @p133, @p134, @p135, @p136, @p137, @p138, @p139, @p140, @p141, @p142, @p143, @p144, @p145, @p146, @p147, @p148, @p149, @p150, @p151, @p152, @p153, @p154, @p155, @p156, @p157, @p158, @p159, @p160, @p161, @p162, @p163, @p164, @p165, @p166, @p167, 2), (@p168, @p169, @p170, @p171, @p172, @p173, @p174, @p175, @p176, @p177, @p178, @p179, @p180, @p181, @p182, @p183, @p184, @p185, @p186, @p187, @p188, @p189, @p190, @p191, @p192, @p193, @p194, @p195, @p196, @p197, @p198, @p199, @p200, @p201, @p202, @p203, @p204, @p205, @p206, @p207, @p208, @p209, @p210, @p211, @p212, @p213, @p214, @p215, @p216, @p217, @p218, @p219, @p220, @p221, @p222, @p223, 3), (@p224, @p225, @p226, @p227, @p228, @p229, @p230, @p231, @p232, @p233, @p234, @p235, @p236, @p237, @p238, @p239, @p240, @p241, @p242, @p243, @p244, @p245, @p246, @p247, @p248, @p249, @p250, @p251, @p252, @p253, @p254, @p255, @p256, @p257, @p258, @p259, @p260, @p261, @p262, @p263, @p264, @p265, @p266, @p267, @p268, @p269, @p270, @p271, @p272, @p273, @p274, @p275, @p276, @p277, @p278, @p279, 4), (@p280, @p281, @p282, @p283, @p284, @p285, @p286, @p287, @p288, @p289, @p290, @p291, @p292, @p293, @p294, @p295, @p296, @p297, @p298, @p299, @p300, @p301, @p302, @p303, @p304, @p305, @p306, @p307, @p308, @p309, @p310, @p311, @p312, @p313, @p314, @p315, @p316, @p317, @p318, @p319, @p320, @p321, @p322, @p323, @p324, @p325, @p326, @p327, @p328, @p329, @p330, @p331, @p332, @p333, @p334, @p335, 5), (@p336, @p337, @p338, @p339, @p340, @p341, @p342, @p343, @p344, @p345, @p346, @p347, @p348, @p349, @p350, @p351, @p352, @p353, @p354, @p355, @p356, @p357, @p358, @p359, @p360, @p361, @p362, @p363, @p364, @p365, @p366, @p367, @p368, @p369, @p370, @p371, @p372, @p373, @p374, @p375, @p376, @p377, @p378, @p379, @p380, @p381, @p382, @p383, @p384, @p385, @p386, @p387, @p388, @p389, @p390, @p391, 6), (@p392, @p393, @p394, @p395, @p396, @p397, @p398, @p399, @p400, @p401, @p402, @p403, @p404, @p405, @p406, @p407, @p408, @p409, @p410, @p411, @p412, @p413, @p414, @p415, @p416, @p417, @p418, @p419, @p420, @p421, @p422, @p423, @p424, @p425, @p426, @p427, @p428, @p429, @p430, @p431, @p432, @p433, @p434, @p435, @p436, @p437, @p438, @p439, @p440, @p441, @p442, @p443, @p444, @p445, @p446, @p447, 7), (@p448, @p449, @p450, @p451, @p452, @p453, @p454, @p455, @p456, @p457, @p458, @p459, @p460, @p461, @p462, @p463, @p464, @p465, @p466, @p467, @p468, @p469, @p470, @p471, @p472, @p473, @p474, @p475, @p476, @p477, @p478, @p479, @p480, @p481, @p482, @p483, @p484, @p485, @p486, @p487, @p488, @p489, @p490, @p491, @p492, @p493, @p494, @p495, @p496, @p497, @p498, @p499, @p500, @p501, @p502, @p503, 8), (@p504, @p505, @p506, @p507, @p508, @p509, @p510, @p511, @p512, @p513, @p514, @p515, @p516, @p517, @p518, @p519, @p520, @p521, @p522, @p523, @p524, @p525, @p526, @p527, @p528, @p529, @p530, @p531, @p532, @p533, @p534, @p535, @p536, @p537, @p538, @p539, @p540, @p541, @p542, @p543, @p544, @p545, @p546, @p547, @p548, @p549, @p550, @p551, @p552, @p553, @p554, @p555, @p556, @p557, @p558, @p559, 9), (@p560, @p561, @p562, @p563, @p564, @p565, @p566, @p567, @p568, @p569, @p570, @p571, @p572, @p573, @p574, @p575, @p576, @p577, @p578, @p579, @p580, @p581, @p582, @p583, @p584, @p585, @p586, @p587, @p588, @p589, @p590, @p591, @p592, @p593, @p594, @p595, @p596, @p597, @p598, @p599, @p600, @p601, @p602, @p603, @p604, @p605, @p606, @p607, @p608, @p609, @p610, @p611, @p612, @p613, @p614, @p615, 10), (@p616, @p617, @p618, @p619, @p620, @p621, @p622, @p623, @p624, @p625, @p626, @p627, @p628, @p629, @p630, @p631, @p632, @p633, @p634, @p635, @p636, @p637, @p638, @p639, @p640, @p641, @p642, @p643, @p644, @p645, @p646, @p647, @p648, @p649, @p650, @p651, @p652, @p653, @p654, @p655, @p656, @p657, @p658, @p659, @p660, @p661, @p662, @p663, @p664, @p665, @p666, @p667, @p668, @p669, @p670, @p671, 11), (@p672, @p673, @p674, @p675, @p676, @p677, @p678, @p679, @p680, @p681, @p682, @p683, @p684, @p685, @p686, @p687, @p688, @p689, @p690, @p691, @p692, @p693, @p694, @p695, @p696, @p697, @p698, @p699, @p700, @p701, @p702, @p703, @p704, @p705, @p706, @p707, @p708, @p709, @p710, @p711, @p712, @p713, @p714, @p715, @p716, @p717, @p718, @p719, @p720, @p721, @p722, @p723, @p724, @p725, @p726, @p727, 12), (@p728, @p729, @p730, @p731, @p732, @p733, @p734, @p735, @p736, @p737, @p738, @p739, @p740, @p741, @p742, @p743, @p744, @p745, @p746, @p747, @p748, @p749, @p750, @p751, @p752, @p753, @p754, @p755, @p756, @p757, @p758, @p759, @p760, @p761, @p762, @p763, @p764, @p765, @p766, @p767, @p768, @p769, @p770, @p771, @p772, @p773, @p774, @p775, @p776, @p777, @p778, @p779, @p780, @p781, @p782, @p783, 13), (@p784, @p785, @p786, @p787, @p788, @p789, @p790, @p791, @p792, @p793, @p794, @p795, @p796, @p797, @p798, @p799, @p800, @p801, @p802, @p803, @p804, @p805, @p806, @p807, @p808, @p809, @p810, @p811, @p812, @p813, @p814, @p815, @p816, @p817, @p818, @p819, @p820, @p821, @p822, @p823, @p824, @p825, @p826, @p827, @p828, @p829, @p830, @p831, @p832, @p833, @p834, @p835, @p836, @p837, @p838, @p839, 14), (@p840, @p841, @p842, @p843, @p844, @p845, @p846, @p847, @p848, @p849, @p850, @p851, @p852, @p853, @p854, @p855, @p856, @p857, @p858, @p859, @p860, @p861, @p862, @p863, @p864, @p865, @p866, @p867, @p868, @p869, @p870, @p871, @p872, @p873, @p874, @p875, @p876, @p877, @p878, @p879, @p880, @p881, @p882, @p883, @p884, @p885, @p886, @p887, @p888, @p889, @p890, @p891, @p892, @p893, @p894, @p895, 15), (@p896, @p897, @p898, @p899, @p900, @p901, @p902, @p903, @p904, @p905, @p906, @p907, @p908, @p909, @p910, @p911, @p912, @p913, @p914, @p915, @p916, @p917, @p918, @p919, @p920, @p921, @p922, @p923, @p924, @p925, @p926, @p927, @p928, @p929, @p930, @p931, @p932, @p933, @p934, @p935, @p936, @p937, @p938, @p939, @p940, @p941, @p942, @p943, @p944, @p945, @p946, @p947, @p948, @p949, @p950, @p951, 16), (@p952, @p953, @p954, @p955, @p956, @p957, @p958, @p959, @p960, @p961, @p962, @p963, @p964, @p965, @p966, @p967, @p968, @p969, @p970, @p971, @p972, @p973, @p974, @p975, @p976, @p977, @p978, @p979, @p980, @p981, @p982, @p983, @p984, @p985, @p986, @p987, @p988, @p989, @p990, @p991, @p992, @p993, @p994, @p995, @p996, @p997, @p998, @p999, @p1000, @p1001, @p1002, @p1003, @p1004, @p1005, @p1006, @p1007, 17), (@p1008, @p1009, @p1010, @p1011, @p1012, @p1013, @p1014, @p1015, @p1016, @p1017, @p1018, @p1019, @p1020, @p1021, @p1022, @p1023, @p1024, @p1025, @p1026, @p1027, @p1028, @p1029, @p1030, @p1031, @p1032, @p1033, @p1034, @p1035, @p1036, @p1037, @p1038, @p1039, @p1040, @p1041, @p1042, @p1043, @p1044, @p1045, @p1046, @p1047, @p1048, @p1049, @p1050, @p1051, @p1052, @p1053, @p1054, @p1055, @p1056, @p1057, @p1058, @p1059, @p1060, @p1061, @p1062, @p1063, 18), (@p1064, @p1065, @p1066, @p1067, @p1068, @p1069, @p1070, @p1071, @p1072, @p1073, @p1074, @p1075, @p1076, @p1077, @p1078, @p1079, @p1080, @p1081, @p1082, @p1083, @p1084, @p1085, @p1086, @p1087, @p1088, @p1089, @p1090, @p1091, @p1092, @p1093, @p1094, @p1095, @p1096, @p1097, @p1098, @p1099, @p1100, @p1101, @p1102, @p1103, @p1104, @p1105, @p1106, @p1107, @p1108, @p1109, @p1110, @p1111, @p1112, @p1113, @p1114, @p1115, @p1116, @p1117, @p1118, @p1119, 19), (@p1120, @p1121, @p1122, @p1123, @p1124, @p1125, @p1126, @p1127, @p1128, @p1129, @p1130, @p1131, @p1132, @p1133, @p1134, @p1135, @p1136, @p1137, @p1138, @p1139, @p1140, @p1141, @p1142, @p1143, @p1144, @p1145, @p1146, @p1147, @p1148, @p1149, @p1150, @p1151, @p1152, @p1153, @p1154, @p1155, @p1156, @p1157, @p1158, @p1159, @p1160, @p1161, @p1162, @p1163, @p1164, @p1165, @p1166, @p1167, @p1168, @p1169, @p1170, @p1171, @p1172, @p1173, @p1174, @p1175, 20), (@p1176, @p1177, @p1178, @p1179, @p1180, @p1181, @p1182, @p1183, @p1184, @p1185, @p1186, @p1187, @p1188, @p1189, @p1190, @p1191, @p1192, @p1193, @p1194, @p1195, @p1196, @p1197, @p1198, @p1199, @p1200, @p1201, @p1202, @p1203, @p1204, @p1205, @p1206, @p1207, @p1208, @p1209, @p1210, @p1211, @p1212, @p1213, @p1214, @p1215, @p1216, @p1217, @p1218, @p1219, @p1220, @p1221, @p1222, @p1223, @p1224, @p1225, @p1226, @p1227, @p1228, @p1229, @p1230, @p1231, 21), (@p1232, @p1233, @p1234, @p1235, @p1236, @p1237, @p1238, @p1239, @p1240, @p1241, @p1242, @p1243, @p1244, @p1245, @p1246, @p1247, @p1248, @p1249, @p1250, @p1251, @p1252, @p1253, @p1254, @p1255, @p1256, @p1257, @p1258, @p1259, @p1260, @p1261, @p1262, @p1263, @p1264, @p1265, @p1266, @p1267, @p1268, @p1269, @p1270, @p1271, @p1272, @p1273, @p1274, @p1275, @p1276, @p1277, @p1278, @p1279, @p1280, @p1281, @p1282, @p1283, @p1284, @p1285, @p1286, @p1287, 22), (@p1288, @p1289, @p1290, @p1291, @p1292, @p1293, @p1294, @p1295, @p1296, @p1297, @p1298, @p1299, @p1300, @p1301, @p1302, @p1303, @p1304, @p1305, @p1306, @p1307, @p1308, @p1309, @p1310, @p1311, @p1312, @p1313, @p1314, @p1315, @p1316, @p1317, @p1318, @p1319, @p1320, @p1321, @p1322, @p1323, @p1324, @p1325, @p1326, @p1327, @p1328, @p1329, @p1330, @p1331, @p1332, @p1333, @p1334, @p1335, @p1336, @p1337, @p1338, @p1339, @p1340, @p1341, @p1342, @p1343, 23), (@p1344, @p1345, @p1346, @p1347, @p1348, @p1349, @p1350, @p1351, @p1352, @p1353, @p1354, @p1355, @p1356, @p1357, @p1358, @p1359, @p1360, @p1361, @p1362, @p1363, @p1364, @p1365, @p1366, @p1367, @p1368, @p1369, @p1370, @p1371, @p1372, @p1373, @p1374, @p1375, @p1376, @p1377, @p1378, @p1379, @p1380, @p1381, @p1382, @p1383, @p1384, @p1385, @p1386, @p1387, @p1388, @p1389, @p1390, @p1391, @p1392, @p1393, @p1394, @p1395, @p1396, @p1397, @p1398, @p1399, 24), (@p1400, @p1401, @p1402, @p1403, @p1404, @p1405, @p1406, @p1407, @p1408, @p1409, @p1410, @p1411, @p1412, @p1413, @p1414, @p1415, @p1416, @p1417, @p1418, @p1419, @p1420, @p1421, @p1422, @p1423, @p1424, @p1425, @p1426, @p1427, @p1428, @p1429, @p1430, @p1431, @p1432, @p1433, @p1434, @p1435, @p1436, @p1437, @p1438, @p1439, @p1440, @p1441, @p1442, @p1443, @p1444, @p1445, @p1446, @p1447, @p1448, @p1449, @p1450, @p1451, @p1452, @p1453, @p1454, @p1455, 25), (@p1456, @p1457, @p1458, @p1459, @p1460, @p1461, @p1462, @p1463, @p1464, @p1465, @p1466, @p1467, @p1468, @p1469, @p1470, @p1471, @p1472, @p1473, @p1474, @p1475, @p1476, @p1477, @p1478, @p1479, @p1480, @p1481, @p1482, @p1483, @p1484, @p1485, @p1486, @p1487, @p1488, @p1489, @p1490, @p1491, @p1492, @p1493, @p1494, @p1495, @p1496, @p1497, @p1498, @p1499, @p1500, @p1501, @p1502, @p1503, @p1504, @p1505, @p1506, @p1507, @p1508, @p1509, @p1510, @p1511, 26), (@p1512, @p1513, @p1514, @p1515, @p1516, @p1517, @p1518, @p1519, @p1520, @p1521, @p1522, @p1523, @p1524, @p1525, @p1526, @p1527, @p1528, @p1529, @p1530, @p1531, @p1532, @p1533, @p1534, @p1535, @p1536, @p1537, @p1538, @p1539, @p1540, @p1541, @p1542, @p1543, @p1544, @p1545, @p1546, @p1547, @p1548, @p1549, @p1550, @p1551, @p1552, @p1553, @p1554, @p1555, @p1556, @p1557, @p1558, @p1559, @p1560, @p1561, @p1562, @p1563, @p1564, @p1565, @p1566, @p1567, 27), (@p1568, @p1569, @p1570, @p1571, @p1572, @p1573, @p1574, @p1575, @p1576, @p1577, @p1578, @p1579, @p1580, @p1581, @p1582, @p1583, @p1584, @p1585, @p1586, @p1587, @p1588, @p1589, @p1590, @p1591, @p1592, @p1593, @p1594, @p1595, @p1596, @p1597, @p1598, @p1599, @p1600, @p1601, @p1602, @p1603, @p1604, @p1605, @p1606, @p1607, @p1608, @p1609, @p1610, @p1611, @p1612, @p1613, @p1614, @p1615, @p1616, @p1617, @p1618, @p1619, @p1620, @p1621, @p1622, @p1623, 28), (@p1624, @p1625, @p1626, @p1627, @p1628, @p1629, @p1630, @p1631, @p1632, @p1633, @p1634, @p1635, @p1636, @p1637, @p1638, @p1639, @p1640, @p1641, @p1642, @p1643, @p1644, @p1645, @p1646, @p1647, @p1648, @p1649, @p1650, @p1651, @p1652, @p1653, @p1654, @p1655, @p1656, @p1657, @p1658, @p1659, @p1660, @p1661, @p1662, @p1663, @p1664, @p1665, @p1666, @p1667, @p1668, @p1669, @p1670, @p1671, @p1672, @p1673, @p1674, @p1675, @p1676, @p1677, @p1678, @p1679, 29), (@p1680, @p1681, @p1682, @p1683, @p1684, @p1685, @p1686, @p1687, @p1688, @p1689, @p1690, @p1691, @p1692, @p1693, @p1694, @p1695, @p1696, @p1697, @p1698, @p1699, @p1700, @p1701, @p1702, @p1703, @p1704, @p1705, @p1706, @p1707, @p1708, @p1709, @p1710, @p1711, @p1712, @p1713, @p1714, @p1715, @p1716, @p1717, @p1718, @p1719, @p1720, @p1721, @p1722, @p1723, @p1724, @p1725, @p1726, @p1727, @p1728, @p1729, @p1730, @p1731, @p1732, @p1733, @p1734, @p1735, 30), (@p1736, @p1737, @p1738, @p1739, @p1740, @p1741, @p1742, @p1743, @p1744, @p1745, @p1746, @p1747, @p1748, @p1749, @p1750, @p1751, @p1752, @p1753, @p1754, @p1755, @p1756, @p1757, @p1758, @p1759, @p1760, @p1761, @p1762, @p1763, @p1764, @p1765, @p1766, @p1767, @p1768, @p1769, @p1770, @p1771, @p1772, @p1773, @p1774, @p1775, @p1776, @p1777, @p1778, @p1779, @p1780, @p1781, @p1782, @p1783, @p1784, @p1785, @p1786, @p1787, @p1788, @p1789, @p1790, @p1791, 31), (@p1792, @p1793, @p1794, @p1795, @p1796, @p1797, @p1798, @p1799, @p1800, @p1801, @p1802, @p1803, @p1804, @p1805, @p1806, @p1807, @p1808, @p1809, @p1810, @p1811, @p1812, @p1813, @p1814, @p1815, @p1816, @p1817, @p1818, @p1819, @p1820, @p1821, @p1822, @p1823, @p1824, @p1825, @p1826, @p1827, @p1828, @p1829, @p1830, @p1831, @p1832, @p1833, @p1834, @p1835, @p1836, @p1837, @p1838, @p1839, @p1840, @p1841, @p1842, @p1843, @p1844, @p1845, @p1846, @p1847, 32), (@p1848, @p1849, @p1850, @p1851, @p1852, @p1853, @p1854, @p1855, @p1856, @p1857, @p1858, @p1859, @p1860, @p1861, @p1862, @p1863, @p1864, @p1865, @p1866, @p1867, @p1868, @p1869, @p1870, @p1871, @p1872, @p1873, @p1874, @p1875, @p1876, @p1877, @p1878, @p1879, @p1880, @p1881, @p1882, @p1883, @p1884, @p1885, @p1886, @p1887, @p1888, @p1889, @p1890, @p1891, @p1892, @p1893, @p1894, @p1895, @p1896, @p1897, @p1898, @p1899, @p1900, @p1901, @p1902, @p1903, 33), (@p1904, @p1905, @p1906, @p1907, @p1908, @p1909, @p1910, @p1911, @p1912, @p1913, @p1914, @p1915, @p1916, @p1917, @p1918, @p1919, @p1920, @p1921, @p1922, @p1923, @p1924, @p1925, @p1926, @p1927, @p1928, @p1929, @p1930, @p1931, @p1932, @p1933, @p1934, @p1935, @p1936, @p1937, @p1938, @p1939, @p1940, @p1941, @p1942, @p1943, @p1944, @p1945, @p1946, @p1947, @p1948, @p1949, @p1950, @p1951, @p1952, @p1953, @p1954, @p1955, @p1956, @p1957, @p1958, @p1959, 34), (@p1960, @p1961, @p1962, @p1963, @p1964, @p1965, @p1966, @p1967, @p1968, @p1969, @p1970, @p1971, @p1972, @p1973, @p1974, @p1975, @p1976, @p1977, @p1978, @p1979, @p1980, @p1981, @p1982, @p1983, @p1984, @p1985, @p1986, @p1987, @p1988, @p1989, @p1990, @p1991, @p1992, @p1993, @p1994, @p1995, @p1996, @p1997, @p1998, @p1999, @p2000, @p2001, @p2002, @p2003, @p2004, @p2005, @p2006, @p2007, @p2008, @p2009, @p2010, @p2011, @p2012, @p2013, @p2014, @p2015, 35), (@p2016, @p2017, @p2018, @p2019, @p2020, @p2021, @p2022, @p2023, @p2024, @p2025, @p2026, @p2027, @p2028, @p2029, @p2030, @p2031, @p2032, @p2033, @p2034, @p2035, @p2036, @p2037, @p2038, @p2039, @p2040, @p2041, @p2042, @p2043, @p2044, @p2045, @p2046, @p2047, @p2048, @p2049, @p2050, @p2051, @p2052, @p2053, @p2054, @p2055, @p2056, @p2057, @p2058, @p2059, @p2060, @p2061, @p2062, @p2063, @p2064, @p2065, @p2066, @p2067, @p2068, @p2069, @p2070, @p2071, 36)) AS i ([addressee_cntry_cd], [addressee_city], [addressee_district], [addressee_email], [addressee_full_address], [addressee_home_address], [addressee_name], [addressee_postcode], [addressee_province], [addressee_subdistrict], [addressee_tel], [create_table], [delivery_code], [delivery_recipient_name], [delivery_relation_id], [delivery_status_id], [dest_outlet_id], [dest_outlet_port], [document_number], [item_barcode], [item_cod], [item_gross_weight], [item_height], [item_length], [item_price], [item_width], [lat], [log_id], [long], [outlet_id], [outlet_port], [podUrl], [remark], [scan_cntry_cd], [scan_cntry_postcode], [sender_cntry_cd], [sender_district], [sender_email], [sender_full_address], [sender_home_address], [member_id], [sender_name], [sender_postcode], [sender_province], [sender_subdistrict], [sender_tel], [server_id], [signatureUrl], [state], [status_code], [status_dtm], [timestamp], [transmit_dtm], [user_id], [wckt_id], [wkstn_no], _Position) ON 1=0 WHEN NOT MATCHED THEN INSERT ([addressee_cntry_cd], [addressee_city], [addressee_district], [addressee_email], [addressee_full_address], [addressee_home_address], [addressee_name], [addressee_postcode], [addressee_province], [addressee_subdistrict], [addressee_tel], [create_table], [delivery_code], [delivery_recipient_name], [delivery_relation_id], [delivery_status_id], [dest_outlet_id], [dest_outlet_port], [document_number], [item_barcode], [item_cod], [item_gross_weight], [item_height], [item_length], [item_price], [item_width], [lat], [log_id], [long], [outlet_id], [outlet_port], [podUrl], [remark], [scan_cntry_cd], [scan_cntry_postcode], [sender_cntry_cd], [sender_district], [sender_email], [sender_full_address], [sender_home_address], [member_id], [sender_name], [sender_postcode], [sender_province], [sender_subdistrict], [sender_tel], [server_id], [signatureUrl], [state], [status_code], [status_dtm], [timestamp], [transmit_dtm], [user_id], [wckt_id], [wkstn_no]) VALUES (i.[addressee_cntry_cd], i.[addressee_city], i.[addressee_district], i.[addressee_email], i.[addressee_full_address], i.[addressee_home_address], i.[addressee_name], i.[addressee_postcode], i.[addressee_province], i.[addressee_subdistrict], i.[addressee_tel], i.[create_table], i.[delivery_code], i.[delivery_recipient_name], i.[delivery_relation_id], i.[delivery_status_id], i.[dest_outlet_id], i.[dest_outlet_port], i.[document_number], i.[item_barcode], i.[item_cod], i.[item_gross_weight], i.[item_height], i.[item_length], i.[item_price], i.[item_width], i.[lat], i.[log_id], i.[long], i.[outlet_id], i.[outlet_port], i.[podUrl], i.[remark], i.[scan_cntry_cd], i.[scan_cntry_postcode], i.[sender_cntry_cd], i.[sender_district], i.[sender_email], i.[sender_full_address], i.[sender_home_address], i.[member_id], i.[sender_name], i.[sender_postcode], i.[sender_province], i.[sender_subdistrict], i.[sender_tel], i.[server_id], i.[signatureUrl], i.[state], i.[status_code], i.[status_dtm], i.[timestamp], i.[transmit_dtm], i.[user_id], i.[wckt_id], i.[wkstn_no]) OUTPUT INSERTED.[item_id], i._Position INTO @inserted0;  SELECT [t].[item_id] FROM [raw_data] t INNER JOIN @inserted0 i ON ([t].[item_id] = [i].[item_id]) ORDER BY [i].[_Position];  ",6,6,0,449,7,6
"(@p0 nvarchar(4000),@p1 nvarchar(4000),@p2 nvarchar(4000),@p3 nvarchar(4000),@p4 nvarchar(4000),@p5 nvarchar(4000),@p6 nvarchar(4000),@p7 nvarchar(4000),@p8 nvarchar(4000),@p9 nvarchar(4000),@p10 nvarchar(4000),@p11 datetime2(7),@p12 nvarchar(4000),@p13 nvarchar(4000),@p14 int,@p15 int,@p16 int,@p17 nvarchar(4000),@p18 nvarchar(4000),@p19 nvarchar(4000),@p20 nvarchar(4000),@p21 decimal(18,2),@p22 nvarchar(4000),@p23 nvarchar(4000),@p24 decimal(18,2),@p25 nvarchar(4000),@p26 nvarchar(4000),@p27 nvarchar(4000),@p28 nvarchar(4000),@p29 int,@p30 nvarchar(4000),@p31 nvarchar(4000),@p32 nvarchar(4000),@p33 nvarchar(4000),@p34 nvarchar(4000),@p35 nvarchar(4000),@p36 nvarchar(4000),@p37 nvarchar(4000),@p38 nvarchar(4000),@p39 nvarchar(4000),@p40 int,@p41 nvarchar(4000),@p42 nvarchar(4000),@p43 nvarchar(4000),@p44 nvarchar(4000),@p45 nvarchar(4000),@p46 int,@p47 nvarchar(4000),@p48 int,@p49 int,@p50 datetime2(7),@p51 datetime2(7),@p52 datetime2(7),@p53 nvarchar(4000),@p54 nvarchar(4000),@p55 nvarchar(4000),@p56 nvarchar(4000),@p57 nvarchar(4000),@p58 nvarchar(4000),@p59 nvarchar(4000),@p60 nvarchar(4000),@p61 nvarchar(4000),@p62 nvarchar(4000),@p63 nvarchar(4000),@p64 nvarchar(4000),@p65 nvarchar(4000),@p66 nvarchar(4000),@p67 datetime2(7),@p68 nvarchar(4000),@p69 nvarchar(4000),@p70 int,@p71 int,@p72 int,@p73 nvarchar(4000),@p74 nvarchar(4000),@p75 nvarchar(4000),@p76 nvarchar(4000),@p77 decimal(18,2),@p78 nvarchar(4000),@p79 nvarchar(4000),@p80 decimal(18,2),@p81 nvarchar(4000),@p82 nvarchar(4000),@p83 nvarchar(4000),@p84 nvarchar(4000),@p85 int,@p86 nvarchar(4000),@p87 nvarchar(4000),@p88 nvarchar(4000),@p89 nvarchar(4000),@p90 nvarchar(4000),@p91 nvarchar(4000),@p92 nvarchar(4000),@p93 nvarchar(4000),@p94 nvarchar(4000),@p95 nvarchar(4000),@p96 int,@p97 nvarchar(4000),@p98 nvarchar(4000),@p99 nvarchar(4000),@p100 nvarchar(4000),@p101 nvarchar(4000),@p102 int,@p103 nvarchar(4000),@p104 int,@p105 int,@p106 datetime2(7),@p107 datetime2(7),@p108 datetime2(7),@p109 nvarchar(4000),@p110 nvarchar(4000),@p111 nvarchar(4000),@p112 nvarchar(4000),@p113 nvarchar(4000),@p114 nvarchar(4000),@p115 nvarchar(4000),@p116 nvarchar(4000),@p117 nvarchar(4000),@p118 nvarchar(4000),@p119 nvarchar(4000),@p120 nvarchar(4000),@p121 nvarchar(4000),@p122 nvarchar(4000),@p123 datetime2(7),@p124 nvarchar(4000),@p125 nvarchar(4000),@p126 int,@p127 int,@p128 int,@p129 nvarchar(4000),@p130 nvarchar(4000),@p131 nvarchar(4000),@p132 nvarchar(4000),@p133 decimal(18,2),@p134 nvarchar(4000),@p135 nvarchar(4000),@p136 decimal(18,2),@p137 nvarchar(4000),@p138 nvarchar(4000),@p139 nvarchar(4000),@p140 nvarchar(4000),@p141 int,@p142 nvarchar(4000),@p143 nvarchar(4000),@p144 nvarchar(4000),@p145 nvarchar(4000),@p146 nvarchar(4000),@p147 nvarchar(4000),@p148 nvarchar(4000),@p149 nvarchar(4000),@p150 nvarchar(4000),@p151 nvarchar(4000),@p152 int,@p153 nvarchar(4000),@p154 nvarchar(4000),@p155 nvarchar(4000),@p156 nvarchar(4000),@p157 nvarchar(4000),@p158 int,@p159 nvarchar(4000),@p160 int,@p161 int,@p162 datetime2(7),@p163 datetime2(7),@p164 datetime2(7),@p165 nvarchar(4000),@p166 nvarchar(4000),@p167 nvarchar(4000),@p168 nvarchar(4000),@p169 nvarchar(4000),@p170 nvarchar(4000),@p171 nvarchar(4000),@p172 nvarchar(4000),@p173 nvarchar(4000),@p174 nvarchar(4000),@p175 nvarchar(4000),@p176 nvarchar(4000),@p177 nvarchar(4000),@p178 nvarchar(4000),@p179 datetime2(7),@p180 nvarchar(4000),@p181 nvarchar(4000),@p182 int,@p183 int,@p184 int,@p185 nvarchar(4000),@p186 nvarchar(4000),@p187 nvarchar(4000),@p188 nvarchar(4000),@p189 decimal(18,2),@p190 nvarchar(4000),@p191 nvarchar(4000),@p192 decimal(18,2),@p193 nvarchar(4000),@p194 nvarchar(4000),@p195 nvarchar(4000),@p196 nvarchar(4000),@p197 int,@p198 nvarchar(4000),@p199 nvarchar(4000),@p200 nvarchar(4000),@p201 nvarchar(4000),@p202 nvarchar(4000),@p203 nvarchar(4000),@p204 nvarchar(4000),@p205 nvarchar(4000),@p206 nvarchar(4000),@p207 nvarchar(4000),@p208 int,@p209 nvarchar(4000),@p210 nvarchar(4000),@p211 nvarchar(4000),@p212 nvarchar(4000),@p213 nvarchar(4000),@p214 int,@p215 nvarchar(4000),@p216 int,@p217 int,@p218 datetime2(7),@p219 datetime2(7),@p220 datetime2(7),@p221 nvarchar(4000),@p222 nvarchar(4000),@p223 nvarchar(4000),@p224 nvarchar(4000),@p225 nvarchar(4000),@p226 nvarchar(4000),@p227 nvarchar(4000),@p228 nvarchar(4000),@p229 nvarchar(4000),@p230 nvarchar(4000),@p231 nvarchar(4000),@p232 nvarchar(4000),@p233 nvarchar(4000),@p234 nvarchar(4000),@p235 datetime2(7),@p236 nvarchar(4000),@p237 nvarchar(4000),@p238 int,@p239 int,@p240 int,@p241 nvarchar(4000),@p242 nvarchar(4000),@p243 nvarchar(4000),@p244 nvarchar(4000),@p245 decimal(18,2),@p246 nvarchar(4000),@p247 nvarchar(4000),@p248 decimal(18,2),@p249 nvarchar(4000),@p250 nvarchar(4000),@p251 nvarchar(4000),@p252 nvarchar(4000),@p253 int,@p254 nvarchar(4000),@p255 nvarchar(4000),@p256 nvarchar(4000),@p257 nvarchar(4000),@p258 nvarchar(4000),@p259 nvarchar(4000),@p260 nvarchar(4000),@p261 nvarchar(4000),@p262 nvarchar(4000),@p263 nvarchar(4000),@p264 int,@p265 nvarchar(4000),@p266 nvarchar(4000),@p267 nvarchar(4000),@p268 nvarchar(4000),@p269 nvarchar(4000),@p270 int,@p271 nvarchar(4000),@p272 int,@p273 int,@p274 datetime2(7),@p275 datetime2(7),@p276 datetime2(7),@p277 nvarchar(4000),@p278 nvarchar(4000),@p279 nvarchar(4000),@p280 nvarchar(4000),@p281 nvarchar(4000),@p282 nvarchar(4000),@p283 nvarchar(4000),@p284 nvarchar(4000),@p285 nvarchar(4000),@p286 nvarchar(4000),@p287 nvarchar(4000),@p288 nvarchar(4000),@p289 nvarchar(4000),@p290 nvarchar(4000),@p291 datetime2(7),@p292 nvarchar(4000),@p293 nvarchar(4000),@p294 int,@p295 int,@p296 int,@p297 nvarchar(4000),@p298 nvarchar(4000),@p299 nvarchar(4000),@p300 nvarchar(4000),@p301 decimal(18,2),@p302 nvarchar(4000),@p303 nvarchar(4000),@p304 decimal(18,2),@p305 nvarchar(4000),@p306 nvarchar(4000),@p307 nvarchar(4000),@p308 nvarchar(4000),@p309 int,@p310 nvarchar(4000),@p311 nvarchar(4000),@p312 nvarchar(4000),@p313 nvarchar(4000),@p314 nvarchar(4000),@p315 nvarchar(4000),@p316 nvarchar(4000),@p317 nvarchar(4000),@p318 nvarchar(4000),@p319 nvarchar(4000),@p320 int,@p321 nvarchar(4000),@p322 nvarchar(4000),@p323 nvarchar(4000),@p324 nvarchar(4000),@p325 nvarchar(4000),@p326 int,@p327 nvarchar(4000),@p328 int,@p329 int,@p330 datetime2(7),@p331 datetime2(7),@p332 datetime2(7),@p333 nvarchar(4000),@p334 nvarchar(4000),@p335 nvarchar(4000),@p336 nvarchar(4000),@p337 nvarchar(4000),@p338 nvarchar(4000),@p339 nvarchar(4000),@p340 nvarchar(4000),@p341 nvarchar(4000),@p342 nvarchar(4000),@p343 nvarchar(4000),@p344 nvarchar(4000),@p345 nvarchar(4000),@p346 nvarchar(4000),@p347 datetime2(7),@p348 nvarchar(4000),@p349 nvarchar(4000),@p350 int,@p351 int,@p352 int,@p353 nvarchar(4000),@p354 nvarchar(4000),@p355 nvarchar(4000),@p356 nvarchar(4000),@p357 decimal(18,2),@p358 nvarchar(4000),@p359 nvarchar(4000),@p360 decimal(18,2),@p361 nvarchar(4000),@p362 nvarchar(4000),@p363 nvarchar(4000),@p364 nvarchar(4000),@p365 int,@p366 nvarchar(4000),@p367 nvarchar(4000),@p368 nvarchar(4000),@p369 nvarchar(4000),@p370 nvarchar(4000),@p371 nvarchar(4000),@p372 nvarchar(4000),@p373 nvarchar(4000),@p374 nvarchar(4000),@p375 nvarchar(4000),@p376 int,@p377 nvarchar(4000),@p378 nvarchar(4000),@p379 nvarchar(4000),@p380 nvarchar(4000),@p381 nvarchar(4000),@p382 int,@p383 nvarchar(4000),@p384 int,@p385 int,@p386 datetime2(7),@p387 datetime2(7),@p388 datetime2(7),@p389 nvarchar(4000),@p390 nvarchar(4000),@p391 nvarchar(4000),@p392 nvarchar(4000),@p393 nvarchar(4000),@p394 nvarchar(4000),@p395 nvarchar(4000),@p396 nvarchar(4000),@p397 nvarchar(4000),@p398 nvarchar(4000),@p399 nvarchar(4000),@p400 nvarchar(4000),@p401 nvarchar(4000),@p402 nvarchar(4000),@p403 datetime2(7),@p404 nvarchar(4000),@p405 nvarchar(4000),@p406 int,@p407 int,@p408 int,@p409 nvarchar(4000),@p410 nvarchar(4000),@p411 nvarchar(4000),@p412 nvarchar(4000),@p413 decimal(18,2),@p414 nvarchar(4000),@p415 nvarchar(4000),@p416 decimal(18,2),@p417 nvarchar(4000),@p418 nvarchar(4000),@p419 nvarchar(4000),@p420 nvarchar(4000),@p421 int,@p422 nvarchar(4000),@p423 nvarchar(4000),@p424 nvarchar(4000),@p425 nvarchar(4000),@p426 nvarchar(4000),@p427 nvarchar(4000),@p428 nvarchar(4000),@p429 nvarchar(4000),@p430 nvarchar(4000),@p431 nvarchar(4000),@p432 int,@p433 nvarchar(4000),@p434 nvarchar(4000),@p435 nvarchar(4000),@p436 nvarchar(4000),@p437 nvarchar(4000),@p438 int,@p439 nvarchar(4000),@p440 int,@p441 int,@p442 datetime2(7),@p443 datetime2(7),@p444 datetime2(7),@p445 nvarchar(4000),@p446 nvarchar(4000),@p447 nvarchar(4000),@p448 nvarchar(4000),@p449 nvarchar(4000),@p450 nvarchar(4000),@p451 nvarchar(4000),@p452 nvarchar(4000),@p453 nvarchar(4000),@p454 nvarchar(4000),@p455 nvarchar(4000),@p456 nvarchar(4000),@p457 nvarchar(4000),@p458 nvarchar(4000),@p459 datetime2(7),@p460 nvarchar(4000),@p461 nvarchar(4000),@p462 int,@p463 int,@p464 int,@p465 nvarchar(4000),@p466 nvarchar(4000),@p467 nvarchar(4000),@p468 nvarchar(4000),@p469 decimal(18,2),@p470 nvarchar(4000),@p471 nvarchar(4000),@p472 decimal(18,2),@p473 nvarchar(4000),@p474 nvarchar(4000),@p475 nvarchar(4000),@p476 nvarchar(4000),@p477 int,@p478 nvarchar(4000),@p479 nvarchar(4000),@p480 nvarchar(4000),@p481 nvarchar(4000),@p482 nvarchar(4000),@p483 nvarchar(4000),@p484 nvarchar(4000),@p485 nvarchar(4000),@p486 nvarchar(4000),@p487 nvarchar(4000),@p488 int,@p489 nvarchar(4000),@p490 nvarchar(4000),@p491 nvarchar(4000),@p492 nvarchar(4000),@p493 nvarchar(4000),@p494 int,@p495 nvarchar(4000),@p496 int,@p497 int,@p498 datetime2(7),@p499 datetime2(7),@p500 datetime2(7),@p501 nvarchar(4000),@p502 nvarchar(4000),@p503 nvarchar(4000),@p504 nvarchar(4000),@p505 nvarchar(4000),@p506 nvarchar(4000),@p507 nvarchar(4000),@p508 nvarchar(4000),@p509 nvarchar(4000),@p510 nvarchar(4000),@p511 nvarchar(4000),@p512 nvarchar(4000),@p513 nvarchar(4000),@p514 nvarchar(4000),@p515 datetime2(7),@p516 nvarchar(4000),@p517 nvarchar(4000),@p518 int,@p519 int,@p520 int,@p521 nvarchar(4000),@p522 nvarchar(4000),@p523 nvarchar(4000),@p524 nvarchar(4000),@p525 decimal(18,2),@p526 nvarchar(4000),@p527 nvarchar(4000),@p528 decimal(18,2),@p529 nvarchar(4000),@p530 nvarchar(4000),@p531 nvarchar(4000),@p532 nvarchar(4000),@p533 int,@p534 nvarchar(4000),@p535 nvarchar(4000),@p536 nvarchar(4000),@p537 nvarchar(4000),@p538 nvarchar(4000),@p539 nvarchar(4000),@p540 nvarchar(4000),@p541 nvarchar(4000),@p542 nvarchar(4000),@p543 nvarchar(4000),@p544 int,@p545 nvarchar(4000),@p546 nvarchar(4000),@p547 nvarchar(4000),@p548 nvarchar(4000),@p549 nvarchar(4000),@p550 int,@p551 nvarchar(4000),@p552 int,@p553 int,@p554 datetime2(7),@p555 datetime2(7),@p556 datetime2(7),@p557 nvarchar(4000),@p558 nvarchar(4000),@p559 nvarchar(4000),@p560 nvarchar(4000),@p561 nvarchar(4000),@p562 nvarchar(4000),@p563 nvarchar(4000),@p564 nvarchar(4000),@p565 nvarchar(4000),@p566 nvarchar(4000),@p567 nvarchar(4000),@p568 nvarchar(4000),@p569 nvarchar(4000),@p570 nvarchar(4000),@p571 datetime2(7),@p572 nvarchar(4000),@p573 nvarchar(4000),@p574 int,@p575 int,@p576 int,@p577 nvarchar(4000),@p578 nvarchar(4000),@p579 nvarchar(4000),@p580 nvarchar(4000),@p581 decimal(18,2),@p582 nvarchar(4000),@p583 nvarchar(4000),@p584 decimal(18,2),@p585 nvarchar(4000),@p586 nvarchar(4000),@p587 nvarchar(4000),@p588 nvarchar(4000),@p589 int,@p590 nvarchar(4000),@p591 nvarchar(4000),@p592 nvarchar(4000),@p593 nvarchar(4000),@p594 nvarchar(4000),@p595 nvarchar(4000),@p596 nvarchar(4000),@p597 nvarchar(4000),@p598 nvarchar(4000),@p599 nvarchar(4000),@p600 int,@p601 nvarchar(4000),@p602 nvarchar(4000),@p603 nvarchar(4000),@p604 nvarchar(4000),@p605 nvarchar(4000),@p606 int,@p607 nvarchar(4000),@p608 int,@p609 int,@p610 datetime2(7),@p611 datetime2(7),@p612 datetime2(7),@p613 nvarchar(4000),@p614 nvarchar(4000),@p615 nvarchar(4000),@p616 nvarchar(4000),@p617 nvarchar(4000),@p618 nvarchar(4000),@p619 nvarchar(4000),@p620 nvarchar(4000),@p621 nvarchar(4000),@p622 nvarchar(4000),@p623 nvarchar(4000),@p624 nvarchar(4000),@p625 nvarchar(4000),@p626 nvarchar(4000),@p627 datetime2(7),@p628 nvarchar(4000),@p629 nvarchar(4000),@p630 int,@p631 int,@p632 int,@p633 nvarchar(4000),@p634 nvarchar(4000),@p635 nvarchar(4000),@p636 nvarchar(4000),@p637 decimal(18,2),@p638 nvarchar(4000),@p639 nvarchar(4000),@p640 decimal(18,2),@p641 nvarchar(4000),@p642 nvarchar(4000),@p643 nvarchar(4000),@p644 nvarchar(4000),@p645 int,@p646 nvarchar(4000),@p647 nvarchar(4000),@p648 nvarchar(4000),@p649 nvarchar(4000),@p650 nvarchar(4000),@p651 nvarchar(4000),@p652 nvarchar(4000),@p653 nvarchar(4000),@p654 nvarchar(4000),@p655 nvarchar(4000),@p656 int,@p657 nvarchar(4000),@p658 nvarchar(4000),@p659 nvarchar(4000),@p660 nvarchar(4000),@p661 nvarchar(4000),@p662 int,@p663 nvarchar(4000),@p664 int,@p665 int,@p666 datetime2(7),@p667 datetime2(7),@p668 datetime2(7),@p669 nvarchar(4000),@p670 nvarchar(4000),@p671 nvarchar(4000),@p672 nvarchar(4000),@p673 nvarchar(4000),@p674 nvarchar(4000),@p675 nvarchar(4000),@p676 nvarchar(4000),@p677 nvarchar(4000),@p678 nvarchar(4000),@p679 nvarchar(4000),@p680 nvarchar(4000),@p681 nvarchar(4000),@p682 nvarchar(4000),@p683 datetime2(7),@p684 nvarchar(4000),@p685 nvarchar(4000),@p686 int,@p687 int,@p688 int,@p689 nvarchar(4000),@p690 nvarchar(4000),@p691 nvarchar(4000),@p692 nvarchar(4000),@p693 decimal(18,2),@p694 nvarchar(4000),@p695 nvarchar(4000),@p696 decimal(18,2),@p697 nvarchar(4000),@p698 nvarchar(4000),@p699 nvarchar(4000),@p700 nvarchar(4000),@p701 int,@p702 nvarchar(4000),@p703 nvarchar(4000),@p704 nvarchar(4000),@p705 nvarchar(4000),@p706 nvarchar(4000),@p707 nvarchar(4000),@p708 nvarchar(4000),@p709 nvarchar(4000),@p710 nvarchar(4000),@p711 nvarchar(4000),@p712 int,@p713 nvarchar(4000),@p714 nvarchar(4000),@p715 nvarchar(4000),@p716 nvarchar(4000),@p717 nvarchar(4000),@p718 int,@p719 nvarchar(4000),@p720 int,@p721 int,@p722 datetime2(7),@p723 datetime2(7),@p724 datetime2(7),@p725 nvarchar(4000),@p726 nvarchar(4000),@p727 nvarchar(4000),@p728 nvarchar(4000),@p729 nvarchar(4000),@p730 nvarchar(4000),@p731 nvarchar(4000),@p732 nvarchar(4000),@p733 nvarchar(4000),@p734 nvarchar(4000),@p735 nvarchar(4000),@p736 nvarchar(4000),@p737 nvarchar(4000),@p738 nvarchar(4000),@p739 datetime2(7),@p740 nvarchar(4000),@p741 nvarchar(4000),@p742 int,@p743 int,@p744 int,@p745 nvarchar(4000),@p746 nvarchar(4000),@p747 nvarchar(4000),@p748 nvarchar(4000),@p749 decimal(18,2),@p750 nvarchar(4000),@p751 nvarchar(4000),@p752 decimal(18,2),@p753 nvarchar(4000),@p754 nvarchar(4000),@p755 nvarchar(4000),@p756 nvarchar(4000),@p757 int,@p758 nvarchar(4000),@p759 nvarchar(4000),@p760 nvarchar(4000),@p761 nvarchar(4000),@p762 nvarchar(4000),@p763 nvarchar(4000),@p764 nvarchar(4000),@p765 nvarchar(4000),@p766 nvarchar(4000),@p767 nvarchar(4000),@p768 int,@p769 nvarchar(4000),@p770 nvarchar(4000),@p771 nvarchar(4000),@p772 nvarchar(4000),@p773 nvarchar(4000),@p774 int,@p775 nvarchar(4000),@p776 int,@p777 int,@p778 datetime2(7),@p779 datetime2(7),@p780 datetime2(7),@p781 nvarchar(4000),@p782 nvarchar(4000),@p783 nvarchar(4000),@p784 nvarchar(4000),@p785 nvarchar(4000),@p786 nvarchar(4000),@p787 nvarchar(4000),@p788 nvarchar(4000),@p789 nvarchar(4000),@p790 nvarchar(4000),@p791 nvarchar(4000),@p792 nvarchar(4000),@p793 nvarchar(4000),@p794 nvarchar(4000),@p795 datetime2(7),@p796 nvarchar(4000),@p797 nvarchar(4000),@p798 int,@p799 int,@p800 int,@p801 nvarchar(4000),@p802 nvarchar(4000),@p803 nvarchar(4000),@p804 nvarchar(4000),@p805 decimal(18,2),@p806 nvarchar(4000),@p807 nvarchar(4000),@p808 decimal(18,2),@p809 nvarchar(4000),@p810 nvarchar(4000),@p811 nvarchar(4000),@p812 nvarchar(4000),@p813 int,@p814 nvarchar(4000),@p815 nvarchar(4000),@p816 nvarchar(4000),@p817 nvarchar(4000),@p818 nvarchar(4000),@p819 nvarchar(4000),@p820 nvarchar(4000),@p821 nvarchar(4000),@p822 nvarchar(4000),@p823 nvarchar(4000),@p824 int,@p825 nvarchar(4000),@p826 nvarchar(4000),@p827 nvarchar(4000),@p828 nvarchar(4000),@p829 nvarchar(4000),@p830 int,@p831 nvarchar(4000),@p832 int,@p833 int,@p834 datetime2(7),@p835 datetime2(7),@p836 datetime2(7),@p837 nvarchar(4000),@p838 nvarchar(4000),@p839 nvarchar(4000),@p840 nvarchar(4000),@p841 nvarchar(4000),@p842 nvarchar(4000),@p843 nvarchar(4000),@p844 nvarchar(4000),@p845 nvarchar(4000),@p846 nvarchar(4000),@p847 nvarchar(4000),@p848 nvarchar(4000),@p849 nvarchar(4000),@p850 nvarchar(4000),@p851 datetime2(7),@p852 nvarchar(4000),@p853 nvarchar(4000),@p854 int,@p855 int,@p856 int,@p857 nvarchar(4000),@p858 nvarchar(4000),@p859 nvarchar(4000),@p860 nvarchar(4000),@p861 decimal(18,2),@p862 nvarchar(4000),@p863 nvarchar(4000),@p864 decimal(18,2),@p865 nvarchar(4000),@p866 nvarchar(4000),@p867 nvarchar(4000),@p868 nvarchar(4000),@p869 int,@p870 nvarchar(4000),@p871 nvarchar(4000),@p872 nvarchar(4000),@p873 nvarchar(4000),@p874 nvarchar(4000),@p875 nvarchar(4000),@p876 nvarchar(4000),@p877 nvarchar(4000),@p878 nvarchar(4000),@p879 nvarchar(4000),@p880 int,@p881 nvarchar(4000),@p882 nvarchar(4000),@p883 nvarchar(4000),@p884 nvarchar(4000),@p885 nvarchar(4000),@p886 int,@p887 nvarchar(4000),@p888 int,@p889 int,@p890 datetime2(7),@p891 datetime2(7),@p892 datetime2(7),@p893 nvarchar(4000),@p894 nvarchar(4000),@p895 nvarchar(4000),@p896 nvarchar(4000),@p897 nvarchar(4000),@p898 nvarchar(4000),@p899 nvarchar(4000),@p900 nvarchar(4000),@p901 nvarchar(4000),@p902 nvarchar(4000),@p903 nvarchar(4000),@p904 nvarchar(4000),@p905 nvarchar(4000),@p906 nvarchar(4000),@p907 datetime2(7),@p908 nvarchar(4000),@p909 nvarchar(4000),@p910 int,@p911 int,@p912 int,@p913 nvarchar(4000),@p914 nvarchar(4000),@p915 nvarchar(4000),@p916 nvarchar(4000),@p917 decimal(18,2),@p918 nvarchar(4000),@p919 nvarchar(4000),@p920 decimal(18,2),@p921 nvarchar(4000),@p922 nvarchar(4000),@p923 nvarchar(4000),@p924 nvarchar(4000),@p925 int,@p926 nvarchar(4000),@p927 nvarchar(4000),@p928 nvarchar(4000),@p929 nvarchar(4000),@p930 nvarchar(4000),@p931 nvarchar(4000),@p932 nvarchar(4000),@p933 nvarchar(4000),@p934 nvarchar(4000),@p935 nvarchar(4000),@p936 int,@p937 nvarchar(4000),@p938 nvarchar(4000),@p939 nvarchar(4000),@p940 nvarchar(4000),@p941 nvarchar(4000),@p942 int,@p943 nvarchar(4000),@p944 int,@p945 int,@p946 datetime2(7),@p947 datetime2(7),@p948 datetime2(7),@p949 nvarchar(4000),@p950 nvarchar(4000),@p951 nvarchar(4000),@p952 nvarchar(4000),@p953 nvarchar(4000),@p954 nvarchar(4000),@p955 nvarchar(4000),@p956 nvarchar(4000),@p957 nvarchar(4000),@p958 nvarchar(4000),@p959 nvarchar(4000),@p960 nvarchar(4000),@p961 nvarchar(4000),@p962 nvarchar(4000),@p963 datetime2(7),@p964 nvarchar(4000),@p965 nvarchar(4000),@p966 int,@p967 int,@p968 int,@p969 nvarchar(4000),@p970 nvarchar(4000),@p971 nvarchar(4000),@p972 nvarchar(4000),@p973 decimal(18,2),@p974 nvarchar(4000),@p975 nvarchar(4000),@p976 decimal(18,2),@p977 nvarchar(4000),@p978 nvarchar(4000),@p979 nvarchar(4000),@p980 nvarchar(4000),@p981 int,@p982 nvarchar(4000),@p983 nvarchar(4000),@p984 nvarchar(4000),@p985 nvarchar(4000),@p986 nvarchar(4000),@p987 nvarchar(4000),@p988 nvarchar(4000),@p989 nvarchar(4000),@p990 nvarchar(4000),@p991 nvarchar(4000),@p992 int,@p993 nvarchar(4000),@p994 nvarchar(4000),@p995 nvarchar(4000),@p996 nvarchar(4000),@p997 nvarchar(4000),@p998 int,@p999 nvarchar(4000),@p1000 int,@p1001 int,@p1002 datetime2(7),@p1003 datetime2(7),@p1004 datetime2(7),@p1005 nvarchar(4000),@p1006 nvarchar(4000),@p1007 nvarchar(4000),@p1008 nvarchar(4000),@p1009 nvarchar(4000),@p1010 nvarchar(4000),@p1011 nvarchar(4000),@p1012 nvarchar(4000),@p1013 nvarchar(4000),@p1014 nvarchar(4000),@p1015 nvarchar(4000),@p1016 nvarchar(4000),@p1017 nvarchar(4000),@p1018 nvarchar(4000),@p1019 datetime2(7),@p1020 nvarchar(4000),@p1021 nvarchar(4000),@p1022 int,@p1023 int,@p1024 int,@p1025 nvarchar(4000),@p1026 nvarchar(4000),@p1027 nvarchar(4000),@p1028 decimal(18,2),@p1029 decimal(18,2),@p1030 nvarchar(4000),@p1031 nvarchar(4000),@p1032 decimal(18,2),@p1033 nvarchar(4000),@p1034 nvarchar(4000),@p1035 nvarchar(4000),@p1036 nvarchar(4000),@p1037 int,@p1038 nvarchar(4000),@p1039 nvarchar(4000),@p1040 nvarchar(4000),@p1041 nvarchar(4000),@p1042 nvarchar(4000),@p1043 nvarchar(4000),@p1044 nvarchar(4000),@p1045 nvarchar(4000),@p1046 nvarchar(4000),@p1047 nvarchar(4000),@p1048 int,@p1049 nvarchar(4000),@p1050 nvarchar(4000),@p1051 nvarchar(4000),@p1052 nvarchar(4000),@p1053 nvarchar(4000),@p1054 int,@p1055 nvarchar(4000),@p1056 int,@p1057 int,@p1058 datetime2(7),@p1059 datetime2(7),@p1060 datetime2(7),@p1061 nvarchar(4000),@p1062 nvarchar(4000),@p1063 nvarchar(4000),@p1064 nvarchar(4000),@p1065 nvarchar(4000),@p1066 nvarchar(4000),@p1067 nvarchar(4000),@p1068 nvarchar(4000),@p1069 nvarchar(4000),@p1070 nvarchar(4000),@p1071 nvarchar(4000),@p1072 nvarchar(4000),@p1073 nvarchar(4000),@p1074 nvarchar(4000),@p1075 datetime2(7),@p1076 nvarchar(4000),@p1077 nvarchar(4000),@p1078 int,@p1079 int,@p1080 int,@p1081 nvarchar(4000),@p1082 nvarchar(4000),@p1083 nvarchar(4000),@p1084 decimal(18,2),@p1085 decimal(18,2),@p1086 nvarchar(4000),@p1087 nvarchar(4000),@p1088 decimal(18,2),@p1089 nvarchar(4000),@p1090 nvarchar(4000),@p1091 nvarchar(4000),@p1092 nvarchar(4000),@p1093 int,@p1094 nvarchar(4000),@p1095 nvarchar(4000),@p1096 nvarchar(4000),@p1097 nvarchar(4000),@p1098 nvarchar(4000),@p1099 nvarchar(4000),@p1100 nvarchar(4000),@p1101 nvarchar(4000),@p1102 nvarchar(4000),@p1103 nvarchar(4000),@p1104 int,@p1105 nvarchar(4000),@p1106 nvarchar(4000),@p1107 nvarchar(4000),@p1108 nvarchar(4000),@p1109 nvarchar(4000),@p1110 int,@p1111 nvarchar(4000),@p1112 int,@p1113 int,@p1114 datetime2(7),@p1115 datetime2(7),@p1116 datetime2(7),@p1117 nvarchar(4000),@p1118 nvarchar(4000),@p1119 nvarchar(4000),@p1120 nvarchar(4000),@p1121 nvarchar(4000),@p1122 nvarchar(4000),@p1123 nvarchar(4000),@p1124 nvarchar(4000),@p1125 nvarchar(4000),@p1126 nvarchar(4000),@p1127 nvarchar(4000),@p1128 nvarchar(4000),@p1129 nvarchar(4000),@p1130 nvarchar(4000),@p1131 datetime2(7),@p1132 nvarchar(4000),@p1133 nvarchar(4000),@p1134 int,@p1135 int,@p1136 int,@p1137 nvarchar(4000),@p1138 nvarchar(4000),@p1139 nvarchar(4000),@p1140 decimal(18,2),@p1141 decimal(18,2),@p1142 nvarchar(4000),@p1143 nvarchar(4000),@p1144 decimal(18,2),@p1145 nvarchar(4000),@p1146 nvarchar(4000),@p1147 nvarchar(4000),@p1148 nvarchar(4000),@p1149 int,@p1150 nvarchar(4000),@p1151 nvarchar(4000),@p1152 nvarchar(4000),@p1153 nvarchar(4000),@p1154 nvarchar(4000),@p1155 nvarchar(4000),@p1156 nvarchar(4000),@p1157 nvarchar(4000),@p1158 nvarchar(4000),@p1159 nvarchar(4000),@p1160 int,@p1161 nvarchar(4000),@p1162 nvarchar(4000),@p1163 nvarchar(4000),@p1164 nvarchar(4000),@p1165 nvarchar(4000),@p1166 int,@p1167 nvarchar(4000),@p1168 int,@p1169 int,@p1170 datetime2(7),@p1171 datetime2(7),@p1172 datetime2(7),@p1173 nvarchar(4000),@p1174 nvarchar(4000),@p1175 nvarchar(4000),@p1176 nvarchar(4000),@p1177 nvarchar(4000),@p1178 nvarchar(4000),@p1179 nvarchar(4000),@p1180 nvarchar(4000),@p1181 nvarchar(4000),@p1182 nvarchar(4000),@p1183 nvarchar(4000),@p1184 nvarchar(4000),@p1185 nvarchar(4000),@p1186 nvarchar(4000),@p1187 datetime2(7),@p1188 nvarchar(4000),@p1189 nvarchar(4000),@p1190 int,@p1191 int,@p1192 int,@p1193 nvarchar(4000),@p1194 nvarchar(4000),@p1195 nvarchar(4000),@p1196 decimal(18,2),@p1197 decimal(18,2),@p1198 nvarchar(4000),@p1199 nvarchar(4000),@p1200 decimal(18,2),@p1201 nvarchar(4000),@p1202 nvarchar(4000),@p1203 nvarchar(4000),@p1204 nvarchar(4000),@p1205 int,@p1206 nvarchar(4000),@p1207 nvarchar(4000),@p1208 nvarchar(4000),@p1209 nvarchar(4000),@p1210 nvarchar(4000),@p1211 nvarchar(4000),@p1212 nvarchar(4000),@p1213 nvarchar(4000),@p1214 nvarchar(4000),@p1215 nvarchar(4000),@p1216 int,@p1217 nvarchar(4000),@p1218 nvarchar(4000),@p1219 nvarchar(4000),@p1220 nvarchar(4000),@p1221 nvarchar(4000),@p1222 int,@p1223 nvarchar(4000),@p1224 int,@p1225 int,@p1226 datetime2(7),@p1227 datetime2(7),@p1228 datetime2(7),@p1229 nvarchar(4000),@p1230 nvarchar(4000),@p1231 nvarchar(4000),@p1232 nvarchar(4000),@p1233 nvarchar(4000),@p1234 nvarchar(4000),@p1235 nvarchar(4000),@p1236 nvarchar(4000),@p1237 nvarchar(4000),@p1238 nvarchar(4000),@p1239 nvarchar(4000),@p1240 nvarchar(4000),@p1241 nvarchar(4000),@p1242 nvarchar(4000),@p1243 datetime2(7),@p1244 nvarchar(4000),@p1245 nvarchar(4000),@p1246 int,@p1247 int,@p1248 int,@p1249 nvarchar(4000),@p1250 nvarchar(4000),@p1251 nvarchar(4000),@p1252 decimal(18,2),@p1253 decimal(18,2),@p1254 nvarchar(4000),@p1255 nvarchar(4000),@p1256 decimal(18,2),@p1257 nvarchar(4000),@p1258 nvarchar(4000),@p1259 nvarchar(4000),@p1260 nvarchar(4000),@p1261 int,@p1262 nvarchar(4000),@p1263 nvarchar(4000),@p1264 nvarchar(4000),@p1265 nvarchar(4000),@p1266 nvarchar(4000),@p1267 nvarchar(4000),@p1268 nvarchar(4000),@p1269 nvarchar(4000),@p1270 nvarchar(4000),@p1271 nvarchar(4000),@p1272 int,@p1273 nvarchar(4000),@p1274 nvarchar(4000),@p1275 nvarchar(4000),@p1276 nvarchar(4000),@p1277 nvarchar(4000),@p1278 int,@p1279 nvarchar(4000),@p1280 int,@p1281 int,@p1282 datetime2(7),@p1283 datetime2(7),@p1284 datetime2(7),@p1285 nvarchar(4000),@p1286 nvarchar(4000),@p1287 nvarchar(4000),@p1288 nvarchar(4000),@p1289 nvarchar(4000),@p1290 nvarchar(4000),@p1291 nvarchar(4000),@p1292 nvarchar(4000),@p1293 nvarchar(4000),@p1294 nvarchar(4000),@p1295 nvarchar(4000),@p1296 nvarchar(4000),@p1297 nvarchar(4000),@p1298 nvarchar(4000),@p1299 datetime2(7),@p1300 nvarchar(4000),@p1301 nvarchar(4000),@p1302 int,@p1303 int,@p1304 int,@p1305 nvarchar(4000),@p1306 nvarchar(4000),@p1307 nvarchar(4000),@p1308 decimal(18,2),@p1309 decimal(18,2),@p1310 nvarchar(4000),@p1311 nvarchar(4000),@p1312 decimal(18,2),@p1313 nvarchar(4000),@p1314 nvarchar(4000),@p1315 nvarchar(4000),@p1316 nvarchar(4000),@p1317 int,@p1318 nvarchar(4000),@p1319 nvarchar(4000),@p1320 nvarchar(4000),@p1321 nvarchar(4000),@p1322 nvarchar(4000),@p1323 nvarchar(4000),@p1324 nvarchar(4000),@p1325 nvarchar(4000),@p1326 nvarchar(4000),@p1327 nvarchar(4000),@p1328 int,@p1329 nvarchar(4000),@p1330 nvarchar(4000),@p1331 nvarchar(4000),@p1332 nvarchar(4000),@p1333 nvarchar(4000),@p1334 int,@p1335 nvarchar(4000),@p1336 int,@p1337 int,@p1338 datetime2(7),@p1339 datetime2(7),@p1340 datetime2(7),@p1341 nvarchar(4000),@p1342 nvarchar(4000),@p1343 nvarchar(4000),@p1344 nvarchar(4000),@p1345 nvarchar(4000),@p1346 nvarchar(4000),@p1347 nvarchar(4000),@p1348 nvarchar(4000),@p1349 nvarchar(4000),@p1350 nvarchar(4000),@p1351 nvarchar(4000),@p1352 nvarchar(4000),@p1353 nvarchar(4000),@p1354 nvarchar(4000),@p1355 datetime2(7),@p1356 nvarchar(4000),@p1357 nvarchar(4000),@p1358 int,@p1359 int,@p1360 int,@p1361 nvarchar(4000),@p1362 nvarchar(4000),@p1363 nvarchar(4000),@p1364 decimal(18,2),@p1365 decimal(18,2),@p1366 nvarchar(4000),@p1367 nvarchar(4000),@p1368 decimal(18,2),@p1369 nvarchar(4000),@p1370 nvarchar(4000),@p1371 nvarchar(4000),@p1372 nvarchar(4000),@p1373 int,@p1374 nvarchar(4000),@p1375 nvarchar(4000),@p1376 nvarchar(4000),@p1377 nvarchar(4000),@p1378 nvarchar(4000),@p1379 nvarchar(4000),@p1380 nvarchar(4000),@p1381 nvarchar(4000),@p1382 nvarchar(4000),@p1383 nvarchar(4000),@p1384 int,@p1385 nvarchar(4000),@p1386 nvarchar(4000),@p1387 nvarchar(4000),@p1388 nvarchar(4000),@p1389 nvarchar(4000),@p1390 int,@p1391 nvarchar(4000),@p1392 int,@p1393 int,@p1394 datetime2(7),@p1395 datetime2(7),@p1396 datetime2(7),@p1397 nvarchar(4000),@p1398 nvarchar(4000),@p1399 nvarchar(4000),@p1400 nvarchar(4000),@p1401 nvarchar(4000),@p1402 nvarchar(4000),@p1403 nvarchar(4000),@p1404 nvarchar(4000),@p1405 nvarchar(4000),@p1406 nvarchar(4000),@p1407 nvarchar(4000),@p1408 nvarchar(4000),@p1409 nvarchar(4000),@p1410 nvarchar(4000),@p1411 datetime2(7),@p1412 nvarchar(4000),@p1413 nvarchar(4000),@p1414 int,@p1415 int,@p1416 int,@p1417 nvarchar(4000),@p1418 nvarchar(4000),@p1419 nvarchar(4000),@p1420 nvarchar(4000),@p1421 decimal(18,2),@p1422 nvarchar(4000),@p1423 nvarchar(4000),@p1424 decimal(18,2),@p1425 nvarchar(4000),@p1426 nvarchar(4000),@p1427 nvarchar(4000),@p1428 nvarchar(4000),@p1429 int,@p1430 nvarchar(4000),@p1431 nvarchar(4000),@p1432 nvarchar(4000),@p1433 nvarchar(4000),@p1434 nvarchar(4000),@p1435 nvarchar(4000),@p1436 nvarchar(4000),@p1437 nvarchar(4000),@p1438 nvarchar(4000),@p1439 nvarchar(4000),@p1440 int,@p1441 nvarchar(4000),@p1442 nvarchar(4000),@p1443 nvarchar(4000),@p1444 nvarchar(4000),@p1445 nvarchar(4000),@p1446 int,@p1447 nvarchar(4000),@p1448 int,@p1449 int,@p1450 datetime2(7),@p1451 datetime2(7),@p1452 datetime2(7),@p1453 nvarchar(4000),@p1454 nvarchar(4000),@p1455 nvarchar(4000),@p1456 nvarchar(4000),@p1457 nvarchar(4000),@p1458 nvarchar(4000),@p1459 nvarchar(4000),@p1460 nvarchar(4000),@p1461 nvarchar(4000),@p1462 nvarchar(4000),@p1463 nvarchar(4000),@p1464 nvarchar(4000),@p1465 nvarchar(4000),@p1466 nvarchar(4000),@p1467 datetime2(7),@p1468 nvarchar(4000),@p1469 nvarchar(4000),@p1470 int,@p1471 int,@p1472 int,@p1473 nvarchar(4000),@p1474 nvarchar(4000),@p1475 nvarchar(4000),@p1476 decimal(18,2),@p1477 decimal(18,2),@p1478 nvarchar(4000),@p1479 nvarchar(4000),@p1480 decimal(18,2),@p1481 nvarchar(4000),@p1482 nvarchar(4000),@p1483 nvarchar(4000),@p1484 nvarchar(4000),@p1485 int,@p1486 nvarchar(4000),@p1487 nvarchar(4000),@p1488 nvarchar(4000),@p1489 nvarchar(4000),@p1490 nvarchar(4000),@p1491 nvarchar(4000),@p1492 nvarchar(4000),@p1493 nvarchar(4000),@p1494 nvarchar(4000),@p1495 nvarchar(4000),@p1496 int,@p1497 nvarchar(4000),@p1498 nvarchar(4000),@p1499 nvarchar(4000),@p1500 nvarchar(4000),@p1501 nvarchar(4000),@p1502 int,@p1503 nvarchar(4000),@p1504 int,@p1505 int,@p1506 datetime2(7),@p1507 datetime2(7),@p1508 datetime2(7),@p1509 nvarchar(4000),@p1510 nvarchar(4000),@p1511 nvarchar(4000),@p1512 nvarchar(4000),@p1513 nvarchar(4000),@p1514 nvarchar(4000),@p1515 nvarchar(4000),@p1516 nvarchar(4000),@p1517 nvarchar(4000),@p1518 nvarchar(4000),@p1519 nvarchar(4000),@p1520 nvarchar(4000),@p1521 nvarchar(4000),@p1522 nvarchar(4000),@p1523 datetime2(7),@p1524 nvarchar(4000),@p1525 nvarchar(4000),@p1526 int,@p1527 int,@p1528 int,@p1529 nvarchar(4000),@p1530 nvarchar(4000),@p1531 nvarchar(4000),@p1532 decimal(18,2),@p1533 decimal(18,2),@p1534 nvarchar(4000),@p1535 nvarchar(4000),@p1536 decimal(18,2),@p1537 nvarchar(4000),@p1538 nvarchar(4000),@p1539 nvarchar(4000),@p1540 nvarchar(4000),@p1541 int,@p1542 nvarchar(4000),@p1543 nvarchar(4000),@p1544 nvarchar(4000),@p1545 nvarchar(4000),@p1546 nvarchar(4000),@p1547 nvarchar(4000),@p1548 nvarchar(4000),@p1549 nvarchar(4000),@p1550 nvarchar(4000),@p1551 nvarchar(4000),@p1552 int,@p1553 nvarchar(4000),@p1554 nvarchar(4000),@p1555 nvarchar(4000),@p1556 nvarchar(4000),@p1557 nvarchar(4000),@p1558 int,@p1559 nvarchar(4000),@p1560 int,@p1561 int,@p1562 datetime2(7),@p1563 datetime2(7),@p1564 datetime2(7),@p1565 nvarchar(4000),@p1566 nvarchar(4000),@p1567 nvarchar(4000),@p1568 nvarchar(4000),@p1569 nvarchar(4000),@p1570 nvarchar(4000),@p1571 nvarchar(4000),@p1572 nvarchar(4000),@p1573 nvarchar(4000),@p1574 nvarchar(4000),@p1575 nvarchar(4000),@p1576 nvarchar(4000),@p1577 nvarchar(4000),@p1578 nvarchar(4000),@p1579 datetime2(7),@p1580 nvarchar(4000),@p1581 nvarchar(4000),@p1582 int,@p1583 int,@p1584 int,@p1585 nvarchar(4000),@p1586 nvarchar(4000),@p1587 nvarchar(4000),@p1588 decimal(18,2),@p1589 decimal(18,2),@p1590 nvarchar(4000),@p1591 nvarchar(4000),@p1592 decimal(18,2),@p1593 nvarchar(4000),@p1594 nvarchar(4000),@p1595 nvarchar(4000),@p1596 nvarchar(4000),@p1597 int,@p1598 nvarchar(4000),@p1599 nvarchar(4000),@p1600 nvarchar(4000),@p1601 nvarchar(4000),@p1602 nvarchar(4000),@p1603 nvarchar(4000),@p1604 nvarchar(4000),@p1605 nvarchar(4000),@p1606 nvarchar(4000),@p1607 nvarchar(4000),@p1608 int,@p1609 nvarchar(4000),@p1610 nvarchar(4000),@p1611 nvarchar(4000),@p1612 nvarchar(4000),@p1613 nvarchar(4000),@p1614 int,@p1615 nvarchar(4000),@p1616 int,@p1617 int,@p1618 datetime2(7),@p1619 datetime2(7),@p1620 datetime2(7),@p1621 nvarchar(4000),@p1622 nvarchar(4000),@p1623 nvarchar(4000),@p1624 nvarchar(4000),@p1625 nvarchar(4000),@p1626 nvarchar(4000),@p1627 nvarchar(4000),@p1628 nvarchar(4000),@p1629 nvarchar(4000),@p1630 nvarchar(4000),@p1631 nvarchar(4000),@p1632 nvarchar(4000),@p1633 nvarchar(4000),@p1634 nvarchar(4000),@p1635 datetime2(7),@p1636 nvarchar(4000),@p1637 nvarchar(4000),@p1638 int,@p1639 int,@p1640 int,@p1641 nvarchar(4000),@p1642 nvarchar(4000),@p1643 nvarchar(4000),@p1644 decimal(18,2),@p1645 decimal(18,2),@p1646 nvarchar(4000),@p1647 nvarchar(4000),@p1648 decimal(18,2),@p1649 nvarchar(4000),@p1650 nvarchar(4000),@p1651 nvarchar(4000),@p1652 nvarchar(4000),@p1653 int,@p1654 nvarchar(4000),@p1655 nvarchar(4000),@p1656 nvarchar(4000),@p1657 nvarchar(4000),@p1658 nvarchar(4000),@p1659 nvarchar(4000),@p1660 nvarchar(4000),@p1661 nvarchar(4000),@p1662 nvarchar(4000),@p1663 nvarchar(4000),@p1664 int,@p1665 nvarchar(4000),@p1666 nvarchar(4000),@p1667 nvarchar(4000),@p1668 nvarchar(4000),@p1669 nvarchar(4000),@p1670 int,@p1671 nvarchar(4000),@p1672 int,@p1673 int,@p1674 datetime2(7),@p1675 datetime2(7),@p1676 datetime2(7),@p1677 nvarchar(4000),@p1678 nvarchar(4000),@p1679 nvarchar(4000),@p1680 nvarchar(4000),@p1681 nvarchar(4000),@p1682 nvarchar(4000),@p1683 nvarchar(4000),@p1684 nvarchar(4000),@p1685 nvarchar(4000),@p1686 nvarchar(4000),@p1687 nvarchar(4000),@p1688 nvarchar(4000),@p1689 nvarchar(4000),@p1690 nvarchar(4000),@p1691 datetime2(7),@p1692 nvarchar(4000),@p1693 nvarchar(4000),@p1694 int,@p1695 int,@p1696 int,@p1697 nvarchar(4000),@p1698 nvarchar(4000),@p1699 nvarchar(4000),@p1700 decimal(18,2),@p1701 decimal(18,2),@p1702 nvarchar(4000),@p1703 nvarchar(4000),@p1704 decimal(18,2),@p1705 nvarchar(4000),@p1706 nvarchar(4000),@p1707 nvarchar(4000),@p1708 nvarchar(4000),@p1709 int,@p1710 nvarchar(4000),@p1711 nvarchar(4000),@p1712 nvarchar(4000),@p1713 nvarchar(4000),@p1714 nvarchar(4000),@p1715 nvarchar(4000),@p1716 nvarchar(4000),@p1717 nvarchar(4000),@p1718 nvarchar(4000),@p1719 nvarchar(4000),@p1720 int,@p1721 nvarchar(4000),@p1722 nvarchar(4000),@p1723 nvarchar(4000),@p1724 nvarchar(4000),@p1725 nvarchar(4000),@p1726 int,@p1727 nvarchar(4000),@p1728 int,@p1729 int,@p1730 datetime2(7),@p1731 datetime2(7),@p1732 datetime2(7),@p1733 nvarchar(4000),@p1734 nvarchar(4000),@p1735 nvarchar(4000),@p1736 nvarchar(4000),@p1737 nvarchar(4000),@p1738 nvarchar(4000),@p1739 nvarchar(4000),@p1740 nvarchar(4000),@p1741 nvarchar(4000),@p1742 nvarchar(4000),@p1743 nvarchar(4000),@p1744 nvarchar(4000),@p1745 nvarchar(4000),@p1746 nvarchar(4000),@p1747 datetime2(7),@p1748 nvarchar(4000),@p1749 nvarchar(4000),@p1750 int,@p1751 int,@p1752 int,@p1753 nvarchar(4000),@p1754 nvarchar(4000),@p1755 nvarchar(4000),@p1756 decimal(18,2),@p1757 decimal(18,2),@p1758 nvarchar(4000),@p1759 nvarchar(4000),@p1760 decimal(18,2),@p1761 nvarchar(4000),@p1762 nvarchar(4000),@p1763 nvarchar(4000),@p1764 nvarchar(4000),@p1765 int,@p1766 nvarchar(4000),@p1767 nvarchar(4000),@p1768 nvarchar(4000),@p1769 nvarchar(4000),@p1770 nvarchar(4000),@p1771 nvarchar(4000),@p1772 nvarchar(4000),@p1773 nvarchar(4000),@p1774 nvarchar(4000),@p1775 nvarchar(4000),@p1776 int,@p1777 nvarchar(4000),@p1778 nvarchar(4000),@p1779 nvarchar(4000),@p1780 nvarchar(4000),@p1781 nvarchar(4000),@p1782 int,@p1783 nvarchar(4000),@p1784 int,@p1785 int,@p1786 datetime2(7),@p1787 datetime2(7),@p1788 datetime2(7),@p1789 nvarchar(4000),@p1790 nvarchar(4000),@p1791 nvarchar(4000),@p1792 nvarchar(4000),@p1793 nvarchar(4000),@p1794 nvarchar(4000),@p1795 nvarchar(4000),@p1796 nvarchar(4000),@p1797 nvarchar(4000),@p1798 nvarchar(4000),@p1799 nvarchar(4000),@p1800 nvarchar(4000),@p1801 nvarchar(4000),@p1802 nvarchar(4000),@p1803 datetime2(7),@p1804 nvarchar(4000),@p1805 nvarchar(4000),@p1806 int,@p1807 int,@p1808 int,@p1809 nvarchar(4000),@p1810 nvarchar(4000),@p1811 nvarchar(4000),@p1812 decimal(18,2),@p1813 decimal(18,2),@p1814 nvarchar(4000),@p1815 nvarchar(4000),@p1816 decimal(18,2),@p1817 nvarchar(4000),@p1818 nvarchar(4000),@p1819 nvarchar(4000),@p1820 nvarchar(4000),@p1821 int,@p1822 nvarchar(4000),@p1823 nvarchar(4000),@p1824 nvarchar(4000),@p1825 nvarchar(4000),@p1826 nvarchar(4000),@p1827 nvarchar(4000),@p1828 nvarchar(4000),@p1829 nvarchar(4000),@p1830 nvarchar(4000),@p1831 nvarchar(4000),@p1832 int,@p1833 nvarchar(4000),@p1834 nvarchar(4000),@p1835 nvarchar(4000),@p1836 nvarchar(4000),@p1837 nvarchar(4000),@p1838 int,@p1839 nvarchar(4000),@p1840 int,@p1841 int,@p1842 datetime2(7),@p1843 datetime2(7),@p1844 datetime2(7),@p1845 nvarchar(4000),@p1846 nvarchar(4000),@p1847 nvarchar(4000),@p1848 nvarchar(4000),@p1849 nvarchar(4000),@p1850 nvarchar(4000),@p1851 nvarchar(4000),@p1852 nvarchar(4000),@p1853 nvarchar(4000),@p1854 nvarchar(4000),@p1855 nvarchar(4000),@p1856 nvarchar(4000),@p1857 nvarchar(4000),@p1858 nvarchar(4000),@p1859 datetime2(7),@p1860 nvarchar(4000),@p1861 nvarchar(4000),@p1862 int,@p1863 int,@p1864 int,@p1865 nvarchar(4000),@p1866 nvarchar(4000),@p1867 nvarchar(4000),@p1868 decimal(18,2),@p1869 decimal(18,2),@p1870 nvarchar(4000),@p1871 nvarchar(4000),@p1872 decimal(18,2),@p1873 nvarchar(4000),@p1874 nvarchar(4000),@p1875 nvarchar(4000),@p1876 nvarchar(4000),@p1877 int,@p1878 nvarchar(4000),@p1879 nvarchar(4000),@p1880 nvarchar(4000),@p1881 nvarchar(4000),@p1882 nvarchar(4000),@p1883 nvarchar(4000),@p1884 nvarchar(4000),@p1885 nvarchar(4000),@p1886 nvarchar(4000),@p1887 nvarchar(4000),@p1888 int,@p1889 nvarchar(4000),@p1890 nvarchar(4000),@p1891 nvarchar(4000),@p1892 nvarchar(4000),@p1893 nvarchar(4000),@p1894 int,@p1895 nvarchar(4000),@p1896 int,@p1897 int,@p1898 datetime2(7),@p1899 datetime2(7),@p1900 datetime2(7),@p1901 nvarchar(4000),@p1902 nvarchar(4000),@p1903 nvarchar(4000),@p1904 nvarchar(4000),@p1905 nvarchar(4000),@p1906 nvarchar(4000),@p1907 nvarchar(4000),@p1908 nvarchar(4000),@p1909 nvarchar(4000),@p1910 nvarchar(4000),@p1911 nvarchar(4000),@p1912 nvarchar(4000),@p1913 nvarchar(4000),@p1914 nvarchar(4000),@p1915 datetime2(7),@p1916 nvarchar(4000),@p1917 nvarchar(4000),@p1918 int,@p1919 int,@p1920 int,@p1921 nvarchar(4000),@p1922 nvarchar(4000),@p1923 nvarchar(4000),@p1924 decimal(18,2),@p1925 decimal(18,2),@p1926 nvarchar(4000),@p1927 nvarchar(4000),@p1928 decimal(18,2),@p1929 nvarchar(4000),@p1930 nvarchar(4000),@p1931 nvarchar(4000),@p1932 nvarchar(4000),@p1933 int,@p1934 nvarchar(4000),@p1935 nvarchar(4000),@p1936 nvarchar(4000),@p1937 nvarchar(4000),@p1938 nvarchar(4000),@p1939 nvarchar(4000),@p1940 nvarchar(4000),@p1941 nvarchar(4000),@p1942 nvarchar(4000),@p1943 nvarchar(4000),@p1944 int,@p1945 nvarchar(4000),@p1946 nvarchar(4000),@p1947 nvarchar(4000),@p1948 nvarchar(4000),@p1949 nvarchar(4000),@p1950 int,@p1951 nvarchar(4000),@p1952 int,@p1953 int,@p1954 datetime2(7),@p1955 datetime2(7),@p1956 datetime2(7),@p1957 nvarchar(4000),@p1958 nvarchar(4000),@p1959 nvarchar(4000),@p1960 nvarchar(4000),@p1961 nvarchar(4000),@p1962 nvarchar(4000),@p1963 nvarchar(4000),@p1964 nvarchar(4000),@p1965 nvarchar(4000),@p1966 nvarchar(4000),@p1967 nvarchar(4000),@p1968 nvarchar(4000),@p1969 nvarchar(4000),@p1970 nvarchar(4000),@p1971 datetime2(7),@p1972 nvarchar(4000),@p1973 nvarchar(4000),@p1974 int,@p1975 int,@p1976 int,@p1977 nvarchar(4000),@p1978 nvarchar(4000),@p1979 nvarchar(4000),@p1980 decimal(18,2),@p1981 decimal(18,2),@p1982 nvarchar(4000),@p1983 nvarchar(4000),@p1984 decimal(18,2),@p1985 nvarchar(4000),@p1986 nvarchar(4000),@p1987 nvarchar(4000),@p1988 nvarchar(4000),@p1989 int,@p1990 nvarchar(4000),@p1991 nvarchar(4000),@p1992 nvarchar(4000),@p1993 nvarchar(4000),@p1994 nvarchar(4000),@p1995 nvarchar(4000),@p1996 nvarchar(4000),@p1997 nvarchar(4000),@p1998 nvarchar(4000),@p1999 nvarchar(4000),@p2000 int,@p2001 nvarchar(4000),@p2002 nvarchar(4000),@p2003 nvarchar(4000),@p2004 nvarchar(4000),@p2005 nvarchar(4000),@p2006 int,@p2007 nvarchar(4000),@p2008 int,@p2009 int,@p2010 datetime2(7),@p2011 datetime2(7),@p2012 datetime2(7),@p2013 nvarchar(4000),@p2014 nvarchar(4000),@p2015 nvarchar(4000),@p2016 nvarchar(4000),@p2017 nvarchar(4000),@p2018 nvarchar(4000),@p2019 nvarchar(4000),@p2020 nvarchar(4000),@p2021 nvarchar(4000),@p2022 nvarchar(4000),@p2023 nvarchar(4000),@p2024 nvarchar(4000),@p2025 nvarchar(4000),@p2026 nvarchar(4000),@p2027 datetime2(7),@p2028 nvarchar(4000),@p2029 nvarchar(4000),@p2030 int,@p2031 int,@p2032 int,@p2033 nvarchar(4000),@p2034 nvarchar(4000),@p2035 nvarchar(4000),@p2036 decimal(18,2),@p2037 decimal(18,2),@p2038 nvarchar(4000),@p2039 nvarchar(4000),@p2040 decimal(18,2),@p2041 nvarchar(4000),@p2042 nvarchar(4000),@p2043 nvarchar(4000),@p2044 nvarchar(4000),@p2045 int,@p2046 nvarchar(4000),@p2047 nvarchar(4000),@p2048 nvarchar(4000),@p2049 nvarchar(4000),@p2050 nvarchar(4000),@p2051 nvarchar(4000),@p2052 nvarchar(4000),@p2053 nvarchar(4000),@p2054 nvarchar(4000),@p2055 nvarchar(4000),@p2056 int,@p2057 nvarchar(4000),@p2058 nvarchar(4000),@p2059 nvarchar(4000),@p2060 nvarchar(4000),@p2061 nvarchar(4000),@p2062 int,@p2063 nvarchar(4000),@p2064 int,@p2065 int,@p2066 datetime2(7),@p2067 datetime2(7),@p2068 datetime2(7),@p2069 nvarchar(4000),@p2070 nvarchar(4000),@p2071 nvarchar(4000))SET NOCOUNT ON; DECLARE @inserted0 TABLE ([item_id] int, [_Position] [int]); MERGE [raw_data] USING ( VALUES (@p0, @p1, @p2, @p3, @p4, @p5, @p6, @p7, @p8, @p9, @p10, @p11, @p12, @p13, @p14, @p15, @p16, @p17, @p18, @p19, @p20, @p21, @p22, @p23, @p24, @p25, @p26, @p27, @p28, @p29, @p30, @p31, @p32, @p33, @p34, @p35, @p36, @p37, @p38, @p39, @p40, @p41, @p42, @p43, @p44, @p45, @p46, @p47, @p48, @p49, @p50, @p51, @p52, @p53, @p54, @p55, 0), (@p56, @p57, @p58, @p59, @p60, @p61, @p62, @p63, @p64, @p65, @p66, @p67, @p68, @p69, @p70, @p71, @p72, @p73, @p74, @p75, @p76, @p77, @p78, @p79, @p80, @p81, @p82, @p83, @p84, @p85, @p86, @p87, @p88, @p89, @p90, @p91, @p92, @p93, @p94, @p95, @p96, @p97, @p98, @p99, @p100, @p101, @p102, @p103, @p104, @p105, @p106, @p107, @p108, @p109, @p110, @p111, 1), (@p112, @p113, @p114, @p115, @p116, @p117, @p118, @p119, @p120, @p121, @p122, @p123, @p124, @p125, @p126, @p127, @p128, @p129, @p130, @p131, @p132, @p133, @p134, @p135, @p136, @p137, @p138, @p139, @p140, @p141, @p142, @p143, @p144, @p145, @p146, @p147, @p148, @p149, @p150, @p151, @p152, @p153, @p154, @p155, @p156, @p157, @p158, @p159, @p160, @p161, @p162, @p163, @p164, @p165, @p166, @p167, 2), (@p168, @p169, @p170, @p171, @p172, @p173, @p174, @p175, @p176, @p177, @p178, @p179, @p180, @p181, @p182, @p183, @p184, @p185, @p186, @p187, @p188, @p189, @p190, @p191, @p192, @p193, @p194, @p195, @p196, @p197, @p198, @p199, @p200, @p201, @p202, @p203, @p204, @p205, @p206, @p207, @p208, @p209, @p210, @p211, @p212, @p213, @p214, @p215, @p216, @p217, @p218, @p219, @p220, @p221, @p222, @p223, 3), (@p224, @p225, @p226, @p227, @p228, @p229, @p230, @p231, @p232, @p233, @p234, @p235, @p236, @p237, @p238, @p239, @p240, @p241, @p242, @p243, @p244, @p245, @p246, @p247, @p248, @p249, @p250, @p251, @p252, @p253, @p254, @p255, @p256, @p257, @p258, @p259, @p260, @p261, @p262, @p263, @p264, @p265, @p266, @p267, @p268, @p269, @p270, @p271, @p272, @p273, @p274, @p275, @p276, @p277, @p278, @p279, 4), (@p280, @p281, @p282, @p283, @p284, @p285, @p286, @p287, @p288, @p289, @p290, @p291, @p292, @p293, @p294, @p295, @p296, @p297, @p298, @p299, @p300, @p301, @p302, @p303, @p304, @p305, @p306, @p307, @p308, @p309, @p310, @p311, @p312, @p313, @p314, @p315, @p316, @p317, @p318, @p319, @p320, @p321, @p322, @p323, @p324, @p325, @p326, @p327, @p328, @p329, @p330, @p331, @p332, @p333, @p334, @p335, 5), (@p336, @p337, @p338, @p339, @p340, @p341, @p342, @p343, @p344, @p345, @p346, @p347, @p348, @p349, @p350, @p351, @p352, @p353, @p354, @p355, @p356, @p357, @p358, @p359, @p360, @p361, @p362, @p363, @p364, @p365, @p366, @p367, @p368, @p369, @p370, @p371, @p372, @p373, @p374, @p375, @p376, @p377, @p378, @p379, @p380, @p381, @p382, @p383, @p384, @p385, @p386, @p387, @p388, @p389, @p390, @p391, 6), (@p392, @p393, @p394, @p395, @p396, @p397, @p398, @p399, @p400, @p401, @p402, @p403, @p404, @p405, @p406, @p407, @p408, @p409, @p410, @p411, @p412, @p413, @p414, @p415, @p416, @p417, @p418, @p419, @p420, @p421, @p422, @p423, @p424, @p425, @p426, @p427, @p428, @p429, @p430, @p431, @p432, @p433, @p434, @p435, @p436, @p437, @p438, @p439, @p440, @p441, @p442, @p443, @p444, @p445, @p446, @p447, 7), (@p448, @p449, @p450, @p451, @p452, @p453, @p454, @p455, @p456, @p457, @p458, @p459, @p460, @p461, @p462, @p463, @p464, @p465, @p466, @p467, @p468, @p469, @p470, @p471, @p472, @p473, @p474, @p475, @p476, @p477, @p478, @p479, @p480, @p481, @p482, @p483, @p484, @p485, @p486, @p487, @p488, @p489, @p490, @p491, @p492, @p493, @p494, @p495, @p496, @p497, @p498, @p499, @p500, @p501, @p502, @p503, 8), (@p504, @p505, @p506, @p507, @p508, @p509, @p510, @p511, @p512, @p513, @p514, @p515, @p516, @p517, @p518, @p519, @p520, @p521, @p522, @p523, @p524, @p525, @p526, @p527, @p528, @p529, @p530, @p531, @p532, @p533, @p534, @p535, @p536, @p537, @p538, @p539, @p540, @p541, @p542, @p543, @p544, @p545, @p546, @p547, @p548, @p549, @p550, @p551, @p552, @p553, @p554, @p555, @p556, @p557, @p558, @p559, 9), (@p560, @p561, @p562, @p563, @p564, @p565, @p566, @p567, @p568, @p569, @p570, @p571, @p572, @p573, @p574, @p575, @p576, @p577, @p578, @p579, @p580, @p581, @p582, @p583, @p584, @p585, @p586, @p587, @p588, @p589, @p590, @p591, @p592, @p593, @p594, @p595, @p596, @p597, @p598, @p599, @p600, @p601, @p602, @p603, @p604, @p605, @p606, @p607, @p608, @p609, @p610, @p611, @p612, @p613, @p614, @p615, 10), (@p616, @p617, @p618, @p619, @p620, @p621, @p622, @p623, @p624, @p625, @p626, @p627, @p628, @p629, @p630, @p631, @p632, @p633, @p634, @p635, @p636, @p637, @p638, @p639, @p640, @p641, @p642, @p643, @p644, @p645, @p646, @p647, @p648, @p649, @p650, @p651, @p652, @p653, @p654, @p655, @p656, @p657, @p658, @p659, @p660, @p661, @p662, @p663, @p664, @p665, @p666, @p667, @p668, @p669, @p670, @p671, 11), (@p672, @p673, @p674, @p675, @p676, @p677, @p678, @p679, @p680, @p681, @p682, @p683, @p684, @p685, @p686, @p687, @p688, @p689, @p690, @p691, @p692, @p693, @p694, @p695, @p696, @p697, @p698, @p699, @p700, @p701, @p702, @p703, @p704, @p705, @p706, @p707, @p708, @p709, @p710, @p711, @p712, @p713, @p714, @p715, @p716, @p717, @p718, @p719, @p720, @p721, @p722, @p723, @p724, @p725, @p726, @p727, 12), (@p728, @p729, @p730, @p731, @p732, @p733, @p734, @p735, @p736, @p737, @p738, @p739, @p740, @p741, @p742, @p743, @p744, @p745, @p746, @p747, @p748, @p749, @p750, @p751, @p752, @p753, @p754, @p755, @p756, @p757, @p758, @p759, @p760, @p761, @p762, @p763, @p764, @p765, @p766, @p767, @p768, @p769, @p770, @p771, @p772, @p773, @p774, @p775, @p776, @p777, @p778, @p779, @p780, @p781, @p782, @p783, 13), (@p784, @p785, @p786, @p787, @p788, @p789, @p790, @p791, @p792, @p793, @p794, @p795, @p796, @p797, @p798, @p799, @p800, @p801, @p802, @p803, @p804, @p805, @p806, @p807, @p808, @p809, @p810, @p811, @p812, @p813, @p814, @p815, @p816, @p817, @p818, @p819, @p820, @p821, @p822, @p823, @p824, @p825, @p826, @p827, @p828, @p829, @p830, @p831, @p832, @p833, @p834, @p835, @p836, @p837, @p838, @p839, 14), (@p840, @p841, @p842, @p843, @p844, @p845, @p846, @p847, @p848, @p849, @p850, @p851, @p852, @p853, @p854, @p855, @p856, @p857, @p858, @p859, @p860, @p861, @p862, @p863, @p864, @p865, @p866, @p867, @p868, @p869, @p870, @p871, @p872, @p873, @p874, @p875, @p876, @p877, @p878, @p879, @p880, @p881, @p882, @p883, @p884, @p885, @p886, @p887, @p888, @p889, @p890, @p891, @p892, @p893, @p894, @p895, 15), (@p896, @p897, @p898, @p899, @p900, @p901, @p902, @p903, @p904, @p905, @p906, @p907, @p908, @p909, @p910, @p911, @p912, @p913, @p914, @p915, @p916, @p917, @p918, @p919, @p920, @p921, @p922, @p923, @p924, @p925, @p926, @p927, @p928, @p929, @p930, @p931, @p932, @p933, @p934, @p935, @p936, @p937, @p938, @p939, @p940, @p941, @p942, @p943, @p944, @p945, @p946, @p947, @p948, @p949, @p950, @p951, 16), (@p952, @p953, @p954, @p955, @p956, @p957, @p958, @p959, @p960, @p961, @p962, @p963, @p964, @p965, @p966, @p967, @p968, @p969, @p970, @p971, @p972, @p973, @p974, @p975, @p976, @p977, @p978, @p979, @p980, @p981, @p982, @p983, @p984, @p985, @p986, @p987, @p988, @p989, @p990, @p991, @p992, @p993, @p994, @p995, @p996, @p997, @p998, @p999, @p1000, @p1001, @p1002, @p1003, @p1004, @p1005, @p1006, @p1007, 17), (@p1008, @p1009, @p1010, @p1011, @p1012, @p1013, @p1014, @p1015, @p1016, @p1017, @p1018, @p1019, @p1020, @p1021, @p1022, @p1023, @p1024, @p1025, @p1026, @p1027, @p1028, @p1029, @p1030, @p1031, @p1032, @p1033, @p1034, @p1035, @p1036, @p1037, @p1038, @p1039, @p1040, @p1041, @p1042, @p1043, @p1044, @p1045, @p1046, @p1047, @p1048, @p1049, @p1050, @p1051, @p1052, @p1053, @p1054, @p1055, @p1056, @p1057, @p1058, @p1059, @p1060, @p1061, @p1062, @p1063, 18), (@p1064, @p1065, @p1066, @p1067, @p1068, @p1069, @p1070, @p1071, @p1072, @p1073, @p1074, @p1075, @p1076, @p1077, @p1078, @p1079, @p1080, @p1081, @p1082, @p1083, @p1084, @p1085, @p1086, @p1087, @p1088, @p1089, @p1090, @p1091, @p1092, @p1093, @p1094, @p1095, @p1096, @p1097, @p1098, @p1099, @p1100, @p1101, @p1102, @p1103, @p1104, @p1105, @p1106, @p1107, @p1108, @p1109, @p1110, @p1111, @p1112, @p1113, @p1114, @p1115, @p1116, @p1117, @p1118, @p1119, 19), (@p1120, @p1121, @p1122, @p1123, @p1124, @p1125, @p1126, @p1127, @p1128, @p1129, @p1130, @p1131, @p1132, @p1133, @p1134, @p1135, @p1136, @p1137, @p1138, @p1139, @p1140, @p1141, @p1142, @p1143, @p1144, @p1145, @p1146, @p1147, @p1148, @p1149, @p1150, @p1151, @p1152, @p1153, @p1154, @p1155, @p1156, @p1157, @p1158, @p1159, @p1160, @p1161, @p1162, @p1163, @p1164, @p1165, @p1166, @p1167, @p1168, @p1169, @p1170, @p1171, @p1172, @p1173, @p1174, @p1175, 20), (@p1176, @p1177, @p1178, @p1179, @p1180, @p1181, @p1182, @p1183, @p1184, @p1185, @p1186, @p1187, @p1188, @p1189, @p1190, @p1191, @p1192, @p1193, @p1194, @p1195, @p1196, @p1197, @p1198, @p1199, @p1200, @p1201, @p1202, @p1203, @p1204, @p1205, @p1206, @p1207, @p1208, @p1209, @p1210, @p1211, @p1212, @p1213, @p1214, @p1215, @p1216, @p1217, @p1218, @p1219, @p1220, @p1221, @p1222, @p1223, @p1224, @p1225, @p1226, @p1227, @p1228, @p1229, @p1230, @p1231, 21), (@p1232, @p1233, @p1234, @p1235, @p1236, @p1237, @p1238, @p1239, @p1240, @p1241, @p1242, @p1243, @p1244, @p1245, @p1246, @p1247, @p1248, @p1249, @p1250, @p1251, @p1252, @p1253, @p1254, @p1255, @p1256, @p1257, @p1258, @p1259, @p1260, @p1261, @p1262, @p1263, @p1264, @p1265, @p1266, @p1267, @p1268, @p1269, @p1270, @p1271, @p1272, @p1273, @p1274, @p1275, @p1276, @p1277, @p1278, @p1279, @p1280, @p1281, @p1282, @p1283, @p1284, @p1285, @p1286, @p1287, 22), (@p1288, @p1289, @p1290, @p1291, @p1292, @p1293, @p1294, @p1295, @p1296, @p1297, @p1298, @p1299, @p1300, @p1301, @p1302, @p1303, @p1304, @p1305, @p1306, @p1307, @p1308, @p1309, @p1310, @p1311, @p1312, @p1313, @p1314, @p1315, @p1316, @p1317, @p1318, @p1319, @p1320, @p1321, @p1322, @p1323, @p1324, @p1325, @p1326, @p1327, @p1328, @p1329, @p1330, @p1331, @p1332, @p1333, @p1334, @p1335, @p1336, @p1337, @p1338, @p1339, @p1340, @p1341, @p1342, @p1343, 23), (@p1344, @p1345, @p1346, @p1347, @p1348, @p1349, @p1350, @p1351, @p1352, @p1353, @p1354, @p1355, @p1356, @p1357, @p1358, @p1359, @p1360, @p1361, @p1362, @p1363, @p1364, @p1365, @p1366, @p1367, @p1368, @p1369, @p1370, @p1371, @p1372, @p1373, @p1374, @p1375, @p1376, @p1377, @p1378, @p1379, @p1380, @p1381, @p1382, @p1383, @p1384, @p1385, @p1386, @p1387, @p1388, @p1389, @p1390, @p1391, @p1392, @p1393, @p1394, @p1395, @p1396, @p1397, @p1398, @p1399, 24), (@p1400, @p1401, @p1402, @p1403, @p1404, @p1405, @p1406, @p1407, @p1408, @p1409, @p1410, @p1411, @p1412, @p1413, @p1414, @p1415, @p1416, @p1417, @p1418, @p1419, @p1420, @p1421, @p1422, @p1423, @p1424, @p1425, @p1426, @p1427, @p1428, @p1429, @p1430, @p1431, @p1432, @p1433, @p1434, @p1435, @p1436, @p1437, @p1438, @p1439, @p1440, @p1441, @p1442, @p1443, @p1444, @p1445, @p1446, @p1447, @p1448, @p1449, @p1450, @p1451, @p1452, @p1453, @p1454, @p1455, 25), (@p1456, @p1457, @p1458, @p1459, @p1460, @p1461, @p1462, @p1463, @p1464, @p1465, @p1466, @p1467, @p1468, @p1469, @p1470, @p1471, @p1472, @p1473, @p1474, @p1475, @p1476, @p1477, @p1478, @p1479, @p1480, @p1481, @p1482, @p1483, @p1484, @p1485, @p1486, @p1487, @p1488, @p1489, @p1490, @p1491, @p1492, @p1493, @p1494, @p1495, @p1496, @p1497, @p1498, @p1499, @p1500, @p1501, @p1502, @p1503, @p1504, @p1505, @p1506, @p1507, @p1508, @p1509, @p1510, @p1511, 26), (@p1512, @p1513, @p1514, @p1515, @p1516, @p1517, @p1518, @p1519, @p1520, @p1521, @p1522, @p1523, @p1524, @p1525, @p1526, @p1527, @p1528, @p1529, @p1530, @p1531, @p1532, @p1533, @p1534, @p1535, @p1536, @p1537, @p1538, @p1539, @p1540, @p1541, @p1542, @p1543, @p1544, @p1545, @p1546, @p1547, @p1548, @p1549, @p1550, @p1551, @p1552, @p1553, @p1554, @p1555, @p1556, @p1557, @p1558, @p1559, @p1560, @p1561, @p1562, @p1563, @p1564, @p1565, @p1566, @p1567, 27), (@p1568, @p1569, @p1570, @p1571, @p1572, @p1573, @p1574, @p1575, @p1576, @p1577, @p1578, @p1579, @p1580, @p1581, @p1582, @p1583, @p1584, @p1585, @p1586, @p1587, @p1588, @p1589, @p1590, @p1591, @p1592, @p1593, @p1594, @p1595, @p1596, @p1597, @p1598, @p1599, @p1600, @p1601, @p1602, @p1603, @p1604, @p1605, @p1606, @p1607, @p1608, @p1609, @p1610, @p1611, @p1612, @p1613, @p1614, @p1615, @p1616, @p1617, @p1618, @p1619, @p1620, @p1621, @p1622, @p1623, 28), (@p1624, @p1625, @p1626, @p1627, @p1628, @p1629, @p1630, @p1631, @p1632, @p1633, @p1634, @p1635, @p1636, @p1637, @p1638, @p1639, @p1640, @p1641, @p1642, @p1643, @p1644, @p1645, @p1646, @p1647, @p1648, @p1649, @p1650, @p1651, @p1652, @p1653, @p1654, @p1655, @p1656, @p1657, @p1658, @p1659, @p1660, @p1661, @p1662, @p1663, @p1664, @p1665, @p1666, @p1667, @p1668, @p1669, @p1670, @p1671, @p1672, @p1673, @p1674, @p1675, @p1676, @p1677, @p1678, @p1679, 29), (@p1680, @p1681, @p1682, @p1683, @p1684, @p1685, @p1686, @p1687, @p1688, @p1689, @p1690, @p1691, @p1692, @p1693, @p1694, @p1695, @p1696, @p1697, @p1698, @p1699, @p1700, @p1701, @p1702, @p1703, @p1704, @p1705, @p1706, @p1707, @p1708, @p1709, @p1710, @p1711, @p1712, @p1713, @p1714, @p1715, @p1716, @p1717, @p1718, @p1719, @p1720, @p1721, @p1722, @p1723, @p1724, @p1725, @p1726, @p1727, @p1728, @p1729, @p1730, @p1731, @p1732, @p1733, @p1734, @p1735, 30), (@p1736, @p1737, @p1738, @p1739, @p1740, @p1741, @p1742, @p1743, @p1744, @p1745, @p1746, @p1747, @p1748, @p1749, @p1750, @p1751, @p1752, @p1753, @p1754, @p1755, @p1756, @p1757, @p1758, @p1759, @p1760, @p1761, @p1762, @p1763, @p1764, @p1765, @p1766, @p1767, @p1768, @p1769, @p1770, @p1771, @p1772, @p1773, @p1774, @p1775, @p1776, @p1777, @p1778, @p1779, @p1780, @p1781, @p1782, @p1783, @p1784, @p1785, @p1786, @p1787, @p1788, @p1789, @p1790, @p1791, 31), (@p1792, @p1793, @p1794, @p1795, @p1796, @p1797, @p1798, @p1799, @p1800, @p1801, @p1802, @p1803, @p1804, @p1805, @p1806, @p1807, @p1808, @p1809, @p1810, @p1811, @p1812, @p1813, @p1814, @p1815, @p1816, @p1817, @p1818, @p1819, @p1820, @p1821, @p1822, @p1823, @p1824, @p1825, @p1826, @p1827, @p1828, @p1829, @p1830, @p1831, @p1832, @p1833, @p1834, @p1835, @p1836, @p1837, @p1838, @p1839, @p1840, @p1841, @p1842, @p1843, @p1844, @p1845, @p1846, @p1847, 32), (@p1848, @p1849, @p1850, @p1851, @p1852, @p1853, @p1854, @p1855, @p1856, @p1857, @p1858, @p1859, @p1860, @p1861, @p1862, @p1863, @p1864, @p1865, @p1866, @p1867, @p1868, @p1869, @p1870, @p1871, @p1872, @p1873, @p1874, @p1875, @p1876, @p1877, @p1878, @p1879, @p1880, @p1881, @p1882, @p1883, @p1884, @p1885, @p1886, @p1887, @p1888, @p1889, @p1890, @p1891, @p1892, @p1893, @p1894, @p1895, @p1896, @p1897, @p1898, @p1899, @p1900, @p1901, @p1902, @p1903, 33), (@p1904, @p1905, @p1906, @p1907, @p1908, @p1909, @p1910, @p1911, @p1912, @p1913, @p1914, @p1915, @p1916, @p1917, @p1918, @p1919, @p1920, @p1921, @p1922, @p1923, @p1924, @p1925, @p1926, @p1927, @p1928, @p1929, @p1930, @p1931, @p1932, @p1933, @p1934, @p1935, @p1936, @p1937, @p1938, @p1939, @p1940, @p1941, @p1942, @p1943, @p1944, @p1945, @p1946, @p1947, @p1948, @p1949, @p1950, @p1951, @p1952, @p1953, @p1954, @p1955, @p1956, @p1957, @p1958, @p1959, 34), (@p1960, @p1961, @p1962, @p1963, @p1964, @p1965, @p1966, @p1967, @p1968, @p1969, @p1970, @p1971, @p1972, @p1973, @p1974, @p1975, @p1976, @p1977, @p1978, @p1979, @p1980, @p1981, @p1982, @p1983, @p1984, @p1985, @p1986, @p1987, @p1988, @p1989, @p1990, @p1991, @p1992, @p1993, @p1994, @p1995, @p1996, @p1997, @p1998, @p1999, @p2000, @p2001, @p2002, @p2003, @p2004, @p2005, @p2006, @p2007, @p2008, @p2009, @p2010, @p2011, @p2012, @p2013, @p2014, @p2015, 35), (@p2016, @p2017, @p2018, @p2019, @p2020, @p2021, @p2022, @p2023, @p2024, @p2025, @p2026, @p2027, @p2028, @p2029, @p2030, @p2031, @p2032, @p2033, @p2034, @p2035, @p2036, @p2037, @p2038, @p2039, @p2040, @p2041, @p2042, @p2043, @p2044, @p2045, @p2046, @p2047, @p2048, @p2049, @p2050, @p2051, @p2052, @p2053, @p2054, @p2055, @p2056, @p2057, @p2058, @p2059, @p2060, @p2061, @p2062, @p2063, @p2064, @p2065, @p2066, @p2067, @p2068, @p2069, @p2070, @p2071, 36)) AS i ([addressee_cntry_cd], [addressee_city], [addressee_district], [addressee_email], [addressee_full_address], [addressee_home_address], [addressee_name], [addressee_postcode], [addressee_province], [addressee_subdistrict], [addressee_tel], [create_table], [delivery_code], [delivery_recipient_name], [delivery_relation_id], [delivery_status_id], [dest_outlet_id], [dest_outlet_port], [document_number], [item_barcode], [item_cod], [item_gross_weight], [item_height], [item_length], [item_price], [item_width], [lat], [log_id], [long], [outlet_id], [outlet_port], [podUrl], [remark], [scan_cntry_cd], [scan_cntry_postcode], [sender_cntry_cd], [sender_district], [sender_email], [sender_full_address], [sender_home_address], [member_id], [sender_name], [sender_postcode], [sender_province], [sender_subdistrict], [sender_tel], [server_id], [signatureUrl], [state], [status_code], [status_dtm], [timestamp], [transmit_dtm], [user_id], [wckt_id], [wkstn_no], _Position) ON 1=0 WHEN NOT MATCHED THEN INSERT ([addressee_cntry_cd], [addressee_city], [addressee_district], [addressee_email], [addressee_full_address], [addressee_home_address], [addressee_name], [addressee_postcode], [addressee_province], [addressee_subdistrict], [addressee_tel], [create_table], [delivery_code], [delivery_recipient_name], [delivery_relation_id], [delivery_status_id], [dest_outlet_id], [dest_outlet_port], [document_number], [item_barcode], [item_cod], [item_gross_weight], [item_height], [item_length], [item_price], [item_width], [lat], [log_id], [long], [outlet_id], [outlet_port], [podUrl], [remark], [scan_cntry_cd], [scan_cntry_postcode], [sender_cntry_cd], [sender_district], [sender_email], [sender_full_address], [sender_home_address], [member_id], [sender_name], [sender_postcode], [sender_province], [sender_subdistrict], [sender_tel], [server_id], [signatureUrl], [state], [status_code], [status_dtm], [timestamp], [transmit_dtm], [user_id], [wckt_id], [wkstn_no]) VALUES (i.[addressee_cntry_cd], i.[addressee_city], i.[addressee_district], i.[addressee_email], i.[addressee_full_address], i.[addressee_home_address], i.[addressee_name], i.[addressee_postcode], i.[addressee_province], i.[addressee_subdistrict], i.[addressee_tel], i.[create_table], i.[delivery_code], i.[delivery_recipient_name], i.[delivery_relation_id], i.[delivery_status_id], i.[dest_outlet_id], i.[dest_outlet_port], i.[document_number], i.[item_barcode], i.[item_cod], i.[item_gross_weight], i.[item_height], i.[item_length], i.[item_price], i.[item_width], i.[lat], i.[log_id], i.[long], i.[outlet_id], i.[outlet_port], i.[podUrl], i.[remark], i.[scan_cntry_cd], i.[scan_cntry_postcode], i.[sender_cntry_cd], i.[sender_district], i.[sender_email], i.[sender_full_address], i.[sender_home_address], i.[member_id], i.[sender_name], i.[sender_postcode], i.[sender_province], i.[sender_subdistrict], i.[sender_tel], i.[server_id], i.[signatureUrl], i.[state], i.[status_code], i.[status_dtm], i.[timestamp], i.[transmit_dtm], i.[user_id], i.[wckt_id], i.[wkstn_no]) OUTPUT INSERTED.[item_id], i._Position INTO @inserted0;  SELECT [t].[item_id] FROM [raw_data] t INNER JOIN @inserted0 i ON ([t].[item_id] = [i].[item_id]) ORDER BY [i].[_Position];  ",5,5,0,430,1,5
"(@p0 nvarchar(4000),@p1 nvarchar(4000),@p2 nvarchar(4000),@p3 nvarchar(4000),@p4 nvarchar(4000),@p5 nvarchar(4000),@p6 nvarchar(4000),@p7 nvarchar(4000),@p8 nvarchar(4000),@p9 nvarchar(4000),@p10 nvarchar(4000),@p11 datetime2(7),@p12 nvarchar(4000),@p13 nvarchar(4000),@p14 int,@p15 int,@p16 int,@p17 nvarchar(4000),@p18 nvarchar(4000),@p19 nvarchar(4000),@p20 nvarchar(4000),@p21 decimal(18,2),@p22 nvarchar(4000),@p23 nvarchar(4000),@p24 decimal(18,2),@p25 nvarchar(4000),@p26 nvarchar(4000),@p27 nvarchar(4000),@p28 nvarchar(4000),@p29 int,@p30 nvarchar(4000),@p31 nvarchar(4000),@p32 nvarchar(4000),@p33 nvarchar(4000),@p34 nvarchar(4000),@p35 nvarchar(4000),@p36 nvarchar(4000),@p37 nvarchar(4000),@p38 nvarchar(4000),@p39 nvarchar(4000),@p40 int,@p41 nvarchar(4000),@p42 nvarchar(4000),@p43 nvarchar(4000),@p44 nvarchar(4000),@p45 nvarchar(4000),@p46 int,@p47 nvarchar(4000),@p48 int,@p49 int,@p50 datetime2(7),@p51 datetime2(7),@p52 datetime2(7),@p53 nvarchar(4000),@p54 nvarchar(4000),@p55 nvarchar(4000),@p56 nvarchar(4000),@p57 nvarchar(4000),@p58 nvarchar(4000),@p59 nvarchar(4000),@p60 nvarchar(4000),@p61 nvarchar(4000),@p62 nvarchar(4000),@p63 nvarchar(4000),@p64 nvarchar(4000),@p65 nvarchar(4000),@p66 nvarchar(4000),@p67 datetime2(7),@p68 nvarchar(4000),@p69 nvarchar(4000),@p70 int,@p71 int,@p72 int,@p73 nvarchar(4000),@p74 nvarchar(4000),@p75 nvarchar(4000),@p76 nvarchar(4000),@p77 decimal(18,2),@p78 nvarchar(4000),@p79 nvarchar(4000),@p80 decimal(18,2),@p81 nvarchar(4000),@p82 nvarchar(4000),@p83 nvarchar(4000),@p84 nvarchar(4000),@p85 int,@p86 nvarchar(4000),@p87 nvarchar(4000),@p88 nvarchar(4000),@p89 nvarchar(4000),@p90 nvarchar(4000),@p91 nvarchar(4000),@p92 nvarchar(4000),@p93 nvarchar(4000),@p94 nvarchar(4000),@p95 nvarchar(4000),@p96 int,@p97 nvarchar(4000),@p98 nvarchar(4000),@p99 nvarchar(4000),@p100 nvarchar(4000),@p101 nvarchar(4000),@p102 int,@p103 nvarchar(4000),@p104 int,@p105 int,@p106 datetime2(7),@p107 datetime2(7),@p108 datetime2(7),@p109 nvarchar(4000),@p110 nvarchar(4000),@p111 nvarchar(4000),@p112 nvarchar(4000),@p113 nvarchar(4000),@p114 nvarchar(4000),@p115 nvarchar(4000),@p116 nvarchar(4000),@p117 nvarchar(4000),@p118 nvarchar(4000),@p119 nvarchar(4000),@p120 nvarchar(4000),@p121 nvarchar(4000),@p122 nvarchar(4000),@p123 datetime2(7),@p124 nvarchar(4000),@p125 nvarchar(4000),@p126 int,@p127 int,@p128 int,@p129 nvarchar(4000),@p130 nvarchar(4000),@p131 nvarchar(4000),@p132 nvarchar(4000),@p133 decimal(18,2),@p134 nvarchar(4000),@p135 nvarchar(4000),@p136 decimal(18,2),@p137 nvarchar(4000),@p138 nvarchar(4000),@p139 nvarchar(4000),@p140 nvarchar(4000),@p141 int,@p142 nvarchar(4000),@p143 nvarchar(4000),@p144 nvarchar(4000),@p145 nvarchar(4000),@p146 nvarchar(4000),@p147 nvarchar(4000),@p148 nvarchar(4000),@p149 nvarchar(4000),@p150 nvarchar(4000),@p151 nvarchar(4000),@p152 int,@p153 nvarchar(4000),@p154 nvarchar(4000),@p155 nvarchar(4000),@p156 nvarchar(4000),@p157 nvarchar(4000),@p158 int,@p159 nvarchar(4000),@p160 int,@p161 int,@p162 datetime2(7),@p163 datetime2(7),@p164 datetime2(7),@p165 nvarchar(4000),@p166 nvarchar(4000),@p167 nvarchar(4000),@p168 nvarchar(4000),@p169 nvarchar(4000),@p170 nvarchar(4000),@p171 nvarchar(4000),@p172 nvarchar(4000),@p173 nvarchar(4000),@p174 nvarchar(4000),@p175 nvarchar(4000),@p176 nvarchar(4000),@p177 nvarchar(4000),@p178 nvarchar(4000),@p179 datetime2(7),@p180 nvarchar(4000),@p181 nvarchar(4000),@p182 int,@p183 int,@p184 int,@p185 nvarchar(4000),@p186 nvarchar(4000),@p187 nvarchar(4000),@p188 nvarchar(4000),@p189 decimal(18,2),@p190 nvarchar(4000),@p191 nvarchar(4000),@p192 decimal(18,2),@p193 nvarchar(4000),@p194 nvarchar(4000),@p195 nvarchar(4000),@p196 nvarchar(4000),@p197 int,@p198 nvarchar(4000),@p199 nvarchar(4000),@p200 nvarchar(4000),@p201 nvarchar(4000),@p202 nvarchar(4000),@p203 nvarchar(4000),@p204 nvarchar(4000),@p205 nvarchar(4000),@p206 nvarchar(4000),@p207 nvarchar(4000),@p208 int,@p209 nvarchar(4000),@p210 nvarchar(4000),@p211 nvarchar(4000),@p212 nvarchar(4000),@p213 nvarchar(4000),@p214 int,@p215 nvarchar(4000),@p216 int,@p217 int,@p218 datetime2(7),@p219 datetime2(7),@p220 datetime2(7),@p221 nvarchar(4000),@p222 nvarchar(4000),@p223 nvarchar(4000),@p224 nvarchar(4000),@p225 nvarchar(4000),@p226 nvarchar(4000),@p227 nvarchar(4000),@p228 nvarchar(4000),@p229 nvarchar(4000),@p230 nvarchar(4000),@p231 nvarchar(4000),@p232 nvarchar(4000),@p233 nvarchar(4000),@p234 nvarchar(4000),@p235 datetime2(7),@p236 nvarchar(4000),@p237 nvarchar(4000),@p238 int,@p239 int,@p240 int,@p241 nvarchar(4000),@p242 nvarchar(4000),@p243 nvarchar(4000),@p244 nvarchar(4000),@p245 decimal(18,2),@p246 nvarchar(4000),@p247 nvarchar(4000),@p248 decimal(18,2),@p249 nvarchar(4000),@p250 nvarchar(4000),@p251 nvarchar(4000),@p252 nvarchar(4000),@p253 int,@p254 nvarchar(4000),@p255 nvarchar(4000),@p256 nvarchar(4000),@p257 nvarchar(4000),@p258 nvarchar(4000),@p259 nvarchar(4000),@p260 nvarchar(4000),@p261 nvarchar(4000),@p262 nvarchar(4000),@p263 nvarchar(4000),@p264 int,@p265 nvarchar(4000),@p266 nvarchar(4000),@p267 nvarchar(4000),@p268 nvarchar(4000),@p269 nvarchar(4000),@p270 int,@p271 nvarchar(4000),@p272 int,@p273 int,@p274 datetime2(7),@p275 datetime2(7),@p276 datetime2(7),@p277 nvarchar(4000),@p278 nvarchar(4000),@p279 nvarchar(4000),@p280 nvarchar(4000),@p281 nvarchar(4000),@p282 nvarchar(4000),@p283 nvarchar(4000),@p284 nvarchar(4000),@p285 nvarchar(4000),@p286 nvarchar(4000),@p287 nvarchar(4000),@p288 nvarchar(4000),@p289 nvarchar(4000),@p290 nvarchar(4000),@p291 datetime2(7),@p292 nvarchar(4000),@p293 nvarchar(4000),@p294 int,@p295 int,@p296 int,@p297 nvarchar(4000),@p298 nvarchar(4000),@p299 nvarchar(4000),@p300 nvarchar(4000),@p301 decimal(18,2),@p302 nvarchar(4000),@p303 nvarchar(4000),@p304 decimal(18,2),@p305 nvarchar(4000),@p306 nvarchar(4000),@p307 nvarchar(4000),@p308 nvarchar(4000),@p309 int,@p310 nvarchar(4000),@p311 nvarchar(4000),@p312 nvarchar(4000),@p313 nvarchar(4000),@p314 nvarchar(4000),@p315 nvarchar(4000),@p316 nvarchar(4000),@p317 nvarchar(4000),@p318 nvarchar(4000),@p319 nvarchar(4000),@p320 int,@p321 nvarchar(4000),@p322 nvarchar(4000),@p323 nvarchar(4000),@p324 nvarchar(4000),@p325 nvarchar(4000),@p326 int,@p327 nvarchar(4000),@p328 int,@p329 int,@p330 datetime2(7),@p331 datetime2(7),@p332 datetime2(7),@p333 nvarchar(4000),@p334 nvarchar(4000),@p335 nvarchar(4000),@p336 nvarchar(4000),@p337 nvarchar(4000),@p338 nvarchar(4000),@p339 nvarchar(4000),@p340 nvarchar(4000),@p341 nvarchar(4000),@p342 nvarchar(4000),@p343 nvarchar(4000),@p344 nvarchar(4000),@p345 nvarchar(4000),@p346 nvarchar(4000),@p347 datetime2(7),@p348 nvarchar(4000),@p349 nvarchar(4000),@p350 int,@p351 int,@p352 int,@p353 nvarchar(4000),@p354 nvarchar(4000),@p355 nvarchar(4000),@p356 decimal(18,2),@p357 decimal(18,2),@p358 nvarchar(4000),@p359 nvarchar(4000),@p360 decimal(18,2),@p361 nvarchar(4000),@p362 nvarchar(4000),@p363 nvarchar(4000),@p364 nvarchar(4000),@p365 int,@p366 nvarchar(4000),@p367 nvarchar(4000),@p368 nvarchar(4000),@p369 nvarchar(4000),@p370 nvarchar(4000),@p371 nvarchar(4000),@p372 nvarchar(4000),@p373 nvarchar(4000),@p374 nvarchar(4000),@p375 nvarchar(4000),@p376 int,@p377 nvarchar(4000),@p378 nvarchar(4000),@p379 nvarchar(4000),@p380 nvarchar(4000),@p381 nvarchar(4000),@p382 int,@p383 nvarchar(4000),@p384 int,@p385 int,@p386 datetime2(7),@p387 datetime2(7),@p388 datetime2(7),@p389 nvarchar(4000),@p390 nvarchar(4000),@p391 nvarchar(4000),@p392 nvarchar(4000),@p393 nvarchar(4000),@p394 nvarchar(4000),@p395 nvarchar(4000),@p396 nvarchar(4000),@p397 nvarchar(4000),@p398 nvarchar(4000),@p399 nvarchar(4000),@p400 nvarchar(4000),@p401 nvarchar(4000),@p402 nvarchar(4000),@p403 datetime2(7),@p404 nvarchar(4000),@p405 nvarchar(4000),@p406 int,@p407 int,@p408 int,@p409 nvarchar(4000),@p410 nvarchar(4000),@p411 nvarchar(4000),@p412 nvarchar(4000),@p413 decimal(18,2),@p414 nvarchar(4000),@p415 nvarchar(4000),@p416 decimal(18,2),@p417 nvarchar(4000),@p418 nvarchar(4000),@p419 nvarchar(4000),@p420 nvarchar(4000),@p421 int,@p422 nvarchar(4000),@p423 nvarchar(4000),@p424 nvarchar(4000),@p425 nvarchar(4000),@p426 nvarchar(4000),@p427 nvarchar(4000),@p428 nvarchar(4000),@p429 nvarchar(4000),@p430 nvarchar(4000),@p431 nvarchar(4000),@p432 int,@p433 nvarchar(4000),@p434 nvarchar(4000),@p435 nvarchar(4000),@p436 nvarchar(4000),@p437 nvarchar(4000),@p438 int,@p439 nvarchar(4000),@p440 int,@p441 int,@p442 datetime2(7),@p443 datetime2(7),@p444 datetime2(7),@p445 nvarchar(4000),@p446 nvarchar(4000),@p447 nvarchar(4000),@p448 nvarchar(4000),@p449 nvarchar(4000),@p450 nvarchar(4000),@p451 nvarchar(4000),@p452 nvarchar(4000),@p453 nvarchar(4000),@p454 nvarchar(4000),@p455 nvarchar(4000),@p456 nvarchar(4000),@p457 nvarchar(4000),@p458 nvarchar(4000),@p459 datetime2(7),@p460 nvarchar(4000),@p461 nvarchar(4000),@p462 int,@p463 int,@p464 int,@p465 nvarchar(4000),@p466 nvarchar(4000),@p467 nvarchar(4000),@p468 decimal(18,2),@p469 decimal(18,2),@p470 nvarchar(4000),@p471 nvarchar(4000),@p472 decimal(18,2),@p473 nvarchar(4000),@p474 nvarchar(4000),@p475 nvarchar(4000),@p476 nvarchar(4000),@p477 int,@p478 nvarchar(4000),@p479 nvarchar(4000),@p480 nvarchar(4000),@p481 nvarchar(4000),@p482 nvarchar(4000),@p483 nvarchar(4000),@p484 nvarchar(4000),@p485 nvarchar(4000),@p486 nvarchar(4000),@p487 nvarchar(4000),@p488 int,@p489 nvarchar(4000),@p490 nvarchar(4000),@p491 nvarchar(4000),@p492 nvarchar(4000),@p493 nvarchar(4000),@p494 int,@p495 nvarchar(4000),@p496 int,@p497 int,@p498 datetime2(7),@p499 datetime2(7),@p500 datetime2(7),@p501 nvarchar(4000),@p502 nvarchar(4000),@p503 nvarchar(4000),@p504 nvarchar(4000),@p505 nvarchar(4000),@p506 nvarchar(4000),@p507 nvarchar(4000),@p508 nvarchar(4000),@p509 nvarchar(4000),@p510 nvarchar(4000),@p511 nvarchar(4000),@p512 nvarchar(4000),@p513 nvarchar(4000),@p514 nvarchar(4000),@p515 datetime2(7),@p516 nvarchar(4000),@p517 nvarchar(4000),@p518 int,@p519 int,@p520 int,@p521 nvarchar(4000),@p522 nvarchar(4000),@p523 nvarchar(4000),@p524 decimal(18,2),@p525 decimal(18,2),@p526 nvarchar(4000),@p527 nvarchar(4000),@p528 decimal(18,2),@p529 nvarchar(4000),@p530 nvarchar(4000),@p531 nvarchar(4000),@p532 nvarchar(4000),@p533 int,@p534 nvarchar(4000),@p535 nvarchar(4000),@p536 nvarchar(4000),@p537 nvarchar(4000),@p538 nvarchar(4000),@p539 nvarchar(4000),@p540 nvarchar(4000),@p541 nvarchar(4000),@p542 nvarchar(4000),@p543 nvarchar(4000),@p544 int,@p545 nvarchar(4000),@p546 nvarchar(4000),@p547 nvarchar(4000),@p548 nvarchar(4000),@p549 nvarchar(4000),@p550 int,@p551 nvarchar(4000),@p552 int,@p553 int,@p554 datetime2(7),@p555 datetime2(7),@p556 datetime2(7),@p557 nvarchar(4000),@p558 nvarchar(4000),@p559 nvarchar(4000),@p560 nvarchar(4000),@p561 nvarchar(4000),@p562 nvarchar(4000),@p563 nvarchar(4000),@p564 nvarchar(4000),@p565 nvarchar(4000),@p566 nvarchar(4000),@p567 nvarchar(4000),@p568 nvarchar(4000),@p569 nvarchar(4000),@p570 nvarchar(4000),@p571 datetime2(7),@p572 nvarchar(4000),@p573 nvarchar(4000),@p574 int,@p575 int,@p576 int,@p577 nvarchar(4000),@p578 nvarchar(4000),@p579 nvarchar(4000),@p580 decimal(18,2),@p581 decimal(18,2),@p582 nvarchar(4000),@p583 nvarchar(4000),@p584 decimal(18,2),@p585 nvarchar(4000),@p586 nvarchar(4000),@p587 nvarchar(4000),@p588 nvarchar(4000),@p589 int,@p590 nvarchar(4000),@p591 nvarchar(4000),@p592 nvarchar(4000),@p593 nvarchar(4000),@p594 nvarchar(4000),@p595 nvarchar(4000),@p596 nvarchar(4000),@p597 nvarchar(4000),@p598 nvarchar(4000),@p599 nvarchar(4000),@p600 int,@p601 nvarchar(4000),@p602 nvarchar(4000),@p603 nvarchar(4000),@p604 nvarchar(4000),@p605 nvarchar(4000),@p606 int,@p607 nvarchar(4000),@p608 int,@p609 int,@p610 datetime2(7),@p611 datetime2(7),@p612 datetime2(7),@p613 nvarchar(4000),@p614 nvarchar(4000),@p615 nvarchar(4000),@p616 nvarchar(4000),@p617 nvarchar(4000),@p618 nvarchar(4000),@p619 nvarchar(4000),@p620 nvarchar(4000),@p621 nvarchar(4000),@p622 nvarchar(4000),@p623 nvarchar(4000),@p624 nvarchar(4000),@p625 nvarchar(4000),@p626 nvarchar(4000),@p627 datetime2(7),@p628 nvarchar(4000),@p629 nvarchar(4000),@p630 int,@p631 int,@p632 int,@p633 nvarchar(4000),@p634 nvarchar(4000),@p635 nvarchar(4000),@p636 decimal(18,2),@p637 decimal(18,2),@p638 nvarchar(4000),@p639 nvarchar(4000),@p640 decimal(18,2),@p641 nvarchar(4000),@p642 nvarchar(4000),@p643 nvarchar(4000),@p644 nvarchar(4000),@p645 int,@p646 nvarchar(4000),@p647 nvarchar(4000),@p648 nvarchar(4000),@p649 nvarchar(4000),@p650 nvarchar(4000),@p651 nvarchar(4000),@p652 nvarchar(4000),@p653 nvarchar(4000),@p654 nvarchar(4000),@p655 nvarchar(4000),@p656 int,@p657 nvarchar(4000),@p658 nvarchar(4000),@p659 nvarchar(4000),@p660 nvarchar(4000),@p661 nvarchar(4000),@p662 int,@p663 nvarchar(4000),@p664 int,@p665 int,@p666 datetime2(7),@p667 datetime2(7),@p668 datetime2(7),@p669 nvarchar(4000),@p670 nvarchar(4000),@p671 nvarchar(4000),@p672 nvarchar(4000),@p673 nvarchar(4000),@p674 nvarchar(4000),@p675 nvarchar(4000),@p676 nvarchar(4000),@p677 nvarchar(4000),@p678 nvarchar(4000),@p679 nvarchar(4000),@p680 nvarchar(4000),@p681 nvarchar(4000),@p682 nvarchar(4000),@p683 datetime2(7),@p684 nvarchar(4000),@p685 nvarchar(4000),@p686 int,@p687 int,@p688 int,@p689 nvarchar(4000),@p690 nvarchar(4000),@p691 nvarchar(4000),@p692 decimal(18,2),@p693 decimal(18,2),@p694 nvarchar(4000),@p695 nvarchar(4000),@p696 decimal(18,2),@p697 nvarchar(4000),@p698 nvarchar(4000),@p699 nvarchar(4000),@p700 nvarchar(4000),@p701 int,@p702 nvarchar(4000),@p703 nvarchar(4000),@p704 nvarchar(4000),@p705 nvarchar(4000),@p706 nvarchar(4000),@p707 nvarchar(4000),@p708 nvarchar(4000),@p709 nvarchar(4000),@p710 nvarchar(4000),@p711 nvarchar(4000),@p712 int,@p713 nvarchar(4000),@p714 nvarchar(4000),@p715 nvarchar(4000),@p716 nvarchar(4000),@p717 nvarchar(4000),@p718 int,@p719 nvarchar(4000),@p720 int,@p721 int,@p722 datetime2(7),@p723 datetime2(7),@p724 datetime2(7),@p725 nvarchar(4000),@p726 nvarchar(4000),@p727 nvarchar(4000),@p728 nvarchar(4000),@p729 nvarchar(4000),@p730 nvarchar(4000),@p731 nvarchar(4000),@p732 nvarchar(4000),@p733 nvarchar(4000),@p734 nvarchar(4000),@p735 nvarchar(4000),@p736 nvarchar(4000),@p737 nvarchar(4000),@p738 nvarchar(4000),@p739 datetime2(7),@p740 nvarchar(4000),@p741 nvarchar(4000),@p742 int,@p743 int,@p744 int,@p745 nvarchar(4000),@p746 nvarchar(4000),@p747 nvarchar(4000),@p748 decimal(18,2),@p749 decimal(18,2),@p750 nvarchar(4000),@p751 nvarchar(4000),@p752 decimal(18,2),@p753 nvarchar(4000),@p754 nvarchar(4000),@p755 nvarchar(4000),@p756 nvarchar(4000),@p757 int,@p758 nvarchar(4000),@p759 nvarchar(4000),@p760 nvarchar(4000),@p761 nvarchar(4000),@p762 nvarchar(4000),@p763 nvarchar(4000),@p764 nvarchar(4000),@p765 nvarchar(4000),@p766 nvarchar(4000),@p767 nvarchar(4000),@p768 int,@p769 nvarchar(4000),@p770 nvarchar(4000),@p771 nvarchar(4000),@p772 nvarchar(4000),@p773 nvarchar(4000),@p774 int,@p775 nvarchar(4000),@p776 int,@p777 int,@p778 datetime2(7),@p779 datetime2(7),@p780 datetime2(7),@p781 nvarchar(4000),@p782 nvarchar(4000),@p783 nvarchar(4000),@p784 nvarchar(4000),@p785 nvarchar(4000),@p786 nvarchar(4000),@p787 nvarchar(4000),@p788 nvarchar(4000),@p789 nvarchar(4000),@p790 nvarchar(4000),@p791 nvarchar(4000),@p792 nvarchar(4000),@p793 nvarchar(4000),@p794 nvarchar(4000),@p795 datetime2(7),@p796 nvarchar(4000),@p797 nvarchar(4000),@p798 int,@p799 int,@p800 int,@p801 nvarchar(4000),@p802 nvarchar(4000),@p803 nvarchar(4000),@p804 decimal(18,2),@p805 decimal(18,2),@p806 nvarchar(4000),@p807 nvarchar(4000),@p808 decimal(18,2),@p809 nvarchar(4000),@p810 nvarchar(4000),@p811 nvarchar(4000),@p812 nvarchar(4000),@p813 int,@p814 nvarchar(4000),@p815 nvarchar(4000),@p816 nvarchar(4000),@p817 nvarchar(4000),@p818 nvarchar(4000),@p819 nvarchar(4000),@p820 nvarchar(4000),@p821 nvarchar(4000),@p822 nvarchar(4000),@p823 nvarchar(4000),@p824 int,@p825 nvarchar(4000),@p826 nvarchar(4000),@p827 nvarchar(4000),@p828 nvarchar(4000),@p829 nvarchar(4000),@p830 int,@p831 nvarchar(4000),@p832 int,@p833 int,@p834 datetime2(7),@p835 datetime2(7),@p836 datetime2(7),@p837 nvarchar(4000),@p838 nvarchar(4000),@p839 nvarchar(4000),@p840 nvarchar(4000),@p841 nvarchar(4000),@p842 nvarchar(4000),@p843 nvarchar(4000),@p844 nvarchar(4000),@p845 nvarchar(4000),@p846 nvarchar(4000),@p847 nvarchar(4000),@p848 nvarchar(4000),@p849 nvarchar(4000),@p850 nvarchar(4000),@p851 datetime2(7),@p852 nvarchar(4000),@p853 nvarchar(4000),@p854 int,@p855 int,@p856 int,@p857 nvarchar(4000),@p858 nvarchar(4000),@p859 nvarchar(4000),@p860 decimal(18,2),@p861 decimal(18,2),@p862 nvarchar(4000),@p863 nvarchar(4000),@p864 decimal(18,2),@p865 nvarchar(4000),@p866 nvarchar(4000),@p867 nvarchar(4000),@p868 nvarchar(4000),@p869 int,@p870 nvarchar(4000),@p871 nvarchar(4000),@p872 nvarchar(4000),@p873 nvarchar(4000),@p874 nvarchar(4000),@p875 nvarchar(4000),@p876 nvarchar(4000),@p877 nvarchar(4000),@p878 nvarchar(4000),@p879 nvarchar(4000),@p880 int,@p881 nvarchar(4000),@p882 nvarchar(4000),@p883 nvarchar(4000),@p884 nvarchar(4000),@p885 nvarchar(4000),@p886 int,@p887 nvarchar(4000),@p888 int,@p889 int,@p890 datetime2(7),@p891 datetime2(7),@p892 datetime2(7),@p893 nvarchar(4000),@p894 nvarchar(4000),@p895 nvarchar(4000),@p896 nvarchar(4000),@p897 nvarchar(4000),@p898 nvarchar(4000),@p899 nvarchar(4000),@p900 nvarchar(4000),@p901 nvarchar(4000),@p902 nvarchar(4000),@p903 nvarchar(4000),@p904 nvarchar(4000),@p905 nvarchar(4000),@p906 nvarchar(4000),@p907 datetime2(7),@p908 nvarchar(4000),@p909 nvarchar(4000),@p910 int,@p911 int,@p912 int,@p913 nvarchar(4000),@p914 nvarchar(4000),@p915 nvarchar(4000),@p916 nvarchar(4000),@p917 decimal(18,2),@p918 nvarchar(4000),@p919 nvarchar(4000),@p920 decimal(18,2),@p921 nvarchar(4000),@p922 nvarchar(4000),@p923 nvarchar(4000),@p924 nvarchar(4000),@p925 int,@p926 nvarchar(4000),@p927 nvarchar(4000),@p928 nvarchar(4000),@p929 nvarchar(4000),@p930 nvarchar(4000),@p931 nvarchar(4000),@p932 nvarchar(4000),@p933 nvarchar(4000),@p934 nvarchar(4000),@p935 nvarchar(4000),@p936 int,@p937 nvarchar(4000),@p938 nvarchar(4000),@p939 nvarchar(4000),@p940 nvarchar(4000),@p941 nvarchar(4000),@p942 int,@p943 nvarchar(4000),@p944 int,@p945 int,@p946 datetime2(7),@p947 datetime2(7),@p948 datetime2(7),@p949 nvarchar(4000),@p950 nvarchar(4000),@p951 nvarchar(4000),@p952 nvarchar(4000),@p953 nvarchar(4000),@p954 nvarchar(4000),@p955 nvarchar(4000),@p956 nvarchar(4000),@p957 nvarchar(4000),@p958 nvarchar(4000),@p959 nvarchar(4000),@p960 nvarchar(4000),@p961 nvarchar(4000),@p962 nvarchar(4000),@p963 datetime2(7),@p964 nvarchar(4000),@p965 nvarchar(4000),@p966 int,@p967 int,@p968 int,@p969 nvarchar(4000),@p970 nvarchar(4000),@p971 nvarchar(4000),@p972 decimal(18,2),@p973 decimal(18,2),@p974 nvarchar(4000),@p975 nvarchar(4000),@p976 decimal(18,2),@p977 nvarchar(4000),@p978 nvarchar(4000),@p979 nvarchar(4000),@p980 nvarchar(4000),@p981 int,@p982 nvarchar(4000),@p983 nvarchar(4000),@p984 nvarchar(4000),@p985 nvarchar(4000),@p986 nvarchar(4000),@p987 nvarchar(4000),@p988 nvarchar(4000),@p989 nvarchar(4000),@p990 nvarchar(4000),@p991 nvarchar(4000),@p992 int,@p993 nvarchar(4000),@p994 nvarchar(4000),@p995 nvarchar(4000),@p996 nvarchar(4000),@p997 nvarchar(4000),@p998 int,@p999 nvarchar(4000),@p1000 int,@p1001 int,@p1002 datetime2(7),@p1003 datetime2(7),@p1004 datetime2(7),@p1005 nvarchar(4000),@p1006 nvarchar(4000),@p1007 nvarchar(4000),@p1008 nvarchar(4000),@p1009 nvarchar(4000),@p1010 nvarchar(4000),@p1011 nvarchar(4000),@p1012 nvarchar(4000),@p1013 nvarchar(4000),@p1014 nvarchar(4000),@p1015 nvarchar(4000),@p1016 nvarchar(4000),@p1017 nvarchar(4000),@p1018 nvarchar(4000),@p1019 datetime2(7),@p1020 nvarchar(4000),@p1021 nvarchar(4000),@p1022 int,@p1023 int,@p1024 int,@p1025 nvarchar(4000),@p1026 nvarchar(4000),@p1027 nvarchar(4000),@p1028 decimal(18,2),@p1029 decimal(18,2),@p1030 nvarchar(4000),@p1031 nvarchar(4000),@p1032 decimal(18,2),@p1033 nvarchar(4000),@p1034 nvarchar(4000),@p1035 nvarchar(4000),@p1036 nvarchar(4000),@p1037 int,@p1038 nvarchar(4000),@p1039 nvarchar(4000),@p1040 nvarchar(4000),@p1041 nvarchar(4000),@p1042 nvarchar(4000),@p1043 nvarchar(4000),@p1044 nvarchar(4000),@p1045 nvarchar(4000),@p1046 nvarchar(4000),@p1047 nvarchar(4000),@p1048 int,@p1049 nvarchar(4000),@p1050 nvarchar(4000),@p1051 nvarchar(4000),@p1052 nvarchar(4000),@p1053 nvarchar(4000),@p1054 int,@p1055 nvarchar(4000),@p1056 int,@p1057 int,@p1058 datetime2(7),@p1059 datetime2(7),@p1060 datetime2(7),@p1061 nvarchar(4000),@p1062 nvarchar(4000),@p1063 nvarchar(4000),@p1064 nvarchar(4000),@p1065 nvarchar(4000),@p1066 nvarchar(4000),@p1067 nvarchar(4000),@p1068 nvarchar(4000),@p1069 nvarchar(4000),@p1070 nvarchar(4000),@p1071 nvarchar(4000),@p1072 nvarchar(4000),@p1073 nvarchar(4000),@p1074 nvarchar(4000),@p1075 datetime2(7),@p1076 nvarchar(4000),@p1077 nvarchar(4000),@p1078 int,@p1079 int,@p1080 int,@p1081 nvarchar(4000),@p1082 nvarchar(4000),@p1083 nvarchar(4000),@p1084 decimal(18,2),@p1085 decimal(18,2),@p1086 nvarchar(4000),@p1087 nvarchar(4000),@p1088 decimal(18,2),@p1089 nvarchar(4000),@p1090 nvarchar(4000),@p1091 nvarchar(4000),@p1092 nvarchar(4000),@p1093 int,@p1094 nvarchar(4000),@p1095 nvarchar(4000),@p1096 nvarchar(4000),@p1097 nvarchar(4000),@p1098 nvarchar(4000),@p1099 nvarchar(4000),@p1100 nvarchar(4000),@p1101 nvarchar(4000),@p1102 nvarchar(4000),@p1103 nvarchar(4000),@p1104 int,@p1105 nvarchar(4000),@p1106 nvarchar(4000),@p1107 nvarchar(4000),@p1108 nvarchar(4000),@p1109 nvarchar(4000),@p1110 int,@p1111 nvarchar(4000),@p1112 int,@p1113 int,@p1114 datetime2(7),@p1115 datetime2(7),@p1116 datetime2(7),@p1117 nvarchar(4000),@p1118 nvarchar(4000),@p1119 nvarchar(4000),@p1120 nvarchar(4000),@p1121 nvarchar(4000),@p1122 nvarchar(4000),@p1123 nvarchar(4000),@p1124 nvarchar(4000),@p1125 nvarchar(4000),@p1126 nvarchar(4000),@p1127 nvarchar(4000),@p1128 nvarchar(4000),@p1129 nvarchar(4000),@p1130 nvarchar(4000),@p1131 datetime2(7),@p1132 nvarchar(4000),@p1133 nvarchar(4000),@p1134 int,@p1135 int,@p1136 int,@p1137 nvarchar(4000),@p1138 nvarchar(4000),@p1139 nvarchar(4000),@p1140 decimal(18,2),@p1141 decimal(18,2),@p1142 nvarchar(4000),@p1143 nvarchar(4000),@p1144 decimal(18,2),@p1145 nvarchar(4000),@p1146 nvarchar(4000),@p1147 nvarchar(4000),@p1148 nvarchar(4000),@p1149 int,@p1150 nvarchar(4000),@p1151 nvarchar(4000),@p1152 nvarchar(4000),@p1153 nvarchar(4000),@p1154 nvarchar(4000),@p1155 nvarchar(4000),@p1156 nvarchar(4000),@p1157 nvarchar(4000),@p1158 nvarchar(4000),@p1159 nvarchar(4000),@p1160 int,@p1161 nvarchar(4000),@p1162 nvarchar(4000),@p1163 nvarchar(4000),@p1164 nvarchar(4000),@p1165 nvarchar(4000),@p1166 int,@p1167 nvarchar(4000),@p1168 int,@p1169 int,@p1170 datetime2(7),@p1171 datetime2(7),@p1172 datetime2(7),@p1173 nvarchar(4000),@p1174 nvarchar(4000),@p1175 nvarchar(4000),@p1176 nvarchar(4000),@p1177 nvarchar(4000),@p1178 nvarchar(4000),@p1179 nvarchar(4000),@p1180 nvarchar(4000),@p1181 nvarchar(4000),@p1182 nvarchar(4000),@p1183 nvarchar(4000),@p1184 nvarchar(4000),@p1185 nvarchar(4000),@p1186 nvarchar(4000),@p1187 datetime2(7),@p1188 nvarchar(4000),@p1189 nvarchar(4000),@p1190 int,@p1191 int,@p1192 int,@p1193 nvarchar(4000),@p1194 nvarchar(4000),@p1195 nvarchar(4000),@p1196 decimal(18,2),@p1197 decimal(18,2),@p1198 nvarchar(4000),@p1199 nvarchar(4000),@p1200 decimal(18,2),@p1201 nvarchar(4000),@p1202 nvarchar(4000),@p1203 nvarchar(4000),@p1204 nvarchar(4000),@p1205 int,@p1206 nvarchar(4000),@p1207 nvarchar(4000),@p1208 nvarchar(4000),@p1209 nvarchar(4000),@p1210 nvarchar(4000),@p1211 nvarchar(4000),@p1212 nvarchar(4000),@p1213 nvarchar(4000),@p1214 nvarchar(4000),@p1215 nvarchar(4000),@p1216 int,@p1217 nvarchar(4000),@p1218 nvarchar(4000),@p1219 nvarchar(4000),@p1220 nvarchar(4000),@p1221 nvarchar(4000),@p1222 int,@p1223 nvarchar(4000),@p1224 int,@p1225 int,@p1226 datetime2(7),@p1227 datetime2(7),@p1228 datetime2(7),@p1229 nvarchar(4000),@p1230 nvarchar(4000),@p1231 nvarchar(4000),@p1232 nvarchar(4000),@p1233 nvarchar(4000),@p1234 nvarchar(4000),@p1235 nvarchar(4000),@p1236 nvarchar(4000),@p1237 nvarchar(4000),@p1238 nvarchar(4000),@p1239 nvarchar(4000),@p1240 nvarchar(4000),@p1241 nvarchar(4000),@p1242 nvarchar(4000),@p1243 datetime2(7),@p1244 nvarchar(4000),@p1245 nvarchar(4000),@p1246 int,@p1247 int,@p1248 int,@p1249 nvarchar(4000),@p1250 nvarchar(4000),@p1251 nvarchar(4000),@p1252 decimal(18,2),@p1253 decimal(18,2),@p1254 nvarchar(4000),@p1255 nvarchar(4000),@p1256 decimal(18,2),@p1257 nvarchar(4000),@p1258 nvarchar(4000),@p1259 nvarchar(4000),@p1260 nvarchar(4000),@p1261 int,@p1262 nvarchar(4000),@p1263 nvarchar(4000),@p1264 nvarchar(4000),@p1265 nvarchar(4000),@p1266 nvarchar(4000),@p1267 nvarchar(4000),@p1268 nvarchar(4000),@p1269 nvarchar(4000),@p1270 nvarchar(4000),@p1271 nvarchar(4000),@p1272 int,@p1273 nvarchar(4000),@p1274 nvarchar(4000),@p1275 nvarchar(4000),@p1276 nvarchar(4000),@p1277 nvarchar(4000),@p1278 int,@p1279 nvarchar(4000),@p1280 int,@p1281 int,@p1282 datetime2(7),@p1283 datetime2(7),@p1284 datetime2(7),@p1285 nvarchar(4000),@p1286 nvarchar(4000),@p1287 nvarchar(4000),@p1288 nvarchar(4000),@p1289 nvarchar(4000),@p1290 nvarchar(4000),@p1291 nvarchar(4000),@p1292 nvarchar(4000),@p1293 nvarchar(4000),@p1294 nvarchar(4000),@p1295 nvarchar(4000),@p1296 nvarchar(4000),@p1297 nvarchar(4000),@p1298 nvarchar(4000),@p1299 datetime2(7),@p1300 nvarchar(4000),@p1301 nvarchar(4000),@p1302 int,@p1303 int,@p1304 int,@p1305 nvarchar(4000),@p1306 nvarchar(4000),@p1307 nvarchar(4000),@p1308 decimal(18,2),@p1309 decimal(18,2),@p1310 nvarchar(4000),@p1311 nvarchar(4000),@p1312 decimal(18,2),@p1313 nvarchar(4000),@p1314 nvarchar(4000),@p1315 nvarchar(4000),@p1316 nvarchar(4000),@p1317 int,@p1318 nvarchar(4000),@p1319 nvarchar(4000),@p1320 nvarchar(4000),@p1321 nvarchar(4000),@p1322 nvarchar(4000),@p1323 nvarchar(4000),@p1324 nvarchar(4000),@p1325 nvarchar(4000),@p1326 nvarchar(4000),@p1327 nvarchar(4000),@p1328 int,@p1329 nvarchar(4000),@p1330 nvarchar(4000),@p1331 nvarchar(4000),@p1332 nvarchar(4000),@p1333 nvarchar(4000),@p1334 int,@p1335 nvarchar(4000),@p1336 int,@p1337 int,@p1338 datetime2(7),@p1339 datetime2(7),@p1340 datetime2(7),@p1341 nvarchar(4000),@p1342 nvarchar(4000),@p1343 nvarchar(4000),@p1344 nvarchar(4000),@p1345 nvarchar(4000),@p1346 nvarchar(4000),@p1347 nvarchar(4000),@p1348 nvarchar(4000),@p1349 nvarchar(4000),@p1350 nvarchar(4000),@p1351 nvarchar(4000),@p1352 nvarchar(4000),@p1353 nvarchar(4000),@p1354 nvarchar(4000),@p1355 datetime2(7),@p1356 nvarchar(4000),@p1357 nvarchar(4000),@p1358 int,@p1359 int,@p1360 int,@p1361 nvarchar(4000),@p1362 nvarchar(4000),@p1363 nvarchar(4000),@p1364 decimal(18,2),@p1365 decimal(18,2),@p1366 nvarchar(4000),@p1367 nvarchar(4000),@p1368 decimal(18,2),@p1369 nvarchar(4000),@p1370 nvarchar(4000),@p1371 nvarchar(4000),@p1372 nvarchar(4000),@p1373 int,@p1374 nvarchar(4000),@p1375 nvarchar(4000),@p1376 nvarchar(4000),@p1377 nvarchar(4000),@p1378 nvarchar(4000),@p1379 nvarchar(4000),@p1380 nvarchar(4000),@p1381 nvarchar(4000),@p1382 nvarchar(4000),@p1383 nvarchar(4000),@p1384 int,@p1385 nvarchar(4000),@p1386 nvarchar(4000),@p1387 nvarchar(4000),@p1388 nvarchar(4000),@p1389 nvarchar(4000),@p1390 int,@p1391 nvarchar(4000),@p1392 int,@p1393 int,@p1394 datetime2(7),@p1395 datetime2(7),@p1396 datetime2(7),@p1397 nvarchar(4000),@p1398 nvarchar(4000),@p1399 nvarchar(4000),@p1400 nvarchar(4000),@p1401 nvarchar(4000),@p1402 nvarchar(4000),@p1403 nvarchar(4000),@p1404 nvarchar(4000),@p1405 nvarchar(4000),@p1406 nvarchar(4000),@p1407 nvarchar(4000),@p1408 nvarchar(4000),@p1409 nvarchar(4000),@p1410 nvarchar(4000),@p1411 datetime2(7),@p1412 nvarchar(4000),@p1413 nvarchar(4000),@p1414 int,@p1415 int,@p1416 int,@p1417 nvarchar(4000),@p1418 nvarchar(4000),@p1419 nvarchar(4000),@p1420 decimal(18,2),@p1421 decimal(18,2),@p1422 nvarchar(4000),@p1423 nvarchar(4000),@p1424 decimal(18,2),@p1425 nvarchar(4000),@p1426 nvarchar(4000),@p1427 nvarchar(4000),@p1428 nvarchar(4000),@p1429 int,@p1430 nvarchar(4000),@p1431 nvarchar(4000),@p1432 nvarchar(4000),@p1433 nvarchar(4000),@p1434 nvarchar(4000),@p1435 nvarchar(4000),@p1436 nvarchar(4000),@p1437 nvarchar(4000),@p1438 nvarchar(4000),@p1439 nvarchar(4000),@p1440 int,@p1441 nvarchar(4000),@p1442 nvarchar(4000),@p1443 nvarchar(4000),@p1444 nvarchar(4000),@p1445 nvarchar(4000),@p1446 int,@p1447 nvarchar(4000),@p1448 int,@p1449 int,@p1450 datetime2(7),@p1451 datetime2(7),@p1452 datetime2(7),@p1453 nvarchar(4000),@p1454 nvarchar(4000),@p1455 nvarchar(4000),@p1456 nvarchar(4000),@p1457 nvarchar(4000),@p1458 nvarchar(4000),@p1459 nvarchar(4000),@p1460 nvarchar(4000),@p1461 nvarchar(4000),@p1462 nvarchar(4000),@p1463 nvarchar(4000),@p1464 nvarchar(4000),@p1465 nvarchar(4000),@p1466 nvarchar(4000),@p1467 datetime2(7),@p1468 nvarchar(4000),@p1469 nvarchar(4000),@p1470 int,@p1471 int,@p1472 int,@p1473 nvarchar(4000),@p1474 nvarchar(4000),@p1475 nvarchar(4000),@p1476 decimal(18,2),@p1477 decimal(18,2),@p1478 nvarchar(4000),@p1479 nvarchar(4000),@p1480 decimal(18,2),@p1481 nvarchar(4000),@p1482 nvarchar(4000),@p1483 nvarchar(4000),@p1484 nvarchar(4000),@p1485 int,@p1486 nvarchar(4000),@p1487 nvarchar(4000),@p1488 nvarchar(4000),@p1489 nvarchar(4000),@p1490 nvarchar(4000),@p1491 nvarchar(4000),@p1492 nvarchar(4000),@p1493 nvarchar(4000),@p1494 nvarchar(4000),@p1495 nvarchar(4000),@p1496 int,@p1497 nvarchar(4000),@p1498 nvarchar(4000),@p1499 nvarchar(4000),@p1500 nvarchar(4000),@p1501 nvarchar(4000),@p1502 int,@p1503 nvarchar(4000),@p1504 int,@p1505 int,@p1506 datetime2(7),@p1507 datetime2(7),@p1508 datetime2(7),@p1509 nvarchar(4000),@p1510 nvarchar(4000),@p1511 nvarchar(4000),@p1512 nvarchar(4000),@p1513 nvarchar(4000),@p1514 nvarchar(4000),@p1515 nvarchar(4000),@p1516 nvarchar(4000),@p1517 nvarchar(4000),@p1518 nvarchar(4000),@p1519 nvarchar(4000),@p1520 nvarchar(4000),@p1521 nvarchar(4000),@p1522 nvarchar(4000),@p1523 datetime2(7),@p1524 nvarchar(4000),@p1525 nvarchar(4000),@p1526 int,@p1527 int,@p1528 int,@p1529 nvarchar(4000),@p1530 nvarchar(4000),@p1531 nvarchar(4000),@p1532 decimal(18,2),@p1533 decimal(18,2),@p1534 nvarchar(4000),@p1535 nvarchar(4000),@p1536 decimal(18,2),@p1537 nvarchar(4000),@p1538 nvarchar(4000),@p1539 nvarchar(4000),@p1540 nvarchar(4000),@p1541 int,@p1542 nvarchar(4000),@p1543 nvarchar(4000),@p1544 nvarchar(4000),@p1545 nvarchar(4000),@p1546 nvarchar(4000),@p1547 nvarchar(4000),@p1548 nvarchar(4000),@p1549 nvarchar(4000),@p1550 nvarchar(4000),@p1551 nvarchar(4000),@p1552 int,@p1553 nvarchar(4000),@p1554 nvarchar(4000),@p1555 nvarchar(4000),@p1556 nvarchar(4000),@p1557 nvarchar(4000),@p1558 int,@p1559 nvarchar(4000),@p1560 int,@p1561 int,@p1562 datetime2(7),@p1563 datetime2(7),@p1564 datetime2(7),@p1565 nvarchar(4000),@p1566 nvarchar(4000),@p1567 nvarchar(4000),@p1568 nvarchar(4000),@p1569 nvarchar(4000),@p1570 nvarchar(4000),@p1571 nvarchar(4000),@p1572 nvarchar(4000),@p1573 nvarchar(4000),@p1574 nvarchar(4000),@p1575 nvarchar(4000),@p1576 nvarchar(4000),@p1577 nvarchar(4000),@p1578 nvarchar(4000),@p1579 datetime2(7),@p1580 nvarchar(4000),@p1581 nvarchar(4000),@p1582 int,@p1583 int,@p1584 int,@p1585 nvarchar(4000),@p1586 nvarchar(4000),@p1587 nvarchar(4000),@p1588 decimal(18,2),@p1589 decimal(18,2),@p1590 nvarchar(4000),@p1591 nvarchar(4000),@p1592 decimal(18,2),@p1593 nvarchar(4000),@p1594 nvarchar(4000),@p1595 nvarchar(4000),@p1596 nvarchar(4000),@p1597 int,@p1598 nvarchar(4000),@p1599 nvarchar(4000),@p1600 nvarchar(4000),@p1601 nvarchar(4000),@p1602 nvarchar(4000),@p1603 nvarchar(4000),@p1604 nvarchar(4000),@p1605 nvarchar(4000),@p1606 nvarchar(4000),@p1607 nvarchar(4000),@p1608 int,@p1609 nvarchar(4000),@p1610 nvarchar(4000),@p1611 nvarchar(4000),@p1612 nvarchar(4000),@p1613 nvarchar(4000),@p1614 int,@p1615 nvarchar(4000),@p1616 int,@p1617 int,@p1618 datetime2(7),@p1619 datetime2(7),@p1620 datetime2(7),@p1621 nvarchar(4000),@p1622 nvarchar(4000),@p1623 nvarchar(4000),@p1624 nvarchar(4000),@p1625 nvarchar(4000),@p1626 nvarchar(4000),@p1627 nvarchar(4000),@p1628 nvarchar(4000),@p1629 nvarchar(4000),@p1630 nvarchar(4000),@p1631 nvarchar(4000),@p1632 nvarchar(4000),@p1633 nvarchar(4000),@p1634 nvarchar(4000),@p1635 datetime2(7),@p1636 nvarchar(4000),@p1637 nvarchar(4000),@p1638 int,@p1639 int,@p1640 int,@p1641 nvarchar(4000),@p1642 nvarchar(4000),@p1643 nvarchar(4000),@p1644 decimal(18,2),@p1645 decimal(18,2),@p1646 nvarchar(4000),@p1647 nvarchar(4000),@p1648 decimal(18,2),@p1649 nvarchar(4000),@p1650 nvarchar(4000),@p1651 nvarchar(4000),@p1652 nvarchar(4000),@p1653 int,@p1654 nvarchar(4000),@p1655 nvarchar(4000),@p1656 nvarchar(4000),@p1657 nvarchar(4000),@p1658 nvarchar(4000),@p1659 nvarchar(4000),@p1660 nvarchar(4000),@p1661 nvarchar(4000),@p1662 nvarchar(4000),@p1663 nvarchar(4000),@p1664 int,@p1665 nvarchar(4000),@p1666 nvarchar(4000),@p1667 nvarchar(4000),@p1668 nvarchar(4000),@p1669 nvarchar(4000),@p1670 int,@p1671 nvarchar(4000),@p1672 int,@p1673 int,@p1674 datetime2(7),@p1675 datetime2(7),@p1676 datetime2(7),@p1677 nvarchar(4000),@p1678 nvarchar(4000),@p1679 nvarchar(4000),@p1680 nvarchar(4000),@p1681 nvarchar(4000),@p1682 nvarchar(4000),@p1683 nvarchar(4000),@p1684 nvarchar(4000),@p1685 nvarchar(4000),@p1686 nvarchar(4000),@p1687 nvarchar(4000),@p1688 nvarchar(4000),@p1689 nvarchar(4000),@p1690 nvarchar(4000),@p1691 datetime2(7),@p1692 nvarchar(4000),@p1693 nvarchar(4000),@p1694 int,@p1695 int,@p1696 int,@p1697 nvarchar(4000),@p1698 nvarchar(4000),@p1699 nvarchar(4000),@p1700 decimal(18,2),@p1701 decimal(18,2),@p1702 nvarchar(4000),@p1703 nvarchar(4000),@p1704 decimal(18,2),@p1705 nvarchar(4000),@p1706 nvarchar(4000),@p1707 nvarchar(4000),@p1708 nvarchar(4000),@p1709 int,@p1710 nvarchar(4000),@p1711 nvarchar(4000),@p1712 nvarchar(4000),@p1713 nvarchar(4000),@p1714 nvarchar(4000),@p1715 nvarchar(4000),@p1716 nvarchar(4000),@p1717 nvarchar(4000),@p1718 nvarchar(4000),@p1719 nvarchar(4000),@p1720 int,@p1721 nvarchar(4000),@p1722 nvarchar(4000),@p1723 nvarchar(4000),@p1724 nvarchar(4000),@p1725 nvarchar(4000),@p1726 int,@p1727 nvarchar(4000),@p1728 int,@p1729 int,@p1730 datetime2(7),@p1731 datetime2(7),@p1732 datetime2(7),@p1733 nvarchar(4000),@p1734 nvarchar(4000),@p1735 nvarchar(4000),@p1736 nvarchar(4000),@p1737 nvarchar(4000),@p1738 nvarchar(4000),@p1739 nvarchar(4000),@p1740 nvarchar(4000),@p1741 nvarchar(4000),@p1742 nvarchar(4000),@p1743 nvarchar(4000),@p1744 nvarchar(4000),@p1745 nvarchar(4000),@p1746 nvarchar(4000),@p1747 datetime2(7),@p1748 nvarchar(4000),@p1749 nvarchar(4000),@p1750 int,@p1751 int,@p1752 int,@p1753 nvarchar(4000),@p1754 nvarchar(4000),@p1755 nvarchar(4000),@p1756 decimal(18,2),@p1757 decimal(18,2),@p1758 nvarchar(4000),@p1759 nvarchar(4000),@p1760 decimal(18,2),@p1761 nvarchar(4000),@p1762 nvarchar(4000),@p1763 nvarchar(4000),@p1764 nvarchar(4000),@p1765 int,@p1766 nvarchar(4000),@p1767 nvarchar(4000),@p1768 nvarchar(4000),@p1769 nvarchar(4000),@p1770 nvarchar(4000),@p1771 nvarchar(4000),@p1772 nvarchar(4000),@p1773 nvarchar(4000),@p1774 nvarchar(4000),@p1775 nvarchar(4000),@p1776 int,@p1777 nvarchar(4000),@p1778 nvarchar(4000),@p1779 nvarchar(4000),@p1780 nvarchar(4000),@p1781 nvarchar(4000),@p1782 int,@p1783 nvarchar(4000),@p1784 int,@p1785 int,@p1786 datetime2(7),@p1787 datetime2(7),@p1788 datetime2(7),@p1789 nvarchar(4000),@p1790 nvarchar(4000),@p1791 nvarchar(4000),@p1792 nvarchar(4000),@p1793 nvarchar(4000),@p1794 nvarchar(4000),@p1795 nvarchar(4000),@p1796 nvarchar(4000),@p1797 nvarchar(4000),@p1798 nvarchar(4000),@p1799 nvarchar(4000),@p1800 nvarchar(4000),@p1801 nvarchar(4000),@p1802 nvarchar(4000),@p1803 datetime2(7),@p1804 nvarchar(4000),@p1805 nvarchar(4000),@p1806 int,@p1807 int,@p1808 int,@p1809 nvarchar(4000),@p1810 nvarchar(4000),@p1811 nvarchar(4000),@p1812 decimal(18,2),@p1813 decimal(18,2),@p1814 nvarchar(4000),@p1815 nvarchar(4000),@p1816 decimal(18,2),@p1817 nvarchar(4000),@p1818 nvarchar(4000),@p1819 nvarchar(4000),@p1820 nvarchar(4000),@p1821 int,@p1822 nvarchar(4000),@p1823 nvarchar(4000),@p1824 nvarchar(4000),@p1825 nvarchar(4000),@p1826 nvarchar(4000),@p1827 nvarchar(4000),@p1828 nvarchar(4000),@p1829 nvarchar(4000),@p1830 nvarchar(4000),@p1831 nvarchar(4000),@p1832 int,@p1833 nvarchar(4000),@p1834 nvarchar(4000),@p1835 nvarchar(4000),@p1836 nvarchar(4000),@p1837 nvarchar(4000),@p1838 int,@p1839 nvarchar(4000),@p1840 int,@p1841 int,@p1842 datetime2(7),@p1843 datetime2(7),@p1844 datetime2(7),@p1845 nvarchar(4000),@p1846 nvarchar(4000),@p1847 nvarchar(4000),@p1848 nvarchar(4000),@p1849 nvarchar(4000),@p1850 nvarchar(4000),@p1851 nvarchar(4000),@p1852 nvarchar(4000),@p1853 nvarchar(4000),@p1854 nvarchar(4000),@p1855 nvarchar(4000),@p1856 nvarchar(4000),@p1857 nvarchar(4000),@p1858 nvarchar(4000),@p1859 datetime2(7),@p1860 nvarchar(4000),@p1861 nvarchar(4000),@p1862 int,@p1863 int,@p1864 int,@p1865 nvarchar(4000),@p1866 nvarchar(4000),@p1867 nvarchar(4000),@p1868 decimal(18,2),@p1869 decimal(18,2),@p1870 nvarchar(4000),@p1871 nvarchar(4000),@p1872 decimal(18,2),@p1873 nvarchar(4000),@p1874 nvarchar(4000),@p1875 nvarchar(4000),@p1876 nvarchar(4000),@p1877 int,@p1878 nvarchar(4000),@p1879 nvarchar(4000),@p1880 nvarchar(4000),@p1881 nvarchar(4000),@p1882 nvarchar(4000),@p1883 nvarchar(4000),@p1884 nvarchar(4000),@p1885 nvarchar(4000),@p1886 nvarchar(4000),@p1887 nvarchar(4000),@p1888 int,@p1889 nvarchar(4000),@p1890 nvarchar(4000),@p1891 nvarchar(4000),@p1892 nvarchar(4000),@p1893 nvarchar(4000),@p1894 int,@p1895 nvarchar(4000),@p1896 int,@p1897 int,@p1898 datetime2(7),@p1899 datetime2(7),@p1900 datetime2(7),@p1901 nvarchar(4000),@p1902 nvarchar(4000),@p1903 nvarchar(4000),@p1904 nvarchar(4000),@p1905 nvarchar(4000),@p1906 nvarchar(4000),@p1907 nvarchar(4000),@p1908 nvarchar(4000),@p1909 nvarchar(4000),@p1910 nvarchar(4000),@p1911 nvarchar(4000),@p1912 nvarchar(4000),@p1913 nvarchar(4000),@p1914 nvarchar(4000),@p1915 datetime2(7),@p1916 nvarchar(4000),@p1917 nvarchar(4000),@p1918 int,@p1919 int,@p1920 int,@p1921 nvarchar(4000),@p1922 nvarchar(4000),@p1923 nvarchar(4000),@p1924 decimal(18,2),@p1925 decimal(18,2),@p1926 nvarchar(4000),@p1927 nvarchar(4000),@p1928 decimal(18,2),@p1929 nvarchar(4000),@p1930 nvarchar(4000),@p1931 nvarchar(4000),@p1932 nvarchar(4000),@p1933 int,@p1934 nvarchar(4000),@p1935 nvarchar(4000),@p1936 nvarchar(4000),@p1937 nvarchar(4000),@p1938 nvarchar(4000),@p1939 nvarchar(4000),@p1940 nvarchar(4000),@p1941 nvarchar(4000),@p1942 nvarchar(4000),@p1943 nvarchar(4000),@p1944 int,@p1945 nvarchar(4000),@p1946 nvarchar(4000),@p1947 nvarchar(4000),@p1948 nvarchar(4000),@p1949 nvarchar(4000),@p1950 int,@p1951 nvarchar(4000),@p1952 int,@p1953 int,@p1954 datetime2(7),@p1955 datetime2(7),@p1956 datetime2(7),@p1957 nvarchar(4000),@p1958 nvarchar(4000),@p1959 nvarchar(4000),@p1960 nvarchar(4000),@p1961 nvarchar(4000),@p1962 nvarchar(4000),@p1963 nvarchar(4000),@p1964 nvarchar(4000),@p1965 nvarchar(4000),@p1966 nvarchar(4000),@p1967 nvarchar(4000),@p1968 nvarchar(4000),@p1969 nvarchar(4000),@p1970 nvarchar(4000),@p1971 datetime2(7),@p1972 nvarchar(4000),@p1973 nvarchar(4000),@p1974 int,@p1975 int,@p1976 int,@p1977 nvarchar(4000),@p1978 nvarchar(4000),@p1979 nvarchar(4000),@p1980 decimal(18,2),@p1981 decimal(18,2),@p1982 nvarchar(4000),@p1983 nvarchar(4000),@p1984 decimal(18,2),@p1985 nvarchar(4000),@p1986 nvarchar(4000),@p1987 nvarchar(4000),@p1988 nvarchar(4000),@p1989 int,@p1990 nvarchar(4000),@p1991 nvarchar(4000),@p1992 nvarchar(4000),@p1993 nvarchar(4000),@p1994 nvarchar(4000),@p1995 nvarchar(4000),@p1996 nvarchar(4000),@p1997 nvarchar(4000),@p1998 nvarchar(4000),@p1999 nvarchar(4000),@p2000 int,@p2001 nvarchar(4000),@p2002 nvarchar(4000),@p2003 nvarchar(4000),@p2004 nvarchar(4000),@p2005 nvarchar(4000),@p2006 int,@p2007 nvarchar(4000),@p2008 int,@p2009 int,@p2010 datetime2(7),@p2011 datetime2(7),@p2012 datetime2(7),@p2013 nvarchar(4000),@p2014 nvarchar(4000),@p2015 nvarchar(4000),@p2016 nvarchar(4000),@p2017 nvarchar(4000),@p2018 nvarchar(4000),@p2019 nvarchar(4000),@p2020 nvarchar(4000),@p2021 nvarchar(4000),@p2022 nvarchar(4000),@p2023 nvarchar(4000),@p2024 nvarchar(4000),@p2025 nvarchar(4000),@p2026 nvarchar(4000),@p2027 datetime2(7),@p2028 nvarchar(4000),@p2029 nvarchar(4000),@p2030 int,@p2031 int,@p2032 int,@p2033 nvarchar(4000),@p2034 nvarchar(4000),@p2035 nvarchar(4000),@p2036 decimal(18,2),@p2037 decimal(18,2),@p2038 nvarchar(4000),@p2039 nvarchar(4000),@p2040 decimal(18,2),@p2041 nvarchar(4000),@p2042 nvarchar(4000),@p2043 nvarchar(4000),@p2044 nvarchar(4000),@p2045 int,@p2046 nvarchar(4000),@p2047 nvarchar(4000),@p2048 nvarchar(4000),@p2049 nvarchar(4000),@p2050 nvarchar(4000),@p2051 nvarchar(4000),@p2052 nvarchar(4000),@p2053 nvarchar(4000),@p2054 nvarchar(4000),@p2055 nvarchar(4000),@p2056 int,@p2057 nvarchar(4000),@p2058 nvarchar(4000),@p2059 nvarchar(4000),@p2060 nvarchar(4000),@p2061 nvarchar(4000),@p2062 int,@p2063 nvarchar(4000),@p2064 int,@p2065 int,@p2066 datetime2(7),@p2067 datetime2(7),@p2068 datetime2(7),@p2069 nvarchar(4000),@p2070 nvarchar(4000),@p2071 nvarchar(4000))SET NOCOUNT ON; DECLARE @inserted0 TABLE ([item_id] int, [_Position] [int]); MERGE [raw_data] USING ( VALUES (@p0, @p1, @p2, @p3, @p4, @p5, @p6, @p7, @p8, @p9, @p10, @p11, @p12, @p13, @p14, @p15, @p16, @p17, @p18, @p19, @p20, @p21, @p22, @p23, @p24, @p25, @p26, @p27, @p28, @p29, @p30, @p31, @p32, @p33, @p34, @p35, @p36, @p37, @p38, @p39, @p40, @p41, @p42, @p43, @p44, @p45, @p46, @p47, @p48, @p49, @p50, @p51, @p52, @p53, @p54, @p55, 0), (@p56, @p57, @p58, @p59, @p60, @p61, @p62, @p63, @p64, @p65, @p66, @p67, @p68, @p69, @p70, @p71, @p72, @p73, @p74, @p75, @p76, @p77, @p78, @p79, @p80, @p81, @p82, @p83, @p84, @p85, @p86, @p87, @p88, @p89, @p90, @p91, @p92, @p93, @p94, @p95, @p96, @p97, @p98, @p99, @p100, @p101, @p102, @p103, @p104, @p105, @p106, @p107, @p108, @p109, @p110, @p111, 1), (@p112, @p113, @p114, @p115, @p116, @p117, @p118, @p119, @p120, @p121, @p122, @p123, @p124, @p125, @p126, @p127, @p128, @p129, @p130, @p131, @p132, @p133, @p134, @p135, @p136, @p137, @p138, @p139, @p140, @p141, @p142, @p143, @p144, @p145, @p146, @p147, @p148, @p149, @p150, @p151, @p152, @p153, @p154, @p155, @p156, @p157, @p158, @p159, @p160, @p161, @p162, @p163, @p164, @p165, @p166, @p167, 2), (@p168, @p169, @p170, @p171, @p172, @p173, @p174, @p175, @p176, @p177, @p178, @p179, @p180, @p181, @p182, @p183, @p184, @p185, @p186, @p187, @p188, @p189, @p190, @p191, @p192, @p193, @p194, @p195, @p196, @p197, @p198, @p199, @p200, @p201, @p202, @p203, @p204, @p205, @p206, @p207, @p208, @p209, @p210, @p211, @p212, @p213, @p214, @p215, @p216, @p217, @p218, @p219, @p220, @p221, @p222, @p223, 3), (@p224, @p225, @p226, @p227, @p228, @p229, @p230, @p231, @p232, @p233, @p234, @p235, @p236, @p237, @p238, @p239, @p240, @p241, @p242, @p243, @p244, @p245, @p246, @p247, @p248, @p249, @p250, @p251, @p252, @p253, @p254, @p255, @p256, @p257, @p258, @p259, @p260, @p261, @p262, @p263, @p264, @p265, @p266, @p267, @p268, @p269, @p270, @p271, @p272, @p273, @p274, @p275, @p276, @p277, @p278, @p279, 4), (@p280, @p281, @p282, @p283, @p284, @p285, @p286, @p287, @p288, @p289, @p290, @p291, @p292, @p293, @p294, @p295, @p296, @p297, @p298, @p299, @p300, @p301, @p302, @p303, @p304, @p305, @p306, @p307, @p308, @p309, @p310, @p311, @p312, @p313, @p314, @p315, @p316, @p317, @p318, @p319, @p320, @p321, @p322, @p323, @p324, @p325, @p326, @p327, @p328, @p329, @p330, @p331, @p332, @p333, @p334, @p335, 5), (@p336, @p337, @p338, @p339, @p340, @p341, @p342, @p343, @p344, @p345, @p346, @p347, @p348, @p349, @p350, @p351, @p352, @p353, @p354, @p355, @p356, @p357, @p358, @p359, @p360, @p361, @p362, @p363, @p364, @p365, @p366, @p367, @p368, @p369, @p370, @p371, @p372, @p373, @p374, @p375, @p376, @p377, @p378, @p379, @p380, @p381, @p382, @p383, @p384, @p385, @p386, @p387, @p388, @p389, @p390, @p391, 6), (@p392, @p393, @p394, @p395, @p396, @p397, @p398, @p399, @p400, @p401, @p402, @p403, @p404, @p405, @p406, @p407, @p408, @p409, @p410, @p411, @p412, @p413, @p414, @p415, @p416, @p417, @p418, @p419, @p420, @p421, @p422, @p423, @p424, @p425, @p426, @p427, @p428, @p429, @p430, @p431, @p432, @p433, @p434, @p435, @p436, @p437, @p438, @p439, @p440, @p441, @p442, @p443, @p444, @p445, @p446, @p447, 7), (@p448, @p449, @p450, @p451, @p452, @p453, @p454, @p455, @p456, @p457, @p458, @p459, @p460, @p461, @p462, @p463, @p464, @p465, @p466, @p467, @p468, @p469, @p470, @p471, @p472, @p473, @p474, @p475, @p476, @p477, @p478, @p479, @p480, @p481, @p482, @p483, @p484, @p485, @p486, @p487, @p488, @p489, @p490, @p491, @p492, @p493, @p494, @p495, @p496, @p497, @p498, @p499, @p500, @p501, @p502, @p503, 8), (@p504, @p505, @p506, @p507, @p508, @p509, @p510, @p511, @p512, @p513, @p514, @p515, @p516, @p517, @p518, @p519, @p520, @p521, @p522, @p523, @p524, @p525, @p526, @p527, @p528, @p529, @p530, @p531, @p532, @p533, @p534, @p535, @p536, @p537, @p538, @p539, @p540, @p541, @p542, @p543, @p544, @p545, @p546, @p547, @p548, @p549, @p550, @p551, @p552, @p553, @p554, @p555, @p556, @p557, @p558, @p559, 9), (@p560, @p561, @p562, @p563, @p564, @p565, @p566, @p567, @p568, @p569, @p570, @p571, @p572, @p573, @p574, @p575, @p576, @p577, @p578, @p579, @p580, @p581, @p582, @p583, @p584, @p585, @p586, @p587, @p588, @p589, @p590, @p591, @p592, @p593, @p594, @p595, @p596, @p597, @p598, @p599, @p600, @p601, @p602, @p603, @p604, @p605, @p606, @p607, @p608, @p609, @p610, @p611, @p612, @p613, @p614, @p615, 10), (@p616, @p617, @p618, @p619, @p620, @p621, @p622, @p623, @p624, @p625, @p626, @p627, @p628, @p629, @p630, @p631, @p632, @p633, @p634, @p635, @p636, @p637, @p638, @p639, @p640, @p641, @p642, @p643, @p644, @p645, @p646, @p647, @p648, @p649, @p650, @p651, @p652, @p653, @p654, @p655, @p656, @p657, @p658, @p659, @p660, @p661, @p662, @p663, @p664, @p665, @p666, @p667, @p668, @p669, @p670, @p671, 11), (@p672, @p673, @p674, @p675, @p676, @p677, @p678, @p679, @p680, @p681, @p682, @p683, @p684, @p685, @p686, @p687, @p688, @p689, @p690, @p691, @p692, @p693, @p694, @p695, @p696, @p697, @p698, @p699, @p700, @p701, @p702, @p703, @p704, @p705, @p706, @p707, @p708, @p709, @p710, @p711, @p712, @p713, @p714, @p715, @p716, @p717, @p718, @p719, @p720, @p721, @p722, @p723, @p724, @p725, @p726, @p727, 12), (@p728, @p729, @p730, @p731, @p732, @p733, @p734, @p735, @p736, @p737, @p738, @p739, @p740, @p741, @p742, @p743, @p744, @p745, @p746, @p747, @p748, @p749, @p750, @p751, @p752, @p753, @p754, @p755, @p756, @p757, @p758, @p759, @p760, @p761, @p762, @p763, @p764, @p765, @p766, @p767, @p768, @p769, @p770, @p771, @p772, @p773, @p774, @p775, @p776, @p777, @p778, @p779, @p780, @p781, @p782, @p783, 13), (@p784, @p785, @p786, @p787, @p788, @p789, @p790, @p791, @p792, @p793, @p794, @p795, @p796, @p797, @p798, @p799, @p800, @p801, @p802, @p803, @p804, @p805, @p806, @p807, @p808, @p809, @p810, @p811, @p812, @p813, @p814, @p815, @p816, @p817, @p818, @p819, @p820, @p821, @p822, @p823, @p824, @p825, @p826, @p827, @p828, @p829, @p830, @p831, @p832, @p833, @p834, @p835, @p836, @p837, @p838, @p839, 14), (@p840, @p841, @p842, @p843, @p844, @p845, @p846, @p847, @p848, @p849, @p850, @p851, @p852, @p853, @p854, @p855, @p856, @p857, @p858, @p859, @p860, @p861, @p862, @p863, @p864, @p865, @p866, @p867, @p868, @p869, @p870, @p871, @p872, @p873, @p874, @p875, @p876, @p877, @p878, @p879, @p880, @p881, @p882, @p883, @p884, @p885, @p886, @p887, @p888, @p889, @p890, @p891, @p892, @p893, @p894, @p895, 15), (@p896, @p897, @p898, @p899, @p900, @p901, @p902, @p903, @p904, @p905, @p906, @p907, @p908, @p909, @p910, @p911, @p912, @p913, @p914, @p915, @p916, @p917, @p918, @p919, @p920, @p921, @p922, @p923, @p924, @p925, @p926, @p927, @p928, @p929, @p930, @p931, @p932, @p933, @p934, @p935, @p936, @p937, @p938, @p939, @p940, @p941, @p942, @p943, @p944, @p945, @p946, @p947, @p948, @p949, @p950, @p951, 16), (@p952, @p953, @p954, @p955, @p956, @p957, @p958, @p959, @p960, @p961, @p962, @p963, @p964, @p965, @p966, @p967, @p968, @p969, @p970, @p971, @p972, @p973, @p974, @p975, @p976, @p977, @p978, @p979, @p980, @p981, @p982, @p983, @p984, @p985, @p986, @p987, @p988, @p989, @p990, @p991, @p992, @p993, @p994, @p995, @p996, @p997, @p998, @p999, @p1000, @p1001, @p1002, @p1003, @p1004, @p1005, @p1006, @p1007, 17), (@p1008, @p1009, @p1010, @p1011, @p1012, @p1013, @p1014, @p1015, @p1016, @p1017, @p1018, @p1019, @p1020, @p1021, @p1022, @p1023, @p1024, @p1025, @p1026, @p1027, @p1028, @p1029, @p1030, @p1031, @p1032, @p1033, @p1034, @p1035, @p1036, @p1037, @p1038, @p1039, @p1040, @p1041, @p1042, @p1043, @p1044, @p1045, @p1046, @p1047, @p1048, @p1049, @p1050, @p1051, @p1052, @p1053, @p1054, @p1055, @p1056, @p1057, @p1058, @p1059, @p1060, @p1061, @p1062, @p1063, 18), (@p1064, @p1065, @p1066, @p1067, @p1068, @p1069, @p1070, @p1071, @p1072, @p1073, @p1074, @p1075, @p1076, @p1077, @p1078, @p1079, @p1080, @p1081, @p1082, @p1083, @p1084, @p1085, @p1086, @p1087, @p1088, @p1089, @p1090, @p1091, @p1092, @p1093, @p1094, @p1095, @p1096, @p1097, @p1098, @p1099, @p1100, @p1101, @p1102, @p1103, @p1104, @p1105, @p1106, @p1107, @p1108, @p1109, @p1110, @p1111, @p1112, @p1113, @p1114, @p1115, @p1116, @p1117, @p1118, @p1119, 19), (@p1120, @p1121, @p1122, @p1123, @p1124, @p1125, @p1126, @p1127, @p1128, @p1129, @p1130, @p1131, @p1132, @p1133, @p1134, @p1135, @p1136, @p1137, @p1138, @p1139, @p1140, @p1141, @p1142, @p1143, @p1144, @p1145, @p1146, @p1147, @p1148, @p1149, @p1150, @p1151, @p1152, @p1153, @p1154, @p1155, @p1156, @p1157, @p1158, @p1159, @p1160, @p1161, @p1162, @p1163, @p1164, @p1165, @p1166, @p1167, @p1168, @p1169, @p1170, @p1171, @p1172, @p1173, @p1174, @p1175, 20), (@p1176, @p1177, @p1178, @p1179, @p1180, @p1181, @p1182, @p1183, @p1184, @p1185, @p1186, @p1187, @p1188, @p1189, @p1190, @p1191, @p1192, @p1193, @p1194, @p1195, @p1196, @p1197, @p1198, @p1199, @p1200, @p1201, @p1202, @p1203, @p1204, @p1205, @p1206, @p1207, @p1208, @p1209, @p1210, @p1211, @p1212, @p1213, @p1214, @p1215, @p1216, @p1217, @p1218, @p1219, @p1220, @p1221, @p1222, @p1223, @p1224, @p1225, @p1226, @p1227, @p1228, @p1229, @p1230, @p1231, 21), (@p1232, @p1233, @p1234, @p1235, @p1236, @p1237, @p1238, @p1239, @p1240, @p1241, @p1242, @p1243, @p1244, @p1245, @p1246, @p1247, @p1248, @p1249, @p1250, @p1251, @p1252, @p1253, @p1254, @p1255, @p1256, @p1257, @p1258, @p1259, @p1260, @p1261, @p1262, @p1263, @p1264, @p1265, @p1266, @p1267, @p1268, @p1269, @p1270, @p1271, @p1272, @p1273, @p1274, @p1275, @p1276, @p1277, @p1278, @p1279, @p1280, @p1281, @p1282, @p1283, @p1284, @p1285, @p1286, @p1287, 22), (@p1288, @p1289, @p1290, @p1291, @p1292, @p1293, @p1294, @p1295, @p1296, @p1297, @p1298, @p1299, @p1300, @p1301, @p1302, @p1303, @p1304, @p1305, @p1306, @p1307, @p1308, @p1309, @p1310, @p1311, @p1312, @p1313, @p1314, @p1315, @p1316, @p1317, @p1318, @p1319, @p1320, @p1321, @p1322, @p1323, @p1324, @p1325, @p1326, @p1327, @p1328, @p1329, @p1330, @p1331, @p1332, @p1333, @p1334, @p1335, @p1336, @p1337, @p1338, @p1339, @p1340, @p1341, @p1342, @p1343, 23), (@p1344, @p1345, @p1346, @p1347, @p1348, @p1349, @p1350, @p1351, @p1352, @p1353, @p1354, @p1355, @p1356, @p1357, @p1358, @p1359, @p1360, @p1361, @p1362, @p1363, @p1364, @p1365, @p1366, @p1367, @p1368, @p1369, @p1370, @p1371, @p1372, @p1373, @p1374, @p1375, @p1376, @p1377, @p1378, @p1379, @p1380, @p1381, @p1382, @p1383, @p1384, @p1385, @p1386, @p1387, @p1388, @p1389, @p1390, @p1391, @p1392, @p1393, @p1394, @p1395, @p1396, @p1397, @p1398, @p1399, 24), (@p1400, @p1401, @p1402, @p1403, @p1404, @p1405, @p1406, @p1407, @p1408, @p1409, @p1410, @p1411, @p1412, @p1413, @p1414, @p1415, @p1416, @p1417, @p1418, @p1419, @p1420, @p1421, @p1422, @p1423, @p1424, @p1425, @p1426, @p1427, @p1428, @p1429, @p1430, @p1431, @p1432, @p1433, @p1434, @p1435, @p1436, @p1437, @p1438, @p1439, @p1440, @p1441, @p1442, @p1443, @p1444, @p1445, @p1446, @p1447, @p1448, @p1449, @p1450, @p1451, @p1452, @p1453, @p1454, @p1455, 25), (@p1456, @p1457, @p1458, @p1459, @p1460, @p1461, @p1462, @p1463, @p1464, @p1465, @p1466, @p1467, @p1468, @p1469, @p1470, @p1471, @p1472, @p1473, @p1474, @p1475, @p1476, @p1477, @p1478, @p1479, @p1480, @p1481, @p1482, @p1483, @p1484, @p1485, @p1486, @p1487, @p1488, @p1489, @p1490, @p1491, @p1492, @p1493, @p1494, @p1495, @p1496, @p1497, @p1498, @p1499, @p1500, @p1501, @p1502, @p1503, @p1504, @p1505, @p1506, @p1507, @p1508, @p1509, @p1510, @p1511, 26), (@p1512, @p1513, @p1514, @p1515, @p1516, @p1517, @p1518, @p1519, @p1520, @p1521, @p1522, @p1523, @p1524, @p1525, @p1526, @p1527, @p1528, @p1529, @p1530, @p1531, @p1532, @p1533, @p1534, @p1535, @p1536, @p1537, @p1538, @p1539, @p1540, @p1541, @p1542, @p1543, @p1544, @p1545, @p1546, @p1547, @p1548, @p1549, @p1550, @p1551, @p1552, @p1553, @p1554, @p1555, @p1556, @p1557, @p1558, @p1559, @p1560, @p1561, @p1562, @p1563, @p1564, @p1565, @p1566, @p1567, 27), (@p1568, @p1569, @p1570, @p1571, @p1572, @p1573, @p1574, @p1575, @p1576, @p1577, @p1578, @p1579, @p1580, @p1581, @p1582, @p1583, @p1584, @p1585, @p1586, @p1587, @p1588, @p1589, @p1590, @p1591, @p1592, @p1593, @p1594, @p1595, @p1596, @p1597, @p1598, @p1599, @p1600, @p1601, @p1602, @p1603, @p1604, @p1605, @p1606, @p1607, @p1608, @p1609, @p1610, @p1611, @p1612, @p1613, @p1614, @p1615, @p1616, @p1617, @p1618, @p1619, @p1620, @p1621, @p1622, @p1623, 28), (@p1624, @p1625, @p1626, @p1627, @p1628, @p1629, @p1630, @p1631, @p1632, @p1633, @p1634, @p1635, @p1636, @p1637, @p1638, @p1639, @p1640, @p1641, @p1642, @p1643, @p1644, @p1645, @p1646, @p1647, @p1648, @p1649, @p1650, @p1651, @p1652, @p1653, @p1654, @p1655, @p1656, @p1657, @p1658, @p1659, @p1660, @p1661, @p1662, @p1663, @p1664, @p1665, @p1666, @p1667, @p1668, @p1669, @p1670, @p1671, @p1672, @p1673, @p1674, @p1675, @p1676, @p1677, @p1678, @p1679, 29), (@p1680, @p1681, @p1682, @p1683, @p1684, @p1685, @p1686, @p1687, @p1688, @p1689, @p1690, @p1691, @p1692, @p1693, @p1694, @p1695, @p1696, @p1697, @p1698, @p1699, @p1700, @p1701, @p1702, @p1703, @p1704, @p1705, @p1706, @p1707, @p1708, @p1709, @p1710, @p1711, @p1712, @p1713, @p1714, @p1715, @p1716, @p1717, @p1718, @p1719, @p1720, @p1721, @p1722, @p1723, @p1724, @p1725, @p1726, @p1727, @p1728, @p1729, @p1730, @p1731, @p1732, @p1733, @p1734, @p1735, 30), (@p1736, @p1737, @p1738, @p1739, @p1740, @p1741, @p1742, @p1743, @p1744, @p1745, @p1746, @p1747, @p1748, @p1749, @p1750, @p1751, @p1752, @p1753, @p1754, @p1755, @p1756, @p1757, @p1758, @p1759, @p1760, @p1761, @p1762, @p1763, @p1764, @p1765, @p1766, @p1767, @p1768, @p1769, @p1770, @p1771, @p1772, @p1773, @p1774, @p1775, @p1776, @p1777, @p1778, @p1779, @p1780, @p1781, @p1782, @p1783, @p1784, @p1785, @p1786, @p1787, @p1788, @p1789, @p1790, @p1791, 31), (@p1792, @p1793, @p1794, @p1795, @p1796, @p1797, @p1798, @p1799, @p1800, @p1801, @p1802, @p1803, @p1804, @p1805, @p1806, @p1807, @p1808, @p1809, @p1810, @p1811, @p1812, @p1813, @p1814, @p1815, @p1816, @p1817, @p1818, @p1819, @p1820, @p1821, @p1822, @p1823, @p1824, @p1825, @p1826, @p1827, @p1828, @p1829, @p1830, @p1831, @p1832, @p1833, @p1834, @p1835, @p1836, @p1837, @p1838, @p1839, @p1840, @p1841, @p1842, @p1843, @p1844, @p1845, @p1846, @p1847, 32), (@p1848, @p1849, @p1850, @p1851, @p1852, @p1853, @p1854, @p1855, @p1856, @p1857, @p1858, @p1859, @p1860, @p1861, @p1862, @p1863, @p1864, @p1865, @p1866, @p1867, @p1868, @p1869, @p1870, @p1871, @p1872, @p1873, @p1874, @p1875, @p1876, @p1877, @p1878, @p1879, @p1880, @p1881, @p1882, @p1883, @p1884, @p1885, @p1886, @p1887, @p1888, @p1889, @p1890, @p1891, @p1892, @p1893, @p1894, @p1895, @p1896, @p1897, @p1898, @p1899, @p1900, @p1901, @p1902, @p1903, 33), (@p1904, @p1905, @p1906, @p1907, @p1908, @p1909, @p1910, @p1911, @p1912, @p1913, @p1914, @p1915, @p1916, @p1917, @p1918, @p1919, @p1920, @p1921, @p1922, @p1923, @p1924, @p1925, @p1926, @p1927, @p1928, @p1929, @p1930, @p1931, @p1932, @p1933, @p1934, @p1935, @p1936, @p1937, @p1938, @p1939, @p1940, @p1941, @p1942, @p1943, @p1944, @p1945, @p1946, @p1947, @p1948, @p1949, @p1950, @p1951, @p1952, @p1953, @p1954, @p1955, @p1956, @p1957, @p1958, @p1959, 34), (@p1960, @p1961, @p1962, @p1963, @p1964, @p1965, @p1966, @p1967, @p1968, @p1969, @p1970, @p1971, @p1972, @p1973, @p1974, @p1975, @p1976, @p1977, @p1978, @p1979, @p1980, @p1981, @p1982, @p1983, @p1984, @p1985, @p1986, @p1987, @p1988, @p1989, @p1990, @p1991, @p1992, @p1993, @p1994, @p1995, @p1996, @p1997, @p1998, @p1999, @p2000, @p2001, @p2002, @p2003, @p2004, @p2005, @p2006, @p2007, @p2008, @p2009, @p2010, @p2011, @p2012, @p2013, @p2014, @p2015, 35), (@p2016, @p2017, @p2018, @p2019, @p2020, @p2021, @p2022, @p2023, @p2024, @p2025, @p2026, @p2027, @p2028, @p2029, @p2030, @p2031, @p2032, @p2033, @p2034, @p2035, @p2036, @p2037, @p2038, @p2039, @p2040, @p2041, @p2042, @p2043, @p2044, @p2045, @p2046, @p2047, @p2048, @p2049, @p2050, @p2051, @p2052, @p2053, @p2054, @p2055, @p2056, @p2057, @p2058, @p2059, @p2060, @p2061, @p2062, @p2063, @p2064, @p2065, @p2066, @p2067, @p2068, @p2069, @p2070, @p2071, 36)) AS i ([addressee_cntry_cd], [addressee_city], [addressee_district], [addressee_email], [addressee_full_address], [addressee_home_address], [addressee_name], [addressee_postcode], [addressee_province], [addressee_subdistrict], [addressee_tel], [create_table], [delivery_code], [delivery_recipient_name], [delivery_relation_id], [delivery_status_id], [dest_outlet_id], [dest_outlet_port], [document_number], [item_barcode], [item_cod], [item_gross_weight], [item_height], [item_length], [item_price], [item_width], [lat], [log_id], [long], [outlet_id], [outlet_port], [podUrl], [remark], [scan_cntry_cd], [scan_cntry_postcode], [sender_cntry_cd], [sender_district], [sender_email], [sender_full_address], [sender_home_address], [member_id], [sender_name], [sender_postcode], [sender_province], [sender_subdistrict], [sender_tel], [server_id], [signatureUrl], [state], [status_code], [status_dtm], [timestamp], [transmit_dtm], [user_id], [wckt_id], [wkstn_no], _Position) ON 1=0 WHEN NOT MATCHED THEN INSERT ([addressee_cntry_cd], [addressee_city], [addressee_district], [addressee_email], [addressee_full_address], [addressee_home_address], [addressee_name], [addressee_postcode], [addressee_province], [addressee_subdistrict], [addressee_tel], [create_table], [delivery_code], [delivery_recipient_name], [delivery_relation_id], [delivery_status_id], [dest_outlet_id], [dest_outlet_port], [document_number], [item_barcode], [item_cod], [item_gross_weight], [item_height], [item_length], [item_price], [item_width], [lat], [log_id], [long], [outlet_id], [outlet_port], [podUrl], [remark], [scan_cntry_cd], [scan_cntry_postcode], [sender_cntry_cd], [sender_district], [sender_email], [sender_full_address], [sender_home_address], [member_id], [sender_name], [sender_postcode], [sender_province], [sender_subdistrict], [sender_tel], [server_id], [signatureUrl], [state], [status_code], [status_dtm], [timestamp], [transmit_dtm], [user_id], [wckt_id], [wkstn_no]) VALUES (i.[addressee_cntry_cd], i.[addressee_city], i.[addressee_district], i.[addressee_email], i.[addressee_full_address], i.[addressee_home_address], i.[addressee_name], i.[addressee_postcode], i.[addressee_province], i.[addressee_subdistrict], i.[addressee_tel], i.[create_table], i.[delivery_code], i.[delivery_recipient_name], i.[delivery_relation_id], i.[delivery_status_id], i.[dest_outlet_id], i.[dest_outlet_port], i.[document_number], i.[item_barcode], i.[item_cod], i.[item_gross_weight], i.[item_height], i.[item_length], i.[item_price], i.[item_width], i.[lat], i.[log_id], i.[long], i.[outlet_id], i.[outlet_port], i.[podUrl], i.[remark], i.[scan_cntry_cd], i.[scan_cntry_postcode], i.[sender_cntry_cd], i.[sender_district], i.[sender_email], i.[sender_full_address], i.[sender_home_address], i.[member_id], i.[sender_name], i.[sender_postcode], i.[sender_province], i.[sender_subdistrict], i.[sender_tel], i.[server_id], i.[signatureUrl], i.[state], i.[status_code], i.[status_dtm], i.[timestamp], i.[transmit_dtm], i.[user_id], i.[wckt_id], i.[wkstn_no]) OUTPUT INSERTED.[item_id], i._Position INTO @inserted0;  SELECT [t].[item_id] FROM [raw_data] t INNER JOIN @inserted0 i ON ([t].[item_id] = [i].[item_id]) ORDER BY [i].[_Position];  ",5,5,0,438,3,5
"(@p0 nvarchar(4000),@p1 nvarchar(4000),@p2 nvarchar(4000),@p3 nvarchar(4000),@p4 nvarchar(4000),@p5 nvarchar(4000),@p6 nvarchar(4000),@p7 nvarchar(4000),@p8 nvarchar(4000),@p9 nvarchar(4000),@p10 nvarchar(4000),@p11 datetime2(7),@p12 nvarchar(4000),@p13 nvarchar(4000),@p14 int,@p15 int,@p16 int,@p17 nvarchar(4000),@p18 nvarchar(4000),@p19 nvarchar(4000),@p20 nvarchar(4000),@p21 nvarchar(4000),@p22 nvarchar(4000),@p23 nvarchar(4000),@p24 nvarchar(4000),@p25 nvarchar(4000),@p26 nvarchar(4000),@p27 nvarchar(4000),@p28 nvarchar(4000),@p29 int,@p30 nvarchar(4000),@p31 nvarchar(4000),@p32 nvarchar(4000),@p33 nvarchar(4000),@p34 nvarchar(4000),@p35 nvarchar(4000),@p36 nvarchar(4000),@p37 nvarchar(4000),@p38 nvarchar(4000),@p39 nvarchar(4000),@p40 int,@p41 nvarchar(4000),@p42 nvarchar(4000),@p43 nvarchar(4000),@p44 nvarchar(4000),@p45 nvarchar(4000),@p46 int,@p47 nvarchar(4000),@p48 int,@p49 int,@p50 datetime2(7),@p51 datetime2(7),@p52 datetime2(7),@p53 nvarchar(4000),@p54 nvarchar(4000),@p55 nvarchar(4000),@p56 nvarchar(4000),@p57 nvarchar(4000),@p58 nvarchar(4000),@p59 nvarchar(4000),@p60 nvarchar(4000),@p61 nvarchar(4000),@p62 nvarchar(4000),@p63 nvarchar(4000),@p64 nvarchar(4000),@p65 nvarchar(4000),@p66 nvarchar(4000),@p67 datetime2(7),@p68 nvarchar(4000),@p69 nvarchar(4000),@p70 int,@p71 int,@p72 int,@p73 nvarchar(4000),@p74 nvarchar(4000),@p75 nvarchar(4000),@p76 nvarchar(4000),@p77 nvarchar(4000),@p78 nvarchar(4000),@p79 nvarchar(4000),@p80 nvarchar(4000),@p81 nvarchar(4000),@p82 nvarchar(4000),@p83 nvarchar(4000),@p84 nvarchar(4000),@p85 int,@p86 nvarchar(4000),@p87 nvarchar(4000),@p88 nvarchar(4000),@p89 nvarchar(4000),@p90 nvarchar(4000),@p91 nvarchar(4000),@p92 nvarchar(4000),@p93 nvarchar(4000),@p94 nvarchar(4000),@p95 nvarchar(4000),@p96 int,@p97 nvarchar(4000),@p98 nvarchar(4000),@p99 nvarchar(4000),@p100 nvarchar(4000),@p101 nvarchar(4000),@p102 int,@p103 nvarchar(4000),@p104 int,@p105 int,@p106 datetime2(7),@p107 datetime2(7),@p108 datetime2(7),@p109 nvarchar(4000),@p110 nvarchar(4000),@p111 nvarchar(4000),@p112 nvarchar(4000),@p113 nvarchar(4000),@p114 nvarchar(4000),@p115 nvarchar(4000),@p116 nvarchar(4000),@p117 nvarchar(4000),@p118 nvarchar(4000),@p119 nvarchar(4000),@p120 nvarchar(4000),@p121 nvarchar(4000),@p122 nvarchar(4000),@p123 datetime2(7),@p124 nvarchar(4000),@p125 nvarchar(4000),@p126 int,@p127 int,@p128 int,@p129 nvarchar(4000),@p130 nvarchar(4000),@p131 nvarchar(4000),@p132 nvarchar(4000),@p133 nvarchar(4000),@p134 nvarchar(4000),@p135 nvarchar(4000),@p136 nvarchar(4000),@p137 nvarchar(4000),@p138 nvarchar(4000),@p139 nvarchar(4000),@p140 nvarchar(4000),@p141 int,@p142 nvarchar(4000),@p143 nvarchar(4000),@p144 nvarchar(4000),@p145 nvarchar(4000),@p146 nvarchar(4000),@p147 nvarchar(4000),@p148 nvarchar(4000),@p149 nvarchar(4000),@p150 nvarchar(4000),@p151 nvarchar(4000),@p152 int,@p153 nvarchar(4000),@p154 nvarchar(4000),@p155 nvarchar(4000),@p156 nvarchar(4000),@p157 nvarchar(4000),@p158 int,@p159 nvarchar(4000),@p160 int,@p161 int,@p162 datetime2(7),@p163 datetime2(7),@p164 datetime2(7),@p165 nvarchar(4000),@p166 nvarchar(4000),@p167 nvarchar(4000),@p168 nvarchar(4000),@p169 nvarchar(4000),@p170 nvarchar(4000),@p171 nvarchar(4000),@p172 nvarchar(4000),@p173 nvarchar(4000),@p174 nvarchar(4000),@p175 nvarchar(4000),@p176 nvarchar(4000),@p177 nvarchar(4000),@p178 nvarchar(4000),@p179 datetime2(7),@p180 nvarchar(4000),@p181 nvarchar(4000),@p182 int,@p183 int,@p184 int,@p185 nvarchar(4000),@p186 nvarchar(4000),@p187 nvarchar(4000),@p188 nvarchar(4000),@p189 nvarchar(4000),@p190 nvarchar(4000),@p191 nvarchar(4000),@p192 nvarchar(4000),@p193 nvarchar(4000),@p194 nvarchar(4000),@p195 nvarchar(4000),@p196 nvarchar(4000),@p197 int,@p198 nvarchar(4000),@p199 nvarchar(4000),@p200 nvarchar(4000),@p201 nvarchar(4000),@p202 nvarchar(4000),@p203 nvarchar(4000),@p204 nvarchar(4000),@p205 nvarchar(4000),@p206 nvarchar(4000),@p207 nvarchar(4000),@p208 int,@p209 nvarchar(4000),@p210 nvarchar(4000),@p211 nvarchar(4000),@p212 nvarchar(4000),@p213 nvarchar(4000),@p214 int,@p215 nvarchar(4000),@p216 int,@p217 int,@p218 datetime2(7),@p219 datetime2(7),@p220 datetime2(7),@p221 nvarchar(4000),@p222 nvarchar(4000),@p223 nvarchar(4000),@p224 nvarchar(4000),@p225 nvarchar(4000),@p226 nvarchar(4000),@p227 nvarchar(4000),@p228 nvarchar(4000),@p229 nvarchar(4000),@p230 nvarchar(4000),@p231 nvarchar(4000),@p232 nvarchar(4000),@p233 nvarchar(4000),@p234 nvarchar(4000),@p235 datetime2(7),@p236 nvarchar(4000),@p237 nvarchar(4000),@p238 int,@p239 int,@p240 int,@p241 nvarchar(4000),@p242 nvarchar(4000),@p243 nvarchar(4000),@p244 nvarchar(4000),@p245 nvarchar(4000),@p246 nvarchar(4000),@p247 nvarchar(4000),@p248 nvarchar(4000),@p249 nvarchar(4000),@p250 nvarchar(4000),@p251 nvarchar(4000),@p252 nvarchar(4000),@p253 int,@p254 nvarchar(4000),@p255 nvarchar(4000),@p256 nvarchar(4000),@p257 nvarchar(4000),@p258 nvarchar(4000),@p259 nvarchar(4000),@p260 nvarchar(4000),@p261 nvarchar(4000),@p262 nvarchar(4000),@p263 nvarchar(4000),@p264 int,@p265 nvarchar(4000),@p266 nvarchar(4000),@p267 nvarchar(4000),@p268 nvarchar(4000),@p269 nvarchar(4000),@p270 int,@p271 nvarchar(4000),@p272 int,@p273 int,@p274 datetime2(7),@p275 datetime2(7),@p276 datetime2(7),@p277 nvarchar(4000),@p278 nvarchar(4000),@p279 nvarchar(4000),@p280 nvarchar(4000),@p281 nvarchar(4000),@p282 nvarchar(4000),@p283 nvarchar(4000),@p284 nvarchar(4000),@p285 nvarchar(4000),@p286 nvarchar(4000),@p287 nvarchar(4000),@p288 nvarchar(4000),@p289 nvarchar(4000),@p290 nvarchar(4000),@p291 datetime2(7),@p292 nvarchar(4000),@p293 nvarchar(4000),@p294 int,@p295 int,@p296 int,@p297 nvarchar(4000),@p298 nvarchar(4000),@p299 nvarchar(4000),@p300 nvarchar(4000),@p301 nvarchar(4000),@p302 nvarchar(4000),@p303 nvarchar(4000),@p304 nvarchar(4000),@p305 nvarchar(4000),@p306 nvarchar(4000),@p307 nvarchar(4000),@p308 nvarchar(4000),@p309 int,@p310 nvarchar(4000),@p311 nvarchar(4000),@p312 nvarchar(4000),@p313 nvarchar(4000),@p314 nvarchar(4000),@p315 nvarchar(4000),@p316 nvarchar(4000),@p317 nvarchar(4000),@p318 nvarchar(4000),@p319 nvarchar(4000),@p320 int,@p321 nvarchar(4000),@p322 nvarchar(4000),@p323 nvarchar(4000),@p324 nvarchar(4000),@p325 nvarchar(4000),@p326 int,@p327 nvarchar(4000),@p328 int,@p329 int,@p330 datetime2(7),@p331 datetime2(7),@p332 datetime2(7),@p333 nvarchar(4000),@p334 nvarchar(4000),@p335 nvarchar(4000),@p336 nvarchar(4000),@p337 nvarchar(4000),@p338 nvarchar(4000),@p339 nvarchar(4000),@p340 nvarchar(4000),@p341 nvarchar(4000),@p342 nvarchar(4000),@p343 nvarchar(4000),@p344 nvarchar(4000),@p345 nvarchar(4000),@p346 nvarchar(4000),@p347 datetime2(7),@p348 nvarchar(4000),@p349 nvarchar(4000),@p350 int,@p351 int,@p352 int,@p353 nvarchar(4000),@p354 nvarchar(4000),@p355 nvarchar(4000),@p356 nvarchar(4000),@p357 nvarchar(4000),@p358 nvarchar(4000),@p359 nvarchar(4000),@p360 nvarchar(4000),@p361 nvarchar(4000),@p362 nvarchar(4000),@p363 nvarchar(4000),@p364 nvarchar(4000),@p365 int,@p366 nvarchar(4000),@p367 nvarchar(4000),@p368 nvarchar(4000),@p369 nvarchar(4000),@p370 nvarchar(4000),@p371 nvarchar(4000),@p372 nvarchar(4000),@p373 nvarchar(4000),@p374 nvarchar(4000),@p375 nvarchar(4000),@p376 int,@p377 nvarchar(4000),@p378 nvarchar(4000),@p379 nvarchar(4000),@p380 nvarchar(4000),@p381 nvarchar(4000),@p382 int,@p383 nvarchar(4000),@p384 int,@p385 int,@p386 datetime2(7),@p387 datetime2(7),@p388 datetime2(7),@p389 nvarchar(4000),@p390 nvarchar(4000),@p391 nvarchar(4000),@p392 nvarchar(4000),@p393 nvarchar(4000),@p394 nvarchar(4000),@p395 nvarchar(4000),@p396 nvarchar(4000),@p397 nvarchar(4000),@p398 nvarchar(4000),@p399 nvarchar(4000),@p400 nvarchar(4000),@p401 nvarchar(4000),@p402 nvarchar(4000),@p403 datetime2(7),@p404 nvarchar(4000),@p405 nvarchar(4000),@p406 int,@p407 int,@p408 int,@p409 nvarchar(4000),@p410 nvarchar(4000),@p411 nvarchar(4000),@p412 nvarchar(4000),@p413 nvarchar(4000),@p414 nvarchar(4000),@p415 nvarchar(4000),@p416 nvarchar(4000),@p417 nvarchar(4000),@p418 nvarchar(4000),@p419 nvarchar(4000),@p420 nvarchar(4000),@p421 int,@p422 nvarchar(4000),@p423 nvarchar(4000),@p424 nvarchar(4000),@p425 nvarchar(4000),@p426 nvarchar(4000),@p427 nvarchar(4000),@p428 nvarchar(4000),@p429 nvarchar(4000),@p430 nvarchar(4000),@p431 nvarchar(4000),@p432 int,@p433 nvarchar(4000),@p434 nvarchar(4000),@p435 nvarchar(4000),@p436 nvarchar(4000),@p437 nvarchar(4000),@p438 int,@p439 nvarchar(4000),@p440 int,@p441 int,@p442 datetime2(7),@p443 datetime2(7),@p444 datetime2(7),@p445 nvarchar(4000),@p446 nvarchar(4000),@p447 nvarchar(4000),@p448 nvarchar(4000),@p449 nvarchar(4000),@p450 nvarchar(4000),@p451 nvarchar(4000),@p452 nvarchar(4000),@p453 nvarchar(4000),@p454 nvarchar(4000),@p455 nvarchar(4000),@p456 nvarchar(4000),@p457 nvarchar(4000),@p458 nvarchar(4000),@p459 datetime2(7),@p460 nvarchar(4000),@p461 nvarchar(4000),@p462 int,@p463 int,@p464 int,@p465 nvarchar(4000),@p466 nvarchar(4000),@p467 nvarchar(4000),@p468 nvarchar(4000),@p469 nvarchar(4000),@p470 nvarchar(4000),@p471 nvarchar(4000),@p472 nvarchar(4000),@p473 nvarchar(4000),@p474 nvarchar(4000),@p475 nvarchar(4000),@p476 nvarchar(4000),@p477 int,@p478 nvarchar(4000),@p479 nvarchar(4000),@p480 nvarchar(4000),@p481 nvarchar(4000),@p482 nvarchar(4000),@p483 nvarchar(4000),@p484 nvarchar(4000),@p485 nvarchar(4000),@p486 nvarchar(4000),@p487 nvarchar(4000),@p488 int,@p489 nvarchar(4000),@p490 nvarchar(4000),@p491 nvarchar(4000),@p492 nvarchar(4000),@p493 nvarchar(4000),@p494 int,@p495 nvarchar(4000),@p496 int,@p497 int,@p498 datetime2(7),@p499 datetime2(7),@p500 datetime2(7),@p501 nvarchar(4000),@p502 nvarchar(4000),@p503 nvarchar(4000),@p504 nvarchar(4000),@p505 nvarchar(4000),@p506 nvarchar(4000),@p507 nvarchar(4000),@p508 nvarchar(4000),@p509 nvarchar(4000),@p510 nvarchar(4000),@p511 nvarchar(4000),@p512 nvarchar(4000),@p513 nvarchar(4000),@p514 nvarchar(4000),@p515 datetime2(7),@p516 nvarchar(4000),@p517 nvarchar(4000),@p518 int,@p519 int,@p520 int,@p521 nvarchar(4000),@p522 nvarchar(4000),@p523 nvarchar(4000),@p524 nvarchar(4000),@p525 nvarchar(4000),@p526 nvarchar(4000),@p527 nvarchar(4000),@p528 nvarchar(4000),@p529 nvarchar(4000),@p530 nvarchar(4000),@p531 nvarchar(4000),@p532 nvarchar(4000),@p533 int,@p534 nvarchar(4000),@p535 nvarchar(4000),@p536 nvarchar(4000),@p537 nvarchar(4000),@p538 nvarchar(4000),@p539 nvarchar(4000),@p540 nvarchar(4000),@p541 nvarchar(4000),@p542 nvarchar(4000),@p543 nvarchar(4000),@p544 int,@p545 nvarchar(4000),@p546 nvarchar(4000),@p547 nvarchar(4000),@p548 nvarchar(4000),@p549 nvarchar(4000),@p550 int,@p551 nvarchar(4000),@p552 int,@p553 int,@p554 datetime2(7),@p555 datetime2(7),@p556 datetime2(7),@p557 nvarchar(4000),@p558 nvarchar(4000),@p559 nvarchar(4000),@p560 nvarchar(4000),@p561 nvarchar(4000),@p562 nvarchar(4000),@p563 nvarchar(4000),@p564 nvarchar(4000),@p565 nvarchar(4000),@p566 nvarchar(4000),@p567 nvarchar(4000),@p568 nvarchar(4000),@p569 nvarchar(4000),@p570 nvarchar(4000),@p571 datetime2(7),@p572 nvarchar(4000),@p573 nvarchar(4000),@p574 int,@p575 int,@p576 int,@p577 nvarchar(4000),@p578 nvarchar(4000),@p579 nvarchar(4000),@p580 nvarchar(4000),@p581 nvarchar(4000),@p582 nvarchar(4000),@p583 nvarchar(4000),@p584 nvarchar(4000),@p585 nvarchar(4000),@p586 nvarchar(4000),@p587 nvarchar(4000),@p588 nvarchar(4000),@p589 int,@p590 nvarchar(4000),@p591 nvarchar(4000),@p592 nvarchar(4000),@p593 nvarchar(4000),@p594 nvarchar(4000),@p595 nvarchar(4000),@p596 nvarchar(4000),@p597 nvarchar(4000),@p598 nvarchar(4000),@p599 nvarchar(4000),@p600 int,@p601 nvarchar(4000),@p602 nvarchar(4000),@p603 nvarchar(4000),@p604 nvarchar(4000),@p605 nvarchar(4000),@p606 int,@p607 nvarchar(4000),@p608 int,@p609 int,@p610 datetime2(7),@p611 datetime2(7),@p612 datetime2(7),@p613 nvarchar(4000),@p614 nvarchar(4000),@p615 nvarchar(4000),@p616 nvarchar(4000),@p617 nvarchar(4000),@p618 nvarchar(4000),@p619 nvarchar(4000),@p620 nvarchar(4000),@p621 nvarchar(4000),@p622 nvarchar(4000),@p623 nvarchar(4000),@p624 nvarchar(4000),@p625 nvarchar(4000),@p626 nvarchar(4000),@p627 datetime2(7),@p628 nvarchar(4000),@p629 nvarchar(4000),@p630 int,@p631 int,@p632 int,@p633 nvarchar(4000),@p634 nvarchar(4000),@p635 nvarchar(4000),@p636 nvarchar(4000),@p637 nvarchar(4000),@p638 nvarchar(4000),@p639 nvarchar(4000),@p640 nvarchar(4000),@p641 nvarchar(4000),@p642 nvarchar(4000),@p643 nvarchar(4000),@p644 nvarchar(4000),@p645 int,@p646 nvarchar(4000),@p647 nvarchar(4000),@p648 nvarchar(4000),@p649 nvarchar(4000),@p650 nvarchar(4000),@p651 nvarchar(4000),@p652 nvarchar(4000),@p653 nvarchar(4000),@p654 nvarchar(4000),@p655 nvarchar(4000),@p656 int,@p657 nvarchar(4000),@p658 nvarchar(4000),@p659 nvarchar(4000),@p660 nvarchar(4000),@p661 nvarchar(4000),@p662 int,@p663 nvarchar(4000),@p664 int,@p665 int,@p666 datetime2(7),@p667 datetime2(7),@p668 datetime2(7),@p669 nvarchar(4000),@p670 nvarchar(4000),@p671 nvarchar(4000),@p672 nvarchar(4000),@p673 nvarchar(4000),@p674 nvarchar(4000),@p675 nvarchar(4000),@p676 nvarchar(4000),@p677 nvarchar(4000),@p678 nvarchar(4000),@p679 nvarchar(4000),@p680 nvarchar(4000),@p681 nvarchar(4000),@p682 nvarchar(4000),@p683 datetime2(7),@p684 nvarchar(4000),@p685 nvarchar(4000),@p686 int,@p687 int,@p688 int,@p689 nvarchar(4000),@p690 nvarchar(4000),@p691 nvarchar(4000),@p692 nvarchar(4000),@p693 nvarchar(4000),@p694 nvarchar(4000),@p695 nvarchar(4000),@p696 nvarchar(4000),@p697 nvarchar(4000),@p698 nvarchar(4000),@p699 nvarchar(4000),@p700 nvarchar(4000),@p701 int,@p702 nvarchar(4000),@p703 nvarchar(4000),@p704 nvarchar(4000),@p705 nvarchar(4000),@p706 nvarchar(4000),@p707 nvarchar(4000),@p708 nvarchar(4000),@p709 nvarchar(4000),@p710 nvarchar(4000),@p711 nvarchar(4000),@p712 int,@p713 nvarchar(4000),@p714 nvarchar(4000),@p715 nvarchar(4000),@p716 nvarchar(4000),@p717 nvarchar(4000),@p718 int,@p719 nvarchar(4000),@p720 int,@p721 int,@p722 datetime2(7),@p723 datetime2(7),@p724 datetime2(7),@p725 nvarchar(4000),@p726 nvarchar(4000),@p727 nvarchar(4000),@p728 nvarchar(4000),@p729 nvarchar(4000),@p730 nvarchar(4000),@p731 nvarchar(4000),@p732 nvarchar(4000),@p733 nvarchar(4000),@p734 nvarchar(4000),@p735 nvarchar(4000),@p736 nvarchar(4000),@p737 nvarchar(4000),@p738 nvarchar(4000),@p739 datetime2(7),@p740 nvarchar(4000),@p741 nvarchar(4000),@p742 int,@p743 int,@p744 int,@p745 nvarchar(4000),@p746 nvarchar(4000),@p747 nvarchar(4000),@p748 nvarchar(4000),@p749 nvarchar(4000),@p750 nvarchar(4000),@p751 nvarchar(4000),@p752 nvarchar(4000),@p753 nvarchar(4000),@p754 nvarchar(4000),@p755 nvarchar(4000),@p756 nvarchar(4000),@p757 int,@p758 nvarchar(4000),@p759 nvarchar(4000),@p760 nvarchar(4000),@p761 nvarchar(4000),@p762 nvarchar(4000),@p763 nvarchar(4000),@p764 nvarchar(4000),@p765 nvarchar(4000),@p766 nvarchar(4000),@p767 nvarchar(4000),@p768 int,@p769 nvarchar(4000),@p770 nvarchar(4000),@p771 nvarchar(4000),@p772 nvarchar(4000),@p773 nvarchar(4000),@p774 int,@p775 nvarchar(4000),@p776 int,@p777 int,@p778 datetime2(7),@p779 datetime2(7),@p780 datetime2(7),@p781 nvarchar(4000),@p782 nvarchar(4000),@p783 nvarchar(4000),@p784 nvarchar(4000),@p785 nvarchar(4000),@p786 nvarchar(4000),@p787 nvarchar(4000),@p788 nvarchar(4000),@p789 nvarchar(4000),@p790 nvarchar(4000),@p791 nvarchar(4000),@p792 nvarchar(4000),@p793 nvarchar(4000),@p794 nvarchar(4000),@p795 datetime2(7),@p796 nvarchar(4000),@p797 nvarchar(4000),@p798 int,@p799 int,@p800 int,@p801 nvarchar(4000),@p802 nvarchar(4000),@p803 nvarchar(4000),@p804 nvarchar(4000),@p805 nvarchar(4000),@p806 nvarchar(4000),@p807 nvarchar(4000),@p808 nvarchar(4000),@p809 nvarchar(4000),@p810 nvarchar(4000),@p811 nvarchar(4000),@p812 nvarchar(4000),@p813 int,@p814 nvarchar(4000),@p815 nvarchar(4000),@p816 nvarchar(4000),@p817 nvarchar(4000),@p818 nvarchar(4000),@p819 nvarchar(4000),@p820 nvarchar(4000),@p821 nvarchar(4000),@p822 nvarchar(4000),@p823 nvarchar(4000),@p824 int,@p825 nvarchar(4000),@p826 nvarchar(4000),@p827 nvarchar(4000),@p828 nvarchar(4000),@p829 nvarchar(4000),@p830 int,@p831 nvarchar(4000),@p832 int,@p833 int,@p834 datetime2(7),@p835 datetime2(7),@p836 datetime2(7),@p837 nvarchar(4000),@p838 nvarchar(4000),@p839 nvarchar(4000),@p840 nvarchar(4000),@p841 nvarchar(4000),@p842 nvarchar(4000),@p843 nvarchar(4000),@p844 nvarchar(4000),@p845 nvarchar(4000),@p846 nvarchar(4000),@p847 nvarchar(4000),@p848 nvarchar(4000),@p849 nvarchar(4000),@p850 nvarchar(4000),@p851 datetime2(7),@p852 nvarchar(4000),@p853 nvarchar(4000),@p854 int,@p855 int,@p856 int,@p857 nvarchar(4000),@p858 nvarchar(4000),@p859 nvarchar(4000),@p860 nvarchar(4000),@p861 nvarchar(4000),@p862 nvarchar(4000),@p863 nvarchar(4000),@p864 nvarchar(4000),@p865 nvarchar(4000),@p866 nvarchar(4000),@p867 nvarchar(4000),@p868 nvarchar(4000),@p869 int,@p870 nvarchar(4000),@p871 nvarchar(4000),@p872 nvarchar(4000),@p873 nvarchar(4000),@p874 nvarchar(4000),@p875 nvarchar(4000),@p876 nvarchar(4000),@p877 nvarchar(4000),@p878 nvarchar(4000),@p879 nvarchar(4000),@p880 int,@p881 nvarchar(4000),@p882 nvarchar(4000),@p883 nvarchar(4000),@p884 nvarchar(4000),@p885 nvarchar(4000),@p886 int,@p887 nvarchar(4000),@p888 int,@p889 int,@p890 datetime2(7),@p891 datetime2(7),@p892 datetime2(7),@p893 nvarchar(4000),@p894 nvarchar(4000),@p895 nvarchar(4000),@p896 nvarchar(4000),@p897 nvarchar(4000),@p898 nvarchar(4000),@p899 nvarchar(4000),@p900 nvarchar(4000),@p901 nvarchar(4000),@p902 nvarchar(4000),@p903 nvarchar(4000),@p904 nvarchar(4000),@p905 nvarchar(4000),@p906 nvarchar(4000),@p907 datetime2(7),@p908 nvarchar(4000),@p909 nvarchar(4000),@p910 int,@p911 int,@p912 int,@p913 nvarchar(4000),@p914 nvarchar(4000),@p915 nvarchar(4000),@p916 nvarchar(4000),@p917 nvarchar(4000),@p918 nvarchar(4000),@p919 nvarchar(4000),@p920 nvarchar(4000),@p921 nvarchar(4000),@p922 nvarchar(4000),@p923 nvarchar(4000),@p924 nvarchar(4000),@p925 int,@p926 nvarchar(4000),@p927 nvarchar(4000),@p928 nvarchar(4000),@p929 nvarchar(4000),@p930 nvarchar(4000),@p931 nvarchar(4000),@p932 nvarchar(4000),@p933 nvarchar(4000),@p934 nvarchar(4000),@p935 nvarchar(4000),@p936 int,@p937 nvarchar(4000),@p938 nvarchar(4000),@p939 nvarchar(4000),@p940 nvarchar(4000),@p941 nvarchar(4000),@p942 int,@p943 nvarchar(4000),@p944 int,@p945 int,@p946 datetime2(7),@p947 datetime2(7),@p948 datetime2(7),@p949 nvarchar(4000),@p950 nvarchar(4000),@p951 nvarchar(4000),@p952 nvarchar(4000),@p953 nvarchar(4000),@p954 nvarchar(4000),@p955 nvarchar(4000),@p956 nvarchar(4000),@p957 nvarchar(4000),@p958 nvarchar(4000),@p959 nvarchar(4000),@p960 nvarchar(4000),@p961 nvarchar(4000),@p962 nvarchar(4000),@p963 datetime2(7),@p964 nvarchar(4000),@p965 nvarchar(4000),@p966 int,@p967 int,@p968 int,@p969 nvarchar(4000),@p970 nvarchar(4000),@p971 nvarchar(4000),@p972 nvarchar(4000),@p973 nvarchar(4000),@p974 nvarchar(4000),@p975 nvarchar(4000),@p976 nvarchar(4000),@p977 nvarchar(4000),@p978 nvarchar(4000),@p979 nvarchar(4000),@p980 nvarchar(4000),@p981 int,@p982 nvarchar(4000),@p983 nvarchar(4000),@p984 nvarchar(4000),@p985 nvarchar(4000),@p986 nvarchar(4000),@p987 nvarchar(4000),@p988 nvarchar(4000),@p989 nvarchar(4000),@p990 nvarchar(4000),@p991 nvarchar(4000),@p992 int,@p993 nvarchar(4000),@p994 nvarchar(4000),@p995 nvarchar(4000),@p996 nvarchar(4000),@p997 nvarchar(4000),@p998 int,@p999 nvarchar(4000),@p1000 int,@p1001 int,@p1002 datetime2(7),@p1003 datetime2(7),@p1004 datetime2(7),@p1005 nvarchar(4000),@p1006 nvarchar(4000),@p1007 nvarchar(4000),@p1008 nvarchar(4000),@p1009 nvarchar(4000),@p1010 nvarchar(4000),@p1011 nvarchar(4000),@p1012 nvarchar(4000),@p1013 nvarchar(4000),@p1014 nvarchar(4000),@p1015 nvarchar(4000),@p1016 nvarchar(4000),@p1017 nvarchar(4000),@p1018 nvarchar(4000),@p1019 datetime2(7),@p1020 nvarchar(4000),@p1021 nvarchar(4000),@p1022 int,@p1023 int,@p1024 int,@p1025 nvarchar(4000),@p1026 nvarchar(4000),@p1027 nvarchar(4000),@p1028 nvarchar(4000),@p1029 nvarchar(4000),@p1030 nvarchar(4000),@p1031 nvarchar(4000),@p1032 nvarchar(4000),@p1033 nvarchar(4000),@p1034 nvarchar(4000),@p1035 nvarchar(4000),@p1036 nvarchar(4000),@p1037 int,@p1038 nvarchar(4000),@p1039 nvarchar(4000),@p1040 nvarchar(4000),@p1041 nvarchar(4000),@p1042 nvarchar(4000),@p1043 nvarchar(4000),@p1044 nvarchar(4000),@p1045 nvarchar(4000),@p1046 nvarchar(4000),@p1047 nvarchar(4000),@p1048 int,@p1049 nvarchar(4000),@p1050 nvarchar(4000),@p1051 nvarchar(4000),@p1052 nvarchar(4000),@p1053 nvarchar(4000),@p1054 int,@p1055 nvarchar(4000),@p1056 int,@p1057 int,@p1058 datetime2(7),@p1059 datetime2(7),@p1060 datetime2(7),@p1061 nvarchar(4000),@p1062 nvarchar(4000),@p1063 nvarchar(4000),@p1064 nvarchar(4000),@p1065 nvarchar(4000),@p1066 nvarchar(4000),@p1067 nvarchar(4000),@p1068 nvarchar(4000),@p1069 nvarchar(4000),@p1070 nvarchar(4000),@p1071 nvarchar(4000),@p1072 nvarchar(4000),@p1073 nvarchar(4000),@p1074 nvarchar(4000),@p1075 datetime2(7),@p1076 nvarchar(4000),@p1077 nvarchar(4000),@p1078 int,@p1079 int,@p1080 int,@p1081 nvarchar(4000),@p1082 nvarchar(4000),@p1083 nvarchar(4000),@p1084 nvarchar(4000),@p1085 nvarchar(4000),@p1086 nvarchar(4000),@p1087 nvarchar(4000),@p1088 nvarchar(4000),@p1089 nvarchar(4000),@p1090 nvarchar(4000),@p1091 nvarchar(4000),@p1092 nvarchar(4000),@p1093 int,@p1094 nvarchar(4000),@p1095 nvarchar(4000),@p1096 nvarchar(4000),@p1097 nvarchar(4000),@p1098 nvarchar(4000),@p1099 nvarchar(4000),@p1100 nvarchar(4000),@p1101 nvarchar(4000),@p1102 nvarchar(4000),@p1103 nvarchar(4000),@p1104 int,@p1105 nvarchar(4000),@p1106 nvarchar(4000),@p1107 nvarchar(4000),@p1108 nvarchar(4000),@p1109 nvarchar(4000),@p1110 int,@p1111 nvarchar(4000),@p1112 int,@p1113 int,@p1114 datetime2(7),@p1115 datetime2(7),@p1116 datetime2(7),@p1117 nvarchar(4000),@p1118 nvarchar(4000),@p1119 nvarchar(4000),@p1120 nvarchar(4000),@p1121 nvarchar(4000),@p1122 nvarchar(4000),@p1123 nvarchar(4000),@p1124 nvarchar(4000),@p1125 nvarchar(4000),@p1126 nvarchar(4000),@p1127 nvarchar(4000),@p1128 nvarchar(4000),@p1129 nvarchar(4000),@p1130 nvarchar(4000),@p1131 datetime2(7),@p1132 nvarchar(4000),@p1133 nvarchar(4000),@p1134 int,@p1135 int,@p1136 int,@p1137 nvarchar(4000),@p1138 nvarchar(4000),@p1139 nvarchar(4000),@p1140 nvarchar(4000),@p1141 nvarchar(4000),@p1142 nvarchar(4000),@p1143 nvarchar(4000),@p1144 nvarchar(4000),@p1145 nvarchar(4000),@p1146 nvarchar(4000),@p1147 nvarchar(4000),@p1148 nvarchar(4000),@p1149 int,@p1150 nvarchar(4000),@p1151 nvarchar(4000),@p1152 nvarchar(4000),@p1153 nvarchar(4000),@p1154 nvarchar(4000),@p1155 nvarchar(4000),@p1156 nvarchar(4000),@p1157 nvarchar(4000),@p1158 nvarchar(4000),@p1159 nvarchar(4000),@p1160 int,@p1161 nvarchar(4000),@p1162 nvarchar(4000),@p1163 nvarchar(4000),@p1164 nvarchar(4000),@p1165 nvarchar(4000),@p1166 int,@p1167 nvarchar(4000),@p1168 int,@p1169 int,@p1170 datetime2(7),@p1171 datetime2(7),@p1172 datetime2(7),@p1173 nvarchar(4000),@p1174 nvarchar(4000),@p1175 nvarchar(4000),@p1176 nvarchar(4000),@p1177 nvarchar(4000),@p1178 nvarchar(4000),@p1179 nvarchar(4000),@p1180 nvarchar(4000),@p1181 nvarchar(4000),@p1182 nvarchar(4000),@p1183 nvarchar(4000),@p1184 nvarchar(4000),@p1185 nvarchar(4000),@p1186 nvarchar(4000),@p1187 datetime2(7),@p1188 nvarchar(4000),@p1189 nvarchar(4000),@p1190 int,@p1191 int,@p1192 int,@p1193 nvarchar(4000),@p1194 nvarchar(4000),@p1195 nvarchar(4000),@p1196 nvarchar(4000),@p1197 nvarchar(4000),@p1198 nvarchar(4000),@p1199 nvarchar(4000),@p1200 nvarchar(4000),@p1201 nvarchar(4000),@p1202 nvarchar(4000),@p1203 nvarchar(4000),@p1204 nvarchar(4000),@p1205 int,@p1206 nvarchar(4000),@p1207 nvarchar(4000),@p1208 nvarchar(4000),@p1209 nvarchar(4000),@p1210 nvarchar(4000),@p1211 nvarchar(4000),@p1212 nvarchar(4000),@p1213 nvarchar(4000),@p1214 nvarchar(4000),@p1215 nvarchar(4000),@p1216 int,@p1217 nvarchar(4000),@p1218 nvarchar(4000),@p1219 nvarchar(4000),@p1220 nvarchar(4000),@p1221 nvarchar(4000),@p1222 int,@p1223 nvarchar(4000),@p1224 int,@p1225 int,@p1226 datetime2(7),@p1227 datetime2(7),@p1228 datetime2(7),@p1229 nvarchar(4000),@p1230 nvarchar(4000),@p1231 nvarchar(4000),@p1232 nvarchar(4000),@p1233 nvarchar(4000),@p1234 nvarchar(4000),@p1235 nvarchar(4000),@p1236 nvarchar(4000),@p1237 nvarchar(4000),@p1238 nvarchar(4000),@p1239 nvarchar(4000),@p1240 nvarchar(4000),@p1241 nvarchar(4000),@p1242 nvarchar(4000),@p1243 datetime2(7),@p1244 nvarchar(4000),@p1245 nvarchar(4000),@p1246 int,@p1247 int,@p1248 int,@p1249 nvarchar(4000),@p1250 nvarchar(4000),@p1251 nvarchar(4000),@p1252 nvarchar(4000),@p1253 nvarchar(4000),@p1254 nvarchar(4000),@p1255 nvarchar(4000),@p1256 nvarchar(4000),@p1257 nvarchar(4000),@p1258 nvarchar(4000),@p1259 nvarchar(4000),@p1260 nvarchar(4000),@p1261 int,@p1262 nvarchar(4000),@p1263 nvarchar(4000),@p1264 nvarchar(4000),@p1265 nvarchar(4000),@p1266 nvarchar(4000),@p1267 nvarchar(4000),@p1268 nvarchar(4000),@p1269 nvarchar(4000),@p1270 nvarchar(4000),@p1271 nvarchar(4000),@p1272 int,@p1273 nvarchar(4000),@p1274 nvarchar(4000),@p1275 nvarchar(4000),@p1276 nvarchar(4000),@p1277 nvarchar(4000),@p1278 int,@p1279 nvarchar(4000),@p1280 int,@p1281 int,@p1282 datetime2(7),@p1283 datetime2(7),@p1284 datetime2(7),@p1285 nvarchar(4000),@p1286 nvarchar(4000),@p1287 nvarchar(4000),@p1288 nvarchar(4000),@p1289 nvarchar(4000),@p1290 nvarchar(4000),@p1291 nvarchar(4000),@p1292 nvarchar(4000),@p1293 nvarchar(4000),@p1294 nvarchar(4000),@p1295 nvarchar(4000),@p1296 nvarchar(4000),@p1297 nvarchar(4000),@p1298 nvarchar(4000),@p1299 datetime2(7),@p1300 nvarchar(4000),@p1301 nvarchar(4000),@p1302 int,@p1303 int,@p1304 int,@p1305 nvarchar(4000),@p1306 nvarchar(4000),@p1307 nvarchar(4000),@p1308 nvarchar(4000),@p1309 nvarchar(4000),@p1310 nvarchar(4000),@p1311 nvarchar(4000),@p1312 nvarchar(4000),@p1313 nvarchar(4000),@p1314 nvarchar(4000),@p1315 nvarchar(4000),@p1316 nvarchar(4000),@p1317 int,@p1318 nvarchar(4000),@p1319 nvarchar(4000),@p1320 nvarchar(4000),@p1321 nvarchar(4000),@p1322 nvarchar(4000),@p1323 nvarchar(4000),@p1324 nvarchar(4000),@p1325 nvarchar(4000),@p1326 nvarchar(4000),@p1327 nvarchar(4000),@p1328 int,@p1329 nvarchar(4000),@p1330 nvarchar(4000),@p1331 nvarchar(4000),@p1332 nvarchar(4000),@p1333 nvarchar(4000),@p1334 int,@p1335 nvarchar(4000),@p1336 int,@p1337 int,@p1338 datetime2(7),@p1339 datetime2(7),@p1340 datetime2(7),@p1341 nvarchar(4000),@p1342 nvarchar(4000),@p1343 nvarchar(4000),@p1344 nvarchar(4000),@p1345 nvarchar(4000),@p1346 nvarchar(4000),@p1347 nvarchar(4000),@p1348 nvarchar(4000),@p1349 nvarchar(4000),@p1350 nvarchar(4000),@p1351 nvarchar(4000),@p1352 nvarchar(4000),@p1353 nvarchar(4000),@p1354 nvarchar(4000),@p1355 datetime2(7),@p1356 nvarchar(4000),@p1357 nvarchar(4000),@p1358 int,@p1359 int,@p1360 int,@p1361 nvarchar(4000),@p1362 nvarchar(4000),@p1363 nvarchar(4000),@p1364 nvarchar(4000),@p1365 nvarchar(4000),@p1366 nvarchar(4000),@p1367 nvarchar(4000),@p1368 nvarchar(4000),@p1369 nvarchar(4000),@p1370 nvarchar(4000),@p1371 nvarchar(4000),@p1372 nvarchar(4000),@p1373 int,@p1374 nvarchar(4000),@p1375 nvarchar(4000),@p1376 nvarchar(4000),@p1377 nvarchar(4000),@p1378 nvarchar(4000),@p1379 nvarchar(4000),@p1380 nvarchar(4000),@p1381 nvarchar(4000),@p1382 nvarchar(4000),@p1383 nvarchar(4000),@p1384 int,@p1385 nvarchar(4000),@p1386 nvarchar(4000),@p1387 nvarchar(4000),@p1388 nvarchar(4000),@p1389 nvarchar(4000),@p1390 int,@p1391 nvarchar(4000),@p1392 int,@p1393 int,@p1394 datetime2(7),@p1395 datetime2(7),@p1396 datetime2(7),@p1397 nvarchar(4000),@p1398 nvarchar(4000),@p1399 nvarchar(4000),@p1400 nvarchar(4000),@p1401 nvarchar(4000),@p1402 nvarchar(4000),@p1403 nvarchar(4000),@p1404 nvarchar(4000),@p1405 nvarchar(4000),@p1406 nvarchar(4000),@p1407 nvarchar(4000),@p1408 nvarchar(4000),@p1409 nvarchar(4000),@p1410 nvarchar(4000),@p1411 datetime2(7),@p1412 nvarchar(4000),@p1413 nvarchar(4000),@p1414 int,@p1415 int,@p1416 int,@p1417 nvarchar(4000),@p1418 nvarchar(4000),@p1419 nvarchar(4000),@p1420 nvarchar(4000),@p1421 nvarchar(4000),@p1422 nvarchar(4000),@p1423 nvarchar(4000),@p1424 nvarchar(4000),@p1425 nvarchar(4000),@p1426 nvarchar(4000),@p1427 nvarchar(4000),@p1428 nvarchar(4000),@p1429 int,@p1430 nvarchar(4000),@p1431 nvarchar(4000),@p1432 nvarchar(4000),@p1433 nvarchar(4000),@p1434 nvarchar(4000),@p1435 nvarchar(4000),@p1436 nvarchar(4000),@p1437 nvarchar(4000),@p1438 nvarchar(4000),@p1439 nvarchar(4000),@p1440 int,@p1441 nvarchar(4000),@p1442 nvarchar(4000),@p1443 nvarchar(4000),@p1444 nvarchar(4000),@p1445 nvarchar(4000),@p1446 int,@p1447 nvarchar(4000),@p1448 int,@p1449 int,@p1450 datetime2(7),@p1451 datetime2(7),@p1452 datetime2(7),@p1453 nvarchar(4000),@p1454 nvarchar(4000),@p1455 nvarchar(4000),@p1456 nvarchar(4000),@p1457 nvarchar(4000),@p1458 nvarchar(4000),@p1459 nvarchar(4000),@p1460 nvarchar(4000),@p1461 nvarchar(4000),@p1462 nvarchar(4000),@p1463 nvarchar(4000),@p1464 nvarchar(4000),@p1465 nvarchar(4000),@p1466 nvarchar(4000),@p1467 datetime2(7),@p1468 nvarchar(4000),@p1469 nvarchar(4000),@p1470 int,@p1471 int,@p1472 int,@p1473 nvarchar(4000),@p1474 nvarchar(4000),@p1475 nvarchar(4000),@p1476 nvarchar(4000),@p1477 nvarchar(4000),@p1478 nvarchar(4000),@p1479 nvarchar(4000),@p1480 nvarchar(4000),@p1481 nvarchar(4000),@p1482 nvarchar(4000),@p1483 nvarchar(4000),@p1484 nvarchar(4000),@p1485 int,@p1486 nvarchar(4000),@p1487 nvarchar(4000),@p1488 nvarchar(4000),@p1489 nvarchar(4000),@p1490 nvarchar(4000),@p1491 nvarchar(4000),@p1492 nvarchar(4000),@p1493 nvarchar(4000),@p1494 nvarchar(4000),@p1495 nvarchar(4000),@p1496 int,@p1497 nvarchar(4000),@p1498 nvarchar(4000),@p1499 nvarchar(4000),@p1500 nvarchar(4000),@p1501 nvarchar(4000),@p1502 int,@p1503 nvarchar(4000),@p1504 int,@p1505 int,@p1506 datetime2(7),@p1507 datetime2(7),@p1508 datetime2(7),@p1509 nvarchar(4000),@p1510 nvarchar(4000),@p1511 nvarchar(4000),@p1512 nvarchar(4000),@p1513 nvarchar(4000),@p1514 nvarchar(4000),@p1515 nvarchar(4000),@p1516 nvarchar(4000),@p1517 nvarchar(4000),@p1518 nvarchar(4000),@p1519 nvarchar(4000),@p1520 nvarchar(4000),@p1521 nvarchar(4000),@p1522 nvarchar(4000),@p1523 datetime2(7),@p1524 nvarchar(4000),@p1525 nvarchar(4000),@p1526 int,@p1527 int,@p1528 int,@p1529 nvarchar(4000),@p1530 nvarchar(4000),@p1531 nvarchar(4000),@p1532 nvarchar(4000),@p1533 nvarchar(4000),@p1534 nvarchar(4000),@p1535 nvarchar(4000),@p1536 nvarchar(4000),@p1537 nvarchar(4000),@p1538 nvarchar(4000),@p1539 nvarchar(4000),@p1540 nvarchar(4000),@p1541 int,@p1542 nvarchar(4000),@p1543 nvarchar(4000),@p1544 nvarchar(4000),@p1545 nvarchar(4000),@p1546 nvarchar(4000),@p1547 nvarchar(4000),@p1548 nvarchar(4000),@p1549 nvarchar(4000),@p1550 nvarchar(4000),@p1551 nvarchar(4000),@p1552 int,@p1553 nvarchar(4000),@p1554 nvarchar(4000),@p1555 nvarchar(4000),@p1556 nvarchar(4000),@p1557 nvarchar(4000),@p1558 int,@p1559 nvarchar(4000),@p1560 int,@p1561 int,@p1562 datetime2(7),@p1563 datetime2(7),@p1564 datetime2(7),@p1565 nvarchar(4000),@p1566 nvarchar(4000),@p1567 nvarchar(4000),@p1568 nvarchar(4000),@p1569 nvarchar(4000),@p1570 nvarchar(4000),@p1571 nvarchar(4000),@p1572 nvarchar(4000),@p1573 nvarchar(4000),@p1574 nvarchar(4000),@p1575 nvarchar(4000),@p1576 nvarchar(4000),@p1577 nvarchar(4000),@p1578 nvarchar(4000),@p1579 datetime2(7),@p1580 nvarchar(4000),@p1581 nvarchar(4000),@p1582 int,@p1583 int,@p1584 int,@p1585 nvarchar(4000),@p1586 nvarchar(4000),@p1587 nvarchar(4000),@p1588 nvarchar(4000),@p1589 nvarchar(4000),@p1590 nvarchar(4000),@p1591 nvarchar(4000),@p1592 nvarchar(4000),@p1593 nvarchar(4000),@p1594 nvarchar(4000),@p1595 nvarchar(4000),@p1596 nvarchar(4000),@p1597 int,@p1598 nvarchar(4000),@p1599 nvarchar(4000),@p1600 nvarchar(4000),@p1601 nvarchar(4000),@p1602 nvarchar(4000),@p1603 nvarchar(4000),@p1604 nvarchar(4000),@p1605 nvarchar(4000),@p1606 nvarchar(4000),@p1607 nvarchar(4000),@p1608 int,@p1609 nvarchar(4000),@p1610 nvarchar(4000),@p1611 nvarchar(4000),@p1612 nvarchar(4000),@p1613 nvarchar(4000),@p1614 int,@p1615 nvarchar(4000),@p1616 int,@p1617 int,@p1618 datetime2(7),@p1619 datetime2(7),@p1620 datetime2(7),@p1621 nvarchar(4000),@p1622 nvarchar(4000),@p1623 nvarchar(4000),@p1624 nvarchar(4000),@p1625 nvarchar(4000),@p1626 nvarchar(4000),@p1627 nvarchar(4000),@p1628 nvarchar(4000),@p1629 nvarchar(4000),@p1630 nvarchar(4000),@p1631 nvarchar(4000),@p1632 nvarchar(4000),@p1633 nvarchar(4000),@p1634 nvarchar(4000),@p1635 datetime2(7),@p1636 nvarchar(4000),@p1637 nvarchar(4000),@p1638 int,@p1639 int,@p1640 int,@p1641 nvarchar(4000),@p1642 nvarchar(4000),@p1643 nvarchar(4000),@p1644 nvarchar(4000),@p1645 nvarchar(4000),@p1646 nvarchar(4000),@p1647 nvarchar(4000),@p1648 nvarchar(4000),@p1649 nvarchar(4000),@p1650 nvarchar(4000),@p1651 nvarchar(4000),@p1652 nvarchar(4000),@p1653 int,@p1654 nvarchar(4000),@p1655 nvarchar(4000),@p1656 nvarchar(4000),@p1657 nvarchar(4000),@p1658 nvarchar(4000),@p1659 nvarchar(4000),@p1660 nvarchar(4000),@p1661 nvarchar(4000),@p1662 nvarchar(4000),@p1663 nvarchar(4000),@p1664 int,@p1665 nvarchar(4000),@p1666 nvarchar(4000),@p1667 nvarchar(4000),@p1668 nvarchar(4000),@p1669 nvarchar(4000),@p1670 int,@p1671 nvarchar(4000),@p1672 int,@p1673 int,@p1674 datetime2(7),@p1675 datetime2(7),@p1676 datetime2(7),@p1677 nvarchar(4000),@p1678 nvarchar(4000),@p1679 nvarchar(4000),@p1680 nvarchar(4000),@p1681 nvarchar(4000),@p1682 nvarchar(4000),@p1683 nvarchar(4000),@p1684 nvarchar(4000),@p1685 nvarchar(4000),@p1686 nvarchar(4000),@p1687 nvarchar(4000),@p1688 nvarchar(4000),@p1689 nvarchar(4000),@p1690 nvarchar(4000),@p1691 datetime2(7),@p1692 nvarchar(4000),@p1693 nvarchar(4000),@p1694 int,@p1695 int,@p1696 int,@p1697 nvarchar(4000),@p1698 nvarchar(4000),@p1699 nvarchar(4000),@p1700 nvarchar(4000),@p1701 nvarchar(4000),@p1702 nvarchar(4000),@p1703 nvarchar(4000),@p1704 nvarchar(4000),@p1705 nvarchar(4000),@p1706 nvarchar(4000),@p1707 nvarchar(4000),@p1708 nvarchar(4000),@p1709 int,@p1710 nvarchar(4000),@p1711 nvarchar(4000),@p1712 nvarchar(4000),@p1713 nvarchar(4000),@p1714 nvarchar(4000),@p1715 nvarchar(4000),@p1716 nvarchar(4000),@p1717 nvarchar(4000),@p1718 nvarchar(4000),@p1719 nvarchar(4000),@p1720 int,@p1721 nvarchar(4000),@p1722 nvarchar(4000),@p1723 nvarchar(4000),@p1724 nvarchar(4000),@p1725 nvarchar(4000),@p1726 int,@p1727 nvarchar(4000),@p1728 int,@p1729 int,@p1730 datetime2(7),@p1731 datetime2(7),@p1732 datetime2(7),@p1733 nvarchar(4000),@p1734 nvarchar(4000),@p1735 nvarchar(4000),@p1736 nvarchar(4000),@p1737 nvarchar(4000),@p1738 nvarchar(4000),@p1739 nvarchar(4000),@p1740 nvarchar(4000),@p1741 nvarchar(4000),@p1742 nvarchar(4000),@p1743 nvarchar(4000),@p1744 nvarchar(4000),@p1745 nvarchar(4000),@p1746 nvarchar(4000),@p1747 datetime2(7),@p1748 nvarchar(4000),@p1749 nvarchar(4000),@p1750 int,@p1751 int,@p1752 int,@p1753 nvarchar(4000),@p1754 nvarchar(4000),@p1755 nvarchar(4000),@p1756 nvarchar(4000),@p1757 nvarchar(4000),@p1758 nvarchar(4000),@p1759 nvarchar(4000),@p1760 nvarchar(4000),@p1761 nvarchar(4000),@p1762 nvarchar(4000),@p1763 nvarchar(4000),@p1764 nvarchar(4000),@p1765 int,@p1766 nvarchar(4000),@p1767 nvarchar(4000),@p1768 nvarchar(4000),@p1769 nvarchar(4000),@p1770 nvarchar(4000),@p1771 nvarchar(4000),@p1772 nvarchar(4000),@p1773 nvarchar(4000),@p1774 nvarchar(4000),@p1775 nvarchar(4000),@p1776 int,@p1777 nvarchar(4000),@p1778 nvarchar(4000),@p1779 nvarchar(4000),@p1780 nvarchar(4000),@p1781 nvarchar(4000),@p1782 int,@p1783 nvarchar(4000),@p1784 int,@p1785 int,@p1786 datetime2(7),@p1787 datetime2(7),@p1788 datetime2(7),@p1789 nvarchar(4000),@p1790 nvarchar(4000),@p1791 nvarchar(4000))SET NOCOUNT ON; DECLARE @inserted0 TABLE ([item_id] int, [_Position] [int]); MERGE [raw_data] USING ( VALUES (@p0, @p1, @p2, @p3, @p4, @p5, @p6, @p7, @p8, @p9, @p10, @p11, @p12, @p13, @p14, @p15, @p16, @p17, @p18, @p19, @p20, @p21, @p22, @p23, @p24, @p25, @p26, @p27, @p28, @p29, @p30, @p31, @p32, @p33, @p34, @p35, @p36, @p37, @p38, @p39, @p40, @p41, @p42, @p43, @p44, @p45, @p46, @p47, @p48, @p49, @p50, @p51, @p52, @p53, @p54, @p55, 0), (@p56, @p57, @p58, @p59, @p60, @p61, @p62, @p63, @p64, @p65, @p66, @p67, @p68, @p69, @p70, @p71, @p72, @p73, @p74, @p75, @p76, @p77, @p78, @p79, @p80, @p81, @p82, @p83, @p84, @p85, @p86, @p87, @p88, @p89, @p90, @p91, @p92, @p93, @p94, @p95, @p96, @p97, @p98, @p99, @p100, @p101, @p102, @p103, @p104, @p105, @p106, @p107, @p108, @p109, @p110, @p111, 1), (@p112, @p113, @p114, @p115, @p116, @p117, @p118, @p119, @p120, @p121, @p122, @p123, @p124, @p125, @p126, @p127, @p128, @p129, @p130, @p131, @p132, @p133, @p134, @p135, @p136, @p137, @p138, @p139, @p140, @p141, @p142, @p143, @p144, @p145, @p146, @p147, @p148, @p149, @p150, @p151, @p152, @p153, @p154, @p155, @p156, @p157, @p158, @p159, @p160, @p161, @p162, @p163, @p164, @p165, @p166, @p167, 2), (@p168, @p169, @p170, @p171, @p172, @p173, @p174, @p175, @p176, @p177, @p178, @p179, @p180, @p181, @p182, @p183, @p184, @p185, @p186, @p187, @p188, @p189, @p190, @p191, @p192, @p193, @p194, @p195, @p196, @p197, @p198, @p199, @p200, @p201, @p202, @p203, @p204, @p205, @p206, @p207, @p208, @p209, @p210, @p211, @p212, @p213, @p214, @p215, @p216, @p217, @p218, @p219, @p220, @p221, @p222, @p223, 3), (@p224, @p225, @p226, @p227, @p228, @p229, @p230, @p231, @p232, @p233, @p234, @p235, @p236, @p237, @p238, @p239, @p240, @p241, @p242, @p243, @p244, @p245, @p246, @p247, @p248, @p249, @p250, @p251, @p252, @p253, @p254, @p255, @p256, @p257, @p258, @p259, @p260, @p261, @p262, @p263, @p264, @p265, @p266, @p267, @p268, @p269, @p270, @p271, @p272, @p273, @p274, @p275, @p276, @p277, @p278, @p279, 4), (@p280, @p281, @p282, @p283, @p284, @p285, @p286, @p287, @p288, @p289, @p290, @p291, @p292, @p293, @p294, @p295, @p296, @p297, @p298, @p299, @p300, @p301, @p302, @p303, @p304, @p305, @p306, @p307, @p308, @p309, @p310, @p311, @p312, @p313, @p314, @p315, @p316, @p317, @p318, @p319, @p320, @p321, @p322, @p323, @p324, @p325, @p326, @p327, @p328, @p329, @p330, @p331, @p332, @p333, @p334, @p335, 5), (@p336, @p337, @p338, @p339, @p340, @p341, @p342, @p343, @p344, @p345, @p346, @p347, @p348, @p349, @p350, @p351, @p352, @p353, @p354, @p355, @p356, @p357, @p358, @p359, @p360, @p361, @p362, @p363, @p364, @p365, @p366, @p367, @p368, @p369, @p370, @p371, @p372, @p373, @p374, @p375, @p376, @p377, @p378, @p379, @p380, @p381, @p382, @p383, @p384, @p385, @p386, @p387, @p388, @p389, @p390, @p391, 6), (@p392, @p393, @p394, @p395, @p396, @p397, @p398, @p399, @p400, @p401, @p402, @p403, @p404, @p405, @p406, @p407, @p408, @p409, @p410, @p411, @p412, @p413, @p414, @p415, @p416, @p417, @p418, @p419, @p420, @p421, @p422, @p423, @p424, @p425, @p426, @p427, @p428, @p429, @p430, @p431, @p432, @p433, @p434, @p435, @p436, @p437, @p438, @p439, @p440, @p441, @p442, @p443, @p444, @p445, @p446, @p447, 7), (@p448, @p449, @p450, @p451, @p452, @p453, @p454, @p455, @p456, @p457, @p458, @p459, @p460, @p461, @p462, @p463, @p464, @p465, @p466, @p467, @p468, @p469, @p470, @p471, @p472, @p473, @p474, @p475, @p476, @p477, @p478, @p479, @p480, @p481, @p482, @p483, @p484, @p485, @p486, @p487, @p488, @p489, @p490, @p491, @p492, @p493, @p494, @p495, @p496, @p497, @p498, @p499, @p500, @p501, @p502, @p503, 8), (@p504, @p505, @p506, @p507, @p508, @p509, @p510, @p511, @p512, @p513, @p514, @p515, @p516, @p517, @p518, @p519, @p520, @p521, @p522, @p523, @p524, @p525, @p526, @p527, @p528, @p529, @p530, @p531, @p532, @p533, @p534, @p535, @p536, @p537, @p538, @p539, @p540, @p541, @p542, @p543, @p544, @p545, @p546, @p547, @p548, @p549, @p550, @p551, @p552, @p553, @p554, @p555, @p556, @p557, @p558, @p559, 9), (@p560, @p561, @p562, @p563, @p564, @p565, @p566, @p567, @p568, @p569, @p570, @p571, @p572, @p573, @p574, @p575, @p576, @p577, @p578, @p579, @p580, @p581, @p582, @p583, @p584, @p585, @p586, @p587, @p588, @p589, @p590, @p591, @p592, @p593, @p594, @p595, @p596, @p597, @p598, @p599, @p600, @p601, @p602, @p603, @p604, @p605, @p606, @p607, @p608, @p609, @p610, @p611, @p612, @p613, @p614, @p615, 10), (@p616, @p617, @p618, @p619, @p620, @p621, @p622, @p623, @p624, @p625, @p626, @p627, @p628, @p629, @p630, @p631, @p632, @p633, @p634, @p635, @p636, @p637, @p638, @p639, @p640, @p641, @p642, @p643, @p644, @p645, @p646, @p647, @p648, @p649, @p650, @p651, @p652, @p653, @p654, @p655, @p656, @p657, @p658, @p659, @p660, @p661, @p662, @p663, @p664, @p665, @p666, @p667, @p668, @p669, @p670, @p671, 11), (@p672, @p673, @p674, @p675, @p676, @p677, @p678, @p679, @p680, @p681, @p682, @p683, @p684, @p685, @p686, @p687, @p688, @p689, @p690, @p691, @p692, @p693, @p694, @p695, @p696, @p697, @p698, @p699, @p700, @p701, @p702, @p703, @p704, @p705, @p706, @p707, @p708, @p709, @p710, @p711, @p712, @p713, @p714, @p715, @p716, @p717, @p718, @p719, @p720, @p721, @p722, @p723, @p724, @p725, @p726, @p727, 12), (@p728, @p729, @p730, @p731, @p732, @p733, @p734, @p735, @p736, @p737, @p738, @p739, @p740, @p741, @p742, @p743, @p744, @p745, @p746, @p747, @p748, @p749, @p750, @p751, @p752, @p753, @p754, @p755, @p756, @p757, @p758, @p759, @p760, @p761, @p762, @p763, @p764, @p765, @p766, @p767, @p768, @p769, @p770, @p771, @p772, @p773, @p774, @p775, @p776, @p777, @p778, @p779, @p780, @p781, @p782, @p783, 13), (@p784, @p785, @p786, @p787, @p788, @p789, @p790, @p791, @p792, @p793, @p794, @p795, @p796, @p797, @p798, @p799, @p800, @p801, @p802, @p803, @p804, @p805, @p806, @p807, @p808, @p809, @p810, @p811, @p812, @p813, @p814, @p815, @p816, @p817, @p818, @p819, @p820, @p821, @p822, @p823, @p824, @p825, @p826, @p827, @p828, @p829, @p830, @p831, @p832, @p833, @p834, @p835, @p836, @p837, @p838, @p839, 14), (@p840, @p841, @p842, @p843, @p844, @p845, @p846, @p847, @p848, @p849, @p850, @p851, @p852, @p853, @p854, @p855, @p856, @p857, @p858, @p859, @p860, @p861, @p862, @p863, @p864, @p865, @p866, @p867, @p868, @p869, @p870, @p871, @p872, @p873, @p874, @p875, @p876, @p877, @p878, @p879, @p880, @p881, @p882, @p883, @p884, @p885, @p886, @p887, @p888, @p889, @p890, @p891, @p892, @p893, @p894, @p895, 15), (@p896, @p897, @p898, @p899, @p900, @p901, @p902, @p903, @p904, @p905, @p906, @p907, @p908, @p909, @p910, @p911, @p912, @p913, @p914, @p915, @p916, @p917, @p918, @p919, @p920, @p921, @p922, @p923, @p924, @p925, @p926, @p927, @p928, @p929, @p930, @p931, @p932, @p933, @p934, @p935, @p936, @p937, @p938, @p939, @p940, @p941, @p942, @p943, @p944, @p945, @p946, @p947, @p948, @p949, @p950, @p951, 16), (@p952, @p953, @p954, @p955, @p956, @p957, @p958, @p959, @p960, @p961, @p962, @p963, @p964, @p965, @p966, @p967, @p968, @p969, @p970, @p971, @p972, @p973, @p974, @p975, @p976, @p977, @p978, @p979, @p980, @p981, @p982, @p983, @p984, @p985, @p986, @p987, @p988, @p989, @p990, @p991, @p992, @p993, @p994, @p995, @p996, @p997, @p998, @p999, @p1000, @p1001, @p1002, @p1003, @p1004, @p1005, @p1006, @p1007, 17), (@p1008, @p1009, @p1010, @p1011, @p1012, @p1013, @p1014, @p1015, @p1016, @p1017, @p1018, @p1019, @p1020, @p1021, @p1022, @p1023, @p1024, @p1025, @p1026, @p1027, @p1028, @p1029, @p1030, @p1031, @p1032, @p1033, @p1034, @p1035, @p1036, @p1037, @p1038, @p1039, @p1040, @p1041, @p1042, @p1043, @p1044, @p1045, @p1046, @p1047, @p1048, @p1049, @p1050, @p1051, @p1052, @p1053, @p1054, @p1055, @p1056, @p1057, @p1058, @p1059, @p1060, @p1061, @p1062, @p1063, 18), (@p1064, @p1065, @p1066, @p1067, @p1068, @p1069, @p1070, @p1071, @p1072, @p1073, @p1074, @p1075, @p1076, @p1077, @p1078, @p1079, @p1080, @p1081, @p1082, @p1083, @p1084, @p1085, @p1086, @p1087, @p1088, @p1089, @p1090, @p1091, @p1092, @p1093, @p1094, @p1095, @p1096, @p1097, @p1098, @p1099, @p1100, @p1101, @p1102, @p1103, @p1104, @p1105, @p1106, @p1107, @p1108, @p1109, @p1110, @p1111, @p1112, @p1113, @p1114, @p1115, @p1116, @p1117, @p1118, @p1119, 19), (@p1120, @p1121, @p1122, @p1123, @p1124, @p1125, @p1126, @p1127, @p1128, @p1129, @p1130, @p1131, @p1132, @p1133, @p1134, @p1135, @p1136, @p1137, @p1138, @p1139, @p1140, @p1141, @p1142, @p1143, @p1144, @p1145, @p1146, @p1147, @p1148, @p1149, @p1150, @p1151, @p1152, @p1153, @p1154, @p1155, @p1156, @p1157, @p1158, @p1159, @p1160, @p1161, @p1162, @p1163, @p1164, @p1165, @p1166, @p1167, @p1168, @p1169, @p1170, @p1171, @p1172, @p1173, @p1174, @p1175, 20), (@p1176, @p1177, @p1178, @p1179, @p1180, @p1181, @p1182, @p1183, @p1184, @p1185, @p1186, @p1187, @p1188, @p1189, @p1190, @p1191, @p1192, @p1193, @p1194, @p1195, @p1196, @p1197, @p1198, @p1199, @p1200, @p1201, @p1202, @p1203, @p1204, @p1205, @p1206, @p1207, @p1208, @p1209, @p1210, @p1211, @p1212, @p1213, @p1214, @p1215, @p1216, @p1217, @p1218, @p1219, @p1220, @p1221, @p1222, @p1223, @p1224, @p1225, @p1226, @p1227, @p1228, @p1229, @p1230, @p1231, 21), (@p1232, @p1233, @p1234, @p1235, @p1236, @p1237, @p1238, @p1239, @p1240, @p1241, @p1242, @p1243, @p1244, @p1245, @p1246, @p1247, @p1248, @p1249, @p1250, @p1251, @p1252, @p1253, @p1254, @p1255, @p1256, @p1257, @p1258, @p1259, @p1260, @p1261, @p1262, @p1263, @p1264, @p1265, @p1266, @p1267, @p1268, @p1269, @p1270, @p1271, @p1272, @p1273, @p1274, @p1275, @p1276, @p1277, @p1278, @p1279, @p1280, @p1281, @p1282, @p1283, @p1284, @p1285, @p1286, @p1287, 22), (@p1288, @p1289, @p1290, @p1291, @p1292, @p1293, @p1294, @p1295, @p1296, @p1297, @p1298, @p1299, @p1300, @p1301, @p1302, @p1303, @p1304, @p1305, @p1306, @p1307, @p1308, @p1309, @p1310, @p1311, @p1312, @p1313, @p1314, @p1315, @p1316, @p1317, @p1318, @p1319, @p1320, @p1321, @p1322, @p1323, @p1324, @p1325, @p1326, @p1327, @p1328, @p1329, @p1330, @p1331, @p1332, @p1333, @p1334, @p1335, @p1336, @p1337, @p1338, @p1339, @p1340, @p1341, @p1342, @p1343, 23), (@p1344, @p1345, @p1346, @p1347, @p1348, @p1349, @p1350, @p1351, @p1352, @p1353, @p1354, @p1355, @p1356, @p1357, @p1358, @p1359, @p1360, @p1361, @p1362, @p1363, @p1364, @p1365, @p1366, @p1367, @p1368, @p1369, @p1370, @p1371, @p1372, @p1373, @p1374, @p1375, @p1376, @p1377, @p1378, @p1379, @p1380, @p1381, @p1382, @p1383, @p1384, @p1385, @p1386, @p1387, @p1388, @p1389, @p1390, @p1391, @p1392, @p1393, @p1394, @p1395, @p1396, @p1397, @p1398, @p1399, 24), (@p1400, @p1401, @p1402, @p1403, @p1404, @p1405, @p1406, @p1407, @p1408, @p1409, @p1410, @p1411, @p1412, @p1413, @p1414, @p1415, @p1416, @p1417, @p1418, @p1419, @p1420, @p1421, @p1422, @p1423, @p1424, @p1425, @p1426, @p1427, @p1428, @p1429, @p1430, @p1431, @p1432, @p1433, @p1434, @p1435, @p1436, @p1437, @p1438, @p1439, @p1440, @p1441, @p1442, @p1443, @p1444, @p1445, @p1446, @p1447, @p1448, @p1449, @p1450, @p1451, @p1452, @p1453, @p1454, @p1455, 25), (@p1456, @p1457, @p1458, @p1459, @p1460, @p1461, @p1462, @p1463, @p1464, @p1465, @p1466, @p1467, @p1468, @p1469, @p1470, @p1471, @p1472, @p1473, @p1474, @p1475, @p1476, @p1477, @p1478, @p1479, @p1480, @p1481, @p1482, @p1483, @p1484, @p1485, @p1486, @p1487, @p1488, @p1489, @p1490, @p1491, @p1492, @p1493, @p1494, @p1495, @p1496, @p1497, @p1498, @p1499, @p1500, @p1501, @p1502, @p1503, @p1504, @p1505, @p1506, @p1507, @p1508, @p1509, @p1510, @p1511, 26), (@p1512, @p1513, @p1514, @p1515, @p1516, @p1517, @p1518, @p1519, @p1520, @p1521, @p1522, @p1523, @p1524, @p1525, @p1526, @p1527, @p1528, @p1529, @p1530, @p1531, @p1532, @p1533, @p1534, @p1535, @p1536, @p1537, @p1538, @p1539, @p1540, @p1541, @p1542, @p1543, @p1544, @p1545, @p1546, @p1547, @p1548, @p1549, @p1550, @p1551, @p1552, @p1553, @p1554, @p1555, @p1556, @p1557, @p1558, @p1559, @p1560, @p1561, @p1562, @p1563, @p1564, @p1565, @p1566, @p1567, 27), (@p1568, @p1569, @p1570, @p1571, @p1572, @p1573, @p1574, @p1575, @p1576, @p1577, @p1578, @p1579, @p1580, @p1581, @p1582, @p1583, @p1584, @p1585, @p1586, @p1587, @p1588, @p1589, @p1590, @p1591, @p1592, @p1593, @p1594, @p1595, @p1596, @p1597, @p1598, @p1599, @p1600, @p1601, @p1602, @p1603, @p1604, @p1605, @p1606, @p1607, @p1608, @p1609, @p1610, @p1611, @p1612, @p1613, @p1614, @p1615, @p1616, @p1617, @p1618, @p1619, @p1620, @p1621, @p1622, @p1623, 28), (@p1624, @p1625, @p1626, @p1627, @p1628, @p1629, @p1630, @p1631, @p1632, @p1633, @p1634, @p1635, @p1636, @p1637, @p1638, @p1639, @p1640, @p1641, @p1642, @p1643, @p1644, @p1645, @p1646, @p1647, @p1648, @p1649, @p1650, @p1651, @p1652, @p1653, @p1654, @p1655, @p1656, @p1657, @p1658, @p1659, @p1660, @p1661, @p1662, @p1663, @p1664, @p1665, @p1666, @p1667, @p1668, @p1669, @p1670, @p1671, @p1672, @p1673, @p1674, @p1675, @p1676, @p1677, @p1678, @p1679, 29), (@p1680, @p1681, @p1682, @p1683, @p1684, @p1685, @p1686, @p1687, @p1688, @p1689, @p1690, @p1691, @p1692, @p1693, @p1694, @p1695, @p1696, @p1697, @p1698, @p1699, @p1700, @p1701, @p1702, @p1703, @p1704, @p1705, @p1706, @p1707, @p1708, @p1709, @p1710, @p1711, @p1712, @p1713, @p1714, @p1715, @p1716, @p1717, @p1718, @p1719, @p1720, @p1721, @p1722, @p1723, @p1724, @p1725, @p1726, @p1727, @p1728, @p1729, @p1730, @p1731, @p1732, @p1733, @p1734, @p1735, 30), (@p1736, @p1737, @p1738, @p1739, @p1740, @p1741, @p1742, @p1743, @p1744, @p1745, @p1746, @p1747, @p1748, @p1749, @p1750, @p1751, @p1752, @p1753, @p1754, @p1755, @p1756, @p1757, @p1758, @p1759, @p1760, @p1761, @p1762, @p1763, @p1764, @p1765, @p1766, @p1767, @p1768, @p1769, @p1770, @p1771, @p1772, @p1773, @p1774, @p1775, @p1776, @p1777, @p1778, @p1779, @p1780, @p1781, @p1782, @p1783, @p1784, @p1785, @p1786, @p1787, @p1788, @p1789, @p1790, @p1791, 31)) AS i ([addressee_cntry_cd], [addressee_city], [addressee_district], [addressee_email], [addressee_full_address], [addressee_home_address], [addressee_name], [addressee_postcode], [addressee_province], [addressee_subdistrict], [addressee_tel], [create_table], [delivery_code], [delivery_recipient_name], [delivery_relation_id], [delivery_status_id], [dest_outlet_id], [dest_outlet_port], [document_number], [item_barcode], [item_cod], [item_gross_weight], [item_height], [item_length], [item_price], [item_width], [lat], [log_id], [long], [outlet_id], [outlet_port], [podUrl], [remark], [scan_cntry_cd], [scan_cntry_postcode], [sender_cntry_cd], [sender_district], [sender_email], [sender_full_address], [sender_home_address], [member_id], [sender_name], [sender_postcode], [sender_province], [sender_subdistrict], [sender_tel], [server_id], [signatureUrl], [state], [status_code], [status_dtm], [timestamp], [transmit_dtm], [user_id], [wckt_id], [wkstn_no], _Position) ON 1=0 WHEN NOT MATCHED THEN INSERT ([addressee_cntry_cd], [addressee_city], [addressee_district], [addressee_email], [addressee_full_address], [addressee_home_address], [addressee_name], [addressee_postcode], [addressee_province], [addressee_subdistrict], [addressee_tel], [create_table], [delivery_code], [delivery_recipient_name], [delivery_relation_id], [delivery_status_id], [dest_outlet_id], [dest_outlet_port], [document_number], [item_barcode], [item_cod], [item_gross_weight], [item_height], [item_length], [item_price], [item_width], [lat], [log_id], [long], [outlet_id], [outlet_port], [podUrl], [remark], [scan_cntry_cd], [scan_cntry_postcode], [sender_cntry_cd], [sender_district], [sender_email], [sender_full_address], [sender_home_address], [member_id], [sender_name], [sender_postcode], [sender_province], [sender_subdistrict], [sender_tel], [server_id], [signatureUrl], [state], [status_code], [status_dtm], [timestamp], [transmit_dtm], [user_id], [wckt_id], [wkstn_no]) VALUES (i.[addressee_cntry_cd], i.[addressee_city], i.[addressee_district], i.[addressee_email], i.[addressee_full_address], i.[addressee_home_address], i.[addressee_name], i.[addressee_postcode], i.[addressee_province], i.[addressee_subdistrict], i.[addressee_tel], i.[create_table], i.[delivery_code], i.[delivery_recipient_name], i.[delivery_relation_id], i.[delivery_status_id], i.[dest_outlet_id], i.[dest_outlet_port], i.[document_number], i.[item_barcode], i.[item_cod], i.[item_gross_weight], i.[item_height], i.[item_length], i.[item_price], i.[item_width], i.[lat], i.[log_id], i.[long], i.[outlet_id], i.[outlet_port], i.[podUrl], i.[remark], i.[scan_cntry_cd], i.[scan_cntry_postcode], i.[sender_cntry_cd], i.[sender_district], i.[sender_email], i.[sender_full_address], i.[sender_home_address], i.[member_id], i.[sender_name], i.[sender_postcode], i.[sender_province], i.[sender_subdistrict], i.[sender_tel], i.[server_id], i.[signatureUrl], i.[state], i.[status_code], i.[status_dtm], i.[timestamp], i.[transmit_dtm], i.[user_id], i.[wckt_id], i.[wkstn_no]) OUTPUT INSERTED.[item_id], i._Position INTO @inserted0;  SELECT [t].[item_id] FROM [raw_data] t INNER JOIN @inserted0 i ON ([t].[item_id] = [i].[item_id]) ORDER BY [i].[_Position];  ",5,2,3,336,11,1200
"(@p0 nvarchar(4000),@p1 nvarchar(4000),@p2 nvarchar(4000),@p3 nvarchar(4000),@p4 nvarchar(4000),@p5 nvarchar(4000),@p6 nvarchar(4000),@p7 nvarchar(4000),@p8 nvarchar(4000),@p9 nvarchar(4000),@p10 nvarchar(4000),@p11 datetime2(7),@p12 nvarchar(4000),@p13 nvarchar(4000),@p14 int,@p15 int,@p16 int,@p17 nvarchar(4000),@p18 nvarchar(4000),@p19 nvarchar(4000),@p20 nvarchar(4000),@p21 decimal(18,2),@p22 nvarchar(4000),@p23 nvarchar(4000),@p24 decimal(18,2),@p25 nvarchar(4000),@p26 nvarchar(4000),@p27 nvarchar(4000),@p28 nvarchar(4000),@p29 int,@p30 nvarchar(4000),@p31 nvarchar(4000),@p32 nvarchar(4000),@p33 nvarchar(4000),@p34 nvarchar(4000),@p35 nvarchar(4000),@p36 nvarchar(4000),@p37 nvarchar(4000),@p38 nvarchar(4000),@p39 nvarchar(4000),@p40 int,@p41 nvarchar(4000),@p42 nvarchar(4000),@p43 nvarchar(4000),@p44 nvarchar(4000),@p45 nvarchar(4000),@p46 int,@p47 nvarchar(4000),@p48 int,@p49 int,@p50 datetime2(7),@p51 datetime2(7),@p52 datetime2(7),@p53 nvarchar(4000),@p54 nvarchar(4000),@p55 nvarchar(4000),@p56 nvarchar(4000),@p57 nvarchar(4000),@p58 nvarchar(4000),@p59 nvarchar(4000),@p60 nvarchar(4000),@p61 nvarchar(4000),@p62 nvarchar(4000),@p63 nvarchar(4000),@p64 nvarchar(4000),@p65 nvarchar(4000),@p66 nvarchar(4000),@p67 datetime2(7),@p68 nvarchar(4000),@p69 nvarchar(4000),@p70 int,@p71 int,@p72 int,@p73 nvarchar(4000),@p74 nvarchar(4000),@p75 nvarchar(4000),@p76 nvarchar(4000),@p77 decimal(18,2),@p78 nvarchar(4000),@p79 nvarchar(4000),@p80 decimal(18,2),@p81 nvarchar(4000),@p82 nvarchar(4000),@p83 nvarchar(4000),@p84 nvarchar(4000),@p85 int,@p86 nvarchar(4000),@p87 nvarchar(4000),@p88 nvarchar(4000),@p89 nvarchar(4000),@p90 nvarchar(4000),@p91 nvarchar(4000),@p92 nvarchar(4000),@p93 nvarchar(4000),@p94 nvarchar(4000),@p95 nvarchar(4000),@p96 int,@p97 nvarchar(4000),@p98 nvarchar(4000),@p99 nvarchar(4000),@p100 nvarchar(4000),@p101 nvarchar(4000),@p102 int,@p103 nvarchar(4000),@p104 int,@p105 int,@p106 datetime2(7),@p107 datetime2(7),@p108 datetime2(7),@p109 nvarchar(4000),@p110 nvarchar(4000),@p111 nvarchar(4000),@p112 nvarchar(4000),@p113 nvarchar(4000),@p114 nvarchar(4000),@p115 nvarchar(4000),@p116 nvarchar(4000),@p117 nvarchar(4000),@p118 nvarchar(4000),@p119 nvarchar(4000),@p120 nvarchar(4000),@p121 nvarchar(4000),@p122 nvarchar(4000),@p123 datetime2(7),@p124 nvarchar(4000),@p125 nvarchar(4000),@p126 int,@p127 int,@p128 int,@p129 nvarchar(4000),@p130 nvarchar(4000),@p131 nvarchar(4000),@p132 nvarchar(4000),@p133 decimal(18,2),@p134 nvarchar(4000),@p135 nvarchar(4000),@p136 decimal(18,2),@p137 nvarchar(4000),@p138 nvarchar(4000),@p139 nvarchar(4000),@p140 nvarchar(4000),@p141 int,@p142 nvarchar(4000),@p143 nvarchar(4000),@p144 nvarchar(4000),@p145 nvarchar(4000),@p146 nvarchar(4000),@p147 nvarchar(4000),@p148 nvarchar(4000),@p149 nvarchar(4000),@p150 nvarchar(4000),@p151 nvarchar(4000),@p152 int,@p153 nvarchar(4000),@p154 nvarchar(4000),@p155 nvarchar(4000),@p156 nvarchar(4000),@p157 nvarchar(4000),@p158 int,@p159 nvarchar(4000),@p160 int,@p161 int,@p162 datetime2(7),@p163 datetime2(7),@p164 datetime2(7),@p165 nvarchar(4000),@p166 nvarchar(4000),@p167 nvarchar(4000),@p168 nvarchar(4000),@p169 nvarchar(4000),@p170 nvarchar(4000),@p171 nvarchar(4000),@p172 nvarchar(4000),@p173 nvarchar(4000),@p174 nvarchar(4000),@p175 nvarchar(4000),@p176 nvarchar(4000),@p177 nvarchar(4000),@p178 nvarchar(4000),@p179 datetime2(7),@p180 nvarchar(4000),@p181 nvarchar(4000),@p182 int,@p183 int,@p184 int,@p185 nvarchar(4000),@p186 nvarchar(4000),@p187 nvarchar(4000),@p188 nvarchar(4000),@p189 decimal(18,2),@p190 nvarchar(4000),@p191 nvarchar(4000),@p192 decimal(18,2),@p193 nvarchar(4000),@p194 nvarchar(4000),@p195 nvarchar(4000),@p196 nvarchar(4000),@p197 int,@p198 nvarchar(4000),@p199 nvarchar(4000),@p200 nvarchar(4000),@p201 nvarchar(4000),@p202 nvarchar(4000),@p203 nvarchar(4000),@p204 nvarchar(4000),@p205 nvarchar(4000),@p206 nvarchar(4000),@p207 nvarchar(4000),@p208 int,@p209 nvarchar(4000),@p210 nvarchar(4000),@p211 nvarchar(4000),@p212 nvarchar(4000),@p213 nvarchar(4000),@p214 int,@p215 nvarchar(4000),@p216 int,@p217 int,@p218 datetime2(7),@p219 datetime2(7),@p220 datetime2(7),@p221 nvarchar(4000),@p222 nvarchar(4000),@p223 nvarchar(4000),@p224 nvarchar(4000),@p225 nvarchar(4000),@p226 nvarchar(4000),@p227 nvarchar(4000),@p228 nvarchar(4000),@p229 nvarchar(4000),@p230 nvarchar(4000),@p231 nvarchar(4000),@p232 nvarchar(4000),@p233 nvarchar(4000),@p234 nvarchar(4000),@p235 datetime2(7),@p236 nvarchar(4000),@p237 nvarchar(4000),@p238 int,@p239 int,@p240 int,@p241 nvarchar(4000),@p242 nvarchar(4000),@p243 nvarchar(4000),@p244 nvarchar(4000),@p245 decimal(18,2),@p246 nvarchar(4000),@p247 nvarchar(4000),@p248 decimal(18,2),@p249 nvarchar(4000),@p250 nvarchar(4000),@p251 nvarchar(4000),@p252 nvarchar(4000),@p253 int,@p254 nvarchar(4000),@p255 nvarchar(4000),@p256 nvarchar(4000),@p257 nvarchar(4000),@p258 nvarchar(4000),@p259 nvarchar(4000),@p260 nvarchar(4000),@p261 nvarchar(4000),@p262 nvarchar(4000),@p263 nvarchar(4000),@p264 int,@p265 nvarchar(4000),@p266 nvarchar(4000),@p267 nvarchar(4000),@p268 nvarchar(4000),@p269 nvarchar(4000),@p270 int,@p271 nvarchar(4000),@p272 int,@p273 int,@p274 datetime2(7),@p275 datetime2(7),@p276 datetime2(7),@p277 nvarchar(4000),@p278 nvarchar(4000),@p279 nvarchar(4000),@p280 nvarchar(4000),@p281 nvarchar(4000),@p282 nvarchar(4000),@p283 nvarchar(4000),@p284 nvarchar(4000),@p285 nvarchar(4000),@p286 nvarchar(4000),@p287 nvarchar(4000),@p288 nvarchar(4000),@p289 nvarchar(4000),@p290 nvarchar(4000),@p291 datetime2(7),@p292 nvarchar(4000),@p293 nvarchar(4000),@p294 int,@p295 int,@p296 int,@p297 nvarchar(4000),@p298 nvarchar(4000),@p299 nvarchar(4000),@p300 nvarchar(4000),@p301 decimal(18,2),@p302 nvarchar(4000),@p303 nvarchar(4000),@p304 decimal(18,2),@p305 nvarchar(4000),@p306 nvarchar(4000),@p307 nvarchar(4000),@p308 nvarchar(4000),@p309 int,@p310 nvarchar(4000),@p311 nvarchar(4000),@p312 nvarchar(4000),@p313 nvarchar(4000),@p314 nvarchar(4000),@p315 nvarchar(4000),@p316 nvarchar(4000),@p317 nvarchar(4000),@p318 nvarchar(4000),@p319 nvarchar(4000),@p320 int,@p321 nvarchar(4000),@p322 nvarchar(4000),@p323 nvarchar(4000),@p324 nvarchar(4000),@p325 nvarchar(4000),@p326 int,@p327 nvarchar(4000),@p328 int,@p329 int,@p330 datetime2(7),@p331 datetime2(7),@p332 datetime2(7),@p333 nvarchar(4000),@p334 nvarchar(4000),@p335 nvarchar(4000),@p336 nvarchar(4000),@p337 nvarchar(4000),@p338 nvarchar(4000),@p339 nvarchar(4000),@p340 nvarchar(4000),@p341 nvarchar(4000),@p342 nvarchar(4000),@p343 nvarchar(4000),@p344 nvarchar(4000),@p345 nvarchar(4000),@p346 nvarchar(4000),@p347 datetime2(7),@p348 nvarchar(4000),@p349 nvarchar(4000),@p350 int,@p351 int,@p352 int,@p353 nvarchar(4000),@p354 nvarchar(4000),@p355 nvarchar(4000),@p356 nvarchar(4000),@p357 decimal(18,2),@p358 nvarchar(4000),@p359 nvarchar(4000),@p360 decimal(18,2),@p361 nvarchar(4000),@p362 nvarchar(4000),@p363 nvarchar(4000),@p364 nvarchar(4000),@p365 int,@p366 nvarchar(4000),@p367 nvarchar(4000),@p368 nvarchar(4000),@p369 nvarchar(4000),@p370 nvarchar(4000),@p371 nvarchar(4000),@p372 nvarchar(4000),@p373 nvarchar(4000),@p374 nvarchar(4000),@p375 nvarchar(4000),@p376 int,@p377 nvarchar(4000),@p378 nvarchar(4000),@p379 nvarchar(4000),@p380 nvarchar(4000),@p381 nvarchar(4000),@p382 int,@p383 nvarchar(4000),@p384 int,@p385 int,@p386 datetime2(7),@p387 datetime2(7),@p388 datetime2(7),@p389 nvarchar(4000),@p390 nvarchar(4000),@p391 nvarchar(4000),@p392 nvarchar(4000),@p393 nvarchar(4000),@p394 nvarchar(4000),@p395 nvarchar(4000),@p396 nvarchar(4000),@p397 nvarchar(4000),@p398 nvarchar(4000),@p399 nvarchar(4000),@p400 nvarchar(4000),@p401 nvarchar(4000),@p402 nvarchar(4000),@p403 datetime2(7),@p404 nvarchar(4000),@p405 nvarchar(4000),@p406 int,@p407 int,@p408 int,@p409 nvarchar(4000),@p410 nvarchar(4000),@p411 nvarchar(4000),@p412 nvarchar(4000),@p413 decimal(18,2),@p414 nvarchar(4000),@p415 nvarchar(4000),@p416 decimal(18,2),@p417 nvarchar(4000),@p418 nvarchar(4000),@p419 nvarchar(4000),@p420 nvarchar(4000),@p421 int,@p422 nvarchar(4000),@p423 nvarchar(4000),@p424 nvarchar(4000),@p425 nvarchar(4000),@p426 nvarchar(4000),@p427 nvarchar(4000),@p428 nvarchar(4000),@p429 nvarchar(4000),@p430 nvarchar(4000),@p431 nvarchar(4000),@p432 int,@p433 nvarchar(4000),@p434 nvarchar(4000),@p435 nvarchar(4000),@p436 nvarchar(4000),@p437 nvarchar(4000),@p438 int,@p439 nvarchar(4000),@p440 int,@p441 int,@p442 datetime2(7),@p443 datetime2(7),@p444 datetime2(7),@p445 nvarchar(4000),@p446 nvarchar(4000),@p447 nvarchar(4000),@p448 nvarchar(4000),@p449 nvarchar(4000),@p450 nvarchar(4000),@p451 nvarchar(4000),@p452 nvarchar(4000),@p453 nvarchar(4000),@p454 nvarchar(4000),@p455 nvarchar(4000),@p456 nvarchar(4000),@p457 nvarchar(4000),@p458 nvarchar(4000),@p459 datetime2(7),@p460 nvarchar(4000),@p461 nvarchar(4000),@p462 int,@p463 int,@p464 int,@p465 nvarchar(4000),@p466 nvarchar(4000),@p467 nvarchar(4000),@p468 nvarchar(4000),@p469 decimal(18,2),@p470 nvarchar(4000),@p471 nvarchar(4000),@p472 decimal(18,2),@p473 nvarchar(4000),@p474 nvarchar(4000),@p475 nvarchar(4000),@p476 nvarchar(4000),@p477 int,@p478 nvarchar(4000),@p479 nvarchar(4000),@p480 nvarchar(4000),@p481 nvarchar(4000),@p482 nvarchar(4000),@p483 nvarchar(4000),@p484 nvarchar(4000),@p485 nvarchar(4000),@p486 nvarchar(4000),@p487 nvarchar(4000),@p488 int,@p489 nvarchar(4000),@p490 nvarchar(4000),@p491 nvarchar(4000),@p492 nvarchar(4000),@p493 nvarchar(4000),@p494 int,@p495 nvarchar(4000),@p496 int,@p497 int,@p498 datetime2(7),@p499 datetime2(7),@p500 datetime2(7),@p501 nvarchar(4000),@p502 nvarchar(4000),@p503 nvarchar(4000),@p504 nvarchar(4000),@p505 nvarchar(4000),@p506 nvarchar(4000),@p507 nvarchar(4000),@p508 nvarchar(4000),@p509 nvarchar(4000),@p510 nvarchar(4000),@p511 nvarchar(4000),@p512 nvarchar(4000),@p513 nvarchar(4000),@p514 nvarchar(4000),@p515 datetime2(7),@p516 nvarchar(4000),@p517 nvarchar(4000),@p518 int,@p519 int,@p520 int,@p521 nvarchar(4000),@p522 nvarchar(4000),@p523 nvarchar(4000),@p524 nvarchar(4000),@p525 decimal(18,2),@p526 nvarchar(4000),@p527 nvarchar(4000),@p528 decimal(18,2),@p529 nvarchar(4000),@p530 nvarchar(4000),@p531 nvarchar(4000),@p532 nvarchar(4000),@p533 int,@p534 nvarchar(4000),@p535 nvarchar(4000),@p536 nvarchar(4000),@p537 nvarchar(4000),@p538 nvarchar(4000),@p539 nvarchar(4000),@p540 nvarchar(4000),@p541 nvarchar(4000),@p542 nvarchar(4000),@p543 nvarchar(4000),@p544 int,@p545 nvarchar(4000),@p546 nvarchar(4000),@p547 nvarchar(4000),@p548 nvarchar(4000),@p549 nvarchar(4000),@p550 int,@p551 nvarchar(4000),@p552 int,@p553 int,@p554 datetime2(7),@p555 datetime2(7),@p556 datetime2(7),@p557 nvarchar(4000),@p558 nvarchar(4000),@p559 nvarchar(4000),@p560 nvarchar(4000),@p561 nvarchar(4000),@p562 nvarchar(4000),@p563 nvarchar(4000),@p564 nvarchar(4000),@p565 nvarchar(4000),@p566 nvarchar(4000),@p567 nvarchar(4000),@p568 nvarchar(4000),@p569 nvarchar(4000),@p570 nvarchar(4000),@p571 datetime2(7),@p572 nvarchar(4000),@p573 nvarchar(4000),@p574 int,@p575 int,@p576 int,@p577 nvarchar(4000),@p578 nvarchar(4000),@p579 nvarchar(4000),@p580 nvarchar(4000),@p581 decimal(18,2),@p582 nvarchar(4000),@p583 nvarchar(4000),@p584 decimal(18,2),@p585 nvarchar(4000),@p586 nvarchar(4000),@p587 nvarchar(4000),@p588 nvarchar(4000),@p589 int,@p590 nvarchar(4000),@p591 nvarchar(4000),@p592 nvarchar(4000),@p593 nvarchar(4000),@p594 nvarchar(4000),@p595 nvarchar(4000),@p596 nvarchar(4000),@p597 nvarchar(4000),@p598 nvarchar(4000),@p599 nvarchar(4000),@p600 int,@p601 nvarchar(4000),@p602 nvarchar(4000),@p603 nvarchar(4000),@p604 nvarchar(4000),@p605 nvarchar(4000),@p606 int,@p607 nvarchar(4000),@p608 int,@p609 int,@p610 datetime2(7),@p611 datetime2(7),@p612 datetime2(7),@p613 nvarchar(4000),@p614 nvarchar(4000),@p615 nvarchar(4000),@p616 nvarchar(4000),@p617 nvarchar(4000),@p618 nvarchar(4000),@p619 nvarchar(4000),@p620 nvarchar(4000),@p621 nvarchar(4000),@p622 nvarchar(4000),@p623 nvarchar(4000),@p624 nvarchar(4000),@p625 nvarchar(4000),@p626 nvarchar(4000),@p627 datetime2(7),@p628 nvarchar(4000),@p629 nvarchar(4000),@p630 int,@p631 int,@p632 int,@p633 nvarchar(4000),@p634 nvarchar(4000),@p635 nvarchar(4000),@p636 nvarchar(4000),@p637 decimal(18,2),@p638 nvarchar(4000),@p639 nvarchar(4000),@p640 decimal(18,2),@p641 nvarchar(4000),@p642 nvarchar(4000),@p643 nvarchar(4000),@p644 nvarchar(4000),@p645 int,@p646 nvarchar(4000),@p647 nvarchar(4000),@p648 nvarchar(4000),@p649 nvarchar(4000),@p650 nvarchar(4000),@p651 nvarchar(4000),@p652 nvarchar(4000),@p653 nvarchar(4000),@p654 nvarchar(4000),@p655 nvarchar(4000),@p656 int,@p657 nvarchar(4000),@p658 nvarchar(4000),@p659 nvarchar(4000),@p660 nvarchar(4000),@p661 nvarchar(4000),@p662 int,@p663 nvarchar(4000),@p664 int,@p665 int,@p666 datetime2(7),@p667 datetime2(7),@p668 datetime2(7),@p669 nvarchar(4000),@p670 nvarchar(4000),@p671 nvarchar(4000),@p672 nvarchar(4000),@p673 nvarchar(4000),@p674 nvarchar(4000),@p675 nvarchar(4000),@p676 nvarchar(4000),@p677 nvarchar(4000),@p678 nvarchar(4000),@p679 nvarchar(4000),@p680 nvarchar(4000),@p681 nvarchar(4000),@p682 nvarchar(4000),@p683 datetime2(7),@p684 nvarchar(4000),@p685 nvarchar(4000),@p686 int,@p687 int,@p688 int,@p689 nvarchar(4000),@p690 nvarchar(4000),@p691 nvarchar(4000),@p692 nvarchar(4000),@p693 decimal(18,2),@p694 nvarchar(4000),@p695 nvarchar(4000),@p696 decimal(18,2),@p697 nvarchar(4000),@p698 nvarchar(4000),@p699 nvarchar(4000),@p700 nvarchar(4000),@p701 int,@p702 nvarchar(4000),@p703 nvarchar(4000),@p704 nvarchar(4000),@p705 nvarchar(4000),@p706 nvarchar(4000),@p707 nvarchar(4000),@p708 nvarchar(4000),@p709 nvarchar(4000),@p710 nvarchar(4000),@p711 nvarchar(4000),@p712 int,@p713 nvarchar(4000),@p714 nvarchar(4000),@p715 nvarchar(4000),@p716 nvarchar(4000),@p717 nvarchar(4000),@p718 int,@p719 nvarchar(4000),@p720 int,@p721 int,@p722 datetime2(7),@p723 datetime2(7),@p724 datetime2(7),@p725 nvarchar(4000),@p726 nvarchar(4000),@p727 nvarchar(4000),@p728 nvarchar(4000),@p729 nvarchar(4000),@p730 nvarchar(4000),@p731 nvarchar(4000),@p732 nvarchar(4000),@p733 nvarchar(4000),@p734 nvarchar(4000),@p735 nvarchar(4000),@p736 nvarchar(4000),@p737 nvarchar(4000),@p738 nvarchar(4000),@p739 datetime2(7),@p740 nvarchar(4000),@p741 nvarchar(4000),@p742 int,@p743 int,@p744 int,@p745 nvarchar(4000),@p746 nvarchar(4000),@p747 nvarchar(4000),@p748 decimal(18,2),@p749 decimal(18,2),@p750 nvarchar(4000),@p751 nvarchar(4000),@p752 decimal(18,2),@p753 nvarchar(4000),@p754 nvarchar(4000),@p755 nvarchar(4000),@p756 nvarchar(4000),@p757 int,@p758 nvarchar(4000),@p759 nvarchar(4000),@p760 nvarchar(4000),@p761 nvarchar(4000),@p762 nvarchar(4000),@p763 nvarchar(4000),@p764 nvarchar(4000),@p765 nvarchar(4000),@p766 nvarchar(4000),@p767 nvarchar(4000),@p768 int,@p769 nvarchar(4000),@p770 nvarchar(4000),@p771 nvarchar(4000),@p772 nvarchar(4000),@p773 nvarchar(4000),@p774 int,@p775 nvarchar(4000),@p776 int,@p777 int,@p778 datetime2(7),@p779 datetime2(7),@p780 datetime2(7),@p781 nvarchar(4000),@p782 nvarchar(4000),@p783 nvarchar(4000),@p784 nvarchar(4000),@p785 nvarchar(4000),@p786 nvarchar(4000),@p787 nvarchar(4000),@p788 nvarchar(4000),@p789 nvarchar(4000),@p790 nvarchar(4000),@p791 nvarchar(4000),@p792 nvarchar(4000),@p793 nvarchar(4000),@p794 nvarchar(4000),@p795 datetime2(7),@p796 nvarchar(4000),@p797 nvarchar(4000),@p798 int,@p799 int,@p800 int,@p801 nvarchar(4000),@p802 nvarchar(4000),@p803 nvarchar(4000),@p804 decimal(18,2),@p805 decimal(18,2),@p806 nvarchar(4000),@p807 nvarchar(4000),@p808 decimal(18,2),@p809 nvarchar(4000),@p810 nvarchar(4000),@p811 nvarchar(4000),@p812 nvarchar(4000),@p813 int,@p814 nvarchar(4000),@p815 nvarchar(4000),@p816 nvarchar(4000),@p817 nvarchar(4000),@p818 nvarchar(4000),@p819 nvarchar(4000),@p820 nvarchar(4000),@p821 nvarchar(4000),@p822 nvarchar(4000),@p823 nvarchar(4000),@p824 int,@p825 nvarchar(4000),@p826 nvarchar(4000),@p827 nvarchar(4000),@p828 nvarchar(4000),@p829 nvarchar(4000),@p830 int,@p831 nvarchar(4000),@p832 int,@p833 int,@p834 datetime2(7),@p835 datetime2(7),@p836 datetime2(7),@p837 nvarchar(4000),@p838 nvarchar(4000),@p839 nvarchar(4000),@p840 nvarchar(4000),@p841 nvarchar(4000),@p842 nvarchar(4000),@p843 nvarchar(4000),@p844 nvarchar(4000),@p845 nvarchar(4000),@p846 nvarchar(4000),@p847 nvarchar(4000),@p848 nvarchar(4000),@p849 nvarchar(4000),@p850 nvarchar(4000),@p851 datetime2(7),@p852 nvarchar(4000),@p853 nvarchar(4000),@p854 int,@p855 int,@p856 int,@p857 nvarchar(4000),@p858 nvarchar(4000),@p859 nvarchar(4000),@p860 decimal(18,2),@p861 decimal(18,2),@p862 nvarchar(4000),@p863 nvarchar(4000),@p864 decimal(18,2),@p865 nvarchar(4000),@p866 nvarchar(4000),@p867 nvarchar(4000),@p868 nvarchar(4000),@p869 int,@p870 nvarchar(4000),@p871 nvarchar(4000),@p872 nvarchar(4000),@p873 nvarchar(4000),@p874 nvarchar(4000),@p875 nvarchar(4000),@p876 nvarchar(4000),@p877 nvarchar(4000),@p878 nvarchar(4000),@p879 nvarchar(4000),@p880 int,@p881 nvarchar(4000),@p882 nvarchar(4000),@p883 nvarchar(4000),@p884 nvarchar(4000),@p885 nvarchar(4000),@p886 int,@p887 nvarchar(4000),@p888 int,@p889 int,@p890 datetime2(7),@p891 datetime2(7),@p892 datetime2(7),@p893 nvarchar(4000),@p894 nvarchar(4000),@p895 nvarchar(4000),@p896 nvarchar(4000),@p897 nvarchar(4000),@p898 nvarchar(4000),@p899 nvarchar(4000),@p900 nvarchar(4000),@p901 nvarchar(4000),@p902 nvarchar(4000),@p903 nvarchar(4000),@p904 nvarchar(4000),@p905 nvarchar(4000),@p906 nvarchar(4000),@p907 datetime2(7),@p908 nvarchar(4000),@p909 nvarchar(4000),@p910 int,@p911 int,@p912 int,@p913 nvarchar(4000),@p914 nvarchar(4000),@p915 nvarchar(4000),@p916 nvarchar(4000),@p917 decimal(18,2),@p918 nvarchar(4000),@p919 nvarchar(4000),@p920 decimal(18,2),@p921 nvarchar(4000),@p922 nvarchar(4000),@p923 nvarchar(4000),@p924 nvarchar(4000),@p925 int,@p926 nvarchar(4000),@p927 nvarchar(4000),@p928 nvarchar(4000),@p929 nvarchar(4000),@p930 nvarchar(4000),@p931 nvarchar(4000),@p932 nvarchar(4000),@p933 nvarchar(4000),@p934 nvarchar(4000),@p935 nvarchar(4000),@p936 int,@p937 nvarchar(4000),@p938 nvarchar(4000),@p939 nvarchar(4000),@p940 nvarchar(4000),@p941 nvarchar(4000),@p942 int,@p943 nvarchar(4000),@p944 int,@p945 int,@p946 datetime2(7),@p947 datetime2(7),@p948 datetime2(7),@p949 nvarchar(4000),@p950 nvarchar(4000),@p951 nvarchar(4000),@p952 nvarchar(4000),@p953 nvarchar(4000),@p954 nvarchar(4000),@p955 nvarchar(4000),@p956 nvarchar(4000),@p957 nvarchar(4000),@p958 nvarchar(4000),@p959 nvarchar(4000),@p960 nvarchar(4000),@p961 nvarchar(4000),@p962 nvarchar(4000),@p963 datetime2(7),@p964 nvarchar(4000),@p965 nvarchar(4000),@p966 int,@p967 int,@p968 int,@p969 nvarchar(4000),@p970 nvarchar(4000),@p971 nvarchar(4000),@p972 nvarchar(4000),@p973 decimal(18,2),@p974 nvarchar(4000),@p975 nvarchar(4000),@p976 decimal(18,2),@p977 nvarchar(4000),@p978 nvarchar(4000),@p979 nvarchar(4000),@p980 nvarchar(4000),@p981 int,@p982 nvarchar(4000),@p983 nvarchar(4000),@p984 nvarchar(4000),@p985 nvarchar(4000),@p986 nvarchar(4000),@p987 nvarchar(4000),@p988 nvarchar(4000),@p989 nvarchar(4000),@p990 nvarchar(4000),@p991 nvarchar(4000),@p992 int,@p993 nvarchar(4000),@p994 nvarchar(4000),@p995 nvarchar(4000),@p996 nvarchar(4000),@p997 nvarchar(4000),@p998 int,@p999 nvarchar(4000),@p1000 int,@p1001 int,@p1002 datetime2(7),@p1003 datetime2(7),@p1004 datetime2(7),@p1005 nvarchar(4000),@p1006 nvarchar(4000),@p1007 nvarchar(4000),@p1008 nvarchar(4000),@p1009 nvarchar(4000),@p1010 nvarchar(4000),@p1011 nvarchar(4000),@p1012 nvarchar(4000),@p1013 nvarchar(4000),@p1014 nvarchar(4000),@p1015 nvarchar(4000),@p1016 nvarchar(4000),@p1017 nvarchar(4000),@p1018 nvarchar(4000),@p1019 datetime2(7),@p1020 nvarchar(4000),@p1021 nvarchar(4000),@p1022 int,@p1023 int,@p1024 int,@p1025 nvarchar(4000),@p1026 nvarchar(4000),@p1027 nvarchar(4000),@p1028 nvarchar(4000),@p1029 decimal(18,2),@p1030 nvarchar(4000),@p1031 nvarchar(4000),@p1032 decimal(18,2),@p1033 nvarchar(4000),@p1034 nvarchar(4000),@p1035 nvarchar(4000),@p1036 nvarchar(4000),@p1037 int,@p1038 nvarchar(4000),@p1039 nvarchar(4000),@p1040 nvarchar(4000),@p1041 nvarchar(4000),@p1042 nvarchar(4000),@p1043 nvarchar(4000),@p1044 nvarchar(4000),@p1045 nvarchar(4000),@p1046 nvarchar(4000),@p1047 nvarchar(4000),@p1048 int,@p1049 nvarchar(4000),@p1050 nvarchar(4000),@p1051 nvarchar(4000),@p1052 nvarchar(4000),@p1053 nvarchar(4000),@p1054 int,@p1055 nvarchar(4000),@p1056 int,@p1057 int,@p1058 datetime2(7),@p1059 datetime2(7),@p1060 datetime2(7),@p1061 nvarchar(4000),@p1062 nvarchar(4000),@p1063 nvarchar(4000),@p1064 nvarchar(4000),@p1065 nvarchar(4000),@p1066 nvarchar(4000),@p1067 nvarchar(4000),@p1068 nvarchar(4000),@p1069 nvarchar(4000),@p1070 nvarchar(4000),@p1071 nvarchar(4000),@p1072 nvarchar(4000),@p1073 nvarchar(4000),@p1074 nvarchar(4000),@p1075 datetime2(7),@p1076 nvarchar(4000),@p1077 nvarchar(4000),@p1078 int,@p1079 int,@p1080 int,@p1081 nvarchar(4000),@p1082 nvarchar(4000),@p1083 nvarchar(4000),@p1084 nvarchar(4000),@p1085 decimal(18,2),@p1086 nvarchar(4000),@p1087 nvarchar(4000),@p1088 decimal(18,2),@p1089 nvarchar(4000),@p1090 nvarchar(4000),@p1091 nvarchar(4000),@p1092 nvarchar(4000),@p1093 int,@p1094 nvarchar(4000),@p1095 nvarchar(4000),@p1096 nvarchar(4000),@p1097 nvarchar(4000),@p1098 nvarchar(4000),@p1099 nvarchar(4000),@p1100 nvarchar(4000),@p1101 nvarchar(4000),@p1102 nvarchar(4000),@p1103 nvarchar(4000),@p1104 int,@p1105 nvarchar(4000),@p1106 nvarchar(4000),@p1107 nvarchar(4000),@p1108 nvarchar(4000),@p1109 nvarchar(4000),@p1110 int,@p1111 nvarchar(4000),@p1112 int,@p1113 int,@p1114 datetime2(7),@p1115 datetime2(7),@p1116 datetime2(7),@p1117 nvarchar(4000),@p1118 nvarchar(4000),@p1119 nvarchar(4000),@p1120 nvarchar(4000),@p1121 nvarchar(4000),@p1122 nvarchar(4000),@p1123 nvarchar(4000),@p1124 nvarchar(4000),@p1125 nvarchar(4000),@p1126 nvarchar(4000),@p1127 nvarchar(4000),@p1128 nvarchar(4000),@p1129 nvarchar(4000),@p1130 nvarchar(4000),@p1131 datetime2(7),@p1132 nvarchar(4000),@p1133 nvarchar(4000),@p1134 int,@p1135 int,@p1136 int,@p1137 nvarchar(4000),@p1138 nvarchar(4000),@p1139 nvarchar(4000),@p1140 nvarchar(4000),@p1141 decimal(18,2),@p1142 nvarchar(4000),@p1143 nvarchar(4000),@p1144 decimal(18,2),@p1145 nvarchar(4000),@p1146 nvarchar(4000),@p1147 nvarchar(4000),@p1148 nvarchar(4000),@p1149 int,@p1150 nvarchar(4000),@p1151 nvarchar(4000),@p1152 nvarchar(4000),@p1153 nvarchar(4000),@p1154 nvarchar(4000),@p1155 nvarchar(4000),@p1156 nvarchar(4000),@p1157 nvarchar(4000),@p1158 nvarchar(4000),@p1159 nvarchar(4000),@p1160 int,@p1161 nvarchar(4000),@p1162 nvarchar(4000),@p1163 nvarchar(4000),@p1164 nvarchar(4000),@p1165 nvarchar(4000),@p1166 int,@p1167 nvarchar(4000),@p1168 int,@p1169 int,@p1170 datetime2(7),@p1171 datetime2(7),@p1172 datetime2(7),@p1173 nvarchar(4000),@p1174 nvarchar(4000),@p1175 nvarchar(4000),@p1176 nvarchar(4000),@p1177 nvarchar(4000),@p1178 nvarchar(4000),@p1179 nvarchar(4000),@p1180 nvarchar(4000),@p1181 nvarchar(4000),@p1182 nvarchar(4000),@p1183 nvarchar(4000),@p1184 nvarchar(4000),@p1185 nvarchar(4000),@p1186 nvarchar(4000),@p1187 datetime2(7),@p1188 nvarchar(4000),@p1189 nvarchar(4000),@p1190 int,@p1191 int,@p1192 int,@p1193 nvarchar(4000),@p1194 nvarchar(4000),@p1195 nvarchar(4000),@p1196 nvarchar(4000),@p1197 decimal(18,2),@p1198 nvarchar(4000),@p1199 nvarchar(4000),@p1200 decimal(18,2),@p1201 nvarchar(4000),@p1202 nvarchar(4000),@p1203 nvarchar(4000),@p1204 nvarchar(4000),@p1205 int,@p1206 nvarchar(4000),@p1207 nvarchar(4000),@p1208 nvarchar(4000),@p1209 nvarchar(4000),@p1210 nvarchar(4000),@p1211 nvarchar(4000),@p1212 nvarchar(4000),@p1213 nvarchar(4000),@p1214 nvarchar(4000),@p1215 nvarchar(4000),@p1216 int,@p1217 nvarchar(4000),@p1218 nvarchar(4000),@p1219 nvarchar(4000),@p1220 nvarchar(4000),@p1221 nvarchar(4000),@p1222 int,@p1223 nvarchar(4000),@p1224 int,@p1225 int,@p1226 datetime2(7),@p1227 datetime2(7),@p1228 datetime2(7),@p1229 nvarchar(4000),@p1230 nvarchar(4000),@p1231 nvarchar(4000),@p1232 nvarchar(4000),@p1233 nvarchar(4000),@p1234 nvarchar(4000),@p1235 nvarchar(4000),@p1236 nvarchar(4000),@p1237 nvarchar(4000),@p1238 nvarchar(4000),@p1239 nvarchar(4000),@p1240 nvarchar(4000),@p1241 nvarchar(4000),@p1242 nvarchar(4000),@p1243 datetime2(7),@p1244 nvarchar(4000),@p1245 nvarchar(4000),@p1246 int,@p1247 int,@p1248 int,@p1249 nvarchar(4000),@p1250 nvarchar(4000),@p1251 nvarchar(4000),@p1252 nvarchar(4000),@p1253 decimal(18,2),@p1254 nvarchar(4000),@p1255 nvarchar(4000),@p1256 decimal(18,2),@p1257 nvarchar(4000),@p1258 nvarchar(4000),@p1259 nvarchar(4000),@p1260 nvarchar(4000),@p1261 int,@p1262 nvarchar(4000),@p1263 nvarchar(4000),@p1264 nvarchar(4000),@p1265 nvarchar(4000),@p1266 nvarchar(4000),@p1267 nvarchar(4000),@p1268 nvarchar(4000),@p1269 nvarchar(4000),@p1270 nvarchar(4000),@p1271 nvarchar(4000),@p1272 int,@p1273 nvarchar(4000),@p1274 nvarchar(4000),@p1275 nvarchar(4000),@p1276 nvarchar(4000),@p1277 nvarchar(4000),@p1278 int,@p1279 nvarchar(4000),@p1280 int,@p1281 int,@p1282 datetime2(7),@p1283 datetime2(7),@p1284 datetime2(7),@p1285 nvarchar(4000),@p1286 nvarchar(4000),@p1287 nvarchar(4000),@p1288 nvarchar(4000),@p1289 nvarchar(4000),@p1290 nvarchar(4000),@p1291 nvarchar(4000),@p1292 nvarchar(4000),@p1293 nvarchar(4000),@p1294 nvarchar(4000),@p1295 nvarchar(4000),@p1296 nvarchar(4000),@p1297 nvarchar(4000),@p1298 nvarchar(4000),@p1299 datetime2(7),@p1300 nvarchar(4000),@p1301 nvarchar(4000),@p1302 int,@p1303 int,@p1304 int,@p1305 nvarchar(4000),@p1306 nvarchar(4000),@p1307 nvarchar(4000),@p1308 nvarchar(4000),@p1309 decimal(18,2),@p1310 nvarchar(4000),@p1311 nvarchar(4000),@p1312 decimal(18,2),@p1313 nvarchar(4000),@p1314 nvarchar(4000),@p1315 nvarchar(4000),@p1316 nvarchar(4000),@p1317 int,@p1318 nvarchar(4000),@p1319 nvarchar(4000),@p1320 nvarchar(4000),@p1321 nvarchar(4000),@p1322 nvarchar(4000),@p1323 nvarchar(4000),@p1324 nvarchar(4000),@p1325 nvarchar(4000),@p1326 nvarchar(4000),@p1327 nvarchar(4000),@p1328 int,@p1329 nvarchar(4000),@p1330 nvarchar(4000),@p1331 nvarchar(4000),@p1332 nvarchar(4000),@p1333 nvarchar(4000),@p1334 int,@p1335 nvarchar(4000),@p1336 int,@p1337 int,@p1338 datetime2(7),@p1339 datetime2(7),@p1340 datetime2(7),@p1341 nvarchar(4000),@p1342 nvarchar(4000),@p1343 nvarchar(4000),@p1344 nvarchar(4000),@p1345 nvarchar(4000),@p1346 nvarchar(4000),@p1347 nvarchar(4000),@p1348 nvarchar(4000),@p1349 nvarchar(4000),@p1350 nvarchar(4000),@p1351 nvarchar(4000),@p1352 nvarchar(4000),@p1353 nvarchar(4000),@p1354 nvarchar(4000),@p1355 datetime2(7),@p1356 nvarchar(4000),@p1357 nvarchar(4000),@p1358 int,@p1359 int,@p1360 int,@p1361 nvarchar(4000),@p1362 nvarchar(4000),@p1363 nvarchar(4000),@p1364 nvarchar(4000),@p1365 decimal(18,2),@p1366 nvarchar(4000),@p1367 nvarchar(4000),@p1368 decimal(18,2),@p1369 nvarchar(4000),@p1370 nvarchar(4000),@p1371 nvarchar(4000),@p1372 nvarchar(4000),@p1373 int,@p1374 nvarchar(4000),@p1375 nvarchar(4000),@p1376 nvarchar(4000),@p1377 nvarchar(4000),@p1378 nvarchar(4000),@p1379 nvarchar(4000),@p1380 nvarchar(4000),@p1381 nvarchar(4000),@p1382 nvarchar(4000),@p1383 nvarchar(4000),@p1384 int,@p1385 nvarchar(4000),@p1386 nvarchar(4000),@p1387 nvarchar(4000),@p1388 nvarchar(4000),@p1389 nvarchar(4000),@p1390 int,@p1391 nvarchar(4000),@p1392 int,@p1393 int,@p1394 datetime2(7),@p1395 datetime2(7),@p1396 datetime2(7),@p1397 nvarchar(4000),@p1398 nvarchar(4000),@p1399 nvarchar(4000),@p1400 nvarchar(4000),@p1401 nvarchar(4000),@p1402 nvarchar(4000),@p1403 nvarchar(4000),@p1404 nvarchar(4000),@p1405 nvarchar(4000),@p1406 nvarchar(4000),@p1407 nvarchar(4000),@p1408 nvarchar(4000),@p1409 nvarchar(4000),@p1410 nvarchar(4000),@p1411 datetime2(7),@p1412 nvarchar(4000),@p1413 nvarchar(4000),@p1414 int,@p1415 int,@p1416 int,@p1417 nvarchar(4000),@p1418 nvarchar(4000),@p1419 nvarchar(4000),@p1420 nvarchar(4000),@p1421 decimal(18,2),@p1422 nvarchar(4000),@p1423 nvarchar(4000),@p1424 decimal(18,2),@p1425 nvarchar(4000),@p1426 nvarchar(4000),@p1427 nvarchar(4000),@p1428 nvarchar(4000),@p1429 int,@p1430 nvarchar(4000),@p1431 nvarchar(4000),@p1432 nvarchar(4000),@p1433 nvarchar(4000),@p1434 nvarchar(4000),@p1435 nvarchar(4000),@p1436 nvarchar(4000),@p1437 nvarchar(4000),@p1438 nvarchar(4000),@p1439 nvarchar(4000),@p1440 int,@p1441 nvarchar(4000),@p1442 nvarchar(4000),@p1443 nvarchar(4000),@p1444 nvarchar(4000),@p1445 nvarchar(4000),@p1446 int,@p1447 nvarchar(4000),@p1448 int,@p1449 int,@p1450 datetime2(7),@p1451 datetime2(7),@p1452 datetime2(7),@p1453 nvarchar(4000),@p1454 nvarchar(4000),@p1455 nvarchar(4000),@p1456 nvarchar(4000),@p1457 nvarchar(4000),@p1458 nvarchar(4000),@p1459 nvarchar(4000),@p1460 nvarchar(4000),@p1461 nvarchar(4000),@p1462 nvarchar(4000),@p1463 nvarchar(4000),@p1464 nvarchar(4000),@p1465 nvarchar(4000),@p1466 nvarchar(4000),@p1467 datetime2(7),@p1468 nvarchar(4000),@p1469 nvarchar(4000),@p1470 int,@p1471 int,@p1472 int,@p1473 nvarchar(4000),@p1474 nvarchar(4000),@p1475 nvarchar(4000),@p1476 nvarchar(4000),@p1477 decimal(18,2),@p1478 nvarchar(4000),@p1479 nvarchar(4000),@p1480 decimal(18,2),@p1481 nvarchar(4000),@p1482 nvarchar(4000),@p1483 nvarchar(4000),@p1484 nvarchar(4000),@p1485 int,@p1486 nvarchar(4000),@p1487 nvarchar(4000),@p1488 nvarchar(4000),@p1489 nvarchar(4000),@p1490 nvarchar(4000),@p1491 nvarchar(4000),@p1492 nvarchar(4000),@p1493 nvarchar(4000),@p1494 nvarchar(4000),@p1495 nvarchar(4000),@p1496 int,@p1497 nvarchar(4000),@p1498 nvarchar(4000),@p1499 nvarchar(4000),@p1500 nvarchar(4000),@p1501 nvarchar(4000),@p1502 int,@p1503 nvarchar(4000),@p1504 int,@p1505 int,@p1506 datetime2(7),@p1507 datetime2(7),@p1508 datetime2(7),@p1509 nvarchar(4000),@p1510 nvarchar(4000),@p1511 nvarchar(4000),@p1512 nvarchar(4000),@p1513 nvarchar(4000),@p1514 nvarchar(4000),@p1515 nvarchar(4000),@p1516 nvarchar(4000),@p1517 nvarchar(4000),@p1518 nvarchar(4000),@p1519 nvarchar(4000),@p1520 nvarchar(4000),@p1521 nvarchar(4000),@p1522 nvarchar(4000),@p1523 datetime2(7),@p1524 nvarchar(4000),@p1525 nvarchar(4000),@p1526 int,@p1527 int,@p1528 int,@p1529 nvarchar(4000),@p1530 nvarchar(4000),@p1531 nvarchar(4000),@p1532 nvarchar(4000),@p1533 decimal(18,2),@p1534 nvarchar(4000),@p1535 nvarchar(4000),@p1536 decimal(18,2),@p1537 nvarchar(4000),@p1538 nvarchar(4000),@p1539 nvarchar(4000),@p1540 nvarchar(4000),@p1541 int,@p1542 nvarchar(4000),@p1543 nvarchar(4000),@p1544 nvarchar(4000),@p1545 nvarchar(4000),@p1546 nvarchar(4000),@p1547 nvarchar(4000),@p1548 nvarchar(4000),@p1549 nvarchar(4000),@p1550 nvarchar(4000),@p1551 nvarchar(4000),@p1552 int,@p1553 nvarchar(4000),@p1554 nvarchar(4000),@p1555 nvarchar(4000),@p1556 nvarchar(4000),@p1557 nvarchar(4000),@p1558 int,@p1559 nvarchar(4000),@p1560 int,@p1561 int,@p1562 datetime2(7),@p1563 datetime2(7),@p1564 datetime2(7),@p1565 nvarchar(4000),@p1566 nvarchar(4000),@p1567 nvarchar(4000),@p1568 nvarchar(4000),@p1569 nvarchar(4000),@p1570 nvarchar(4000),@p1571 nvarchar(4000),@p1572 nvarchar(4000),@p1573 nvarchar(4000),@p1574 nvarchar(4000),@p1575 nvarchar(4000),@p1576 nvarchar(4000),@p1577 nvarchar(4000),@p1578 nvarchar(4000),@p1579 datetime2(7),@p1580 nvarchar(4000),@p1581 nvarchar(4000),@p1582 int,@p1583 int,@p1584 int,@p1585 nvarchar(4000),@p1586 nvarchar(4000),@p1587 nvarchar(4000),@p1588 nvarchar(4000),@p1589 decimal(18,2),@p1590 nvarchar(4000),@p1591 nvarchar(4000),@p1592 decimal(18,2),@p1593 nvarchar(4000),@p1594 nvarchar(4000),@p1595 nvarchar(4000),@p1596 nvarchar(4000),@p1597 int,@p1598 nvarchar(4000),@p1599 nvarchar(4000),@p1600 nvarchar(4000),@p1601 nvarchar(4000),@p1602 nvarchar(4000),@p1603 nvarchar(4000),@p1604 nvarchar(4000),@p1605 nvarchar(4000),@p1606 nvarchar(4000),@p1607 nvarchar(4000),@p1608 int,@p1609 nvarchar(4000),@p1610 nvarchar(4000),@p1611 nvarchar(4000),@p1612 nvarchar(4000),@p1613 nvarchar(4000),@p1614 int,@p1615 nvarchar(4000),@p1616 int,@p1617 int,@p1618 datetime2(7),@p1619 datetime2(7),@p1620 datetime2(7),@p1621 nvarchar(4000),@p1622 nvarchar(4000),@p1623 nvarchar(4000),@p1624 nvarchar(4000),@p1625 nvarchar(4000),@p1626 nvarchar(4000),@p1627 nvarchar(4000),@p1628 nvarchar(4000),@p1629 nvarchar(4000),@p1630 nvarchar(4000),@p1631 nvarchar(4000),@p1632 nvarchar(4000),@p1633 nvarchar(4000),@p1634 nvarchar(4000),@p1635 datetime2(7),@p1636 nvarchar(4000),@p1637 nvarchar(4000),@p1638 int,@p1639 int,@p1640 int,@p1641 nvarchar(4000),@p1642 nvarchar(4000),@p1643 nvarchar(4000),@p1644 nvarchar(4000),@p1645 decimal(18,2),@p1646 nvarchar(4000),@p1647 nvarchar(4000),@p1648 decimal(18,2),@p1649 nvarchar(4000),@p1650 nvarchar(4000),@p1651 nvarchar(4000),@p1652 nvarchar(4000),@p1653 int,@p1654 nvarchar(4000),@p1655 nvarchar(4000),@p1656 nvarchar(4000),@p1657 nvarchar(4000),@p1658 nvarchar(4000),@p1659 nvarchar(4000),@p1660 nvarchar(4000),@p1661 nvarchar(4000),@p1662 nvarchar(4000),@p1663 nvarchar(4000),@p1664 int,@p1665 nvarchar(4000),@p1666 nvarchar(4000),@p1667 nvarchar(4000),@p1668 nvarchar(4000),@p1669 nvarchar(4000),@p1670 int,@p1671 nvarchar(4000),@p1672 int,@p1673 int,@p1674 datetime2(7),@p1675 datetime2(7),@p1676 datetime2(7),@p1677 nvarchar(4000),@p1678 nvarchar(4000),@p1679 nvarchar(4000),@p1680 nvarchar(4000),@p1681 nvarchar(4000),@p1682 nvarchar(4000),@p1683 nvarchar(4000),@p1684 nvarchar(4000),@p1685 nvarchar(4000),@p1686 nvarchar(4000),@p1687 nvarchar(4000),@p1688 nvarchar(4000),@p1689 nvarchar(4000),@p1690 nvarchar(4000),@p1691 datetime2(7),@p1692 nvarchar(4000),@p1693 nvarchar(4000),@p1694 int,@p1695 int,@p1696 int,@p1697 nvarchar(4000),@p1698 nvarchar(4000),@p1699 nvarchar(4000),@p1700 nvarchar(4000),@p1701 decimal(18,2),@p1702 nvarchar(4000),@p1703 nvarchar(4000),@p1704 decimal(18,2),@p1705 nvarchar(4000),@p1706 nvarchar(4000),@p1707 nvarchar(4000),@p1708 nvarchar(4000),@p1709 int,@p1710 nvarchar(4000),@p1711 nvarchar(4000),@p1712 nvarchar(4000),@p1713 nvarchar(4000),@p1714 nvarchar(4000),@p1715 nvarchar(4000),@p1716 nvarchar(4000),@p1717 nvarchar(4000),@p1718 nvarchar(4000),@p1719 nvarchar(4000),@p1720 int,@p1721 nvarchar(4000),@p1722 nvarchar(4000),@p1723 nvarchar(4000),@p1724 nvarchar(4000),@p1725 nvarchar(4000),@p1726 int,@p1727 nvarchar(4000),@p1728 int,@p1729 int,@p1730 datetime2(7),@p1731 datetime2(7),@p1732 datetime2(7),@p1733 nvarchar(4000),@p1734 nvarchar(4000),@p1735 nvarchar(4000),@p1736 nvarchar(4000),@p1737 nvarchar(4000),@p1738 nvarchar(4000),@p1739 nvarchar(4000),@p1740 nvarchar(4000),@p1741 nvarchar(4000),@p1742 nvarchar(4000),@p1743 nvarchar(4000),@p1744 nvarchar(4000),@p1745 nvarchar(4000),@p1746 nvarchar(4000),@p1747 datetime2(7),@p1748 nvarchar(4000),@p1749 nvarchar(4000),@p1750 int,@p1751 int,@p1752 int,@p1753 nvarchar(4000),@p1754 nvarchar(4000),@p1755 nvarchar(4000),@p1756 nvarchar(4000),@p1757 decimal(18,2),@p1758 nvarchar(4000),@p1759 nvarchar(4000),@p1760 decimal(18,2),@p1761 nvarchar(4000),@p1762 nvarchar(4000),@p1763 nvarchar(4000),@p1764 nvarchar(4000),@p1765 int,@p1766 nvarchar(4000),@p1767 nvarchar(4000),@p1768 nvarchar(4000),@p1769 nvarchar(4000),@p1770 nvarchar(4000),@p1771 nvarchar(4000),@p1772 nvarchar(4000),@p1773 nvarchar(4000),@p1774 nvarchar(4000),@p1775 nvarchar(4000),@p1776 int,@p1777 nvarchar(4000),@p1778 nvarchar(4000),@p1779 nvarchar(4000),@p1780 nvarchar(4000),@p1781 nvarchar(4000),@p1782 int,@p1783 nvarchar(4000),@p1784 int,@p1785 int,@p1786 datetime2(7),@p1787 datetime2(7),@p1788 datetime2(7),@p1789 nvarchar(4000),@p1790 nvarchar(4000),@p1791 nvarchar(4000),@p1792 nvarchar(4000),@p1793 nvarchar(4000),@p1794 nvarchar(4000),@p1795 nvarchar(4000),@p1796 nvarchar(4000),@p1797 nvarchar(4000),@p1798 nvarchar(4000),@p1799 nvarchar(4000),@p1800 nvarchar(4000),@p1801 nvarchar(4000),@p1802 nvarchar(4000),@p1803 datetime2(7),@p1804 nvarchar(4000),@p1805 nvarchar(4000),@p1806 int,@p1807 int,@p1808 int,@p1809 nvarchar(4000),@p1810 nvarchar(4000),@p1811 nvarchar(4000),@p1812 nvarchar(4000),@p1813 decimal(18,2),@p1814 nvarchar(4000),@p1815 nvarchar(4000),@p1816 decimal(18,2),@p1817 nvarchar(4000),@p1818 nvarchar(4000),@p1819 nvarchar(4000),@p1820 nvarchar(4000),@p1821 int,@p1822 nvarchar(4000),@p1823 nvarchar(4000),@p1824 nvarchar(4000),@p1825 nvarchar(4000),@p1826 nvarchar(4000),@p1827 nvarchar(4000),@p1828 nvarchar(4000),@p1829 nvarchar(4000),@p1830 nvarchar(4000),@p1831 nvarchar(4000),@p1832 int,@p1833 nvarchar(4000),@p1834 nvarchar(4000),@p1835 nvarchar(4000),@p1836 nvarchar(4000),@p1837 nvarchar(4000),@p1838 int,@p1839 nvarchar(4000),@p1840 int,@p1841 int,@p1842 datetime2(7),@p1843 datetime2(7),@p1844 datetime2(7),@p1845 nvarchar(4000),@p1846 nvarchar(4000),@p1847 nvarchar(4000),@p1848 nvarchar(4000),@p1849 nvarchar(4000),@p1850 nvarchar(4000),@p1851 nvarchar(4000),@p1852 nvarchar(4000),@p1853 nvarchar(4000),@p1854 nvarchar(4000),@p1855 nvarchar(4000),@p1856 nvarchar(4000),@p1857 nvarchar(4000),@p1858 nvarchar(4000),@p1859 datetime2(7),@p1860 nvarchar(4000),@p1861 nvarchar(4000),@p1862 int,@p1863 int,@p1864 int,@p1865 nvarchar(4000),@p1866 nvarchar(4000),@p1867 nvarchar(4000),@p1868 nvarchar(4000),@p1869 decimal(18,2),@p1870 nvarchar(4000),@p1871 nvarchar(4000),@p1872 decimal(18,2),@p1873 nvarchar(4000),@p1874 nvarchar(4000),@p1875 nvarchar(4000),@p1876 nvarchar(4000),@p1877 int,@p1878 nvarchar(4000),@p1879 nvarchar(4000),@p1880 nvarchar(4000),@p1881 nvarchar(4000),@p1882 nvarchar(4000),@p1883 nvarchar(4000),@p1884 nvarchar(4000),@p1885 nvarchar(4000),@p1886 nvarchar(4000),@p1887 nvarchar(4000),@p1888 int,@p1889 nvarchar(4000),@p1890 nvarchar(4000),@p1891 nvarchar(4000),@p1892 nvarchar(4000),@p1893 nvarchar(4000),@p1894 int,@p1895 nvarchar(4000),@p1896 int,@p1897 int,@p1898 datetime2(7),@p1899 datetime2(7),@p1900 datetime2(7),@p1901 nvarchar(4000),@p1902 nvarchar(4000),@p1903 nvarchar(4000),@p1904 nvarchar(4000),@p1905 nvarchar(4000),@p1906 nvarchar(4000),@p1907 nvarchar(4000),@p1908 nvarchar(4000),@p1909 nvarchar(4000),@p1910 nvarchar(4000),@p1911 nvarchar(4000),@p1912 nvarchar(4000),@p1913 nvarchar(4000),@p1914 nvarchar(4000),@p1915 datetime2(7),@p1916 nvarchar(4000),@p1917 nvarchar(4000),@p1918 int,@p1919 int,@p1920 int,@p1921 nvarchar(4000),@p1922 nvarchar(4000),@p1923 nvarchar(4000),@p1924 nvarchar(4000),@p1925 decimal(18,2),@p1926 nvarchar(4000),@p1927 nvarchar(4000),@p1928 decimal(18,2),@p1929 nvarchar(4000),@p1930 nvarchar(4000),@p1931 nvarchar(4000),@p1932 nvarchar(4000),@p1933 int,@p1934 nvarchar(4000),@p1935 nvarchar(4000),@p1936 nvarchar(4000),@p1937 nvarchar(4000),@p1938 nvarchar(4000),@p1939 nvarchar(4000),@p1940 nvarchar(4000),@p1941 nvarchar(4000),@p1942 nvarchar(4000),@p1943 nvarchar(4000),@p1944 int,@p1945 nvarchar(4000),@p1946 nvarchar(4000),@p1947 nvarchar(4000),@p1948 nvarchar(4000),@p1949 nvarchar(4000),@p1950 int,@p1951 nvarchar(4000),@p1952 int,@p1953 int,@p1954 datetime2(7),@p1955 datetime2(7),@p1956 datetime2(7),@p1957 nvarchar(4000),@p1958 nvarchar(4000),@p1959 nvarchar(4000),@p1960 nvarchar(4000),@p1961 nvarchar(4000),@p1962 nvarchar(4000),@p1963 nvarchar(4000),@p1964 nvarchar(4000),@p1965 nvarchar(4000),@p1966 nvarchar(4000),@p1967 nvarchar(4000),@p1968 nvarchar(4000),@p1969 nvarchar(4000),@p1970 nvarchar(4000),@p1971 datetime2(7),@p1972 nvarchar(4000),@p1973 nvarchar(4000),@p1974 int,@p1975 int,@p1976 int,@p1977 nvarchar(4000),@p1978 nvarchar(4000),@p1979 nvarchar(4000),@p1980 nvarchar(4000),@p1981 decimal(18,2),@p1982 nvarchar(4000),@p1983 nvarchar(4000),@p1984 decimal(18,2),@p1985 nvarchar(4000),@p1986 nvarchar(4000),@p1987 nvarchar(4000),@p1988 nvarchar(4000),@p1989 int,@p1990 nvarchar(4000),@p1991 nvarchar(4000),@p1992 nvarchar(4000),@p1993 nvarchar(4000),@p1994 nvarchar(4000),@p1995 nvarchar(4000),@p1996 nvarchar(4000),@p1997 nvarchar(4000),@p1998 nvarchar(4000),@p1999 nvarchar(4000),@p2000 int,@p2001 nvarchar(4000),@p2002 nvarchar(4000),@p2003 nvarchar(4000),@p2004 nvarchar(4000),@p2005 nvarchar(4000),@p2006 int,@p2007 nvarchar(4000),@p2008 int,@p2009 int,@p2010 datetime2(7),@p2011 datetime2(7),@p2012 datetime2(7),@p2013 nvarchar(4000),@p2014 nvarchar(4000),@p2015 nvarchar(4000),@p2016 nvarchar(4000),@p2017 nvarchar(4000),@p2018 nvarchar(4000),@p2019 nvarchar(4000),@p2020 nvarchar(4000),@p2021 nvarchar(4000),@p2022 nvarchar(4000),@p2023 nvarchar(4000),@p2024 nvarchar(4000),@p2025 nvarchar(4000),@p2026 nvarchar(4000),@p2027 datetime2(7),@p2028 nvarchar(4000),@p2029 nvarchar(4000),@p2030 int,@p2031 int,@p2032 int,@p2033 nvarchar(4000),@p2034 nvarchar(4000),@p2035 nvarchar(4000),@p2036 nvarchar(4000),@p2037 decimal(18,2),@p2038 nvarchar(4000),@p2039 nvarchar(4000),@p2040 decimal(18,2),@p2041 nvarchar(4000),@p2042 nvarchar(4000),@p2043 nvarchar(4000),@p2044 nvarchar(4000),@p2045 int,@p2046 nvarchar(4000),@p2047 nvarchar(4000),@p2048 nvarchar(4000),@p2049 nvarchar(4000),@p2050 nvarchar(4000),@p2051 nvarchar(4000),@p2052 nvarchar(4000),@p2053 nvarchar(4000),@p2054 nvarchar(4000),@p2055 nvarchar(4000),@p2056 int,@p2057 nvarchar(4000),@p2058 nvarchar(4000),@p2059 nvarchar(4000),@p2060 nvarchar(4000),@p2061 nvarchar(4000),@p2062 int,@p2063 nvarchar(4000),@p2064 int,@p2065 int,@p2066 datetime2(7),@p2067 datetime2(7),@p2068 datetime2(7),@p2069 nvarchar(4000),@p2070 nvarchar(4000),@p2071 nvarchar(4000))SET NOCOUNT ON; DECLARE @inserted0 TABLE ([item_id] int, [_Position] [int]); MERGE [raw_data] USING ( VALUES (@p0, @p1, @p2, @p3, @p4, @p5, @p6, @p7, @p8, @p9, @p10, @p11, @p12, @p13, @p14, @p15, @p16, @p17, @p18, @p19, @p20, @p21, @p22, @p23, @p24, @p25, @p26, @p27, @p28, @p29, @p30, @p31, @p32, @p33, @p34, @p35, @p36, @p37, @p38, @p39, @p40, @p41, @p42, @p43, @p44, @p45, @p46, @p47, @p48, @p49, @p50, @p51, @p52, @p53, @p54, @p55, 0), (@p56, @p57, @p58, @p59, @p60, @p61, @p62, @p63, @p64, @p65, @p66, @p67, @p68, @p69, @p70, @p71, @p72, @p73, @p74, @p75, @p76, @p77, @p78, @p79, @p80, @p81, @p82, @p83, @p84, @p85, @p86, @p87, @p88, @p89, @p90, @p91, @p92, @p93, @p94, @p95, @p96, @p97, @p98, @p99, @p100, @p101, @p102, @p103, @p104, @p105, @p106, @p107, @p108, @p109, @p110, @p111, 1), (@p112, @p113, @p114, @p115, @p116, @p117, @p118, @p119, @p120, @p121, @p122, @p123, @p124, @p125, @p126, @p127, @p128, @p129, @p130, @p131, @p132, @p133, @p134, @p135, @p136, @p137, @p138, @p139, @p140, @p141, @p142, @p143, @p144, @p145, @p146, @p147, @p148, @p149, @p150, @p151, @p152, @p153, @p154, @p155, @p156, @p157, @p158, @p159, @p160, @p161, @p162, @p163, @p164, @p165, @p166, @p167, 2), (@p168, @p169, @p170, @p171, @p172, @p173, @p174, @p175, @p176, @p177, @p178, @p179, @p180, @p181, @p182, @p183, @p184, @p185, @p186, @p187, @p188, @p189, @p190, @p191, @p192, @p193, @p194, @p195, @p196, @p197, @p198, @p199, @p200, @p201, @p202, @p203, @p204, @p205, @p206, @p207, @p208, @p209, @p210, @p211, @p212, @p213, @p214, @p215, @p216, @p217, @p218, @p219, @p220, @p221, @p222, @p223, 3), (@p224, @p225, @p226, @p227, @p228, @p229, @p230, @p231, @p232, @p233, @p234, @p235, @p236, @p237, @p238, @p239, @p240, @p241, @p242, @p243, @p244, @p245, @p246, @p247, @p248, @p249, @p250, @p251, @p252, @p253, @p254, @p255, @p256, @p257, @p258, @p259, @p260, @p261, @p262, @p263, @p264, @p265, @p266, @p267, @p268, @p269, @p270, @p271, @p272, @p273, @p274, @p275, @p276, @p277, @p278, @p279, 4), (@p280, @p281, @p282, @p283, @p284, @p285, @p286, @p287, @p288, @p289, @p290, @p291, @p292, @p293, @p294, @p295, @p296, @p297, @p298, @p299, @p300, @p301, @p302, @p303, @p304, @p305, @p306, @p307, @p308, @p309, @p310, @p311, @p312, @p313, @p314, @p315, @p316, @p317, @p318, @p319, @p320, @p321, @p322, @p323, @p324, @p325, @p326, @p327, @p328, @p329, @p330, @p331, @p332, @p333, @p334, @p335, 5), (@p336, @p337, @p338, @p339, @p340, @p341, @p342, @p343, @p344, @p345, @p346, @p347, @p348, @p349, @p350, @p351, @p352, @p353, @p354, @p355, @p356, @p357, @p358, @p359, @p360, @p361, @p362, @p363, @p364, @p365, @p366, @p367, @p368, @p369, @p370, @p371, @p372, @p373, @p374, @p375, @p376, @p377, @p378, @p379, @p380, @p381, @p382, @p383, @p384, @p385, @p386, @p387, @p388, @p389, @p390, @p391, 6), (@p392, @p393, @p394, @p395, @p396, @p397, @p398, @p399, @p400, @p401, @p402, @p403, @p404, @p405, @p406, @p407, @p408, @p409, @p410, @p411, @p412, @p413, @p414, @p415, @p416, @p417, @p418, @p419, @p420, @p421, @p422, @p423, @p424, @p425, @p426, @p427, @p428, @p429, @p430, @p431, @p432, @p433, @p434, @p435, @p436, @p437, @p438, @p439, @p440, @p441, @p442, @p443, @p444, @p445, @p446, @p447, 7), (@p448, @p449, @p450, @p451, @p452, @p453, @p454, @p455, @p456, @p457, @p458, @p459, @p460, @p461, @p462, @p463, @p464, @p465, @p466, @p467, @p468, @p469, @p470, @p471, @p472, @p473, @p474, @p475, @p476, @p477, @p478, @p479, @p480, @p481, @p482, @p483, @p484, @p485, @p486, @p487, @p488, @p489, @p490, @p491, @p492, @p493, @p494, @p495, @p496, @p497, @p498, @p499, @p500, @p501, @p502, @p503, 8), (@p504, @p505, @p506, @p507, @p508, @p509, @p510, @p511, @p512, @p513, @p514, @p515, @p516, @p517, @p518, @p519, @p520, @p521, @p522, @p523, @p524, @p525, @p526, @p527, @p528, @p529, @p530, @p531, @p532, @p533, @p534, @p535, @p536, @p537, @p538, @p539, @p540, @p541, @p542, @p543, @p544, @p545, @p546, @p547, @p548, @p549, @p550, @p551, @p552, @p553, @p554, @p555, @p556, @p557, @p558, @p559, 9), (@p560, @p561, @p562, @p563, @p564, @p565, @p566, @p567, @p568, @p569, @p570, @p571, @p572, @p573, @p574, @p575, @p576, @p577, @p578, @p579, @p580, @p581, @p582, @p583, @p584, @p585, @p586, @p587, @p588, @p589, @p590, @p591, @p592, @p593, @p594, @p595, @p596, @p597, @p598, @p599, @p600, @p601, @p602, @p603, @p604, @p605, @p606, @p607, @p608, @p609, @p610, @p611, @p612, @p613, @p614, @p615, 10), (@p616, @p617, @p618, @p619, @p620, @p621, @p622, @p623, @p624, @p625, @p626, @p627, @p628, @p629, @p630, @p631, @p632, @p633, @p634, @p635, @p636, @p637, @p638, @p639, @p640, @p641, @p642, @p643, @p644, @p645, @p646, @p647, @p648, @p649, @p650, @p651, @p652, @p653, @p654, @p655, @p656, @p657, @p658, @p659, @p660, @p661, @p662, @p663, @p664, @p665, @p666, @p667, @p668, @p669, @p670, @p671, 11), (@p672, @p673, @p674, @p675, @p676, @p677, @p678, @p679, @p680, @p681, @p682, @p683, @p684, @p685, @p686, @p687, @p688, @p689, @p690, @p691, @p692, @p693, @p694, @p695, @p696, @p697, @p698, @p699, @p700, @p701, @p702, @p703, @p704, @p705, @p706, @p707, @p708, @p709, @p710, @p711, @p712, @p713, @p714, @p715, @p716, @p717, @p718, @p719, @p720, @p721, @p722, @p723, @p724, @p725, @p726, @p727, 12), (@p728, @p729, @p730, @p731, @p732, @p733, @p734, @p735, @p736, @p737, @p738, @p739, @p740, @p741, @p742, @p743, @p744, @p745, @p746, @p747, @p748, @p749, @p750, @p751, @p752, @p753, @p754, @p755, @p756, @p757, @p758, @p759, @p760, @p761, @p762, @p763, @p764, @p765, @p766, @p767, @p768, @p769, @p770, @p771, @p772, @p773, @p774, @p775, @p776, @p777, @p778, @p779, @p780, @p781, @p782, @p783, 13), (@p784, @p785, @p786, @p787, @p788, @p789, @p790, @p791, @p792, @p793, @p794, @p795, @p796, @p797, @p798, @p799, @p800, @p801, @p802, @p803, @p804, @p805, @p806, @p807, @p808, @p809, @p810, @p811, @p812, @p813, @p814, @p815, @p816, @p817, @p818, @p819, @p820, @p821, @p822, @p823, @p824, @p825, @p826, @p827, @p828, @p829, @p830, @p831, @p832, @p833, @p834, @p835, @p836, @p837, @p838, @p839, 14), (@p840, @p841, @p842, @p843, @p844, @p845, @p846, @p847, @p848, @p849, @p850, @p851, @p852, @p853, @p854, @p855, @p856, @p857, @p858, @p859, @p860, @p861, @p862, @p863, @p864, @p865, @p866, @p867, @p868, @p869, @p870, @p871, @p872, @p873, @p874, @p875, @p876, @p877, @p878, @p879, @p880, @p881, @p882, @p883, @p884, @p885, @p886, @p887, @p888, @p889, @p890, @p891, @p892, @p893, @p894, @p895, 15), (@p896, @p897, @p898, @p899, @p900, @p901, @p902, @p903, @p904, @p905, @p906, @p907, @p908, @p909, @p910, @p911, @p912, @p913, @p914, @p915, @p916, @p917, @p918, @p919, @p920, @p921, @p922, @p923, @p924, @p925, @p926, @p927, @p928, @p929, @p930, @p931, @p932, @p933, @p934, @p935, @p936, @p937, @p938, @p939, @p940, @p941, @p942, @p943, @p944, @p945, @p946, @p947, @p948, @p949, @p950, @p951, 16), (@p952, @p953, @p954, @p955, @p956, @p957, @p958, @p959, @p960, @p961, @p962, @p963, @p964, @p965, @p966, @p967, @p968, @p969, @p970, @p971, @p972, @p973, @p974, @p975, @p976, @p977, @p978, @p979, @p980, @p981, @p982, @p983, @p984, @p985, @p986, @p987, @p988, @p989, @p990, @p991, @p992, @p993, @p994, @p995, @p996, @p997, @p998, @p999, @p1000, @p1001, @p1002, @p1003, @p1004, @p1005, @p1006, @p1007, 17), (@p1008, @p1009, @p1010, @p1011, @p1012, @p1013, @p1014, @p1015, @p1016, @p1017, @p1018, @p1019, @p1020, @p1021, @p1022, @p1023, @p1024, @p1025, @p1026, @p1027, @p1028, @p1029, @p1030, @p1031, @p1032, @p1033, @p1034, @p1035, @p1036, @p1037, @p1038, @p1039, @p1040, @p1041, @p1042, @p1043, @p1044, @p1045, @p1046, @p1047, @p1048, @p1049, @p1050, @p1051, @p1052, @p1053, @p1054, @p1055, @p1056, @p1057, @p1058, @p1059, @p1060, @p1061, @p1062, @p1063, 18), (@p1064, @p1065, @p1066, @p1067, @p1068, @p1069, @p1070, @p1071, @p1072, @p1073, @p1074, @p1075, @p1076, @p1077, @p1078, @p1079, @p1080, @p1081, @p1082, @p1083, @p1084, @p1085, @p1086, @p1087, @p1088, @p1089, @p1090, @p1091, @p1092, @p1093, @p1094, @p1095, @p1096, @p1097, @p1098, @p1099, @p1100, @p1101, @p1102, @p1103, @p1104, @p1105, @p1106, @p1107, @p1108, @p1109, @p1110, @p1111, @p1112, @p1113, @p1114, @p1115, @p1116, @p1117, @p1118, @p1119, 19), (@p1120, @p1121, @p1122, @p1123, @p1124, @p1125, @p1126, @p1127, @p1128, @p1129, @p1130, @p1131, @p1132, @p1133, @p1134, @p1135, @p1136, @p1137, @p1138, @p1139, @p1140, @p1141, @p1142, @p1143, @p1144, @p1145, @p1146, @p1147, @p1148, @p1149, @p1150, @p1151, @p1152, @p1153, @p1154, @p1155, @p1156, @p1157, @p1158, @p1159, @p1160, @p1161, @p1162, @p1163, @p1164, @p1165, @p1166, @p1167, @p1168, @p1169, @p1170, @p1171, @p1172, @p1173, @p1174, @p1175, 20), (@p1176, @p1177, @p1178, @p1179, @p1180, @p1181, @p1182, @p1183, @p1184, @p1185, @p1186, @p1187, @p1188, @p1189, @p1190, @p1191, @p1192, @p1193, @p1194, @p1195, @p1196, @p1197, @p1198, @p1199, @p1200, @p1201, @p1202, @p1203, @p1204, @p1205, @p1206, @p1207, @p1208, @p1209, @p1210, @p1211, @p1212, @p1213, @p1214, @p1215, @p1216, @p1217, @p1218, @p1219, @p1220, @p1221, @p1222, @p1223, @p1224, @p1225, @p1226, @p1227, @p1228, @p1229, @p1230, @p1231, 21), (@p1232, @p1233, @p1234, @p1235, @p1236, @p1237, @p1238, @p1239, @p1240, @p1241, @p1242, @p1243, @p1244, @p1245, @p1246, @p1247, @p1248, @p1249, @p1250, @p1251, @p1252, @p1253, @p1254, @p1255, @p1256, @p1257, @p1258, @p1259, @p1260, @p1261, @p1262, @p1263, @p1264, @p1265, @p1266, @p1267, @p1268, @p1269, @p1270, @p1271, @p1272, @p1273, @p1274, @p1275, @p1276, @p1277, @p1278, @p1279, @p1280, @p1281, @p1282, @p1283, @p1284, @p1285, @p1286, @p1287, 22), (@p1288, @p1289, @p1290, @p1291, @p1292, @p1293, @p1294, @p1295, @p1296, @p1297, @p1298, @p1299, @p1300, @p1301, @p1302, @p1303, @p1304, @p1305, @p1306, @p1307, @p1308, @p1309, @p1310, @p1311, @p1312, @p1313, @p1314, @p1315, @p1316, @p1317, @p1318, @p1319, @p1320, @p1321, @p1322, @p1323, @p1324, @p1325, @p1326, @p1327, @p1328, @p1329, @p1330, @p1331, @p1332, @p1333, @p1334, @p1335, @p1336, @p1337, @p1338, @p1339, @p1340, @p1341, @p1342, @p1343, 23), (@p1344, @p1345, @p1346, @p1347, @p1348, @p1349, @p1350, @p1351, @p1352, @p1353, @p1354, @p1355, @p1356, @p1357, @p1358, @p1359, @p1360, @p1361, @p1362, @p1363, @p1364, @p1365, @p1366, @p1367, @p1368, @p1369, @p1370, @p1371, @p1372, @p1373, @p1374, @p1375, @p1376, @p1377, @p1378, @p1379, @p1380, @p1381, @p1382, @p1383, @p1384, @p1385, @p1386, @p1387, @p1388, @p1389, @p1390, @p1391, @p1392, @p1393, @p1394, @p1395, @p1396, @p1397, @p1398, @p1399, 24), (@p1400, @p1401, @p1402, @p1403, @p1404, @p1405, @p1406, @p1407, @p1408, @p1409, @p1410, @p1411, @p1412, @p1413, @p1414, @p1415, @p1416, @p1417, @p1418, @p1419, @p1420, @p1421, @p1422, @p1423, @p1424, @p1425, @p1426, @p1427, @p1428, @p1429, @p1430, @p1431, @p1432, @p1433, @p1434, @p1435, @p1436, @p1437, @p1438, @p1439, @p1440, @p1441, @p1442, @p1443, @p1444, @p1445, @p1446, @p1447, @p1448, @p1449, @p1450, @p1451, @p1452, @p1453, @p1454, @p1455, 25), (@p1456, @p1457, @p1458, @p1459, @p1460, @p1461, @p1462, @p1463, @p1464, @p1465, @p1466, @p1467, @p1468, @p1469, @p1470, @p1471, @p1472, @p1473, @p1474, @p1475, @p1476, @p1477, @p1478, @p1479, @p1480, @p1481, @p1482, @p1483, @p1484, @p1485, @p1486, @p1487, @p1488, @p1489, @p1490, @p1491, @p1492, @p1493, @p1494, @p1495, @p1496, @p1497, @p1498, @p1499, @p1500, @p1501, @p1502, @p1503, @p1504, @p1505, @p1506, @p1507, @p1508, @p1509, @p1510, @p1511, 26), (@p1512, @p1513, @p1514, @p1515, @p1516, @p1517, @p1518, @p1519, @p1520, @p1521, @p1522, @p1523, @p1524, @p1525, @p1526, @p1527, @p1528, @p1529, @p1530, @p1531, @p1532, @p1533, @p1534, @p1535, @p1536, @p1537, @p1538, @p1539, @p1540, @p1541, @p1542, @p1543, @p1544, @p1545, @p1546, @p1547, @p1548, @p1549, @p1550, @p1551, @p1552, @p1553, @p1554, @p1555, @p1556, @p1557, @p1558, @p1559, @p1560, @p1561, @p1562, @p1563, @p1564, @p1565, @p1566, @p1567, 27), (@p1568, @p1569, @p1570, @p1571, @p1572, @p1573, @p1574, @p1575, @p1576, @p1577, @p1578, @p1579, @p1580, @p1581, @p1582, @p1583, @p1584, @p1585, @p1586, @p1587, @p1588, @p1589, @p1590, @p1591, @p1592, @p1593, @p1594, @p1595, @p1596, @p1597, @p1598, @p1599, @p1600, @p1601, @p1602, @p1603, @p1604, @p1605, @p1606, @p1607, @p1608, @p1609, @p1610, @p1611, @p1612, @p1613, @p1614, @p1615, @p1616, @p1617, @p1618, @p1619, @p1620, @p1621, @p1622, @p1623, 28), (@p1624, @p1625, @p1626, @p1627, @p1628, @p1629, @p1630, @p1631, @p1632, @p1633, @p1634, @p1635, @p1636, @p1637, @p1638, @p1639, @p1640, @p1641, @p1642, @p1643, @p1644, @p1645, @p1646, @p1647, @p1648, @p1649, @p1650, @p1651, @p1652, @p1653, @p1654, @p1655, @p1656, @p1657, @p1658, @p1659, @p1660, @p1661, @p1662, @p1663, @p1664, @p1665, @p1666, @p1667, @p1668, @p1669, @p1670, @p1671, @p1672, @p1673, @p1674, @p1675, @p1676, @p1677, @p1678, @p1679, 29), (@p1680, @p1681, @p1682, @p1683, @p1684, @p1685, @p1686, @p1687, @p1688, @p1689, @p1690, @p1691, @p1692, @p1693, @p1694, @p1695, @p1696, @p1697, @p1698, @p1699, @p1700, @p1701, @p1702, @p1703, @p1704, @p1705, @p1706, @p1707, @p1708, @p1709, @p1710, @p1711, @p1712, @p1713, @p1714, @p1715, @p1716, @p1717, @p1718, @p1719, @p1720, @p1721, @p1722, @p1723, @p1724, @p1725, @p1726, @p1727, @p1728, @p1729, @p1730, @p1731, @p1732, @p1733, @p1734, @p1735, 30), (@p1736, @p1737, @p1738, @p1739, @p1740, @p1741, @p1742, @p1743, @p1744, @p1745, @p1746, @p1747, @p1748, @p1749, @p1750, @p1751, @p1752, @p1753, @p1754, @p1755, @p1756, @p1757, @p1758, @p1759, @p1760, @p1761, @p1762, @p1763, @p1764, @p1765, @p1766, @p1767, @p1768, @p1769, @p1770, @p1771, @p1772, @p1773, @p1774, @p1775, @p1776, @p1777, @p1778, @p1779, @p1780, @p1781, @p1782, @p1783, @p1784, @p1785, @p1786, @p1787, @p1788, @p1789, @p1790, @p1791, 31), (@p1792, @p1793, @p1794, @p1795, @p1796, @p1797, @p1798, @p1799, @p1800, @p1801, @p1802, @p1803, @p1804, @p1805, @p1806, @p1807, @p1808, @p1809, @p1810, @p1811, @p1812, @p1813, @p1814, @p1815, @p1816, @p1817, @p1818, @p1819, @p1820, @p1821, @p1822, @p1823, @p1824, @p1825, @p1826, @p1827, @p1828, @p1829, @p1830, @p1831, @p1832, @p1833, @p1834, @p1835, @p1836, @p1837, @p1838, @p1839, @p1840, @p1841, @p1842, @p1843, @p1844, @p1845, @p1846, @p1847, 32), (@p1848, @p1849, @p1850, @p1851, @p1852, @p1853, @p1854, @p1855, @p1856, @p1857, @p1858, @p1859, @p1860, @p1861, @p1862, @p1863, @p1864, @p1865, @p1866, @p1867, @p1868, @p1869, @p1870, @p1871, @p1872, @p1873, @p1874, @p1875, @p1876, @p1877, @p1878, @p1879, @p1880, @p1881, @p1882, @p1883, @p1884, @p1885, @p1886, @p1887, @p1888, @p1889, @p1890, @p1891, @p1892, @p1893, @p1894, @p1895, @p1896, @p1897, @p1898, @p1899, @p1900, @p1901, @p1902, @p1903, 33), (@p1904, @p1905, @p1906, @p1907, @p1908, @p1909, @p1910, @p1911, @p1912, @p1913, @p1914, @p1915, @p1916, @p1917, @p1918, @p1919, @p1920, @p1921, @p1922, @p1923, @p1924, @p1925, @p1926, @p1927, @p1928, @p1929, @p1930, @p1931, @p1932, @p1933, @p1934, @p1935, @p1936, @p1937, @p1938, @p1939, @p1940, @p1941, @p1942, @p1943, @p1944, @p1945, @p1946, @p1947, @p1948, @p1949, @p1950, @p1951, @p1952, @p1953, @p1954, @p1955, @p1956, @p1957, @p1958, @p1959, 34), (@p1960, @p1961, @p1962, @p1963, @p1964, @p1965, @p1966, @p1967, @p1968, @p1969, @p1970, @p1971, @p1972, @p1973, @p1974, @p1975, @p1976, @p1977, @p1978, @p1979, @p1980, @p1981, @p1982, @p1983, @p1984, @p1985, @p1986, @p1987, @p1988, @p1989, @p1990, @p1991, @p1992, @p1993, @p1994, @p1995, @p1996, @p1997, @p1998, @p1999, @p2000, @p2001, @p2002, @p2003, @p2004, @p2005, @p2006, @p2007, @p2008, @p2009, @p2010, @p2011, @p2012, @p2013, @p2014, @p2015, 35), (@p2016, @p2017, @p2018, @p2019, @p2020, @p2021, @p2022, @p2023, @p2024, @p2025, @p2026, @p2027, @p2028, @p2029, @p2030, @p2031, @p2032, @p2033, @p2034, @p2035, @p2036, @p2037, @p2038, @p2039, @p2040, @p2041, @p2042, @p2043, @p2044, @p2045, @p2046, @p2047, @p2048, @p2049, @p2050, @p2051, @p2052, @p2053, @p2054, @p2055, @p2056, @p2057, @p2058, @p2059, @p2060, @p2061, @p2062, @p2063, @p2064, @p2065, @p2066, @p2067, @p2068, @p2069, @p2070, @p2071, 36)) AS i ([addressee_cntry_cd], [addressee_city], [addressee_district], [addressee_email], [addressee_full_address], [addressee_home_address], [addressee_name], [addressee_postcode], [addressee_province], [addressee_subdistrict], [addressee_tel], [create_table], [delivery_code], [delivery_recipient_name], [delivery_relation_id], [delivery_status_id], [dest_outlet_id], [dest_outlet_port], [document_number], [item_barcode], [item_cod], [item_gross_weight], [item_height], [item_length], [item_price], [item_width], [lat], [log_id], [long], [outlet_id], [outlet_port], [podUrl], [remark], [scan_cntry_cd], [scan_cntry_postcode], [sender_cntry_cd], [sender_district], [sender_email], [sender_full_address], [sender_home_address], [member_id], [sender_name], [sender_postcode], [sender_province], [sender_subdistrict], [sender_tel], [server_id], [signatureUrl], [state], [status_code], [status_dtm], [timestamp], [transmit_dtm], [user_id], [wckt_id], [wkstn_no], _Position) ON 1=0 WHEN NOT MATCHED THEN INSERT ([addressee_cntry_cd], [addressee_city], [addressee_district], [addressee_email], [addressee_full_address], [addressee_home_address], [addressee_name], [addressee_postcode], [addressee_province], [addressee_subdistrict], [addressee_tel], [create_table], [delivery_code], [delivery_recipient_name], [delivery_relation_id], [delivery_status_id], [dest_outlet_id], [dest_outlet_port], [document_number], [item_barcode], [item_cod], [item_gross_weight], [item_height], [item_length], [item_price], [item_width], [lat], [log_id], [long], [outlet_id], [outlet_port], [podUrl], [remark], [scan_cntry_cd], [scan_cntry_postcode], [sender_cntry_cd], [sender_district], [sender_email], [sender_full_address], [sender_home_address], [member_id], [sender_name], [sender_postcode], [sender_province], [sender_subdistrict], [sender_tel], [server_id], [signatureUrl], [state], [status_code], [status_dtm], [timestamp], [transmit_dtm], [user_id], [wckt_id], [wkstn_no]) VALUES (i.[addressee_cntry_cd], i.[addressee_city], i.[addressee_district], i.[addressee_email], i.[addressee_full_address], i.[addressee_home_address], i.[addressee_name], i.[addressee_postcode], i.[addressee_province], i.[addressee_subdistrict], i.[addressee_tel], i.[create_table], i.[delivery_code], i.[delivery_recipient_name], i.[delivery_relation_id], i.[delivery_status_id], i.[dest_outlet_id], i.[dest_outlet_port], i.[document_number], i.[item_barcode], i.[item_cod], i.[item_gross_weight], i.[item_height], i.[item_length], i.[item_price], i.[item_width], i.[lat], i.[log_id], i.[long], i.[outlet_id], i.[outlet_port], i.[podUrl], i.[remark], i.[scan_cntry_cd], i.[scan_cntry_postcode], i.[sender_cntry_cd], i.[sender_district], i.[sender_email], i.[sender_full_address], i.[sender_home_address], i.[member_id], i.[sender_name], i.[sender_postcode], i.[sender_province], i.[sender_subdistrict], i.[sender_tel], i.[server_id], i.[signatureUrl], i.[state], i.[status_code], i.[status_dtm], i.[timestamp], i.[transmit_dtm], i.[user_id], i.[wckt_id], i.[wkstn_no]) OUTPUT INSERTED.[item_id], i._Position INTO @inserted0;  SELECT [t].[item_id] FROM [raw_data] t INNER JOIN @inserted0 i ON ([t].[item_id] = [i].[item_id]) ORDER BY [i].[_Position];  ",5,5,0,449,5,5
"(@p0 nvarchar(4000),@p1 nvarchar(4000),@p2 nvarchar(4000),@p3 nvarchar(4000),@p4 nvarchar(4000),@p5 nvarchar(4000),@p6 nvarchar(4000),@p7 nvarchar(4000),@p8 nvarchar(4000),@p9 nvarchar(4000),@p10 nvarchar(4000),@p11 datetime2(7),@p12 nvarchar(4000),@p13 nvarchar(4000),@p14 int,@p15 int,@p16 int,@p17 nvarchar(4000),@p18 nvarchar(4000),@p19 nvarchar(4000),@p20 nvarchar(4000),@p21 decimal(18,2),@p22 nvarchar(4000),@p23 nvarchar(4000),@p24 decimal(18,2),@p25 nvarchar(4000),@p26 nvarchar(4000),@p27 nvarchar(4000),@p28 nvarchar(4000),@p29 int,@p30 nvarchar(4000),@p31 nvarchar(4000),@p32 nvarchar(4000),@p33 nvarchar(4000),@p34 nvarchar(4000),@p35 nvarchar(4000),@p36 nvarchar(4000),@p37 nvarchar(4000),@p38 nvarchar(4000),@p39 nvarchar(4000),@p40 int,@p41 nvarchar(4000),@p42 nvarchar(4000),@p43 nvarchar(4000),@p44 nvarchar(4000),@p45 nvarchar(4000),@p46 int,@p47 nvarchar(4000),@p48 int,@p49 int,@p50 datetime2(7),@p51 datetime2(7),@p52 datetime2(7),@p53 nvarchar(4000),@p54 nvarchar(4000),@p55 nvarchar(4000),@p56 nvarchar(4000),@p57 nvarchar(4000),@p58 nvarchar(4000),@p59 nvarchar(4000),@p60 nvarchar(4000),@p61 nvarchar(4000),@p62 nvarchar(4000),@p63 nvarchar(4000),@p64 nvarchar(4000),@p65 nvarchar(4000),@p66 nvarchar(4000),@p67 datetime2(7),@p68 nvarchar(4000),@p69 nvarchar(4000),@p70 int,@p71 int,@p72 int,@p73 nvarchar(4000),@p74 nvarchar(4000),@p75 nvarchar(4000),@p76 nvarchar(4000),@p77 decimal(18,2),@p78 nvarchar(4000),@p79 nvarchar(4000),@p80 decimal(18,2),@p81 nvarchar(4000),@p82 nvarchar(4000),@p83 nvarchar(4000),@p84 nvarchar(4000),@p85 int,@p86 nvarchar(4000),@p87 nvarchar(4000),@p88 nvarchar(4000),@p89 nvarchar(4000),@p90 nvarchar(4000),@p91 nvarchar(4000),@p92 nvarchar(4000),@p93 nvarchar(4000),@p94 nvarchar(4000),@p95 nvarchar(4000),@p96 int,@p97 nvarchar(4000),@p98 nvarchar(4000),@p99 nvarchar(4000),@p100 nvarchar(4000),@p101 nvarchar(4000),@p102 int,@p103 nvarchar(4000),@p104 int,@p105 int,@p106 datetime2(7),@p107 datetime2(7),@p108 datetime2(7),@p109 nvarchar(4000),@p110 nvarchar(4000),@p111 nvarchar(4000),@p112 nvarchar(4000),@p113 nvarchar(4000),@p114 nvarchar(4000),@p115 nvarchar(4000),@p116 nvarchar(4000),@p117 nvarchar(4000),@p118 nvarchar(4000),@p119 nvarchar(4000),@p120 nvarchar(4000),@p121 nvarchar(4000),@p122 nvarchar(4000),@p123 datetime2(7),@p124 nvarchar(4000),@p125 nvarchar(4000),@p126 int,@p127 int,@p128 int,@p129 nvarchar(4000),@p130 nvarchar(4000),@p131 nvarchar(4000),@p132 nvarchar(4000),@p133 decimal(18,2),@p134 nvarchar(4000),@p135 nvarchar(4000),@p136 decimal(18,2),@p137 nvarchar(4000),@p138 nvarchar(4000),@p139 nvarchar(4000),@p140 nvarchar(4000),@p141 int,@p142 nvarchar(4000),@p143 nvarchar(4000),@p144 nvarchar(4000),@p145 nvarchar(4000),@p146 nvarchar(4000),@p147 nvarchar(4000),@p148 nvarchar(4000),@p149 nvarchar(4000),@p150 nvarchar(4000),@p151 nvarchar(4000),@p152 int,@p153 nvarchar(4000),@p154 nvarchar(4000),@p155 nvarchar(4000),@p156 nvarchar(4000),@p157 nvarchar(4000),@p158 int,@p159 nvarchar(4000),@p160 int,@p161 int,@p162 datetime2(7),@p163 datetime2(7),@p164 datetime2(7),@p165 nvarchar(4000),@p166 nvarchar(4000),@p167 nvarchar(4000),@p168 nvarchar(4000),@p169 nvarchar(4000),@p170 nvarchar(4000),@p171 nvarchar(4000),@p172 nvarchar(4000),@p173 nvarchar(4000),@p174 nvarchar(4000),@p175 nvarchar(4000),@p176 nvarchar(4000),@p177 nvarchar(4000),@p178 nvarchar(4000),@p179 datetime2(7),@p180 nvarchar(4000),@p181 nvarchar(4000),@p182 int,@p183 int,@p184 int,@p185 nvarchar(4000),@p186 nvarchar(4000),@p187 nvarchar(4000),@p188 nvarchar(4000),@p189 decimal(18,2),@p190 nvarchar(4000),@p191 nvarchar(4000),@p192 decimal(18,2),@p193 nvarchar(4000),@p194 nvarchar(4000),@p195 nvarchar(4000),@p196 nvarchar(4000),@p197 int,@p198 nvarchar(4000),@p199 nvarchar(4000),@p200 nvarchar(4000),@p201 nvarchar(4000),@p202 nvarchar(4000),@p203 nvarchar(4000),@p204 nvarchar(4000),@p205 nvarchar(4000),@p206 nvarchar(4000),@p207 nvarchar(4000),@p208 int,@p209 nvarchar(4000),@p210 nvarchar(4000),@p211 nvarchar(4000),@p212 nvarchar(4000),@p213 nvarchar(4000),@p214 int,@p215 nvarchar(4000),@p216 int,@p217 int,@p218 datetime2(7),@p219 datetime2(7),@p220 datetime2(7),@p221 nvarchar(4000),@p222 nvarchar(4000),@p223 nvarchar(4000),@p224 nvarchar(4000),@p225 nvarchar(4000),@p226 nvarchar(4000),@p227 nvarchar(4000),@p228 nvarchar(4000),@p229 nvarchar(4000),@p230 nvarchar(4000),@p231 nvarchar(4000),@p232 nvarchar(4000),@p233 nvarchar(4000),@p234 nvarchar(4000),@p235 datetime2(7),@p236 nvarchar(4000),@p237 nvarchar(4000),@p238 int,@p239 int,@p240 int,@p241 nvarchar(4000),@p242 nvarchar(4000),@p243 nvarchar(4000),@p244 nvarchar(4000),@p245 decimal(18,2),@p246 nvarchar(4000),@p247 nvarchar(4000),@p248 decimal(18,2),@p249 nvarchar(4000),@p250 nvarchar(4000),@p251 nvarchar(4000),@p252 nvarchar(4000),@p253 int,@p254 nvarchar(4000),@p255 nvarchar(4000),@p256 nvarchar(4000),@p257 nvarchar(4000),@p258 nvarchar(4000),@p259 nvarchar(4000),@p260 nvarchar(4000),@p261 nvarchar(4000),@p262 nvarchar(4000),@p263 nvarchar(4000),@p264 int,@p265 nvarchar(4000),@p266 nvarchar(4000),@p267 nvarchar(4000),@p268 nvarchar(4000),@p269 nvarchar(4000),@p270 int,@p271 nvarchar(4000),@p272 int,@p273 int,@p274 datetime2(7),@p275 datetime2(7),@p276 datetime2(7),@p277 nvarchar(4000),@p278 nvarchar(4000),@p279 nvarchar(4000),@p280 nvarchar(4000),@p281 nvarchar(4000),@p282 nvarchar(4000),@p283 nvarchar(4000),@p284 nvarchar(4000),@p285 nvarchar(4000),@p286 nvarchar(4000),@p287 nvarchar(4000),@p288 nvarchar(4000),@p289 nvarchar(4000),@p290 nvarchar(4000),@p291 datetime2(7),@p292 nvarchar(4000),@p293 nvarchar(4000),@p294 int,@p295 int,@p296 int,@p297 nvarchar(4000),@p298 nvarchar(4000),@p299 nvarchar(4000),@p300 nvarchar(4000),@p301 decimal(18,2),@p302 nvarchar(4000),@p303 nvarchar(4000),@p304 decimal(18,2),@p305 nvarchar(4000),@p306 nvarchar(4000),@p307 nvarchar(4000),@p308 nvarchar(4000),@p309 int,@p310 nvarchar(4000),@p311 nvarchar(4000),@p312 nvarchar(4000),@p313 nvarchar(4000),@p314 nvarchar(4000),@p315 nvarchar(4000),@p316 nvarchar(4000),@p317 nvarchar(4000),@p318 nvarchar(4000),@p319 nvarchar(4000),@p320 int,@p321 nvarchar(4000),@p322 nvarchar(4000),@p323 nvarchar(4000),@p324 nvarchar(4000),@p325 nvarchar(4000),@p326 int,@p327 nvarchar(4000),@p328 int,@p329 int,@p330 datetime2(7),@p331 datetime2(7),@p332 datetime2(7),@p333 nvarchar(4000),@p334 nvarchar(4000),@p335 nvarchar(4000),@p336 nvarchar(4000),@p337 nvarchar(4000),@p338 nvarchar(4000),@p339 nvarchar(4000),@p340 nvarchar(4000),@p341 nvarchar(4000),@p342 nvarchar(4000),@p343 nvarchar(4000),@p344 nvarchar(4000),@p345 nvarchar(4000),@p346 nvarchar(4000),@p347 datetime2(7),@p348 nvarchar(4000),@p349 nvarchar(4000),@p350 int,@p351 int,@p352 int,@p353 nvarchar(4000),@p354 nvarchar(4000),@p355 nvarchar(4000),@p356 nvarchar(4000),@p357 decimal(18,2),@p358 nvarchar(4000),@p359 nvarchar(4000),@p360 decimal(18,2),@p361 nvarchar(4000),@p362 nvarchar(4000),@p363 nvarchar(4000),@p364 nvarchar(4000),@p365 int,@p366 nvarchar(4000),@p367 nvarchar(4000),@p368 nvarchar(4000),@p369 nvarchar(4000),@p370 nvarchar(4000),@p371 nvarchar(4000),@p372 nvarchar(4000),@p373 nvarchar(4000),@p374 nvarchar(4000),@p375 nvarchar(4000),@p376 int,@p377 nvarchar(4000),@p378 nvarchar(4000),@p379 nvarchar(4000),@p380 nvarchar(4000),@p381 nvarchar(4000),@p382 int,@p383 nvarchar(4000),@p384 int,@p385 int,@p386 datetime2(7),@p387 datetime2(7),@p388 datetime2(7),@p389 nvarchar(4000),@p390 nvarchar(4000),@p391 nvarchar(4000),@p392 nvarchar(4000),@p393 nvarchar(4000),@p394 nvarchar(4000),@p395 nvarchar(4000),@p396 nvarchar(4000),@p397 nvarchar(4000),@p398 nvarchar(4000),@p399 nvarchar(4000),@p400 nvarchar(4000),@p401 nvarchar(4000),@p402 nvarchar(4000),@p403 datetime2(7),@p404 nvarchar(4000),@p405 nvarchar(4000),@p406 int,@p407 int,@p408 int,@p409 nvarchar(4000),@p410 nvarchar(4000),@p411 nvarchar(4000),@p412 nvarchar(4000),@p413 decimal(18,2),@p414 nvarchar(4000),@p415 nvarchar(4000),@p416 decimal(18,2),@p417 nvarchar(4000),@p418 nvarchar(4000),@p419 nvarchar(4000),@p420 nvarchar(4000),@p421 int,@p422 nvarchar(4000),@p423 nvarchar(4000),@p424 nvarchar(4000),@p425 nvarchar(4000),@p426 nvarchar(4000),@p427 nvarchar(4000),@p428 nvarchar(4000),@p429 nvarchar(4000),@p430 nvarchar(4000),@p431 nvarchar(4000),@p432 int,@p433 nvarchar(4000),@p434 nvarchar(4000),@p435 nvarchar(4000),@p436 nvarchar(4000),@p437 nvarchar(4000),@p438 int,@p439 nvarchar(4000),@p440 int,@p441 int,@p442 datetime2(7),@p443 datetime2(7),@p444 datetime2(7),@p445 nvarchar(4000),@p446 nvarchar(4000),@p447 nvarchar(4000),@p448 nvarchar(4000),@p449 nvarchar(4000),@p450 nvarchar(4000),@p451 nvarchar(4000),@p452 nvarchar(4000),@p453 nvarchar(4000),@p454 nvarchar(4000),@p455 nvarchar(4000),@p456 nvarchar(4000),@p457 nvarchar(4000),@p458 nvarchar(4000),@p459 datetime2(7),@p460 nvarchar(4000),@p461 nvarchar(4000),@p462 int,@p463 int,@p464 int,@p465 nvarchar(4000),@p466 nvarchar(4000),@p467 nvarchar(4000),@p468 nvarchar(4000),@p469 decimal(18,2),@p470 nvarchar(4000),@p471 nvarchar(4000),@p472 decimal(18,2),@p473 nvarchar(4000),@p474 nvarchar(4000),@p475 nvarchar(4000),@p476 nvarchar(4000),@p477 int,@p478 nvarchar(4000),@p479 nvarchar(4000),@p480 nvarchar(4000),@p481 nvarchar(4000),@p482 nvarchar(4000),@p483 nvarchar(4000),@p484 nvarchar(4000),@p485 nvarchar(4000),@p486 nvarchar(4000),@p487 nvarchar(4000),@p488 int,@p489 nvarchar(4000),@p490 nvarchar(4000),@p491 nvarchar(4000),@p492 nvarchar(4000),@p493 nvarchar(4000),@p494 int,@p495 nvarchar(4000),@p496 int,@p497 int,@p498 datetime2(7),@p499 datetime2(7),@p500 datetime2(7),@p501 nvarchar(4000),@p502 nvarchar(4000),@p503 nvarchar(4000),@p504 nvarchar(4000),@p505 nvarchar(4000),@p506 nvarchar(4000),@p507 nvarchar(4000),@p508 nvarchar(4000),@p509 nvarchar(4000),@p510 nvarchar(4000),@p511 nvarchar(4000),@p512 nvarchar(4000),@p513 nvarchar(4000),@p514 nvarchar(4000),@p515 datetime2(7),@p516 nvarchar(4000),@p517 nvarchar(4000),@p518 int,@p519 int,@p520 int,@p521 nvarchar(4000),@p522 nvarchar(4000),@p523 nvarchar(4000),@p524 nvarchar(4000),@p525 decimal(18,2),@p526 nvarchar(4000),@p527 nvarchar(4000),@p528 decimal(18,2),@p529 nvarchar(4000),@p530 nvarchar(4000),@p531 nvarchar(4000),@p532 nvarchar(4000),@p533 int,@p534 nvarchar(4000),@p535 nvarchar(4000),@p536 nvarchar(4000),@p537 nvarchar(4000),@p538 nvarchar(4000),@p539 nvarchar(4000),@p540 nvarchar(4000),@p541 nvarchar(4000),@p542 nvarchar(4000),@p543 nvarchar(4000),@p544 int,@p545 nvarchar(4000),@p546 nvarchar(4000),@p547 nvarchar(4000),@p548 nvarchar(4000),@p549 nvarchar(4000),@p550 int,@p551 nvarchar(4000),@p552 int,@p553 int,@p554 datetime2(7),@p555 datetime2(7),@p556 datetime2(7),@p557 nvarchar(4000),@p558 nvarchar(4000),@p559 nvarchar(4000),@p560 nvarchar(4000),@p561 nvarchar(4000),@p562 nvarchar(4000),@p563 nvarchar(4000),@p564 nvarchar(4000),@p565 nvarchar(4000),@p566 nvarchar(4000),@p567 nvarchar(4000),@p568 nvarchar(4000),@p569 nvarchar(4000),@p570 nvarchar(4000),@p571 datetime2(7),@p572 nvarchar(4000),@p573 nvarchar(4000),@p574 int,@p575 int,@p576 int,@p577 nvarchar(4000),@p578 nvarchar(4000),@p579 nvarchar(4000),@p580 nvarchar(4000),@p581 decimal(18,2),@p582 nvarchar(4000),@p583 nvarchar(4000),@p584 decimal(18,2),@p585 nvarchar(4000),@p586 nvarchar(4000),@p587 nvarchar(4000),@p588 nvarchar(4000),@p589 int,@p590 nvarchar(4000),@p591 nvarchar(4000),@p592 nvarchar(4000),@p593 nvarchar(4000),@p594 nvarchar(4000),@p595 nvarchar(4000),@p596 nvarchar(4000),@p597 nvarchar(4000),@p598 nvarchar(4000),@p599 nvarchar(4000),@p600 int,@p601 nvarchar(4000),@p602 nvarchar(4000),@p603 nvarchar(4000),@p604 nvarchar(4000),@p605 nvarchar(4000),@p606 int,@p607 nvarchar(4000),@p608 int,@p609 int,@p610 datetime2(7),@p611 datetime2(7),@p612 datetime2(7),@p613 nvarchar(4000),@p614 nvarchar(4000),@p615 nvarchar(4000),@p616 nvarchar(4000),@p617 nvarchar(4000),@p618 nvarchar(4000),@p619 nvarchar(4000),@p620 nvarchar(4000),@p621 nvarchar(4000),@p622 nvarchar(4000),@p623 nvarchar(4000),@p624 nvarchar(4000),@p625 nvarchar(4000),@p626 nvarchar(4000),@p627 datetime2(7),@p628 nvarchar(4000),@p629 nvarchar(4000),@p630 int,@p631 int,@p632 int,@p633 nvarchar(4000),@p634 nvarchar(4000),@p635 nvarchar(4000),@p636 nvarchar(4000),@p637 decimal(18,2),@p638 nvarchar(4000),@p639 nvarchar(4000),@p640 decimal(18,2),@p641 nvarchar(4000),@p642 nvarchar(4000),@p643 nvarchar(4000),@p644 nvarchar(4000),@p645 int,@p646 nvarchar(4000),@p647 nvarchar(4000),@p648 nvarchar(4000),@p649 nvarchar(4000),@p650 nvarchar(4000),@p651 nvarchar(4000),@p652 nvarchar(4000),@p653 nvarchar(4000),@p654 nvarchar(4000),@p655 nvarchar(4000),@p656 int,@p657 nvarchar(4000),@p658 nvarchar(4000),@p659 nvarchar(4000),@p660 nvarchar(4000),@p661 nvarchar(4000),@p662 int,@p663 nvarchar(4000),@p664 int,@p665 int,@p666 datetime2(7),@p667 datetime2(7),@p668 datetime2(7),@p669 nvarchar(4000),@p670 nvarchar(4000),@p671 nvarchar(4000),@p672 nvarchar(4000),@p673 nvarchar(4000),@p674 nvarchar(4000),@p675 nvarchar(4000),@p676 nvarchar(4000),@p677 nvarchar(4000),@p678 nvarchar(4000),@p679 nvarchar(4000),@p680 nvarchar(4000),@p681 nvarchar(4000),@p682 nvarchar(4000),@p683 datetime2(7),@p684 nvarchar(4000),@p685 nvarchar(4000),@p686 int,@p687 int,@p688 int,@p689 nvarchar(4000),@p690 nvarchar(4000),@p691 nvarchar(4000),@p692 nvarchar(4000),@p693 decimal(18,2),@p694 nvarchar(4000),@p695 nvarchar(4000),@p696 decimal(18,2),@p697 nvarchar(4000),@p698 nvarchar(4000),@p699 nvarchar(4000),@p700 nvarchar(4000),@p701 int,@p702 nvarchar(4000),@p703 nvarchar(4000),@p704 nvarchar(4000),@p705 nvarchar(4000),@p706 nvarchar(4000),@p707 nvarchar(4000),@p708 nvarchar(4000),@p709 nvarchar(4000),@p710 nvarchar(4000),@p711 nvarchar(4000),@p712 int,@p713 nvarchar(4000),@p714 nvarchar(4000),@p715 nvarchar(4000),@p716 nvarchar(4000),@p717 nvarchar(4000),@p718 int,@p719 nvarchar(4000),@p720 int,@p721 int,@p722 datetime2(7),@p723 datetime2(7),@p724 datetime2(7),@p725 nvarchar(4000),@p726 nvarchar(4000),@p727 nvarchar(4000),@p728 nvarchar(4000),@p729 nvarchar(4000),@p730 nvarchar(4000),@p731 nvarchar(4000),@p732 nvarchar(4000),@p733 nvarchar(4000),@p734 nvarchar(4000),@p735 nvarchar(4000),@p736 nvarchar(4000),@p737 nvarchar(4000),@p738 nvarchar(4000),@p739 datetime2(7),@p740 nvarchar(4000),@p741 nvarchar(4000),@p742 int,@p743 int,@p744 int,@p745 nvarchar(4000),@p746 nvarchar(4000),@p747 nvarchar(4000),@p748 nvarchar(4000),@p749 decimal(18,2),@p750 nvarchar(4000),@p751 nvarchar(4000),@p752 decimal(18,2),@p753 nvarchar(4000),@p754 nvarchar(4000),@p755 nvarchar(4000),@p756 nvarchar(4000),@p757 int,@p758 nvarchar(4000),@p759 nvarchar(4000),@p760 nvarchar(4000),@p761 nvarchar(4000),@p762 nvarchar(4000),@p763 nvarchar(4000),@p764 nvarchar(4000),@p765 nvarchar(4000),@p766 nvarchar(4000),@p767 nvarchar(4000),@p768 int,@p769 nvarchar(4000),@p770 nvarchar(4000),@p771 nvarchar(4000),@p772 nvarchar(4000),@p773 nvarchar(4000),@p774 int,@p775 nvarchar(4000),@p776 int,@p777 int,@p778 datetime2(7),@p779 datetime2(7),@p780 datetime2(7),@p781 nvarchar(4000),@p782 nvarchar(4000),@p783 nvarchar(4000),@p784 nvarchar(4000),@p785 nvarchar(4000),@p786 nvarchar(4000),@p787 nvarchar(4000),@p788 nvarchar(4000),@p789 nvarchar(4000),@p790 nvarchar(4000),@p791 nvarchar(4000),@p792 nvarchar(4000),@p793 nvarchar(4000),@p794 nvarchar(4000),@p795 datetime2(7),@p796 nvarchar(4000),@p797 nvarchar(4000),@p798 int,@p799 int,@p800 int,@p801 nvarchar(4000),@p802 nvarchar(4000),@p803 nvarchar(4000),@p804 nvarchar(4000),@p805 decimal(18,2),@p806 nvarchar(4000),@p807 nvarchar(4000),@p808 decimal(18,2),@p809 nvarchar(4000),@p810 nvarchar(4000),@p811 nvarchar(4000),@p812 nvarchar(4000),@p813 int,@p814 nvarchar(4000),@p815 nvarchar(4000),@p816 nvarchar(4000),@p817 nvarchar(4000),@p818 nvarchar(4000),@p819 nvarchar(4000),@p820 nvarchar(4000),@p821 nvarchar(4000),@p822 nvarchar(4000),@p823 nvarchar(4000),@p824 int,@p825 nvarchar(4000),@p826 nvarchar(4000),@p827 nvarchar(4000),@p828 nvarchar(4000),@p829 nvarchar(4000),@p830 int,@p831 nvarchar(4000),@p832 int,@p833 int,@p834 datetime2(7),@p835 datetime2(7),@p836 datetime2(7),@p837 nvarchar(4000),@p838 nvarchar(4000),@p839 nvarchar(4000),@p840 nvarchar(4000),@p841 nvarchar(4000),@p842 nvarchar(4000),@p843 nvarchar(4000),@p844 nvarchar(4000),@p845 nvarchar(4000),@p846 nvarchar(4000),@p847 nvarchar(4000),@p848 nvarchar(4000),@p849 nvarchar(4000),@p850 nvarchar(4000),@p851 datetime2(7),@p852 nvarchar(4000),@p853 nvarchar(4000),@p854 int,@p855 int,@p856 int,@p857 nvarchar(4000),@p858 nvarchar(4000),@p859 nvarchar(4000),@p860 nvarchar(4000),@p861 decimal(18,2),@p862 nvarchar(4000),@p863 nvarchar(4000),@p864 decimal(18,2),@p865 nvarchar(4000),@p866 nvarchar(4000),@p867 nvarchar(4000),@p868 nvarchar(4000),@p869 int,@p870 nvarchar(4000),@p871 nvarchar(4000),@p872 nvarchar(4000),@p873 nvarchar(4000),@p874 nvarchar(4000),@p875 nvarchar(4000),@p876 nvarchar(4000),@p877 nvarchar(4000),@p878 nvarchar(4000),@p879 nvarchar(4000),@p880 int,@p881 nvarchar(4000),@p882 nvarchar(4000),@p883 nvarchar(4000),@p884 nvarchar(4000),@p885 nvarchar(4000),@p886 int,@p887 nvarchar(4000),@p888 int,@p889 int,@p890 datetime2(7),@p891 datetime2(7),@p892 datetime2(7),@p893 nvarchar(4000),@p894 nvarchar(4000),@p895 nvarchar(4000),@p896 nvarchar(4000),@p897 nvarchar(4000),@p898 nvarchar(4000),@p899 nvarchar(4000),@p900 nvarchar(4000),@p901 nvarchar(4000),@p902 nvarchar(4000),@p903 nvarchar(4000),@p904 nvarchar(4000),@p905 nvarchar(4000),@p906 nvarchar(4000),@p907 datetime2(7),@p908 nvarchar(4000),@p909 nvarchar(4000),@p910 int,@p911 int,@p912 int,@p913 nvarchar(4000),@p914 nvarchar(4000),@p915 nvarchar(4000),@p916 nvarchar(4000),@p917 decimal(18,2),@p918 nvarchar(4000),@p919 nvarchar(4000),@p920 decimal(18,2),@p921 nvarchar(4000),@p922 nvarchar(4000),@p923 nvarchar(4000),@p924 nvarchar(4000),@p925 int,@p926 nvarchar(4000),@p927 nvarchar(4000),@p928 nvarchar(4000),@p929 nvarchar(4000),@p930 nvarchar(4000),@p931 nvarchar(4000),@p932 nvarchar(4000),@p933 nvarchar(4000),@p934 nvarchar(4000),@p935 nvarchar(4000),@p936 int,@p937 nvarchar(4000),@p938 nvarchar(4000),@p939 nvarchar(4000),@p940 nvarchar(4000),@p941 nvarchar(4000),@p942 int,@p943 nvarchar(4000),@p944 int,@p945 int,@p946 datetime2(7),@p947 datetime2(7),@p948 datetime2(7),@p949 nvarchar(4000),@p950 nvarchar(4000),@p951 nvarchar(4000),@p952 nvarchar(4000),@p953 nvarchar(4000),@p954 nvarchar(4000),@p955 nvarchar(4000),@p956 nvarchar(4000),@p957 nvarchar(4000),@p958 nvarchar(4000),@p959 nvarchar(4000),@p960 nvarchar(4000),@p961 nvarchar(4000),@p962 nvarchar(4000),@p963 datetime2(7),@p964 nvarchar(4000),@p965 nvarchar(4000),@p966 int,@p967 int,@p968 int,@p969 nvarchar(4000),@p970 nvarchar(4000),@p971 nvarchar(4000),@p972 nvarchar(4000),@p973 decimal(18,2),@p974 nvarchar(4000),@p975 nvarchar(4000),@p976 decimal(18,2),@p977 nvarchar(4000),@p978 nvarchar(4000),@p979 nvarchar(4000),@p980 nvarchar(4000),@p981 int,@p982 nvarchar(4000),@p983 nvarchar(4000),@p984 nvarchar(4000),@p985 nvarchar(4000),@p986 nvarchar(4000),@p987 nvarchar(4000),@p988 nvarchar(4000),@p989 nvarchar(4000),@p990 nvarchar(4000),@p991 nvarchar(4000),@p992 int,@p993 nvarchar(4000),@p994 nvarchar(4000),@p995 nvarchar(4000),@p996 nvarchar(4000),@p997 nvarchar(4000),@p998 int,@p999 nvarchar(4000),@p1000 int,@p1001 int,@p1002 datetime2(7),@p1003 datetime2(7),@p1004 datetime2(7),@p1005 nvarchar(4000),@p1006 nvarchar(4000),@p1007 nvarchar(4000),@p1008 nvarchar(4000),@p1009 nvarchar(4000),@p1010 nvarchar(4000),@p1011 nvarchar(4000),@p1012 nvarchar(4000),@p1013 nvarchar(4000),@p1014 nvarchar(4000),@p1015 nvarchar(4000),@p1016 nvarchar(4000),@p1017 nvarchar(4000),@p1018 nvarchar(4000),@p1019 datetime2(7),@p1020 nvarchar(4000),@p1021 nvarchar(4000),@p1022 int,@p1023 int,@p1024 int,@p1025 nvarchar(4000),@p1026 nvarchar(4000),@p1027 nvarchar(4000),@p1028 nvarchar(4000),@p1029 decimal(18,2),@p1030 nvarchar(4000),@p1031 nvarchar(4000),@p1032 decimal(18,2),@p1033 nvarchar(4000),@p1034 nvarchar(4000),@p1035 nvarchar(4000),@p1036 nvarchar(4000),@p1037 int,@p1038 nvarchar(4000),@p1039 nvarchar(4000),@p1040 nvarchar(4000),@p1041 nvarchar(4000),@p1042 nvarchar(4000),@p1043 nvarchar(4000),@p1044 nvarchar(4000),@p1045 nvarchar(4000),@p1046 nvarchar(4000),@p1047 nvarchar(4000),@p1048 int,@p1049 nvarchar(4000),@p1050 nvarchar(4000),@p1051 nvarchar(4000),@p1052 nvarchar(4000),@p1053 nvarchar(4000),@p1054 int,@p1055 nvarchar(4000),@p1056 int,@p1057 int,@p1058 datetime2(7),@p1059 datetime2(7),@p1060 datetime2(7),@p1061 nvarchar(4000),@p1062 nvarchar(4000),@p1063 nvarchar(4000),@p1064 nvarchar(4000),@p1065 nvarchar(4000),@p1066 nvarchar(4000),@p1067 nvarchar(4000),@p1068 nvarchar(4000),@p1069 nvarchar(4000),@p1070 nvarchar(4000),@p1071 nvarchar(4000),@p1072 nvarchar(4000),@p1073 nvarchar(4000),@p1074 nvarchar(4000),@p1075 datetime2(7),@p1076 nvarchar(4000),@p1077 nvarchar(4000),@p1078 int,@p1079 int,@p1080 int,@p1081 nvarchar(4000),@p1082 nvarchar(4000),@p1083 nvarchar(4000),@p1084 nvarchar(4000),@p1085 decimal(18,2),@p1086 nvarchar(4000),@p1087 nvarchar(4000),@p1088 decimal(18,2),@p1089 nvarchar(4000),@p1090 nvarchar(4000),@p1091 nvarchar(4000),@p1092 nvarchar(4000),@p1093 int,@p1094 nvarchar(4000),@p1095 nvarchar(4000),@p1096 nvarchar(4000),@p1097 nvarchar(4000),@p1098 nvarchar(4000),@p1099 nvarchar(4000),@p1100 nvarchar(4000),@p1101 nvarchar(4000),@p1102 nvarchar(4000),@p1103 nvarchar(4000),@p1104 int,@p1105 nvarchar(4000),@p1106 nvarchar(4000),@p1107 nvarchar(4000),@p1108 nvarchar(4000),@p1109 nvarchar(4000),@p1110 int,@p1111 nvarchar(4000),@p1112 int,@p1113 int,@p1114 datetime2(7),@p1115 datetime2(7),@p1116 datetime2(7),@p1117 nvarchar(4000),@p1118 nvarchar(4000),@p1119 nvarchar(4000),@p1120 nvarchar(4000),@p1121 nvarchar(4000),@p1122 nvarchar(4000),@p1123 nvarchar(4000),@p1124 nvarchar(4000),@p1125 nvarchar(4000),@p1126 nvarchar(4000),@p1127 nvarchar(4000),@p1128 nvarchar(4000),@p1129 nvarchar(4000),@p1130 nvarchar(4000),@p1131 datetime2(7),@p1132 nvarchar(4000),@p1133 nvarchar(4000),@p1134 int,@p1135 int,@p1136 int,@p1137 nvarchar(4000),@p1138 nvarchar(4000),@p1139 nvarchar(4000),@p1140 nvarchar(4000),@p1141 decimal(18,2),@p1142 nvarchar(4000),@p1143 nvarchar(4000),@p1144 decimal(18,2),@p1145 nvarchar(4000),@p1146 nvarchar(4000),@p1147 nvarchar(4000),@p1148 nvarchar(4000),@p1149 int,@p1150 nvarchar(4000),@p1151 nvarchar(4000),@p1152 nvarchar(4000),@p1153 nvarchar(4000),@p1154 nvarchar(4000),@p1155 nvarchar(4000),@p1156 nvarchar(4000),@p1157 nvarchar(4000),@p1158 nvarchar(4000),@p1159 nvarchar(4000),@p1160 int,@p1161 nvarchar(4000),@p1162 nvarchar(4000),@p1163 nvarchar(4000),@p1164 nvarchar(4000),@p1165 nvarchar(4000),@p1166 int,@p1167 nvarchar(4000),@p1168 int,@p1169 int,@p1170 datetime2(7),@p1171 datetime2(7),@p1172 datetime2(7),@p1173 nvarchar(4000),@p1174 nvarchar(4000),@p1175 nvarchar(4000),@p1176 nvarchar(4000),@p1177 nvarchar(4000),@p1178 nvarchar(4000),@p1179 nvarchar(4000),@p1180 nvarchar(4000),@p1181 nvarchar(4000),@p1182 nvarchar(4000),@p1183 nvarchar(4000),@p1184 nvarchar(4000),@p1185 nvarchar(4000),@p1186 nvarchar(4000),@p1187 datetime2(7),@p1188 nvarchar(4000),@p1189 nvarchar(4000),@p1190 int,@p1191 int,@p1192 int,@p1193 nvarchar(4000),@p1194 nvarchar(4000),@p1195 nvarchar(4000),@p1196 nvarchar(4000),@p1197 decimal(18,2),@p1198 nvarchar(4000),@p1199 nvarchar(4000),@p1200 decimal(18,2),@p1201 nvarchar(4000),@p1202 nvarchar(4000),@p1203 nvarchar(4000),@p1204 nvarchar(4000),@p1205 int,@p1206 nvarchar(4000),@p1207 nvarchar(4000),@p1208 nvarchar(4000),@p1209 nvarchar(4000),@p1210 nvarchar(4000),@p1211 nvarchar(4000),@p1212 nvarchar(4000),@p1213 nvarchar(4000),@p1214 nvarchar(4000),@p1215 nvarchar(4000),@p1216 int,@p1217 nvarchar(4000),@p1218 nvarchar(4000),@p1219 nvarchar(4000),@p1220 nvarchar(4000),@p1221 nvarchar(4000),@p1222 int,@p1223 nvarchar(4000),@p1224 int,@p1225 int,@p1226 datetime2(7),@p1227 datetime2(7),@p1228 datetime2(7),@p1229 nvarchar(4000),@p1230 nvarchar(4000),@p1231 nvarchar(4000),@p1232 nvarchar(4000),@p1233 nvarchar(4000),@p1234 nvarchar(4000),@p1235 nvarchar(4000),@p1236 nvarchar(4000),@p1237 nvarchar(4000),@p1238 nvarchar(4000),@p1239 nvarchar(4000),@p1240 nvarchar(4000),@p1241 nvarchar(4000),@p1242 nvarchar(4000),@p1243 datetime2(7),@p1244 nvarchar(4000),@p1245 nvarchar(4000),@p1246 int,@p1247 int,@p1248 int,@p1249 nvarchar(4000),@p1250 nvarchar(4000),@p1251 nvarchar(4000),@p1252 nvarchar(4000),@p1253 decimal(18,2),@p1254 nvarchar(4000),@p1255 nvarchar(4000),@p1256 decimal(18,2),@p1257 nvarchar(4000),@p1258 nvarchar(4000),@p1259 nvarchar(4000),@p1260 nvarchar(4000),@p1261 int,@p1262 nvarchar(4000),@p1263 nvarchar(4000),@p1264 nvarchar(4000),@p1265 nvarchar(4000),@p1266 nvarchar(4000),@p1267 nvarchar(4000),@p1268 nvarchar(4000),@p1269 nvarchar(4000),@p1270 nvarchar(4000),@p1271 nvarchar(4000),@p1272 int,@p1273 nvarchar(4000),@p1274 nvarchar(4000),@p1275 nvarchar(4000),@p1276 nvarchar(4000),@p1277 nvarchar(4000),@p1278 int,@p1279 nvarchar(4000),@p1280 int,@p1281 int,@p1282 datetime2(7),@p1283 datetime2(7),@p1284 datetime2(7),@p1285 nvarchar(4000),@p1286 nvarchar(4000),@p1287 nvarchar(4000),@p1288 nvarchar(4000),@p1289 nvarchar(4000),@p1290 nvarchar(4000),@p1291 nvarchar(4000),@p1292 nvarchar(4000),@p1293 nvarchar(4000),@p1294 nvarchar(4000),@p1295 nvarchar(4000),@p1296 nvarchar(4000),@p1297 nvarchar(4000),@p1298 nvarchar(4000),@p1299 datetime2(7),@p1300 nvarchar(4000),@p1301 nvarchar(4000),@p1302 int,@p1303 int,@p1304 int,@p1305 nvarchar(4000),@p1306 nvarchar(4000),@p1307 nvarchar(4000),@p1308 nvarchar(4000),@p1309 decimal(18,2),@p1310 nvarchar(4000),@p1311 nvarchar(4000),@p1312 decimal(18,2),@p1313 nvarchar(4000),@p1314 nvarchar(4000),@p1315 nvarchar(4000),@p1316 nvarchar(4000),@p1317 int,@p1318 nvarchar(4000),@p1319 nvarchar(4000),@p1320 nvarchar(4000),@p1321 nvarchar(4000),@p1322 nvarchar(4000),@p1323 nvarchar(4000),@p1324 nvarchar(4000),@p1325 nvarchar(4000),@p1326 nvarchar(4000),@p1327 nvarchar(4000),@p1328 int,@p1329 nvarchar(4000),@p1330 nvarchar(4000),@p1331 nvarchar(4000),@p1332 nvarchar(4000),@p1333 nvarchar(4000),@p1334 int,@p1335 nvarchar(4000),@p1336 int,@p1337 int,@p1338 datetime2(7),@p1339 datetime2(7),@p1340 datetime2(7),@p1341 nvarchar(4000),@p1342 nvarchar(4000),@p1343 nvarchar(4000),@p1344 nvarchar(4000),@p1345 nvarchar(4000),@p1346 nvarchar(4000),@p1347 nvarchar(4000),@p1348 nvarchar(4000),@p1349 nvarchar(4000),@p1350 nvarchar(4000),@p1351 nvarchar(4000),@p1352 nvarchar(4000),@p1353 nvarchar(4000),@p1354 nvarchar(4000),@p1355 datetime2(7),@p1356 nvarchar(4000),@p1357 nvarchar(4000),@p1358 int,@p1359 int,@p1360 int,@p1361 nvarchar(4000),@p1362 nvarchar(4000),@p1363 nvarchar(4000),@p1364 nvarchar(4000),@p1365 decimal(18,2),@p1366 nvarchar(4000),@p1367 nvarchar(4000),@p1368 decimal(18,2),@p1369 nvarchar(4000),@p1370 nvarchar(4000),@p1371 nvarchar(4000),@p1372 nvarchar(4000),@p1373 int,@p1374 nvarchar(4000),@p1375 nvarchar(4000),@p1376 nvarchar(4000),@p1377 nvarchar(4000),@p1378 nvarchar(4000),@p1379 nvarchar(4000),@p1380 nvarchar(4000),@p1381 nvarchar(4000),@p1382 nvarchar(4000),@p1383 nvarchar(4000),@p1384 int,@p1385 nvarchar(4000),@p1386 nvarchar(4000),@p1387 nvarchar(4000),@p1388 nvarchar(4000),@p1389 nvarchar(4000),@p1390 int,@p1391 nvarchar(4000),@p1392 int,@p1393 int,@p1394 datetime2(7),@p1395 datetime2(7),@p1396 datetime2(7),@p1397 nvarchar(4000),@p1398 nvarchar(4000),@p1399 nvarchar(4000),@p1400 nvarchar(4000),@p1401 nvarchar(4000),@p1402 nvarchar(4000),@p1403 nvarchar(4000),@p1404 nvarchar(4000),@p1405 nvarchar(4000),@p1406 nvarchar(4000),@p1407 nvarchar(4000),@p1408 nvarchar(4000),@p1409 nvarchar(4000),@p1410 nvarchar(4000),@p1411 datetime2(7),@p1412 nvarchar(4000),@p1413 nvarchar(4000),@p1414 int,@p1415 int,@p1416 int,@p1417 nvarchar(4000),@p1418 nvarchar(4000),@p1419 nvarchar(4000),@p1420 nvarchar(4000),@p1421 decimal(18,2),@p1422 nvarchar(4000),@p1423 nvarchar(4000),@p1424 decimal(18,2),@p1425 nvarchar(4000),@p1426 nvarchar(4000),@p1427 nvarchar(4000),@p1428 nvarchar(4000),@p1429 int,@p1430 nvarchar(4000),@p1431 nvarchar(4000),@p1432 nvarchar(4000),@p1433 nvarchar(4000),@p1434 nvarchar(4000),@p1435 nvarchar(4000),@p1436 nvarchar(4000),@p1437 nvarchar(4000),@p1438 nvarchar(4000),@p1439 nvarchar(4000),@p1440 int,@p1441 nvarchar(4000),@p1442 nvarchar(4000),@p1443 nvarchar(4000),@p1444 nvarchar(4000),@p1445 nvarchar(4000),@p1446 int,@p1447 nvarchar(4000),@p1448 int,@p1449 int,@p1450 datetime2(7),@p1451 datetime2(7),@p1452 datetime2(7),@p1453 nvarchar(4000),@p1454 nvarchar(4000),@p1455 nvarchar(4000),@p1456 nvarchar(4000),@p1457 nvarchar(4000),@p1458 nvarchar(4000),@p1459 nvarchar(4000),@p1460 nvarchar(4000),@p1461 nvarchar(4000),@p1462 nvarchar(4000),@p1463 nvarchar(4000),@p1464 nvarchar(4000),@p1465 nvarchar(4000),@p1466 nvarchar(4000),@p1467 datetime2(7),@p1468 nvarchar(4000),@p1469 nvarchar(4000),@p1470 int,@p1471 int,@p1472 int,@p1473 nvarchar(4000),@p1474 nvarchar(4000),@p1475 nvarchar(4000),@p1476 nvarchar(4000),@p1477 decimal(18,2),@p1478 nvarchar(4000),@p1479 nvarchar(4000),@p1480 decimal(18,2),@p1481 nvarchar(4000),@p1482 nvarchar(4000),@p1483 nvarchar(4000),@p1484 nvarchar(4000),@p1485 int,@p1486 nvarchar(4000),@p1487 nvarchar(4000),@p1488 nvarchar(4000),@p1489 nvarchar(4000),@p1490 nvarchar(4000),@p1491 nvarchar(4000),@p1492 nvarchar(4000),@p1493 nvarchar(4000),@p1494 nvarchar(4000),@p1495 nvarchar(4000),@p1496 int,@p1497 nvarchar(4000),@p1498 nvarchar(4000),@p1499 nvarchar(4000),@p1500 nvarchar(4000),@p1501 nvarchar(4000),@p1502 int,@p1503 nvarchar(4000),@p1504 int,@p1505 int,@p1506 datetime2(7),@p1507 datetime2(7),@p1508 datetime2(7),@p1509 nvarchar(4000),@p1510 nvarchar(4000),@p1511 nvarchar(4000),@p1512 nvarchar(4000),@p1513 nvarchar(4000),@p1514 nvarchar(4000),@p1515 nvarchar(4000),@p1516 nvarchar(4000),@p1517 nvarchar(4000),@p1518 nvarchar(4000),@p1519 nvarchar(4000),@p1520 nvarchar(4000),@p1521 nvarchar(4000),@p1522 nvarchar(4000),@p1523 datetime2(7),@p1524 nvarchar(4000),@p1525 nvarchar(4000),@p1526 int,@p1527 int,@p1528 int,@p1529 nvarchar(4000),@p1530 nvarchar(4000),@p1531 nvarchar(4000),@p1532 nvarchar(4000),@p1533 decimal(18,2),@p1534 nvarchar(4000),@p1535 nvarchar(4000),@p1536 decimal(18,2),@p1537 nvarchar(4000),@p1538 nvarchar(4000),@p1539 nvarchar(4000),@p1540 nvarchar(4000),@p1541 int,@p1542 nvarchar(4000),@p1543 nvarchar(4000),@p1544 nvarchar(4000),@p1545 nvarchar(4000),@p1546 nvarchar(4000),@p1547 nvarchar(4000),@p1548 nvarchar(4000),@p1549 nvarchar(4000),@p1550 nvarchar(4000),@p1551 nvarchar(4000),@p1552 int,@p1553 nvarchar(4000),@p1554 nvarchar(4000),@p1555 nvarchar(4000),@p1556 nvarchar(4000),@p1557 nvarchar(4000),@p1558 int,@p1559 nvarchar(4000),@p1560 int,@p1561 int,@p1562 datetime2(7),@p1563 datetime2(7),@p1564 datetime2(7),@p1565 nvarchar(4000),@p1566 nvarchar(4000),@p1567 nvarchar(4000),@p1568 nvarchar(4000),@p1569 nvarchar(4000),@p1570 nvarchar(4000),@p1571 nvarchar(4000),@p1572 nvarchar(4000),@p1573 nvarchar(4000),@p1574 nvarchar(4000),@p1575 nvarchar(4000),@p1576 nvarchar(4000),@p1577 nvarchar(4000),@p1578 nvarchar(4000),@p1579 datetime2(7),@p1580 nvarchar(4000),@p1581 nvarchar(4000),@p1582 int,@p1583 int,@p1584 int,@p1585 nvarchar(4000),@p1586 nvarchar(4000),@p1587 nvarchar(4000),@p1588 nvarchar(4000),@p1589 decimal(18,2),@p1590 nvarchar(4000),@p1591 nvarchar(4000),@p1592 decimal(18,2),@p1593 nvarchar(4000),@p1594 nvarchar(4000),@p1595 nvarchar(4000),@p1596 nvarchar(4000),@p1597 int,@p1598 nvarchar(4000),@p1599 nvarchar(4000),@p1600 nvarchar(4000),@p1601 nvarchar(4000),@p1602 nvarchar(4000),@p1603 nvarchar(4000),@p1604 nvarchar(4000),@p1605 nvarchar(4000),@p1606 nvarchar(4000),@p1607 nvarchar(4000),@p1608 int,@p1609 nvarchar(4000),@p1610 nvarchar(4000),@p1611 nvarchar(4000),@p1612 nvarchar(4000),@p1613 nvarchar(4000),@p1614 int,@p1615 nvarchar(4000),@p1616 int,@p1617 int,@p1618 datetime2(7),@p1619 datetime2(7),@p1620 datetime2(7),@p1621 nvarchar(4000),@p1622 nvarchar(4000),@p1623 nvarchar(4000),@p1624 nvarchar(4000),@p1625 nvarchar(4000),@p1626 nvarchar(4000),@p1627 nvarchar(4000),@p1628 nvarchar(4000),@p1629 nvarchar(4000),@p1630 nvarchar(4000),@p1631 nvarchar(4000),@p1632 nvarchar(4000),@p1633 nvarchar(4000),@p1634 nvarchar(4000),@p1635 datetime2(7),@p1636 nvarchar(4000),@p1637 nvarchar(4000),@p1638 int,@p1639 int,@p1640 int,@p1641 nvarchar(4000),@p1642 nvarchar(4000),@p1643 nvarchar(4000),@p1644 decimal(18,2),@p1645 decimal(18,2),@p1646 nvarchar(4000),@p1647 nvarchar(4000),@p1648 decimal(18,2),@p1649 nvarchar(4000),@p1650 nvarchar(4000),@p1651 nvarchar(4000),@p1652 nvarchar(4000),@p1653 int,@p1654 nvarchar(4000),@p1655 nvarchar(4000),@p1656 nvarchar(4000),@p1657 nvarchar(4000),@p1658 nvarchar(4000),@p1659 nvarchar(4000),@p1660 nvarchar(4000),@p1661 nvarchar(4000),@p1662 nvarchar(4000),@p1663 nvarchar(4000),@p1664 int,@p1665 nvarchar(4000),@p1666 nvarchar(4000),@p1667 nvarchar(4000),@p1668 nvarchar(4000),@p1669 nvarchar(4000),@p1670 int,@p1671 nvarchar(4000),@p1672 int,@p1673 int,@p1674 datetime2(7),@p1675 datetime2(7),@p1676 datetime2(7),@p1677 nvarchar(4000),@p1678 nvarchar(4000),@p1679 nvarchar(4000),@p1680 nvarchar(4000),@p1681 nvarchar(4000),@p1682 nvarchar(4000),@p1683 nvarchar(4000),@p1684 nvarchar(4000),@p1685 nvarchar(4000),@p1686 nvarchar(4000),@p1687 nvarchar(4000),@p1688 nvarchar(4000),@p1689 nvarchar(4000),@p1690 nvarchar(4000),@p1691 datetime2(7),@p1692 nvarchar(4000),@p1693 nvarchar(4000),@p1694 int,@p1695 int,@p1696 int,@p1697 nvarchar(4000),@p1698 nvarchar(4000),@p1699 nvarchar(4000),@p1700 nvarchar(4000),@p1701 decimal(18,2),@p1702 nvarchar(4000),@p1703 nvarchar(4000),@p1704 decimal(18,2),@p1705 nvarchar(4000),@p1706 nvarchar(4000),@p1707 nvarchar(4000),@p1708 nvarchar(4000),@p1709 int,@p1710 nvarchar(4000),@p1711 nvarchar(4000),@p1712 nvarchar(4000),@p1713 nvarchar(4000),@p1714 nvarchar(4000),@p1715 nvarchar(4000),@p1716 nvarchar(4000),@p1717 nvarchar(4000),@p1718 nvarchar(4000),@p1719 nvarchar(4000),@p1720 int,@p1721 nvarchar(4000),@p1722 nvarchar(4000),@p1723 nvarchar(4000),@p1724 nvarchar(4000),@p1725 nvarchar(4000),@p1726 int,@p1727 nvarchar(4000),@p1728 int,@p1729 int,@p1730 datetime2(7),@p1731 datetime2(7),@p1732 datetime2(7),@p1733 nvarchar(4000),@p1734 nvarchar(4000),@p1735 nvarchar(4000),@p1736 nvarchar(4000),@p1737 nvarchar(4000),@p1738 nvarchar(4000),@p1739 nvarchar(4000),@p1740 nvarchar(4000),@p1741 nvarchar(4000),@p1742 nvarchar(4000),@p1743 nvarchar(4000),@p1744 nvarchar(4000),@p1745 nvarchar(4000),@p1746 nvarchar(4000),@p1747 datetime2(7),@p1748 nvarchar(4000),@p1749 nvarchar(4000),@p1750 int,@p1751 int,@p1752 int,@p1753 nvarchar(4000),@p1754 nvarchar(4000),@p1755 nvarchar(4000),@p1756 nvarchar(4000),@p1757 decimal(18,2),@p1758 nvarchar(4000),@p1759 nvarchar(4000),@p1760 decimal(18,2),@p1761 nvarchar(4000),@p1762 nvarchar(4000),@p1763 nvarchar(4000),@p1764 nvarchar(4000),@p1765 int,@p1766 nvarchar(4000),@p1767 nvarchar(4000),@p1768 nvarchar(4000),@p1769 nvarchar(4000),@p1770 nvarchar(4000),@p1771 nvarchar(4000),@p1772 nvarchar(4000),@p1773 nvarchar(4000),@p1774 nvarchar(4000),@p1775 nvarchar(4000),@p1776 int,@p1777 nvarchar(4000),@p1778 nvarchar(4000),@p1779 nvarchar(4000),@p1780 nvarchar(4000),@p1781 nvarchar(4000),@p1782 int,@p1783 nvarchar(4000),@p1784 int,@p1785 int,@p1786 datetime2(7),@p1787 datetime2(7),@p1788 datetime2(7),@p1789 nvarchar(4000),@p1790 nvarchar(4000),@p1791 nvarchar(4000),@p1792 nvarchar(4000),@p1793 nvarchar(4000),@p1794 nvarchar(4000),@p1795 nvarchar(4000),@p1796 nvarchar(4000),@p1797 nvarchar(4000),@p1798 nvarchar(4000),@p1799 nvarchar(4000),@p1800 nvarchar(4000),@p1801 nvarchar(4000),@p1802 nvarchar(4000),@p1803 datetime2(7),@p1804 nvarchar(4000),@p1805 nvarchar(4000),@p1806 int,@p1807 int,@p1808 int,@p1809 nvarchar(4000),@p1810 nvarchar(4000),@p1811 nvarchar(4000),@p1812 nvarchar(4000),@p1813 decimal(18,2),@p1814 nvarchar(4000),@p1815 nvarchar(4000),@p1816 decimal(18,2),@p1817 nvarchar(4000),@p1818 nvarchar(4000),@p1819 nvarchar(4000),@p1820 nvarchar(4000),@p1821 int,@p1822 nvarchar(4000),@p1823 nvarchar(4000),@p1824 nvarchar(4000),@p1825 nvarchar(4000),@p1826 nvarchar(4000),@p1827 nvarchar(4000),@p1828 nvarchar(4000),@p1829 nvarchar(4000),@p1830 nvarchar(4000),@p1831 nvarchar(4000),@p1832 int,@p1833 nvarchar(4000),@p1834 nvarchar(4000),@p1835 nvarchar(4000),@p1836 nvarchar(4000),@p1837 nvarchar(4000),@p1838 int,@p1839 nvarchar(4000),@p1840 int,@p1841 int,@p1842 datetime2(7),@p1843 datetime2(7),@p1844 datetime2(7),@p1845 nvarchar(4000),@p1846 nvarchar(4000),@p1847 nvarchar(4000),@p1848 nvarchar(4000),@p1849 nvarchar(4000),@p1850 nvarchar(4000),@p1851 nvarchar(4000),@p1852 nvarchar(4000),@p1853 nvarchar(4000),@p1854 nvarchar(4000),@p1855 nvarchar(4000),@p1856 nvarchar(4000),@p1857 nvarchar(4000),@p1858 nvarchar(4000),@p1859 datetime2(7),@p1860 nvarchar(4000),@p1861 nvarchar(4000),@p1862 int,@p1863 int,@p1864 int,@p1865 nvarchar(4000),@p1866 nvarchar(4000),@p1867 nvarchar(4000),@p1868 nvarchar(4000),@p1869 decimal(18,2),@p1870 nvarchar(4000),@p1871 nvarchar(4000),@p1872 decimal(18,2),@p1873 nvarchar(4000),@p1874 nvarchar(4000),@p1875 nvarchar(4000),@p1876 nvarchar(4000),@p1877 int,@p1878 nvarchar(4000),@p1879 nvarchar(4000),@p1880 nvarchar(4000),@p1881 nvarchar(4000),@p1882 nvarchar(4000),@p1883 nvarchar(4000),@p1884 nvarchar(4000),@p1885 nvarchar(4000),@p1886 nvarchar(4000),@p1887 nvarchar(4000),@p1888 int,@p1889 nvarchar(4000),@p1890 nvarchar(4000),@p1891 nvarchar(4000),@p1892 nvarchar(4000),@p1893 nvarchar(4000),@p1894 int,@p1895 nvarchar(4000),@p1896 int,@p1897 int,@p1898 datetime2(7),@p1899 datetime2(7),@p1900 datetime2(7),@p1901 nvarchar(4000),@p1902 nvarchar(4000),@p1903 nvarchar(4000),@p1904 nvarchar(4000),@p1905 nvarchar(4000),@p1906 nvarchar(4000),@p1907 nvarchar(4000),@p1908 nvarchar(4000),@p1909 nvarchar(4000),@p1910 nvarchar(4000),@p1911 nvarchar(4000),@p1912 nvarchar(4000),@p1913 nvarchar(4000),@p1914 nvarchar(4000),@p1915 datetime2(7),@p1916 nvarchar(4000),@p1917 nvarchar(4000),@p1918 int,@p1919 int,@p1920 int,@p1921 nvarchar(4000),@p1922 nvarchar(4000),@p1923 nvarchar(4000),@p1924 nvarchar(4000),@p1925 decimal(18,2),@p1926 nvarchar(4000),@p1927 nvarchar(4000),@p1928 decimal(18,2),@p1929 nvarchar(4000),@p1930 nvarchar(4000),@p1931 nvarchar(4000),@p1932 nvarchar(4000),@p1933 int,@p1934 nvarchar(4000),@p1935 nvarchar(4000),@p1936 nvarchar(4000),@p1937 nvarchar(4000),@p1938 nvarchar(4000),@p1939 nvarchar(4000),@p1940 nvarchar(4000),@p1941 nvarchar(4000),@p1942 nvarchar(4000),@p1943 nvarchar(4000),@p1944 int,@p1945 nvarchar(4000),@p1946 nvarchar(4000),@p1947 nvarchar(4000),@p1948 nvarchar(4000),@p1949 nvarchar(4000),@p1950 int,@p1951 nvarchar(4000),@p1952 int,@p1953 int,@p1954 datetime2(7),@p1955 datetime2(7),@p1956 datetime2(7),@p1957 nvarchar(4000),@p1958 nvarchar(4000),@p1959 nvarchar(4000),@p1960 nvarchar(4000),@p1961 nvarchar(4000),@p1962 nvarchar(4000),@p1963 nvarchar(4000),@p1964 nvarchar(4000),@p1965 nvarchar(4000),@p1966 nvarchar(4000),@p1967 nvarchar(4000),@p1968 nvarchar(4000),@p1969 nvarchar(4000),@p1970 nvarchar(4000),@p1971 datetime2(7),@p1972 nvarchar(4000),@p1973 nvarchar(4000),@p1974 int,@p1975 int,@p1976 int,@p1977 nvarchar(4000),@p1978 nvarchar(4000),@p1979 nvarchar(4000),@p1980 nvarchar(4000),@p1981 decimal(18,2),@p1982 nvarchar(4000),@p1983 nvarchar(4000),@p1984 decimal(18,2),@p1985 nvarchar(4000),@p1986 nvarchar(4000),@p1987 nvarchar(4000),@p1988 nvarchar(4000),@p1989 int,@p1990 nvarchar(4000),@p1991 nvarchar(4000),@p1992 nvarchar(4000),@p1993 nvarchar(4000),@p1994 nvarchar(4000),@p1995 nvarchar(4000),@p1996 nvarchar(4000),@p1997 nvarchar(4000),@p1998 nvarchar(4000),@p1999 nvarchar(4000),@p2000 int,@p2001 nvarchar(4000),@p2002 nvarchar(4000),@p2003 nvarchar(4000),@p2004 nvarchar(4000),@p2005 nvarchar(4000),@p2006 int,@p2007 nvarchar(4000),@p2008 int,@p2009 int,@p2010 datetime2(7),@p2011 datetime2(7),@p2012 datetime2(7),@p2013 nvarchar(4000),@p2014 nvarchar(4000),@p2015 nvarchar(4000),@p2016 nvarchar(4000),@p2017 nvarchar(4000),@p2018 nvarchar(4000),@p2019 nvarchar(4000),@p2020 nvarchar(4000),@p2021 nvarchar(4000),@p2022 nvarchar(4000),@p2023 nvarchar(4000),@p2024 nvarchar(4000),@p2025 nvarchar(4000),@p2026 nvarchar(4000),@p2027 datetime2(7),@p2028 nvarchar(4000),@p2029 nvarchar(4000),@p2030 int,@p2031 int,@p2032 int,@p2033 nvarchar(4000),@p2034 nvarchar(4000),@p2035 nvarchar(4000),@p2036 nvarchar(4000),@p2037 decimal(18,2),@p2038 nvarchar(4000),@p2039 nvarchar(4000),@p2040 decimal(18,2),@p2041 nvarchar(4000),@p2042 nvarchar(4000),@p2043 nvarchar(4000),@p2044 nvarchar(4000),@p2045 int,@p2046 nvarchar(4000),@p2047 nvarchar(4000),@p2048 nvarchar(4000),@p2049 nvarchar(4000),@p2050 nvarchar(4000),@p2051 nvarchar(4000),@p2052 nvarchar(4000),@p2053 nvarchar(4000),@p2054 nvarchar(4000),@p2055 nvarchar(4000),@p2056 int,@p2057 nvarchar(4000),@p2058 nvarchar(4000),@p2059 nvarchar(4000),@p2060 nvarchar(4000),@p2061 nvarchar(4000),@p2062 int,@p2063 nvarchar(4000),@p2064 int,@p2065 int,@p2066 datetime2(7),@p2067 datetime2(7),@p2068 datetime2(7),@p2069 nvarchar(4000),@p2070 nvarchar(4000),@p2071 nvarchar(4000))SET NOCOUNT ON; DECLARE @inserted0 TABLE ([item_id] int, [_Position] [int]); MERGE [raw_data] USING ( VALUES (@p0, @p1, @p2, @p3, @p4, @p5, @p6, @p7, @p8, @p9, @p10, @p11, @p12, @p13, @p14, @p15, @p16, @p17, @p18, @p19, @p20, @p21, @p22, @p23, @p24, @p25, @p26, @p27, @p28, @p29, @p30, @p31, @p32, @p33, @p34, @p35, @p36, @p37, @p38, @p39, @p40, @p41, @p42, @p43, @p44, @p45, @p46, @p47, @p48, @p49, @p50, @p51, @p52, @p53, @p54, @p55, 0), (@p56, @p57, @p58, @p59, @p60, @p61, @p62, @p63, @p64, @p65, @p66, @p67, @p68, @p69, @p70, @p71, @p72, @p73, @p74, @p75, @p76, @p77, @p78, @p79, @p80, @p81, @p82, @p83, @p84, @p85, @p86, @p87, @p88, @p89, @p90, @p91, @p92, @p93, @p94, @p95, @p96, @p97, @p98, @p99, @p100, @p101, @p102, @p103, @p104, @p105, @p106, @p107, @p108, @p109, @p110, @p111, 1), (@p112, @p113, @p114, @p115, @p116, @p117, @p118, @p119, @p120, @p121, @p122, @p123, @p124, @p125, @p126, @p127, @p128, @p129, @p130, @p131, @p132, @p133, @p134, @p135, @p136, @p137, @p138, @p139, @p140, @p141, @p142, @p143, @p144, @p145, @p146, @p147, @p148, @p149, @p150, @p151, @p152, @p153, @p154, @p155, @p156, @p157, @p158, @p159, @p160, @p161, @p162, @p163, @p164, @p165, @p166, @p167, 2), (@p168, @p169, @p170, @p171, @p172, @p173, @p174, @p175, @p176, @p177, @p178, @p179, @p180, @p181, @p182, @p183, @p184, @p185, @p186, @p187, @p188, @p189, @p190, @p191, @p192, @p193, @p194, @p195, @p196, @p197, @p198, @p199, @p200, @p201, @p202, @p203, @p204, @p205, @p206, @p207, @p208, @p209, @p210, @p211, @p212, @p213, @p214, @p215, @p216, @p217, @p218, @p219, @p220, @p221, @p222, @p223, 3), (@p224, @p225, @p226, @p227, @p228, @p229, @p230, @p231, @p232, @p233, @p234, @p235, @p236, @p237, @p238, @p239, @p240, @p241, @p242, @p243, @p244, @p245, @p246, @p247, @p248, @p249, @p250, @p251, @p252, @p253, @p254, @p255, @p256, @p257, @p258, @p259, @p260, @p261, @p262, @p263, @p264, @p265, @p266, @p267, @p268, @p269, @p270, @p271, @p272, @p273, @p274, @p275, @p276, @p277, @p278, @p279, 4), (@p280, @p281, @p282, @p283, @p284, @p285, @p286, @p287, @p288, @p289, @p290, @p291, @p292, @p293, @p294, @p295, @p296, @p297, @p298, @p299, @p300, @p301, @p302, @p303, @p304, @p305, @p306, @p307, @p308, @p309, @p310, @p311, @p312, @p313, @p314, @p315, @p316, @p317, @p318, @p319, @p320, @p321, @p322, @p323, @p324, @p325, @p326, @p327, @p328, @p329, @p330, @p331, @p332, @p333, @p334, @p335, 5), (@p336, @p337, @p338, @p339, @p340, @p341, @p342, @p343, @p344, @p345, @p346, @p347, @p348, @p349, @p350, @p351, @p352, @p353, @p354, @p355, @p356, @p357, @p358, @p359, @p360, @p361, @p362, @p363, @p364, @p365, @p366, @p367, @p368, @p369, @p370, @p371, @p372, @p373, @p374, @p375, @p376, @p377, @p378, @p379, @p380, @p381, @p382, @p383, @p384, @p385, @p386, @p387, @p388, @p389, @p390, @p391, 6), (@p392, @p393, @p394, @p395, @p396, @p397, @p398, @p399, @p400, @p401, @p402, @p403, @p404, @p405, @p406, @p407, @p408, @p409, @p410, @p411, @p412, @p413, @p414, @p415, @p416, @p417, @p418, @p419, @p420, @p421, @p422, @p423, @p424, @p425, @p426, @p427, @p428, @p429, @p430, @p431, @p432, @p433, @p434, @p435, @p436, @p437, @p438, @p439, @p440, @p441, @p442, @p443, @p444, @p445, @p446, @p447, 7), (@p448, @p449, @p450, @p451, @p452, @p453, @p454, @p455, @p456, @p457, @p458, @p459, @p460, @p461, @p462, @p463, @p464, @p465, @p466, @p467, @p468, @p469, @p470, @p471, @p472, @p473, @p474, @p475, @p476, @p477, @p478, @p479, @p480, @p481, @p482, @p483, @p484, @p485, @p486, @p487, @p488, @p489, @p490, @p491, @p492, @p493, @p494, @p495, @p496, @p497, @p498, @p499, @p500, @p501, @p502, @p503, 8), (@p504, @p505, @p506, @p507, @p508, @p509, @p510, @p511, @p512, @p513, @p514, @p515, @p516, @p517, @p518, @p519, @p520, @p521, @p522, @p523, @p524, @p525, @p526, @p527, @p528, @p529, @p530, @p531, @p532, @p533, @p534, @p535, @p536, @p537, @p538, @p539, @p540, @p541, @p542, @p543, @p544, @p545, @p546, @p547, @p548, @p549, @p550, @p551, @p552, @p553, @p554, @p555, @p556, @p557, @p558, @p559, 9), (@p560, @p561, @p562, @p563, @p564, @p565, @p566, @p567, @p568, @p569, @p570, @p571, @p572, @p573, @p574, @p575, @p576, @p577, @p578, @p579, @p580, @p581, @p582, @p583, @p584, @p585, @p586, @p587, @p588, @p589, @p590, @p591, @p592, @p593, @p594, @p595, @p596, @p597, @p598, @p599, @p600, @p601, @p602, @p603, @p604, @p605, @p606, @p607, @p608, @p609, @p610, @p611, @p612, @p613, @p614, @p615, 10), (@p616, @p617, @p618, @p619, @p620, @p621, @p622, @p623, @p624, @p625, @p626, @p627, @p628, @p629, @p630, @p631, @p632, @p633, @p634, @p635, @p636, @p637, @p638, @p639, @p640, @p641, @p642, @p643, @p644, @p645, @p646, @p647, @p648, @p649, @p650, @p651, @p652, @p653, @p654, @p655, @p656, @p657, @p658, @p659, @p660, @p661, @p662, @p663, @p664, @p665, @p666, @p667, @p668, @p669, @p670, @p671, 11), (@p672, @p673, @p674, @p675, @p676, @p677, @p678, @p679, @p680, @p681, @p682, @p683, @p684, @p685, @p686, @p687, @p688, @p689, @p690, @p691, @p692, @p693, @p694, @p695, @p696, @p697, @p698, @p699, @p700, @p701, @p702, @p703, @p704, @p705, @p706, @p707, @p708, @p709, @p710, @p711, @p712, @p713, @p714, @p715, @p716, @p717, @p718, @p719, @p720, @p721, @p722, @p723, @p724, @p725, @p726, @p727, 12), (@p728, @p729, @p730, @p731, @p732, @p733, @p734, @p735, @p736, @p737, @p738, @p739, @p740, @p741, @p742, @p743, @p744, @p745, @p746, @p747, @p748, @p749, @p750, @p751, @p752, @p753, @p754, @p755, @p756, @p757, @p758, @p759, @p760, @p761, @p762, @p763, @p764, @p765, @p766, @p767, @p768, @p769, @p770, @p771, @p772, @p773, @p774, @p775, @p776, @p777, @p778, @p779, @p780, @p781, @p782, @p783, 13), (@p784, @p785, @p786, @p787, @p788, @p789, @p790, @p791, @p792, @p793, @p794, @p795, @p796, @p797, @p798, @p799, @p800, @p801, @p802, @p803, @p804, @p805, @p806, @p807, @p808, @p809, @p810, @p811, @p812, @p813, @p814, @p815, @p816, @p817, @p818, @p819, @p820, @p821, @p822, @p823, @p824, @p825, @p826, @p827, @p828, @p829, @p830, @p831, @p832, @p833, @p834, @p835, @p836, @p837, @p838, @p839, 14), (@p840, @p841, @p842, @p843, @p844, @p845, @p846, @p847, @p848, @p849, @p850, @p851, @p852, @p853, @p854, @p855, @p856, @p857, @p858, @p859, @p860, @p861, @p862, @p863, @p864, @p865, @p866, @p867, @p868, @p869, @p870, @p871, @p872, @p873, @p874, @p875, @p876, @p877, @p878, @p879, @p880, @p881, @p882, @p883, @p884, @p885, @p886, @p887, @p888, @p889, @p890, @p891, @p892, @p893, @p894, @p895, 15), (@p896, @p897, @p898, @p899, @p900, @p901, @p902, @p903, @p904, @p905, @p906, @p907, @p908, @p909, @p910, @p911, @p912, @p913, @p914, @p915, @p916, @p917, @p918, @p919, @p920, @p921, @p922, @p923, @p924, @p925, @p926, @p927, @p928, @p929, @p930, @p931, @p932, @p933, @p934, @p935, @p936, @p937, @p938, @p939, @p940, @p941, @p942, @p943, @p944, @p945, @p946, @p947, @p948, @p949, @p950, @p951, 16), (@p952, @p953, @p954, @p955, @p956, @p957, @p958, @p959, @p960, @p961, @p962, @p963, @p964, @p965, @p966, @p967, @p968, @p969, @p970, @p971, @p972, @p973, @p974, @p975, @p976, @p977, @p978, @p979, @p980, @p981, @p982, @p983, @p984, @p985, @p986, @p987, @p988, @p989, @p990, @p991, @p992, @p993, @p994, @p995, @p996, @p997, @p998, @p999, @p1000, @p1001, @p1002, @p1003, @p1004, @p1005, @p1006, @p1007, 17), (@p1008, @p1009, @p1010, @p1011, @p1012, @p1013, @p1014, @p1015, @p1016, @p1017, @p1018, @p1019, @p1020, @p1021, @p1022, @p1023, @p1024, @p1025, @p1026, @p1027, @p1028, @p1029, @p1030, @p1031, @p1032, @p1033, @p1034, @p1035, @p1036, @p1037, @p1038, @p1039, @p1040, @p1041, @p1042, @p1043, @p1044, @p1045, @p1046, @p1047, @p1048, @p1049, @p1050, @p1051, @p1052, @p1053, @p1054, @p1055, @p1056, @p1057, @p1058, @p1059, @p1060, @p1061, @p1062, @p1063, 18), (@p1064, @p1065, @p1066, @p1067, @p1068, @p1069, @p1070, @p1071, @p1072, @p1073, @p1074, @p1075, @p1076, @p1077, @p1078, @p1079, @p1080, @p1081, @p1082, @p1083, @p1084, @p1085, @p1086, @p1087, @p1088, @p1089, @p1090, @p1091, @p1092, @p1093, @p1094, @p1095, @p1096, @p1097, @p1098, @p1099, @p1100, @p1101, @p1102, @p1103, @p1104, @p1105, @p1106, @p1107, @p1108, @p1109, @p1110, @p1111, @p1112, @p1113, @p1114, @p1115, @p1116, @p1117, @p1118, @p1119, 19), (@p1120, @p1121, @p1122, @p1123, @p1124, @p1125, @p1126, @p1127, @p1128, @p1129, @p1130, @p1131, @p1132, @p1133, @p1134, @p1135, @p1136, @p1137, @p1138, @p1139, @p1140, @p1141, @p1142, @p1143, @p1144, @p1145, @p1146, @p1147, @p1148, @p1149, @p1150, @p1151, @p1152, @p1153, @p1154, @p1155, @p1156, @p1157, @p1158, @p1159, @p1160, @p1161, @p1162, @p1163, @p1164, @p1165, @p1166, @p1167, @p1168, @p1169, @p1170, @p1171, @p1172, @p1173, @p1174, @p1175, 20), (@p1176, @p1177, @p1178, @p1179, @p1180, @p1181, @p1182, @p1183, @p1184, @p1185, @p1186, @p1187, @p1188, @p1189, @p1190, @p1191, @p1192, @p1193, @p1194, @p1195, @p1196, @p1197, @p1198, @p1199, @p1200, @p1201, @p1202, @p1203, @p1204, @p1205, @p1206, @p1207, @p1208, @p1209, @p1210, @p1211, @p1212, @p1213, @p1214, @p1215, @p1216, @p1217, @p1218, @p1219, @p1220, @p1221, @p1222, @p1223, @p1224, @p1225, @p1226, @p1227, @p1228, @p1229, @p1230, @p1231, 21), (@p1232, @p1233, @p1234, @p1235, @p1236, @p1237, @p1238, @p1239, @p1240, @p1241, @p1242, @p1243, @p1244, @p1245, @p1246, @p1247, @p1248, @p1249, @p1250, @p1251, @p1252, @p1253, @p1254, @p1255, @p1256, @p1257, @p1258, @p1259, @p1260, @p1261, @p1262, @p1263, @p1264, @p1265, @p1266, @p1267, @p1268, @p1269, @p1270, @p1271, @p1272, @p1273, @p1274, @p1275, @p1276, @p1277, @p1278, @p1279, @p1280, @p1281, @p1282, @p1283, @p1284, @p1285, @p1286, @p1287, 22), (@p1288, @p1289, @p1290, @p1291, @p1292, @p1293, @p1294, @p1295, @p1296, @p1297, @p1298, @p1299, @p1300, @p1301, @p1302, @p1303, @p1304, @p1305, @p1306, @p1307, @p1308, @p1309, @p1310, @p1311, @p1312, @p1313, @p1314, @p1315, @p1316, @p1317, @p1318, @p1319, @p1320, @p1321, @p1322, @p1323, @p1324, @p1325, @p1326, @p1327, @p1328, @p1329, @p1330, @p1331, @p1332, @p1333, @p1334, @p1335, @p1336, @p1337, @p1338, @p1339, @p1340, @p1341, @p1342, @p1343, 23), (@p1344, @p1345, @p1346, @p1347, @p1348, @p1349, @p1350, @p1351, @p1352, @p1353, @p1354, @p1355, @p1356, @p1357, @p1358, @p1359, @p1360, @p1361, @p1362, @p1363, @p1364, @p1365, @p1366, @p1367, @p1368, @p1369, @p1370, @p1371, @p1372, @p1373, @p1374, @p1375, @p1376, @p1377, @p1378, @p1379, @p1380, @p1381, @p1382, @p1383, @p1384, @p1385, @p1386, @p1387, @p1388, @p1389, @p1390, @p1391, @p1392, @p1393, @p1394, @p1395, @p1396, @p1397, @p1398, @p1399, 24), (@p1400, @p1401, @p1402, @p1403, @p1404, @p1405, @p1406, @p1407, @p1408, @p1409, @p1410, @p1411, @p1412, @p1413, @p1414, @p1415, @p1416, @p1417, @p1418, @p1419, @p1420, @p1421, @p1422, @p1423, @p1424, @p1425, @p1426, @p1427, @p1428, @p1429, @p1430, @p1431, @p1432, @p1433, @p1434, @p1435, @p1436, @p1437, @p1438, @p1439, @p1440, @p1441, @p1442, @p1443, @p1444, @p1445, @p1446, @p1447, @p1448, @p1449, @p1450, @p1451, @p1452, @p1453, @p1454, @p1455, 25), (@p1456, @p1457, @p1458, @p1459, @p1460, @p1461, @p1462, @p1463, @p1464, @p1465, @p1466, @p1467, @p1468, @p1469, @p1470, @p1471, @p1472, @p1473, @p1474, @p1475, @p1476, @p1477, @p1478, @p1479, @p1480, @p1481, @p1482, @p1483, @p1484, @p1485, @p1486, @p1487, @p1488, @p1489, @p1490, @p1491, @p1492, @p1493, @p1494, @p1495, @p1496, @p1497, @p1498, @p1499, @p1500, @p1501, @p1502, @p1503, @p1504, @p1505, @p1506, @p1507, @p1508, @p1509, @p1510, @p1511, 26), (@p1512, @p1513, @p1514, @p1515, @p1516, @p1517, @p1518, @p1519, @p1520, @p1521, @p1522, @p1523, @p1524, @p1525, @p1526, @p1527, @p1528, @p1529, @p1530, @p1531, @p1532, @p1533, @p1534, @p1535, @p1536, @p1537, @p1538, @p1539, @p1540, @p1541, @p1542, @p1543, @p1544, @p1545, @p1546, @p1547, @p1548, @p1549, @p1550, @p1551, @p1552, @p1553, @p1554, @p1555, @p1556, @p1557, @p1558, @p1559, @p1560, @p1561, @p1562, @p1563, @p1564, @p1565, @p1566, @p1567, 27), (@p1568, @p1569, @p1570, @p1571, @p1572, @p1573, @p1574, @p1575, @p1576, @p1577, @p1578, @p1579, @p1580, @p1581, @p1582, @p1583, @p1584, @p1585, @p1586, @p1587, @p1588, @p1589, @p1590, @p1591, @p1592, @p1593, @p1594, @p1595, @p1596, @p1597, @p1598, @p1599, @p1600, @p1601, @p1602, @p1603, @p1604, @p1605, @p1606, @p1607, @p1608, @p1609, @p1610, @p1611, @p1612, @p1613, @p1614, @p1615, @p1616, @p1617, @p1618, @p1619, @p1620, @p1621, @p1622, @p1623, 28), (@p1624, @p1625, @p1626, @p1627, @p1628, @p1629, @p1630, @p1631, @p1632, @p1633, @p1634, @p1635, @p1636, @p1637, @p1638, @p1639, @p1640, @p1641, @p1642, @p1643, @p1644, @p1645, @p1646, @p1647, @p1648, @p1649, @p1650, @p1651, @p1652, @p1653, @p1654, @p1655, @p1656, @p1657, @p1658, @p1659, @p1660, @p1661, @p1662, @p1663, @p1664, @p1665, @p1666, @p1667, @p1668, @p1669, @p1670, @p1671, @p1672, @p1673, @p1674, @p1675, @p1676, @p1677, @p1678, @p1679, 29), (@p1680, @p1681, @p1682, @p1683, @p1684, @p1685, @p1686, @p1687, @p1688, @p1689, @p1690, @p1691, @p1692, @p1693, @p1694, @p1695, @p1696, @p1697, @p1698, @p1699, @p1700, @p1701, @p1702, @p1703, @p1704, @p1705, @p1706, @p1707, @p1708, @p1709, @p1710, @p1711, @p1712, @p1713, @p1714, @p1715, @p1716, @p1717, @p1718, @p1719, @p1720, @p1721, @p1722, @p1723, @p1724, @p1725, @p1726, @p1727, @p1728, @p1729, @p1730, @p1731, @p1732, @p1733, @p1734, @p1735, 30), (@p1736, @p1737, @p1738, @p1739, @p1740, @p1741, @p1742, @p1743, @p1744, @p1745, @p1746, @p1747, @p1748, @p1749, @p1750, @p1751, @p1752, @p1753, @p1754, @p1755, @p1756, @p1757, @p1758, @p1759, @p1760, @p1761, @p1762, @p1763, @p1764, @p1765, @p1766, @p1767, @p1768, @p1769, @p1770, @p1771, @p1772, @p1773, @p1774, @p1775, @p1776, @p1777, @p1778, @p1779, @p1780, @p1781, @p1782, @p1783, @p1784, @p1785, @p1786, @p1787, @p1788, @p1789, @p1790, @p1791, 31), (@p1792, @p1793, @p1794, @p1795, @p1796, @p1797, @p1798, @p1799, @p1800, @p1801, @p1802, @p1803, @p1804, @p1805, @p1806, @p1807, @p1808, @p1809, @p1810, @p1811, @p1812, @p1813, @p1814, @p1815, @p1816, @p1817, @p1818, @p1819, @p1820, @p1821, @p1822, @p1823, @p1824, @p1825, @p1826, @p1827, @p1828, @p1829, @p1830, @p1831, @p1832, @p1833, @p1834, @p1835, @p1836, @p1837, @p1838, @p1839, @p1840, @p1841, @p1842, @p1843, @p1844, @p1845, @p1846, @p1847, 32), (@p1848, @p1849, @p1850, @p1851, @p1852, @p1853, @p1854, @p1855, @p1856, @p1857, @p1858, @p1859, @p1860, @p1861, @p1862, @p1863, @p1864, @p1865, @p1866, @p1867, @p1868, @p1869, @p1870, @p1871, @p1872, @p1873, @p1874, @p1875, @p1876, @p1877, @p1878, @p1879, @p1880, @p1881, @p1882, @p1883, @p1884, @p1885, @p1886, @p1887, @p1888, @p1889, @p1890, @p1891, @p1892, @p1893, @p1894, @p1895, @p1896, @p1897, @p1898, @p1899, @p1900, @p1901, @p1902, @p1903, 33), (@p1904, @p1905, @p1906, @p1907, @p1908, @p1909, @p1910, @p1911, @p1912, @p1913, @p1914, @p1915, @p1916, @p1917, @p1918, @p1919, @p1920, @p1921, @p1922, @p1923, @p1924, @p1925, @p1926, @p1927, @p1928, @p1929, @p1930, @p1931, @p1932, @p1933, @p1934, @p1935, @p1936, @p1937, @p1938, @p1939, @p1940, @p1941, @p1942, @p1943, @p1944, @p1945, @p1946, @p1947, @p1948, @p1949, @p1950, @p1951, @p1952, @p1953, @p1954, @p1955, @p1956, @p1957, @p1958, @p1959, 34), (@p1960, @p1961, @p1962, @p1963, @p1964, @p1965, @p1966, @p1967, @p1968, @p1969, @p1970, @p1971, @p1972, @p1973, @p1974, @p1975, @p1976, @p1977, @p1978, @p1979, @p1980, @p1981, @p1982, @p1983, @p1984, @p1985, @p1986, @p1987, @p1988, @p1989, @p1990, @p1991, @p1992, @p1993, @p1994, @p1995, @p1996, @p1997, @p1998, @p1999, @p2000, @p2001, @p2002, @p2003, @p2004, @p2005, @p2006, @p2007, @p2008, @p2009, @p2010, @p2011, @p2012, @p2013, @p2014, @p2015, 35), (@p2016, @p2017, @p2018, @p2019, @p2020, @p2021, @p2022, @p2023, @p2024, @p2025, @p2026, @p2027, @p2028, @p2029, @p2030, @p2031, @p2032, @p2033, @p2034, @p2035, @p2036, @p2037, @p2038, @p2039, @p2040, @p2041, @p2042, @p2043, @p2044, @p2045, @p2046, @p2047, @p2048, @p2049, @p2050, @p2051, @p2052, @p2053, @p2054, @p2055, @p2056, @p2057, @p2058, @p2059, @p2060, @p2061, @p2062, @p2063, @p2064, @p2065, @p2066, @p2067, @p2068, @p2069, @p2070, @p2071, 36)) AS i ([addressee_cntry_cd], [addressee_city], [addressee_district], [addressee_email], [addressee_full_address], [addressee_home_address], [addressee_name], [addressee_postcode], [addressee_province], [addressee_subdistrict], [addressee_tel], [create_table], [delivery_code], [delivery_recipient_name], [delivery_relation_id], [delivery_status_id], [dest_outlet_id], [dest_outlet_port], [document_number], [item_barcode], [item_cod], [item_gross_weight], [item_height], [item_length], [item_price], [item_width], [lat], [log_id], [long], [outlet_id], [outlet_port], [podUrl], [remark], [scan_cntry_cd], [scan_cntry_postcode], [sender_cntry_cd], [sender_district], [sender_email], [sender_full_address], [sender_home_address], [member_id], [sender_name], [sender_postcode], [sender_province], [sender_subdistrict], [sender_tel], [server_id], [signatureUrl], [state], [status_code], [status_dtm], [timestamp], [transmit_dtm], [user_id], [wckt_id], [wkstn_no], _Position) ON 1=0 WHEN NOT MATCHED THEN INSERT ([addressee_cntry_cd], [addressee_city], [addressee_district], [addressee_email], [addressee_full_address], [addressee_home_address], [addressee_name], [addressee_postcode], [addressee_province], [addressee_subdistrict], [addressee_tel], [create_table], [delivery_code], [delivery_recipient_name], [delivery_relation_id], [delivery_status_id], [dest_outlet_id], [dest_outlet_port], [document_number], [item_barcode], [item_cod], [item_gross_weight], [item_height], [item_length], [item_price], [item_width], [lat], [log_id], [long], [outlet_id], [outlet_port], [podUrl], [remark], [scan_cntry_cd], [scan_cntry_postcode], [sender_cntry_cd], [sender_district], [sender_email], [sender_full_address], [sender_home_address], [member_id], [sender_name], [sender_postcode], [sender_province], [sender_subdistrict], [sender_tel], [server_id], [signatureUrl], [state], [status_code], [status_dtm], [timestamp], [transmit_dtm], [user_id], [wckt_id], [wkstn_no]) VALUES (i.[addressee_cntry_cd], i.[addressee_city], i.[addressee_district], i.[addressee_email], i.[addressee_full_address], i.[addressee_home_address], i.[addressee_name], i.[addressee_postcode], i.[addressee_province], i.[addressee_subdistrict], i.[addressee_tel], i.[create_table], i.[delivery_code], i.[delivery_recipient_name], i.[delivery_relation_id], i.[delivery_status_id], i.[dest_outlet_id], i.[dest_outlet_port], i.[document_number], i.[item_barcode], i.[item_cod], i.[item_gross_weight], i.[item_height], i.[item_length], i.[item_price], i.[item_width], i.[lat], i.[log_id], i.[long], i.[outlet_id], i.[outlet_port], i.[podUrl], i.[remark], i.[scan_cntry_cd], i.[scan_cntry_postcode], i.[sender_cntry_cd], i.[sender_district], i.[sender_email], i.[sender_full_address], i.[sender_home_address], i.[member_id], i.[sender_name], i.[sender_postcode], i.[sender_province], i.[sender_subdistrict], i.[sender_tel], i.[server_id], i.[signatureUrl], i.[state], i.[status_code], i.[status_dtm], i.[timestamp], i.[transmit_dtm], i.[user_id], i.[wckt_id], i.[wkstn_no]) OUTPUT INSERTED.[item_id], i._Position INTO @inserted0;  SELECT [t].[item_id] FROM [raw_data] t INNER JOIN @inserted0 i ON ([t].[item_id] = [i].[item_id]) ORDER BY [i].[_Position];  ",5,5,0,421,3,20
"(@p0 nvarchar(4000),@p1 nvarchar(4000),@p2 nvarchar(4000),@p3 nvarchar(4000),@p4 nvarchar(4000),@p5 nvarchar(4000),@p6 nvarchar(4000),@p7 nvarchar(4000),@p8 nvarchar(4000),@p9 nvarchar(4000),@p10 nvarchar(4000),@p11 datetime2(7),@p12 nvarchar(4000),@p13 nvarchar(4000),@p14 int,@p15 int,@p16 int,@p17 nvarchar(4000),@p18 nvarchar(4000),@p19 nvarchar(4000),@p20 nvarchar(4000),@p21 decimal(18,2),@p22 nvarchar(4000),@p23 nvarchar(4000),@p24 decimal(18,2),@p25 nvarchar(4000),@p26 nvarchar(4000),@p27 nvarchar(4000),@p28 nvarchar(4000),@p29 int,@p30 nvarchar(4000),@p31 nvarchar(4000),@p32 nvarchar(4000),@p33 nvarchar(4000),@p34 nvarchar(4000),@p35 nvarchar(4000),@p36 nvarchar(4000),@p37 nvarchar(4000),@p38 nvarchar(4000),@p39 nvarchar(4000),@p40 int,@p41 nvarchar(4000),@p42 nvarchar(4000),@p43 nvarchar(4000),@p44 nvarchar(4000),@p45 nvarchar(4000),@p46 int,@p47 nvarchar(4000),@p48 int,@p49 int,@p50 datetime2(7),@p51 datetime2(7),@p52 datetime2(7),@p53 nvarchar(4000),@p54 nvarchar(4000),@p55 nvarchar(4000),@p56 nvarchar(4000),@p57 nvarchar(4000),@p58 nvarchar(4000),@p59 nvarchar(4000),@p60 nvarchar(4000),@p61 nvarchar(4000),@p62 nvarchar(4000),@p63 nvarchar(4000),@p64 nvarchar(4000),@p65 nvarchar(4000),@p66 nvarchar(4000),@p67 datetime2(7),@p68 nvarchar(4000),@p69 nvarchar(4000),@p70 int,@p71 int,@p72 int,@p73 nvarchar(4000),@p74 nvarchar(4000),@p75 nvarchar(4000),@p76 nvarchar(4000),@p77 decimal(18,2),@p78 nvarchar(4000),@p79 nvarchar(4000),@p80 decimal(18,2),@p81 nvarchar(4000),@p82 nvarchar(4000),@p83 nvarchar(4000),@p84 nvarchar(4000),@p85 int,@p86 nvarchar(4000),@p87 nvarchar(4000),@p88 nvarchar(4000),@p89 nvarchar(4000),@p90 nvarchar(4000),@p91 nvarchar(4000),@p92 nvarchar(4000),@p93 nvarchar(4000),@p94 nvarchar(4000),@p95 nvarchar(4000),@p96 int,@p97 nvarchar(4000),@p98 nvarchar(4000),@p99 nvarchar(4000),@p100 nvarchar(4000),@p101 nvarchar(4000),@p102 int,@p103 nvarchar(4000),@p104 int,@p105 int,@p106 datetime2(7),@p107 datetime2(7),@p108 datetime2(7),@p109 nvarchar(4000),@p110 nvarchar(4000),@p111 nvarchar(4000),@p112 nvarchar(4000),@p113 nvarchar(4000),@p114 nvarchar(4000),@p115 nvarchar(4000),@p116 nvarchar(4000),@p117 nvarchar(4000),@p118 nvarchar(4000),@p119 nvarchar(4000),@p120 nvarchar(4000),@p121 nvarchar(4000),@p122 nvarchar(4000),@p123 datetime2(7),@p124 nvarchar(4000),@p125 nvarchar(4000),@p126 int,@p127 int,@p128 int,@p129 nvarchar(4000),@p130 nvarchar(4000),@p131 nvarchar(4000),@p132 nvarchar(4000),@p133 decimal(18,2),@p134 nvarchar(4000),@p135 nvarchar(4000),@p136 decimal(18,2),@p137 nvarchar(4000),@p138 nvarchar(4000),@p139 nvarchar(4000),@p140 nvarchar(4000),@p141 int,@p142 nvarchar(4000),@p143 nvarchar(4000),@p144 nvarchar(4000),@p145 nvarchar(4000),@p146 nvarchar(4000),@p147 nvarchar(4000),@p148 nvarchar(4000),@p149 nvarchar(4000),@p150 nvarchar(4000),@p151 nvarchar(4000),@p152 int,@p153 nvarchar(4000),@p154 nvarchar(4000),@p155 nvarchar(4000),@p156 nvarchar(4000),@p157 nvarchar(4000),@p158 int,@p159 nvarchar(4000),@p160 int,@p161 int,@p162 datetime2(7),@p163 datetime2(7),@p164 datetime2(7),@p165 nvarchar(4000),@p166 nvarchar(4000),@p167 nvarchar(4000),@p168 nvarchar(4000),@p169 nvarchar(4000),@p170 nvarchar(4000),@p171 nvarchar(4000),@p172 nvarchar(4000),@p173 nvarchar(4000),@p174 nvarchar(4000),@p175 nvarchar(4000),@p176 nvarchar(4000),@p177 nvarchar(4000),@p178 nvarchar(4000),@p179 datetime2(7),@p180 nvarchar(4000),@p181 nvarchar(4000),@p182 int,@p183 int,@p184 int,@p185 nvarchar(4000),@p186 nvarchar(4000),@p187 nvarchar(4000),@p188 nvarchar(4000),@p189 decimal(18,2),@p190 nvarchar(4000),@p191 nvarchar(4000),@p192 decimal(18,2),@p193 nvarchar(4000),@p194 nvarchar(4000),@p195 nvarchar(4000),@p196 nvarchar(4000),@p197 int,@p198 nvarchar(4000),@p199 nvarchar(4000),@p200 nvarchar(4000),@p201 nvarchar(4000),@p202 nvarchar(4000),@p203 nvarchar(4000),@p204 nvarchar(4000),@p205 nvarchar(4000),@p206 nvarchar(4000),@p207 nvarchar(4000),@p208 int,@p209 nvarchar(4000),@p210 nvarchar(4000),@p211 nvarchar(4000),@p212 nvarchar(4000),@p213 nvarchar(4000),@p214 int,@p215 nvarchar(4000),@p216 int,@p217 int,@p218 datetime2(7),@p219 datetime2(7),@p220 datetime2(7),@p221 nvarchar(4000),@p222 nvarchar(4000),@p223 nvarchar(4000),@p224 nvarchar(4000),@p225 nvarchar(4000),@p226 nvarchar(4000),@p227 nvarchar(4000),@p228 nvarchar(4000),@p229 nvarchar(4000),@p230 nvarchar(4000),@p231 nvarchar(4000),@p232 nvarchar(4000),@p233 nvarchar(4000),@p234 nvarchar(4000),@p235 datetime2(7),@p236 nvarchar(4000),@p237 nvarchar(4000),@p238 int,@p239 int,@p240 int,@p241 nvarchar(4000),@p242 nvarchar(4000),@p243 nvarchar(4000),@p244 nvarchar(4000),@p245 decimal(18,2),@p246 nvarchar(4000),@p247 nvarchar(4000),@p248 decimal(18,2),@p249 nvarchar(4000),@p250 nvarchar(4000),@p251 nvarchar(4000),@p252 nvarchar(4000),@p253 int,@p254 nvarchar(4000),@p255 nvarchar(4000),@p256 nvarchar(4000),@p257 nvarchar(4000),@p258 nvarchar(4000),@p259 nvarchar(4000),@p260 nvarchar(4000),@p261 nvarchar(4000),@p262 nvarchar(4000),@p263 nvarchar(4000),@p264 int,@p265 nvarchar(4000),@p266 nvarchar(4000),@p267 nvarchar(4000),@p268 nvarchar(4000),@p269 nvarchar(4000),@p270 int,@p271 nvarchar(4000),@p272 int,@p273 int,@p274 datetime2(7),@p275 datetime2(7),@p276 datetime2(7),@p277 nvarchar(4000),@p278 nvarchar(4000),@p279 nvarchar(4000),@p280 nvarchar(4000),@p281 nvarchar(4000),@p282 nvarchar(4000),@p283 nvarchar(4000),@p284 nvarchar(4000),@p285 nvarchar(4000),@p286 nvarchar(4000),@p287 nvarchar(4000),@p288 nvarchar(4000),@p289 nvarchar(4000),@p290 nvarchar(4000),@p291 datetime2(7),@p292 nvarchar(4000),@p293 nvarchar(4000),@p294 int,@p295 int,@p296 int,@p297 nvarchar(4000),@p298 nvarchar(4000),@p299 nvarchar(4000),@p300 nvarchar(4000),@p301 decimal(18,2),@p302 nvarchar(4000),@p303 nvarchar(4000),@p304 decimal(18,2),@p305 nvarchar(4000),@p306 nvarchar(4000),@p307 nvarchar(4000),@p308 nvarchar(4000),@p309 int,@p310 nvarchar(4000),@p311 nvarchar(4000),@p312 nvarchar(4000),@p313 nvarchar(4000),@p314 nvarchar(4000),@p315 nvarchar(4000),@p316 nvarchar(4000),@p317 nvarchar(4000),@p318 nvarchar(4000),@p319 nvarchar(4000),@p320 int,@p321 nvarchar(4000),@p322 nvarchar(4000),@p323 nvarchar(4000),@p324 nvarchar(4000),@p325 nvarchar(4000),@p326 int,@p327 nvarchar(4000),@p328 int,@p329 int,@p330 datetime2(7),@p331 datetime2(7),@p332 datetime2(7),@p333 nvarchar(4000),@p334 nvarchar(4000),@p335 nvarchar(4000),@p336 nvarchar(4000),@p337 nvarchar(4000),@p338 nvarchar(4000),@p339 nvarchar(4000),@p340 nvarchar(4000),@p341 nvarchar(4000),@p342 nvarchar(4000),@p343 nvarchar(4000),@p344 nvarchar(4000),@p345 nvarchar(4000),@p346 nvarchar(4000),@p347 datetime2(7),@p348 nvarchar(4000),@p349 nvarchar(4000),@p350 int,@p351 int,@p352 int,@p353 nvarchar(4000),@p354 nvarchar(4000),@p355 nvarchar(4000),@p356 nvarchar(4000),@p357 decimal(18,2),@p358 nvarchar(4000),@p359 nvarchar(4000),@p360 decimal(18,2),@p361 nvarchar(4000),@p362 nvarchar(4000),@p363 nvarchar(4000),@p364 nvarchar(4000),@p365 int,@p366 nvarchar(4000),@p367 nvarchar(4000),@p368 nvarchar(4000),@p369 nvarchar(4000),@p370 nvarchar(4000),@p371 nvarchar(4000),@p372 nvarchar(4000),@p373 nvarchar(4000),@p374 nvarchar(4000),@p375 nvarchar(4000),@p376 int,@p377 nvarchar(4000),@p378 nvarchar(4000),@p379 nvarchar(4000),@p380 nvarchar(4000),@p381 nvarchar(4000),@p382 int,@p383 nvarchar(4000),@p384 int,@p385 int,@p386 datetime2(7),@p387 datetime2(7),@p388 datetime2(7),@p389 nvarchar(4000),@p390 nvarchar(4000),@p391 nvarchar(4000),@p392 nvarchar(4000),@p393 nvarchar(4000),@p394 nvarchar(4000),@p395 nvarchar(4000),@p396 nvarchar(4000),@p397 nvarchar(4000),@p398 nvarchar(4000),@p399 nvarchar(4000),@p400 nvarchar(4000),@p401 nvarchar(4000),@p402 nvarchar(4000),@p403 datetime2(7),@p404 nvarchar(4000),@p405 nvarchar(4000),@p406 int,@p407 int,@p408 int,@p409 nvarchar(4000),@p410 nvarchar(4000),@p411 nvarchar(4000),@p412 nvarchar(4000),@p413 decimal(18,2),@p414 nvarchar(4000),@p415 nvarchar(4000),@p416 decimal(18,2),@p417 nvarchar(4000),@p418 nvarchar(4000),@p419 nvarchar(4000),@p420 nvarchar(4000),@p421 int,@p422 nvarchar(4000),@p423 nvarchar(4000),@p424 nvarchar(4000),@p425 nvarchar(4000),@p426 nvarchar(4000),@p427 nvarchar(4000),@p428 nvarchar(4000),@p429 nvarchar(4000),@p430 nvarchar(4000),@p431 nvarchar(4000),@p432 int,@p433 nvarchar(4000),@p434 nvarchar(4000),@p435 nvarchar(4000),@p436 nvarchar(4000),@p437 nvarchar(4000),@p438 int,@p439 nvarchar(4000),@p440 int,@p441 int,@p442 datetime2(7),@p443 datetime2(7),@p444 datetime2(7),@p445 nvarchar(4000),@p446 nvarchar(4000),@p447 nvarchar(4000),@p448 nvarchar(4000),@p449 nvarchar(4000),@p450 nvarchar(4000),@p451 nvarchar(4000),@p452 nvarchar(4000),@p453 nvarchar(4000),@p454 nvarchar(4000),@p455 nvarchar(4000),@p456 nvarchar(4000),@p457 nvarchar(4000),@p458 nvarchar(4000),@p459 datetime2(7),@p460 nvarchar(4000),@p461 nvarchar(4000),@p462 int,@p463 int,@p464 int,@p465 nvarchar(4000),@p466 nvarchar(4000),@p467 nvarchar(4000),@p468 nvarchar(4000),@p469 decimal(18,2),@p470 nvarchar(4000),@p471 nvarchar(4000),@p472 decimal(18,2),@p473 nvarchar(4000),@p474 nvarchar(4000),@p475 nvarchar(4000),@p476 nvarchar(4000),@p477 int,@p478 nvarchar(4000),@p479 nvarchar(4000),@p480 nvarchar(4000),@p481 nvarchar(4000),@p482 nvarchar(4000),@p483 nvarchar(4000),@p484 nvarchar(4000),@p485 nvarchar(4000),@p486 nvarchar(4000),@p487 nvarchar(4000),@p488 int,@p489 nvarchar(4000),@p490 nvarchar(4000),@p491 nvarchar(4000),@p492 nvarchar(4000),@p493 nvarchar(4000),@p494 int,@p495 nvarchar(4000),@p496 int,@p497 int,@p498 datetime2(7),@p499 datetime2(7),@p500 datetime2(7),@p501 nvarchar(4000),@p502 nvarchar(4000),@p503 nvarchar(4000),@p504 nvarchar(4000),@p505 nvarchar(4000),@p506 nvarchar(4000),@p507 nvarchar(4000),@p508 nvarchar(4000),@p509 nvarchar(4000),@p510 nvarchar(4000),@p511 nvarchar(4000),@p512 nvarchar(4000),@p513 nvarchar(4000),@p514 nvarchar(4000),@p515 datetime2(7),@p516 nvarchar(4000),@p517 nvarchar(4000),@p518 int,@p519 int,@p520 int,@p521 nvarchar(4000),@p522 nvarchar(4000),@p523 nvarchar(4000),@p524 nvarchar(4000),@p525 decimal(18,2),@p526 nvarchar(4000),@p527 nvarchar(4000),@p528 decimal(18,2),@p529 nvarchar(4000),@p530 nvarchar(4000),@p531 nvarchar(4000),@p532 nvarchar(4000),@p533 int,@p534 nvarchar(4000),@p535 nvarchar(4000),@p536 nvarchar(4000),@p537 nvarchar(4000),@p538 nvarchar(4000),@p539 nvarchar(4000),@p540 nvarchar(4000),@p541 nvarchar(4000),@p542 nvarchar(4000),@p543 nvarchar(4000),@p544 int,@p545 nvarchar(4000),@p546 nvarchar(4000),@p547 nvarchar(4000),@p548 nvarchar(4000),@p549 nvarchar(4000),@p550 int,@p551 nvarchar(4000),@p552 int,@p553 int,@p554 datetime2(7),@p555 datetime2(7),@p556 datetime2(7),@p557 nvarchar(4000),@p558 nvarchar(4000),@p559 nvarchar(4000),@p560 nvarchar(4000),@p561 nvarchar(4000),@p562 nvarchar(4000),@p563 nvarchar(4000),@p564 nvarchar(4000),@p565 nvarchar(4000),@p566 nvarchar(4000),@p567 nvarchar(4000),@p568 nvarchar(4000),@p569 nvarchar(4000),@p570 nvarchar(4000),@p571 datetime2(7),@p572 nvarchar(4000),@p573 nvarchar(4000),@p574 int,@p575 int,@p576 int,@p577 nvarchar(4000),@p578 nvarchar(4000),@p579 nvarchar(4000),@p580 nvarchar(4000),@p581 decimal(18,2),@p582 nvarchar(4000),@p583 nvarchar(4000),@p584 decimal(18,2),@p585 nvarchar(4000),@p586 nvarchar(4000),@p587 nvarchar(4000),@p588 nvarchar(4000),@p589 int,@p590 nvarchar(4000),@p591 nvarchar(4000),@p592 nvarchar(4000),@p593 nvarchar(4000),@p594 nvarchar(4000),@p595 nvarchar(4000),@p596 nvarchar(4000),@p597 nvarchar(4000),@p598 nvarchar(4000),@p599 nvarchar(4000),@p600 int,@p601 nvarchar(4000),@p602 nvarchar(4000),@p603 nvarchar(4000),@p604 nvarchar(4000),@p605 nvarchar(4000),@p606 int,@p607 nvarchar(4000),@p608 int,@p609 int,@p610 datetime2(7),@p611 datetime2(7),@p612 datetime2(7),@p613 nvarchar(4000),@p614 nvarchar(4000),@p615 nvarchar(4000),@p616 nvarchar(4000),@p617 nvarchar(4000),@p618 nvarchar(4000),@p619 nvarchar(4000),@p620 nvarchar(4000),@p621 nvarchar(4000),@p622 nvarchar(4000),@p623 nvarchar(4000),@p624 nvarchar(4000),@p625 nvarchar(4000),@p626 nvarchar(4000),@p627 datetime2(7),@p628 nvarchar(4000),@p629 nvarchar(4000),@p630 int,@p631 int,@p632 int,@p633 nvarchar(4000),@p634 nvarchar(4000),@p635 nvarchar(4000),@p636 nvarchar(4000),@p637 decimal(18,2),@p638 nvarchar(4000),@p639 nvarchar(4000),@p640 decimal(18,2),@p641 nvarchar(4000),@p642 nvarchar(4000),@p643 nvarchar(4000),@p644 nvarchar(4000),@p645 int,@p646 nvarchar(4000),@p647 nvarchar(4000),@p648 nvarchar(4000),@p649 nvarchar(4000),@p650 nvarchar(4000),@p651 nvarchar(4000),@p652 nvarchar(4000),@p653 nvarchar(4000),@p654 nvarchar(4000),@p655 nvarchar(4000),@p656 int,@p657 nvarchar(4000),@p658 nvarchar(4000),@p659 nvarchar(4000),@p660 nvarchar(4000),@p661 nvarchar(4000),@p662 int,@p663 nvarchar(4000),@p664 int,@p665 int,@p666 datetime2(7),@p667 datetime2(7),@p668 datetime2(7),@p669 nvarchar(4000),@p670 nvarchar(4000),@p671 nvarchar(4000),@p672 nvarchar(4000),@p673 nvarchar(4000),@p674 nvarchar(4000),@p675 nvarchar(4000),@p676 nvarchar(4000),@p677 nvarchar(4000),@p678 nvarchar(4000),@p679 nvarchar(4000),@p680 nvarchar(4000),@p681 nvarchar(4000),@p682 nvarchar(4000),@p683 datetime2(7),@p684 nvarchar(4000),@p685 nvarchar(4000),@p686 int,@p687 int,@p688 int,@p689 nvarchar(4000),@p690 nvarchar(4000),@p691 nvarchar(4000),@p692 nvarchar(4000),@p693 decimal(18,2),@p694 nvarchar(4000),@p695 nvarchar(4000),@p696 decimal(18,2),@p697 nvarchar(4000),@p698 nvarchar(4000),@p699 nvarchar(4000),@p700 nvarchar(4000),@p701 int,@p702 nvarchar(4000),@p703 nvarchar(4000),@p704 nvarchar(4000),@p705 nvarchar(4000),@p706 nvarchar(4000),@p707 nvarchar(4000),@p708 nvarchar(4000),@p709 nvarchar(4000),@p710 nvarchar(4000),@p711 nvarchar(4000),@p712 int,@p713 nvarchar(4000),@p714 nvarchar(4000),@p715 nvarchar(4000),@p716 nvarchar(4000),@p717 nvarchar(4000),@p718 int,@p719 nvarchar(4000),@p720 int,@p721 int,@p722 datetime2(7),@p723 datetime2(7),@p724 datetime2(7),@p725 nvarchar(4000),@p726 nvarchar(4000),@p727 nvarchar(4000),@p728 nvarchar(4000),@p729 nvarchar(4000),@p730 nvarchar(4000),@p731 nvarchar(4000),@p732 nvarchar(4000),@p733 nvarchar(4000),@p734 nvarchar(4000),@p735 nvarchar(4000),@p736 nvarchar(4000),@p737 nvarchar(4000),@p738 nvarchar(4000),@p739 datetime2(7),@p740 nvarchar(4000),@p741 nvarchar(4000),@p742 int,@p743 int,@p744 int,@p745 nvarchar(4000),@p746 nvarchar(4000),@p747 nvarchar(4000),@p748 nvarchar(4000),@p749 decimal(18,2),@p750 nvarchar(4000),@p751 nvarchar(4000),@p752 decimal(18,2),@p753 nvarchar(4000),@p754 nvarchar(4000),@p755 nvarchar(4000),@p756 nvarchar(4000),@p757 int,@p758 nvarchar(4000),@p759 nvarchar(4000),@p760 nvarchar(4000),@p761 nvarchar(4000),@p762 nvarchar(4000),@p763 nvarchar(4000),@p764 nvarchar(4000),@p765 nvarchar(4000),@p766 nvarchar(4000),@p767 nvarchar(4000),@p768 int,@p769 nvarchar(4000),@p770 nvarchar(4000),@p771 nvarchar(4000),@p772 nvarchar(4000),@p773 nvarchar(4000),@p774 int,@p775 nvarchar(4000),@p776 int,@p777 int,@p778 datetime2(7),@p779 datetime2(7),@p780 datetime2(7),@p781 nvarchar(4000),@p782 nvarchar(4000),@p783 nvarchar(4000),@p784 nvarchar(4000),@p785 nvarchar(4000),@p786 nvarchar(4000),@p787 nvarchar(4000),@p788 nvarchar(4000),@p789 nvarchar(4000),@p790 nvarchar(4000),@p791 nvarchar(4000),@p792 nvarchar(4000),@p793 nvarchar(4000),@p794 nvarchar(4000),@p795 datetime2(7),@p796 nvarchar(4000),@p797 nvarchar(4000),@p798 int,@p799 int,@p800 int,@p801 nvarchar(4000),@p802 nvarchar(4000),@p803 nvarchar(4000),@p804 nvarchar(4000),@p805 decimal(18,2),@p806 nvarchar(4000),@p807 nvarchar(4000),@p808 decimal(18,2),@p809 nvarchar(4000),@p810 nvarchar(4000),@p811 nvarchar(4000),@p812 nvarchar(4000),@p813 int,@p814 nvarchar(4000),@p815 nvarchar(4000),@p816 nvarchar(4000),@p817 nvarchar(4000),@p818 nvarchar(4000),@p819 nvarchar(4000),@p820 nvarchar(4000),@p821 nvarchar(4000),@p822 nvarchar(4000),@p823 nvarchar(4000),@p824 int,@p825 nvarchar(4000),@p826 nvarchar(4000),@p827 nvarchar(4000),@p828 nvarchar(4000),@p829 nvarchar(4000),@p830 int,@p831 nvarchar(4000),@p832 int,@p833 int,@p834 datetime2(7),@p835 datetime2(7),@p836 datetime2(7),@p837 nvarchar(4000),@p838 nvarchar(4000),@p839 nvarchar(4000),@p840 nvarchar(4000),@p841 nvarchar(4000),@p842 nvarchar(4000),@p843 nvarchar(4000),@p844 nvarchar(4000),@p845 nvarchar(4000),@p846 nvarchar(4000),@p847 nvarchar(4000),@p848 nvarchar(4000),@p849 nvarchar(4000),@p850 nvarchar(4000),@p851 datetime2(7),@p852 nvarchar(4000),@p853 nvarchar(4000),@p854 int,@p855 int,@p856 int,@p857 nvarchar(4000),@p858 nvarchar(4000),@p859 nvarchar(4000),@p860 nvarchar(4000),@p861 decimal(18,2),@p862 nvarchar(4000),@p863 nvarchar(4000),@p864 decimal(18,2),@p865 nvarchar(4000),@p866 nvarchar(4000),@p867 nvarchar(4000),@p868 nvarchar(4000),@p869 int,@p870 nvarchar(4000),@p871 nvarchar(4000),@p872 nvarchar(4000),@p873 nvarchar(4000),@p874 nvarchar(4000),@p875 nvarchar(4000),@p876 nvarchar(4000),@p877 nvarchar(4000),@p878 nvarchar(4000),@p879 nvarchar(4000),@p880 int,@p881 nvarchar(4000),@p882 nvarchar(4000),@p883 nvarchar(4000),@p884 nvarchar(4000),@p885 nvarchar(4000),@p886 int,@p887 nvarchar(4000),@p888 int,@p889 int,@p890 datetime2(7),@p891 datetime2(7),@p892 datetime2(7),@p893 nvarchar(4000),@p894 nvarchar(4000),@p895 nvarchar(4000),@p896 nvarchar(4000),@p897 nvarchar(4000),@p898 nvarchar(4000),@p899 nvarchar(4000),@p900 nvarchar(4000),@p901 nvarchar(4000),@p902 nvarchar(4000),@p903 nvarchar(4000),@p904 nvarchar(4000),@p905 nvarchar(4000),@p906 nvarchar(4000),@p907 datetime2(7),@p908 nvarchar(4000),@p909 nvarchar(4000),@p910 int,@p911 int,@p912 int,@p913 nvarchar(4000),@p914 nvarchar(4000),@p915 nvarchar(4000),@p916 nvarchar(4000),@p917 decimal(18,2),@p918 nvarchar(4000),@p919 nvarchar(4000),@p920 decimal(18,2),@p921 nvarchar(4000),@p922 nvarchar(4000),@p923 nvarchar(4000),@p924 nvarchar(4000),@p925 int,@p926 nvarchar(4000),@p927 nvarchar(4000),@p928 nvarchar(4000),@p929 nvarchar(4000),@p930 nvarchar(4000),@p931 nvarchar(4000),@p932 nvarchar(4000),@p933 nvarchar(4000),@p934 nvarchar(4000),@p935 nvarchar(4000),@p936 int,@p937 nvarchar(4000),@p938 nvarchar(4000),@p939 nvarchar(4000),@p940 nvarchar(4000),@p941 nvarchar(4000),@p942 int,@p943 nvarchar(4000),@p944 int,@p945 int,@p946 datetime2(7),@p947 datetime2(7),@p948 datetime2(7),@p949 nvarchar(4000),@p950 nvarchar(4000),@p951 nvarchar(4000),@p952 nvarchar(4000),@p953 nvarchar(4000),@p954 nvarchar(4000),@p955 nvarchar(4000),@p956 nvarchar(4000),@p957 nvarchar(4000),@p958 nvarchar(4000),@p959 nvarchar(4000),@p960 nvarchar(4000),@p961 nvarchar(4000),@p962 nvarchar(4000),@p963 datetime2(7),@p964 nvarchar(4000),@p965 nvarchar(4000),@p966 int,@p967 int,@p968 int,@p969 nvarchar(4000),@p970 nvarchar(4000),@p971 nvarchar(4000),@p972 nvarchar(4000),@p973 decimal(18,2),@p974 nvarchar(4000),@p975 nvarchar(4000),@p976 decimal(18,2),@p977 nvarchar(4000),@p978 nvarchar(4000),@p979 nvarchar(4000),@p980 nvarchar(4000),@p981 int,@p982 nvarchar(4000),@p983 nvarchar(4000),@p984 nvarchar(4000),@p985 nvarchar(4000),@p986 nvarchar(4000),@p987 nvarchar(4000),@p988 nvarchar(4000),@p989 nvarchar(4000),@p990 nvarchar(4000),@p991 nvarchar(4000),@p992 int,@p993 nvarchar(4000),@p994 nvarchar(4000),@p995 nvarchar(4000),@p996 nvarchar(4000),@p997 nvarchar(4000),@p998 int,@p999 nvarchar(4000),@p1000 int,@p1001 int,@p1002 datetime2(7),@p1003 datetime2(7),@p1004 datetime2(7),@p1005 nvarchar(4000),@p1006 nvarchar(4000),@p1007 nvarchar(4000),@p1008 nvarchar(4000),@p1009 nvarchar(4000),@p1010 nvarchar(4000),@p1011 nvarchar(4000),@p1012 nvarchar(4000),@p1013 nvarchar(4000),@p1014 nvarchar(4000),@p1015 nvarchar(4000),@p1016 nvarchar(4000),@p1017 nvarchar(4000),@p1018 nvarchar(4000),@p1019 datetime2(7),@p1020 nvarchar(4000),@p1021 nvarchar(4000),@p1022 int,@p1023 int,@p1024 int,@p1025 nvarchar(4000),@p1026 nvarchar(4000),@p1027 nvarchar(4000),@p1028 nvarchar(4000),@p1029 decimal(18,2),@p1030 nvarchar(4000),@p1031 nvarchar(4000),@p1032 decimal(18,2),@p1033 nvarchar(4000),@p1034 nvarchar(4000),@p1035 nvarchar(4000),@p1036 nvarchar(4000),@p1037 int,@p1038 nvarchar(4000),@p1039 nvarchar(4000),@p1040 nvarchar(4000),@p1041 nvarchar(4000),@p1042 nvarchar(4000),@p1043 nvarchar(4000),@p1044 nvarchar(4000),@p1045 nvarchar(4000),@p1046 nvarchar(4000),@p1047 nvarchar(4000),@p1048 int,@p1049 nvarchar(4000),@p1050 nvarchar(4000),@p1051 nvarchar(4000),@p1052 nvarchar(4000),@p1053 nvarchar(4000),@p1054 int,@p1055 nvarchar(4000),@p1056 int,@p1057 int,@p1058 datetime2(7),@p1059 datetime2(7),@p1060 datetime2(7),@p1061 nvarchar(4000),@p1062 nvarchar(4000),@p1063 nvarchar(4000),@p1064 nvarchar(4000),@p1065 nvarchar(4000),@p1066 nvarchar(4000),@p1067 nvarchar(4000),@p1068 nvarchar(4000),@p1069 nvarchar(4000),@p1070 nvarchar(4000),@p1071 nvarchar(4000),@p1072 nvarchar(4000),@p1073 nvarchar(4000),@p1074 nvarchar(4000),@p1075 datetime2(7),@p1076 nvarchar(4000),@p1077 nvarchar(4000),@p1078 int,@p1079 int,@p1080 int,@p1081 nvarchar(4000),@p1082 nvarchar(4000),@p1083 nvarchar(4000),@p1084 nvarchar(4000),@p1085 decimal(18,2),@p1086 nvarchar(4000),@p1087 nvarchar(4000),@p1088 decimal(18,2),@p1089 nvarchar(4000),@p1090 nvarchar(4000),@p1091 nvarchar(4000),@p1092 nvarchar(4000),@p1093 int,@p1094 nvarchar(4000),@p1095 nvarchar(4000),@p1096 nvarchar(4000),@p1097 nvarchar(4000),@p1098 nvarchar(4000),@p1099 nvarchar(4000),@p1100 nvarchar(4000),@p1101 nvarchar(4000),@p1102 nvarchar(4000),@p1103 nvarchar(4000),@p1104 int,@p1105 nvarchar(4000),@p1106 nvarchar(4000),@p1107 nvarchar(4000),@p1108 nvarchar(4000),@p1109 nvarchar(4000),@p1110 int,@p1111 nvarchar(4000),@p1112 int,@p1113 int,@p1114 datetime2(7),@p1115 datetime2(7),@p1116 datetime2(7),@p1117 nvarchar(4000),@p1118 nvarchar(4000),@p1119 nvarchar(4000),@p1120 nvarchar(4000),@p1121 nvarchar(4000),@p1122 nvarchar(4000),@p1123 nvarchar(4000),@p1124 nvarchar(4000),@p1125 nvarchar(4000),@p1126 nvarchar(4000),@p1127 nvarchar(4000),@p1128 nvarchar(4000),@p1129 nvarchar(4000),@p1130 nvarchar(4000),@p1131 datetime2(7),@p1132 nvarchar(4000),@p1133 nvarchar(4000),@p1134 int,@p1135 int,@p1136 int,@p1137 nvarchar(4000),@p1138 nvarchar(4000),@p1139 nvarchar(4000),@p1140 nvarchar(4000),@p1141 decimal(18,2),@p1142 nvarchar(4000),@p1143 nvarchar(4000),@p1144 decimal(18,2),@p1145 nvarchar(4000),@p1146 nvarchar(4000),@p1147 nvarchar(4000),@p1148 nvarchar(4000),@p1149 int,@p1150 nvarchar(4000),@p1151 nvarchar(4000),@p1152 nvarchar(4000),@p1153 nvarchar(4000),@p1154 nvarchar(4000),@p1155 nvarchar(4000),@p1156 nvarchar(4000),@p1157 nvarchar(4000),@p1158 nvarchar(4000),@p1159 nvarchar(4000),@p1160 int,@p1161 nvarchar(4000),@p1162 nvarchar(4000),@p1163 nvarchar(4000),@p1164 nvarchar(4000),@p1165 nvarchar(4000),@p1166 int,@p1167 nvarchar(4000),@p1168 int,@p1169 int,@p1170 datetime2(7),@p1171 datetime2(7),@p1172 datetime2(7),@p1173 nvarchar(4000),@p1174 nvarchar(4000),@p1175 nvarchar(4000),@p1176 nvarchar(4000),@p1177 nvarchar(4000),@p1178 nvarchar(4000),@p1179 nvarchar(4000),@p1180 nvarchar(4000),@p1181 nvarchar(4000),@p1182 nvarchar(4000),@p1183 nvarchar(4000),@p1184 nvarchar(4000),@p1185 nvarchar(4000),@p1186 nvarchar(4000),@p1187 datetime2(7),@p1188 nvarchar(4000),@p1189 nvarchar(4000),@p1190 int,@p1191 int,@p1192 int,@p1193 nvarchar(4000),@p1194 nvarchar(4000),@p1195 nvarchar(4000),@p1196 nvarchar(4000),@p1197 decimal(18,2),@p1198 nvarchar(4000),@p1199 nvarchar(4000),@p1200 decimal(18,2),@p1201 nvarchar(4000),@p1202 nvarchar(4000),@p1203 nvarchar(4000),@p1204 nvarchar(4000),@p1205 int,@p1206 nvarchar(4000),@p1207 nvarchar(4000),@p1208 nvarchar(4000),@p1209 nvarchar(4000),@p1210 nvarchar(4000),@p1211 nvarchar(4000),@p1212 nvarchar(4000),@p1213 nvarchar(4000),@p1214 nvarchar(4000),@p1215 nvarchar(4000),@p1216 int,@p1217 nvarchar(4000),@p1218 nvarchar(4000),@p1219 nvarchar(4000),@p1220 nvarchar(4000),@p1221 nvarchar(4000),@p1222 int,@p1223 nvarchar(4000),@p1224 int,@p1225 int,@p1226 datetime2(7),@p1227 datetime2(7),@p1228 datetime2(7),@p1229 nvarchar(4000),@p1230 nvarchar(4000),@p1231 nvarchar(4000),@p1232 nvarchar(4000),@p1233 nvarchar(4000),@p1234 nvarchar(4000),@p1235 nvarchar(4000),@p1236 nvarchar(4000),@p1237 nvarchar(4000),@p1238 nvarchar(4000),@p1239 nvarchar(4000),@p1240 nvarchar(4000),@p1241 nvarchar(4000),@p1242 nvarchar(4000),@p1243 datetime2(7),@p1244 nvarchar(4000),@p1245 nvarchar(4000),@p1246 int,@p1247 int,@p1248 int,@p1249 nvarchar(4000),@p1250 nvarchar(4000),@p1251 nvarchar(4000),@p1252 nvarchar(4000),@p1253 decimal(18,2),@p1254 nvarchar(4000),@p1255 nvarchar(4000),@p1256 decimal(18,2),@p1257 nvarchar(4000),@p1258 nvarchar(4000),@p1259 nvarchar(4000),@p1260 nvarchar(4000),@p1261 int,@p1262 nvarchar(4000),@p1263 nvarchar(4000),@p1264 nvarchar(4000),@p1265 nvarchar(4000),@p1266 nvarchar(4000),@p1267 nvarchar(4000),@p1268 nvarchar(4000),@p1269 nvarchar(4000),@p1270 nvarchar(4000),@p1271 nvarchar(4000),@p1272 int,@p1273 nvarchar(4000),@p1274 nvarchar(4000),@p1275 nvarchar(4000),@p1276 nvarchar(4000),@p1277 nvarchar(4000),@p1278 int,@p1279 nvarchar(4000),@p1280 int,@p1281 int,@p1282 datetime2(7),@p1283 datetime2(7),@p1284 datetime2(7),@p1285 nvarchar(4000),@p1286 nvarchar(4000),@p1287 nvarchar(4000),@p1288 nvarchar(4000),@p1289 nvarchar(4000),@p1290 nvarchar(4000),@p1291 nvarchar(4000),@p1292 nvarchar(4000),@p1293 nvarchar(4000),@p1294 nvarchar(4000),@p1295 nvarchar(4000),@p1296 nvarchar(4000),@p1297 nvarchar(4000),@p1298 nvarchar(4000),@p1299 datetime2(7),@p1300 nvarchar(4000),@p1301 nvarchar(4000),@p1302 int,@p1303 int,@p1304 int,@p1305 nvarchar(4000),@p1306 nvarchar(4000),@p1307 nvarchar(4000),@p1308 nvarchar(4000),@p1309 decimal(18,2),@p1310 nvarchar(4000),@p1311 nvarchar(4000),@p1312 decimal(18,2),@p1313 nvarchar(4000),@p1314 nvarchar(4000),@p1315 nvarchar(4000),@p1316 nvarchar(4000),@p1317 int,@p1318 nvarchar(4000),@p1319 nvarchar(4000),@p1320 nvarchar(4000),@p1321 nvarchar(4000),@p1322 nvarchar(4000),@p1323 nvarchar(4000),@p1324 nvarchar(4000),@p1325 nvarchar(4000),@p1326 nvarchar(4000),@p1327 nvarchar(4000),@p1328 int,@p1329 nvarchar(4000),@p1330 nvarchar(4000),@p1331 nvarchar(4000),@p1332 nvarchar(4000),@p1333 nvarchar(4000),@p1334 int,@p1335 nvarchar(4000),@p1336 int,@p1337 int,@p1338 datetime2(7),@p1339 datetime2(7),@p1340 datetime2(7),@p1341 nvarchar(4000),@p1342 nvarchar(4000),@p1343 nvarchar(4000),@p1344 nvarchar(4000),@p1345 nvarchar(4000),@p1346 nvarchar(4000),@p1347 nvarchar(4000),@p1348 nvarchar(4000),@p1349 nvarchar(4000),@p1350 nvarchar(4000),@p1351 nvarchar(4000),@p1352 nvarchar(4000),@p1353 nvarchar(4000),@p1354 nvarchar(4000),@p1355 datetime2(7),@p1356 nvarchar(4000),@p1357 nvarchar(4000),@p1358 int,@p1359 int,@p1360 int,@p1361 nvarchar(4000),@p1362 nvarchar(4000),@p1363 nvarchar(4000),@p1364 nvarchar(4000),@p1365 decimal(18,2),@p1366 nvarchar(4000),@p1367 nvarchar(4000),@p1368 decimal(18,2),@p1369 nvarchar(4000),@p1370 nvarchar(4000),@p1371 nvarchar(4000),@p1372 nvarchar(4000),@p1373 int,@p1374 nvarchar(4000),@p1375 nvarchar(4000),@p1376 nvarchar(4000),@p1377 nvarchar(4000),@p1378 nvarchar(4000),@p1379 nvarchar(4000),@p1380 nvarchar(4000),@p1381 nvarchar(4000),@p1382 nvarchar(4000),@p1383 nvarchar(4000),@p1384 int,@p1385 nvarchar(4000),@p1386 nvarchar(4000),@p1387 nvarchar(4000),@p1388 nvarchar(4000),@p1389 nvarchar(4000),@p1390 int,@p1391 nvarchar(4000),@p1392 int,@p1393 int,@p1394 datetime2(7),@p1395 datetime2(7),@p1396 datetime2(7),@p1397 nvarchar(4000),@p1398 nvarchar(4000),@p1399 nvarchar(4000),@p1400 nvarchar(4000),@p1401 nvarchar(4000),@p1402 nvarchar(4000),@p1403 nvarchar(4000),@p1404 nvarchar(4000),@p1405 nvarchar(4000),@p1406 nvarchar(4000),@p1407 nvarchar(4000),@p1408 nvarchar(4000),@p1409 nvarchar(4000),@p1410 nvarchar(4000),@p1411 datetime2(7),@p1412 nvarchar(4000),@p1413 nvarchar(4000),@p1414 int,@p1415 int,@p1416 int,@p1417 nvarchar(4000),@p1418 nvarchar(4000),@p1419 nvarchar(4000),@p1420 nvarchar(4000),@p1421 decimal(18,2),@p1422 nvarchar(4000),@p1423 nvarchar(4000),@p1424 decimal(18,2),@p1425 nvarchar(4000),@p1426 nvarchar(4000),@p1427 nvarchar(4000),@p1428 nvarchar(4000),@p1429 int,@p1430 nvarchar(4000),@p1431 nvarchar(4000),@p1432 nvarchar(4000),@p1433 nvarchar(4000),@p1434 nvarchar(4000),@p1435 nvarchar(4000),@p1436 nvarchar(4000),@p1437 nvarchar(4000),@p1438 nvarchar(4000),@p1439 nvarchar(4000),@p1440 int,@p1441 nvarchar(4000),@p1442 nvarchar(4000),@p1443 nvarchar(4000),@p1444 nvarchar(4000),@p1445 nvarchar(4000),@p1446 int,@p1447 nvarchar(4000),@p1448 int,@p1449 int,@p1450 datetime2(7),@p1451 datetime2(7),@p1452 datetime2(7),@p1453 nvarchar(4000),@p1454 nvarchar(4000),@p1455 nvarchar(4000),@p1456 nvarchar(4000),@p1457 nvarchar(4000),@p1458 nvarchar(4000),@p1459 nvarchar(4000),@p1460 nvarchar(4000),@p1461 nvarchar(4000),@p1462 nvarchar(4000),@p1463 nvarchar(4000),@p1464 nvarchar(4000),@p1465 nvarchar(4000),@p1466 nvarchar(4000),@p1467 datetime2(7),@p1468 nvarchar(4000),@p1469 nvarchar(4000),@p1470 int,@p1471 int,@p1472 int,@p1473 nvarchar(4000),@p1474 nvarchar(4000),@p1475 nvarchar(4000),@p1476 nvarchar(4000),@p1477 decimal(18,2),@p1478 nvarchar(4000),@p1479 nvarchar(4000),@p1480 decimal(18,2),@p1481 nvarchar(4000),@p1482 nvarchar(4000),@p1483 nvarchar(4000),@p1484 nvarchar(4000),@p1485 int,@p1486 nvarchar(4000),@p1487 nvarchar(4000),@p1488 nvarchar(4000),@p1489 nvarchar(4000),@p1490 nvarchar(4000),@p1491 nvarchar(4000),@p1492 nvarchar(4000),@p1493 nvarchar(4000),@p1494 nvarchar(4000),@p1495 nvarchar(4000),@p1496 int,@p1497 nvarchar(4000),@p1498 nvarchar(4000),@p1499 nvarchar(4000),@p1500 nvarchar(4000),@p1501 nvarchar(4000),@p1502 int,@p1503 nvarchar(4000),@p1504 int,@p1505 int,@p1506 datetime2(7),@p1507 datetime2(7),@p1508 datetime2(7),@p1509 nvarchar(4000),@p1510 nvarchar(4000),@p1511 nvarchar(4000),@p1512 nvarchar(4000),@p1513 nvarchar(4000),@p1514 nvarchar(4000),@p1515 nvarchar(4000),@p1516 nvarchar(4000),@p1517 nvarchar(4000),@p1518 nvarchar(4000),@p1519 nvarchar(4000),@p1520 nvarchar(4000),@p1521 nvarchar(4000),@p1522 nvarchar(4000),@p1523 datetime2(7),@p1524 nvarchar(4000),@p1525 nvarchar(4000),@p1526 int,@p1527 int,@p1528 int,@p1529 nvarchar(4000),@p1530 nvarchar(4000),@p1531 nvarchar(4000),@p1532 nvarchar(4000),@p1533 decimal(18,2),@p1534 nvarchar(4000),@p1535 nvarchar(4000),@p1536 decimal(18,2),@p1537 nvarchar(4000),@p1538 nvarchar(4000),@p1539 nvarchar(4000),@p1540 nvarchar(4000),@p1541 int,@p1542 nvarchar(4000),@p1543 nvarchar(4000),@p1544 nvarchar(4000),@p1545 nvarchar(4000),@p1546 nvarchar(4000),@p1547 nvarchar(4000),@p1548 nvarchar(4000),@p1549 nvarchar(4000),@p1550 nvarchar(4000),@p1551 nvarchar(4000),@p1552 int,@p1553 nvarchar(4000),@p1554 nvarchar(4000),@p1555 nvarchar(4000),@p1556 nvarchar(4000),@p1557 nvarchar(4000),@p1558 int,@p1559 nvarchar(4000),@p1560 int,@p1561 int,@p1562 datetime2(7),@p1563 datetime2(7),@p1564 datetime2(7),@p1565 nvarchar(4000),@p1566 nvarchar(4000),@p1567 nvarchar(4000),@p1568 nvarchar(4000),@p1569 nvarchar(4000),@p1570 nvarchar(4000),@p1571 nvarchar(4000),@p1572 nvarchar(4000),@p1573 nvarchar(4000),@p1574 nvarchar(4000),@p1575 nvarchar(4000),@p1576 nvarchar(4000),@p1577 nvarchar(4000),@p1578 nvarchar(4000),@p1579 datetime2(7),@p1580 nvarchar(4000),@p1581 nvarchar(4000),@p1582 int,@p1583 int,@p1584 int,@p1585 nvarchar(4000),@p1586 nvarchar(4000),@p1587 nvarchar(4000),@p1588 decimal(18,2),@p1589 decimal(18,2),@p1590 nvarchar(4000),@p1591 nvarchar(4000),@p1592 decimal(18,2),@p1593 nvarchar(4000),@p1594 nvarchar(4000),@p1595 nvarchar(4000),@p1596 nvarchar(4000),@p1597 int,@p1598 nvarchar(4000),@p1599 nvarchar(4000),@p1600 nvarchar(4000),@p1601 nvarchar(4000),@p1602 nvarchar(4000),@p1603 nvarchar(4000),@p1604 nvarchar(4000),@p1605 nvarchar(4000),@p1606 nvarchar(4000),@p1607 nvarchar(4000),@p1608 int,@p1609 nvarchar(4000),@p1610 nvarchar(4000),@p1611 nvarchar(4000),@p1612 nvarchar(4000),@p1613 nvarchar(4000),@p1614 int,@p1615 nvarchar(4000),@p1616 int,@p1617 int,@p1618 datetime2(7),@p1619 datetime2(7),@p1620 datetime2(7),@p1621 nvarchar(4000),@p1622 nvarchar(4000),@p1623 nvarchar(4000),@p1624 nvarchar(4000),@p1625 nvarchar(4000),@p1626 nvarchar(4000),@p1627 nvarchar(4000),@p1628 nvarchar(4000),@p1629 nvarchar(4000),@p1630 nvarchar(4000),@p1631 nvarchar(4000),@p1632 nvarchar(4000),@p1633 nvarchar(4000),@p1634 nvarchar(4000),@p1635 datetime2(7),@p1636 nvarchar(4000),@p1637 nvarchar(4000),@p1638 int,@p1639 int,@p1640 int,@p1641 nvarchar(4000),@p1642 nvarchar(4000),@p1643 nvarchar(4000),@p1644 decimal(18,2),@p1645 decimal(18,2),@p1646 nvarchar(4000),@p1647 nvarchar(4000),@p1648 decimal(18,2),@p1649 nvarchar(4000),@p1650 nvarchar(4000),@p1651 nvarchar(4000),@p1652 nvarchar(4000),@p1653 int,@p1654 nvarchar(4000),@p1655 nvarchar(4000),@p1656 nvarchar(4000),@p1657 nvarchar(4000),@p1658 nvarchar(4000),@p1659 nvarchar(4000),@p1660 nvarchar(4000),@p1661 nvarchar(4000),@p1662 nvarchar(4000),@p1663 nvarchar(4000),@p1664 int,@p1665 nvarchar(4000),@p1666 nvarchar(4000),@p1667 nvarchar(4000),@p1668 nvarchar(4000),@p1669 nvarchar(4000),@p1670 int,@p1671 nvarchar(4000),@p1672 int,@p1673 int,@p1674 datetime2(7),@p1675 datetime2(7),@p1676 datetime2(7),@p1677 nvarchar(4000),@p1678 nvarchar(4000),@p1679 nvarchar(4000),@p1680 nvarchar(4000),@p1681 nvarchar(4000),@p1682 nvarchar(4000),@p1683 nvarchar(4000),@p1684 nvarchar(4000),@p1685 nvarchar(4000),@p1686 nvarchar(4000),@p1687 nvarchar(4000),@p1688 nvarchar(4000),@p1689 nvarchar(4000),@p1690 nvarchar(4000),@p1691 datetime2(7),@p1692 nvarchar(4000),@p1693 nvarchar(4000),@p1694 int,@p1695 int,@p1696 int,@p1697 nvarchar(4000),@p1698 nvarchar(4000),@p1699 nvarchar(4000),@p1700 decimal(18,2),@p1701 decimal(18,2),@p1702 nvarchar(4000),@p1703 nvarchar(4000),@p1704 decimal(18,2),@p1705 nvarchar(4000),@p1706 nvarchar(4000),@p1707 nvarchar(4000),@p1708 nvarchar(4000),@p1709 int,@p1710 nvarchar(4000),@p1711 nvarchar(4000),@p1712 nvarchar(4000),@p1713 nvarchar(4000),@p1714 nvarchar(4000),@p1715 nvarchar(4000),@p1716 nvarchar(4000),@p1717 nvarchar(4000),@p1718 nvarchar(4000),@p1719 nvarchar(4000),@p1720 int,@p1721 nvarchar(4000),@p1722 nvarchar(4000),@p1723 nvarchar(4000),@p1724 nvarchar(4000),@p1725 nvarchar(4000),@p1726 int,@p1727 nvarchar(4000),@p1728 int,@p1729 int,@p1730 datetime2(7),@p1731 datetime2(7),@p1732 datetime2(7),@p1733 nvarchar(4000),@p1734 nvarchar(4000),@p1735 nvarchar(4000),@p1736 nvarchar(4000),@p1737 nvarchar(4000),@p1738 nvarchar(4000),@p1739 nvarchar(4000),@p1740 nvarchar(4000),@p1741 nvarchar(4000),@p1742 nvarchar(4000),@p1743 nvarchar(4000),@p1744 nvarchar(4000),@p1745 nvarchar(4000),@p1746 nvarchar(4000),@p1747 datetime2(7),@p1748 nvarchar(4000),@p1749 nvarchar(4000),@p1750 int,@p1751 int,@p1752 int,@p1753 nvarchar(4000),@p1754 nvarchar(4000),@p1755 nvarchar(4000),@p1756 decimal(18,2),@p1757 decimal(18,2),@p1758 nvarchar(4000),@p1759 nvarchar(4000),@p1760 decimal(18,2),@p1761 nvarchar(4000),@p1762 nvarchar(4000),@p1763 nvarchar(4000),@p1764 nvarchar(4000),@p1765 int,@p1766 nvarchar(4000),@p1767 nvarchar(4000),@p1768 nvarchar(4000),@p1769 nvarchar(4000),@p1770 nvarchar(4000),@p1771 nvarchar(4000),@p1772 nvarchar(4000),@p1773 nvarchar(4000),@p1774 nvarchar(4000),@p1775 nvarchar(4000),@p1776 int,@p1777 nvarchar(4000),@p1778 nvarchar(4000),@p1779 nvarchar(4000),@p1780 nvarchar(4000),@p1781 nvarchar(4000),@p1782 int,@p1783 nvarchar(4000),@p1784 int,@p1785 int,@p1786 datetime2(7),@p1787 datetime2(7),@p1788 datetime2(7),@p1789 nvarchar(4000),@p1790 nvarchar(4000),@p1791 nvarchar(4000),@p1792 nvarchar(4000),@p1793 nvarchar(4000),@p1794 nvarchar(4000),@p1795 nvarchar(4000),@p1796 nvarchar(4000),@p1797 nvarchar(4000),@p1798 nvarchar(4000),@p1799 nvarchar(4000),@p1800 nvarchar(4000),@p1801 nvarchar(4000),@p1802 nvarchar(4000),@p1803 datetime2(7),@p1804 nvarchar(4000),@p1805 nvarchar(4000),@p1806 int,@p1807 int,@p1808 int,@p1809 nvarchar(4000),@p1810 nvarchar(4000),@p1811 nvarchar(4000),@p1812 decimal(18,2),@p1813 decimal(18,2),@p1814 nvarchar(4000),@p1815 nvarchar(4000),@p1816 decimal(18,2),@p1817 nvarchar(4000),@p1818 nvarchar(4000),@p1819 nvarchar(4000),@p1820 nvarchar(4000),@p1821 int,@p1822 nvarchar(4000),@p1823 nvarchar(4000),@p1824 nvarchar(4000),@p1825 nvarchar(4000),@p1826 nvarchar(4000),@p1827 nvarchar(4000),@p1828 nvarchar(4000),@p1829 nvarchar(4000),@p1830 nvarchar(4000),@p1831 nvarchar(4000),@p1832 int,@p1833 nvarchar(4000),@p1834 nvarchar(4000),@p1835 nvarchar(4000),@p1836 nvarchar(4000),@p1837 nvarchar(4000),@p1838 int,@p1839 nvarchar(4000),@p1840 int,@p1841 int,@p1842 datetime2(7),@p1843 datetime2(7),@p1844 datetime2(7),@p1845 nvarchar(4000),@p1846 nvarchar(4000),@p1847 nvarchar(4000),@p1848 nvarchar(4000),@p1849 nvarchar(4000),@p1850 nvarchar(4000),@p1851 nvarchar(4000),@p1852 nvarchar(4000),@p1853 nvarchar(4000),@p1854 nvarchar(4000),@p1855 nvarchar(4000),@p1856 nvarchar(4000),@p1857 nvarchar(4000),@p1858 nvarchar(4000),@p1859 datetime2(7),@p1860 nvarchar(4000),@p1861 nvarchar(4000),@p1862 int,@p1863 int,@p1864 int,@p1865 nvarchar(4000),@p1866 nvarchar(4000),@p1867 nvarchar(4000),@p1868 decimal(18,2),@p1869 decimal(18,2),@p1870 nvarchar(4000),@p1871 nvarchar(4000),@p1872 decimal(18,2),@p1873 nvarchar(4000),@p1874 nvarchar(4000),@p1875 nvarchar(4000),@p1876 nvarchar(4000),@p1877 int,@p1878 nvarchar(4000),@p1879 nvarchar(4000),@p1880 nvarchar(4000),@p1881 nvarchar(4000),@p1882 nvarchar(4000),@p1883 nvarchar(4000),@p1884 nvarchar(4000),@p1885 nvarchar(4000),@p1886 nvarchar(4000),@p1887 nvarchar(4000),@p1888 int,@p1889 nvarchar(4000),@p1890 nvarchar(4000),@p1891 nvarchar(4000),@p1892 nvarchar(4000),@p1893 nvarchar(4000),@p1894 int,@p1895 nvarchar(4000),@p1896 int,@p1897 int,@p1898 datetime2(7),@p1899 datetime2(7),@p1900 datetime2(7),@p1901 nvarchar(4000),@p1902 nvarchar(4000),@p1903 nvarchar(4000),@p1904 nvarchar(4000),@p1905 nvarchar(4000),@p1906 nvarchar(4000),@p1907 nvarchar(4000),@p1908 nvarchar(4000),@p1909 nvarchar(4000),@p1910 nvarchar(4000),@p1911 nvarchar(4000),@p1912 nvarchar(4000),@p1913 nvarchar(4000),@p1914 nvarchar(4000),@p1915 datetime2(7),@p1916 nvarchar(4000),@p1917 nvarchar(4000),@p1918 int,@p1919 int,@p1920 int,@p1921 nvarchar(4000),@p1922 nvarchar(4000),@p1923 nvarchar(4000),@p1924 decimal(18,2),@p1925 decimal(18,2),@p1926 nvarchar(4000),@p1927 nvarchar(4000),@p1928 decimal(18,2),@p1929 nvarchar(4000),@p1930 nvarchar(4000),@p1931 nvarchar(4000),@p1932 nvarchar(4000),@p1933 int,@p1934 nvarchar(4000),@p1935 nvarchar(4000),@p1936 nvarchar(4000),@p1937 nvarchar(4000),@p1938 nvarchar(4000),@p1939 nvarchar(4000),@p1940 nvarchar(4000),@p1941 nvarchar(4000),@p1942 nvarchar(4000),@p1943 nvarchar(4000),@p1944 int,@p1945 nvarchar(4000),@p1946 nvarchar(4000),@p1947 nvarchar(4000),@p1948 nvarchar(4000),@p1949 nvarchar(4000),@p1950 int,@p1951 nvarchar(4000),@p1952 int,@p1953 int,@p1954 datetime2(7),@p1955 datetime2(7),@p1956 datetime2(7),@p1957 nvarchar(4000),@p1958 nvarchar(4000),@p1959 nvarchar(4000),@p1960 nvarchar(4000),@p1961 nvarchar(4000),@p1962 nvarchar(4000),@p1963 nvarchar(4000),@p1964 nvarchar(4000),@p1965 nvarchar(4000),@p1966 nvarchar(4000),@p1967 nvarchar(4000),@p1968 nvarchar(4000),@p1969 nvarchar(4000),@p1970 nvarchar(4000),@p1971 datetime2(7),@p1972 nvarchar(4000),@p1973 nvarchar(4000),@p1974 int,@p1975 int,@p1976 int,@p1977 nvarchar(4000),@p1978 nvarchar(4000),@p1979 nvarchar(4000),@p1980 decimal(18,2),@p1981 decimal(18,2),@p1982 nvarchar(4000),@p1983 nvarchar(4000),@p1984 decimal(18,2),@p1985 nvarchar(4000),@p1986 nvarchar(4000),@p1987 nvarchar(4000),@p1988 nvarchar(4000),@p1989 int,@p1990 nvarchar(4000),@p1991 nvarchar(4000),@p1992 nvarchar(4000),@p1993 nvarchar(4000),@p1994 nvarchar(4000),@p1995 nvarchar(4000),@p1996 nvarchar(4000),@p1997 nvarchar(4000),@p1998 nvarchar(4000),@p1999 nvarchar(4000),@p2000 int,@p2001 nvarchar(4000),@p2002 nvarchar(4000),@p2003 nvarchar(4000),@p2004 nvarchar(4000),@p2005 nvarchar(4000),@p2006 int,@p2007 nvarchar(4000),@p2008 int,@p2009 int,@p2010 datetime2(7),@p2011 datetime2(7),@p2012 datetime2(7),@p2013 nvarchar(4000),@p2014 nvarchar(4000),@p2015 nvarchar(4000),@p2016 nvarchar(4000),@p2017 nvarchar(4000),@p2018 nvarchar(4000),@p2019 nvarchar(4000),@p2020 nvarchar(4000),@p2021 nvarchar(4000),@p2022 nvarchar(4000),@p2023 nvarchar(4000),@p2024 nvarchar(4000),@p2025 nvarchar(4000),@p2026 nvarchar(4000),@p2027 datetime2(7),@p2028 nvarchar(4000),@p2029 nvarchar(4000),@p2030 int,@p2031 int,@p2032 int,@p2033 nvarchar(4000),@p2034 nvarchar(4000),@p2035 nvarchar(4000),@p2036 decimal(18,2),@p2037 decimal(18,2),@p2038 nvarchar(4000),@p2039 nvarchar(4000),@p2040 decimal(18,2),@p2041 nvarchar(4000),@p2042 nvarchar(4000),@p2043 nvarchar(4000),@p2044 nvarchar(4000),@p2045 int,@p2046 nvarchar(4000),@p2047 nvarchar(4000),@p2048 nvarchar(4000),@p2049 nvarchar(4000),@p2050 nvarchar(4000),@p2051 nvarchar(4000),@p2052 nvarchar(4000),@p2053 nvarchar(4000),@p2054 nvarchar(4000),@p2055 nvarchar(4000),@p2056 int,@p2057 nvarchar(4000),@p2058 nvarchar(4000),@p2059 nvarchar(4000),@p2060 nvarchar(4000),@p2061 nvarchar(4000),@p2062 int,@p2063 nvarchar(4000),@p2064 int,@p2065 int,@p2066 datetime2(7),@p2067 datetime2(7),@p2068 datetime2(7),@p2069 nvarchar(4000),@p2070 nvarchar(4000),@p2071 nvarchar(4000))SET NOCOUNT ON; DECLARE @inserted0 TABLE ([item_id] int, [_Position] [int]); MERGE [raw_data] USING ( VALUES (@p0, @p1, @p2, @p3, @p4, @p5, @p6, @p7, @p8, @p9, @p10, @p11, @p12, @p13, @p14, @p15, @p16, @p17, @p18, @p19, @p20, @p21, @p22, @p23, @p24, @p25, @p26, @p27, @p28, @p29, @p30, @p31, @p32, @p33, @p34, @p35, @p36, @p37, @p38, @p39, @p40, @p41, @p42, @p43, @p44, @p45, @p46, @p47, @p48, @p49, @p50, @p51, @p52, @p53, @p54, @p55, 0), (@p56, @p57, @p58, @p59, @p60, @p61, @p62, @p63, @p64, @p65, @p66, @p67, @p68, @p69, @p70, @p71, @p72, @p73, @p74, @p75, @p76, @p77, @p78, @p79, @p80, @p81, @p82, @p83, @p84, @p85, @p86, @p87, @p88, @p89, @p90, @p91, @p92, @p93, @p94, @p95, @p96, @p97, @p98, @p99, @p100, @p101, @p102, @p103, @p104, @p105, @p106, @p107, @p108, @p109, @p110, @p111, 1), (@p112, @p113, @p114, @p115, @p116, @p117, @p118, @p119, @p120, @p121, @p122, @p123, @p124, @p125, @p126, @p127, @p128, @p129, @p130, @p131, @p132, @p133, @p134, @p135, @p136, @p137, @p138, @p139, @p140, @p141, @p142, @p143, @p144, @p145, @p146, @p147, @p148, @p149, @p150, @p151, @p152, @p153, @p154, @p155, @p156, @p157, @p158, @p159, @p160, @p161, @p162, @p163, @p164, @p165, @p166, @p167, 2), (@p168, @p169, @p170, @p171, @p172, @p173, @p174, @p175, @p176, @p177, @p178, @p179, @p180, @p181, @p182, @p183, @p184, @p185, @p186, @p187, @p188, @p189, @p190, @p191, @p192, @p193, @p194, @p195, @p196, @p197, @p198, @p199, @p200, @p201, @p202, @p203, @p204, @p205, @p206, @p207, @p208, @p209, @p210, @p211, @p212, @p213, @p214, @p215, @p216, @p217, @p218, @p219, @p220, @p221, @p222, @p223, 3), (@p224, @p225, @p226, @p227, @p228, @p229, @p230, @p231, @p232, @p233, @p234, @p235, @p236, @p237, @p238, @p239, @p240, @p241, @p242, @p243, @p244, @p245, @p246, @p247, @p248, @p249, @p250, @p251, @p252, @p253, @p254, @p255, @p256, @p257, @p258, @p259, @p260, @p261, @p262, @p263, @p264, @p265, @p266, @p267, @p268, @p269, @p270, @p271, @p272, @p273, @p274, @p275, @p276, @p277, @p278, @p279, 4), (@p280, @p281, @p282, @p283, @p284, @p285, @p286, @p287, @p288, @p289, @p290, @p291, @p292, @p293, @p294, @p295, @p296, @p297, @p298, @p299, @p300, @p301, @p302, @p303, @p304, @p305, @p306, @p307, @p308, @p309, @p310, @p311, @p312, @p313, @p314, @p315, @p316, @p317, @p318, @p319, @p320, @p321, @p322, @p323, @p324, @p325, @p326, @p327, @p328, @p329, @p330, @p331, @p332, @p333, @p334, @p335, 5), (@p336, @p337, @p338, @p339, @p340, @p341, @p342, @p343, @p344, @p345, @p346, @p347, @p348, @p349, @p350, @p351, @p352, @p353, @p354, @p355, @p356, @p357, @p358, @p359, @p360, @p361, @p362, @p363, @p364, @p365, @p366, @p367, @p368, @p369, @p370, @p371, @p372, @p373, @p374, @p375, @p376, @p377, @p378, @p379, @p380, @p381, @p382, @p383, @p384, @p385, @p386, @p387, @p388, @p389, @p390, @p391, 6), (@p392, @p393, @p394, @p395, @p396, @p397, @p398, @p399, @p400, @p401, @p402, @p403, @p404, @p405, @p406, @p407, @p408, @p409, @p410, @p411, @p412, @p413, @p414, @p415, @p416, @p417, @p418, @p419, @p420, @p421, @p422, @p423, @p424, @p425, @p426, @p427, @p428, @p429, @p430, @p431, @p432, @p433, @p434, @p435, @p436, @p437, @p438, @p439, @p440, @p441, @p442, @p443, @p444, @p445, @p446, @p447, 7), (@p448, @p449, @p450, @p451, @p452, @p453, @p454, @p455, @p456, @p457, @p458, @p459, @p460, @p461, @p462, @p463, @p464, @p465, @p466, @p467, @p468, @p469, @p470, @p471, @p472, @p473, @p474, @p475, @p476, @p477, @p478, @p479, @p480, @p481, @p482, @p483, @p484, @p485, @p486, @p487, @p488, @p489, @p490, @p491, @p492, @p493, @p494, @p495, @p496, @p497, @p498, @p499, @p500, @p501, @p502, @p503, 8), (@p504, @p505, @p506, @p507, @p508, @p509, @p510, @p511, @p512, @p513, @p514, @p515, @p516, @p517, @p518, @p519, @p520, @p521, @p522, @p523, @p524, @p525, @p526, @p527, @p528, @p529, @p530, @p531, @p532, @p533, @p534, @p535, @p536, @p537, @p538, @p539, @p540, @p541, @p542, @p543, @p544, @p545, @p546, @p547, @p548, @p549, @p550, @p551, @p552, @p553, @p554, @p555, @p556, @p557, @p558, @p559, 9), (@p560, @p561, @p562, @p563, @p564, @p565, @p566, @p567, @p568, @p569, @p570, @p571, @p572, @p573, @p574, @p575, @p576, @p577, @p578, @p579, @p580, @p581, @p582, @p583, @p584, @p585, @p586, @p587, @p588, @p589, @p590, @p591, @p592, @p593, @p594, @p595, @p596, @p597, @p598, @p599, @p600, @p601, @p602, @p603, @p604, @p605, @p606, @p607, @p608, @p609, @p610, @p611, @p612, @p613, @p614, @p615, 10), (@p616, @p617, @p618, @p619, @p620, @p621, @p622, @p623, @p624, @p625, @p626, @p627, @p628, @p629, @p630, @p631, @p632, @p633, @p634, @p635, @p636, @p637, @p638, @p639, @p640, @p641, @p642, @p643, @p644, @p645, @p646, @p647, @p648, @p649, @p650, @p651, @p652, @p653, @p654, @p655, @p656, @p657, @p658, @p659, @p660, @p661, @p662, @p663, @p664, @p665, @p666, @p667, @p668, @p669, @p670, @p671, 11), (@p672, @p673, @p674, @p675, @p676, @p677, @p678, @p679, @p680, @p681, @p682, @p683, @p684, @p685, @p686, @p687, @p688, @p689, @p690, @p691, @p692, @p693, @p694, @p695, @p696, @p697, @p698, @p699, @p700, @p701, @p702, @p703, @p704, @p705, @p706, @p707, @p708, @p709, @p710, @p711, @p712, @p713, @p714, @p715, @p716, @p717, @p718, @p719, @p720, @p721, @p722, @p723, @p724, @p725, @p726, @p727, 12), (@p728, @p729, @p730, @p731, @p732, @p733, @p734, @p735, @p736, @p737, @p738, @p739, @p740, @p741, @p742, @p743, @p744, @p745, @p746, @p747, @p748, @p749, @p750, @p751, @p752, @p753, @p754, @p755, @p756, @p757, @p758, @p759, @p760, @p761, @p762, @p763, @p764, @p765, @p766, @p767, @p768, @p769, @p770, @p771, @p772, @p773, @p774, @p775, @p776, @p777, @p778, @p779, @p780, @p781, @p782, @p783, 13), (@p784, @p785, @p786, @p787, @p788, @p789, @p790, @p791, @p792, @p793, @p794, @p795, @p796, @p797, @p798, @p799, @p800, @p801, @p802, @p803, @p804, @p805, @p806, @p807, @p808, @p809, @p810, @p811, @p812, @p813, @p814, @p815, @p816, @p817, @p818, @p819, @p820, @p821, @p822, @p823, @p824, @p825, @p826, @p827, @p828, @p829, @p830, @p831, @p832, @p833, @p834, @p835, @p836, @p837, @p838, @p839, 14), (@p840, @p841, @p842, @p843, @p844, @p845, @p846, @p847, @p848, @p849, @p850, @p851, @p852, @p853, @p854, @p855, @p856, @p857, @p858, @p859, @p860, @p861, @p862, @p863, @p864, @p865, @p866, @p867, @p868, @p869, @p870, @p871, @p872, @p873, @p874, @p875, @p876, @p877, @p878, @p879, @p880, @p881, @p882, @p883, @p884, @p885, @p886, @p887, @p888, @p889, @p890, @p891, @p892, @p893, @p894, @p895, 15), (@p896, @p897, @p898, @p899, @p900, @p901, @p902, @p903, @p904, @p905, @p906, @p907, @p908, @p909, @p910, @p911, @p912, @p913, @p914, @p915, @p916, @p917, @p918, @p919, @p920, @p921, @p922, @p923, @p924, @p925, @p926, @p927, @p928, @p929, @p930, @p931, @p932, @p933, @p934, @p935, @p936, @p937, @p938, @p939, @p940, @p941, @p942, @p943, @p944, @p945, @p946, @p947, @p948, @p949, @p950, @p951, 16), (@p952, @p953, @p954, @p955, @p956, @p957, @p958, @p959, @p960, @p961, @p962, @p963, @p964, @p965, @p966, @p967, @p968, @p969, @p970, @p971, @p972, @p973, @p974, @p975, @p976, @p977, @p978, @p979, @p980, @p981, @p982, @p983, @p984, @p985, @p986, @p987, @p988, @p989, @p990, @p991, @p992, @p993, @p994, @p995, @p996, @p997, @p998, @p999, @p1000, @p1001, @p1002, @p1003, @p1004, @p1005, @p1006, @p1007, 17), (@p1008, @p1009, @p1010, @p1011, @p1012, @p1013, @p1014, @p1015, @p1016, @p1017, @p1018, @p1019, @p1020, @p1021, @p1022, @p1023, @p1024, @p1025, @p1026, @p1027, @p1028, @p1029, @p1030, @p1031, @p1032, @p1033, @p1034, @p1035, @p1036, @p1037, @p1038, @p1039, @p1040, @p1041, @p1042, @p1043, @p1044, @p1045, @p1046, @p1047, @p1048, @p1049, @p1050, @p1051, @p1052, @p1053, @p1054, @p1055, @p1056, @p1057, @p1058, @p1059, @p1060, @p1061, @p1062, @p1063, 18), (@p1064, @p1065, @p1066, @p1067, @p1068, @p1069, @p1070, @p1071, @p1072, @p1073, @p1074, @p1075, @p1076, @p1077, @p1078, @p1079, @p1080, @p1081, @p1082, @p1083, @p1084, @p1085, @p1086, @p1087, @p1088, @p1089, @p1090, @p1091, @p1092, @p1093, @p1094, @p1095, @p1096, @p1097, @p1098, @p1099, @p1100, @p1101, @p1102, @p1103, @p1104, @p1105, @p1106, @p1107, @p1108, @p1109, @p1110, @p1111, @p1112, @p1113, @p1114, @p1115, @p1116, @p1117, @p1118, @p1119, 19), (@p1120, @p1121, @p1122, @p1123, @p1124, @p1125, @p1126, @p1127, @p1128, @p1129, @p1130, @p1131, @p1132, @p1133, @p1134, @p1135, @p1136, @p1137, @p1138, @p1139, @p1140, @p1141, @p1142, @p1143, @p1144, @p1145, @p1146, @p1147, @p1148, @p1149, @p1150, @p1151, @p1152, @p1153, @p1154, @p1155, @p1156, @p1157, @p1158, @p1159, @p1160, @p1161, @p1162, @p1163, @p1164, @p1165, @p1166, @p1167, @p1168, @p1169, @p1170, @p1171, @p1172, @p1173, @p1174, @p1175, 20), (@p1176, @p1177, @p1178, @p1179, @p1180, @p1181, @p1182, @p1183, @p1184, @p1185, @p1186, @p1187, @p1188, @p1189, @p1190, @p1191, @p1192, @p1193, @p1194, @p1195, @p1196, @p1197, @p1198, @p1199, @p1200, @p1201, @p1202, @p1203, @p1204, @p1205, @p1206, @p1207, @p1208, @p1209, @p1210, @p1211, @p1212, @p1213, @p1214, @p1215, @p1216, @p1217, @p1218, @p1219, @p1220, @p1221, @p1222, @p1223, @p1224, @p1225, @p1226, @p1227, @p1228, @p1229, @p1230, @p1231, 21), (@p1232, @p1233, @p1234, @p1235, @p1236, @p1237, @p1238, @p1239, @p1240, @p1241, @p1242, @p1243, @p1244, @p1245, @p1246, @p1247, @p1248, @p1249, @p1250, @p1251, @p1252, @p1253, @p1254, @p1255, @p1256, @p1257, @p1258, @p1259, @p1260, @p1261, @p1262, @p1263, @p1264, @p1265, @p1266, @p1267, @p1268, @p1269, @p1270, @p1271, @p1272, @p1273, @p1274, @p1275, @p1276, @p1277, @p1278, @p1279, @p1280, @p1281, @p1282, @p1283, @p1284, @p1285, @p1286, @p1287, 22), (@p1288, @p1289, @p1290, @p1291, @p1292, @p1293, @p1294, @p1295, @p1296, @p1297, @p1298, @p1299, @p1300, @p1301, @p1302, @p1303, @p1304, @p1305, @p1306, @p1307, @p1308, @p1309, @p1310, @p1311, @p1312, @p1313, @p1314, @p1315, @p1316, @p1317, @p1318, @p1319, @p1320, @p1321, @p1322, @p1323, @p1324, @p1325, @p1326, @p1327, @p1328, @p1329, @p1330, @p1331, @p1332, @p1333, @p1334, @p1335, @p1336, @p1337, @p1338, @p1339, @p1340, @p1341, @p1342, @p1343, 23), (@p1344, @p1345, @p1346, @p1347, @p1348, @p1349, @p1350, @p1351, @p1352, @p1353, @p1354, @p1355, @p1356, @p1357, @p1358, @p1359, @p1360, @p1361, @p1362, @p1363, @p1364, @p1365, @p1366, @p1367, @p1368, @p1369, @p1370, @p1371, @p1372, @p1373, @p1374, @p1375, @p1376, @p1377, @p1378, @p1379, @p1380, @p1381, @p1382, @p1383, @p1384, @p1385, @p1386, @p1387, @p1388, @p1389, @p1390, @p1391, @p1392, @p1393, @p1394, @p1395, @p1396, @p1397, @p1398, @p1399, 24), (@p1400, @p1401, @p1402, @p1403, @p1404, @p1405, @p1406, @p1407, @p1408, @p1409, @p1410, @p1411, @p1412, @p1413, @p1414, @p1415, @p1416, @p1417, @p1418, @p1419, @p1420, @p1421, @p1422, @p1423, @p1424, @p1425, @p1426, @p1427, @p1428, @p1429, @p1430, @p1431, @p1432, @p1433, @p1434, @p1435, @p1436, @p1437, @p1438, @p1439, @p1440, @p1441, @p1442, @p1443, @p1444, @p1445, @p1446, @p1447, @p1448, @p1449, @p1450, @p1451, @p1452, @p1453, @p1454, @p1455, 25), (@p1456, @p1457, @p1458, @p1459, @p1460, @p1461, @p1462, @p1463, @p1464, @p1465, @p1466, @p1467, @p1468, @p1469, @p1470, @p1471, @p1472, @p1473, @p1474, @p1475, @p1476, @p1477, @p1478, @p1479, @p1480, @p1481, @p1482, @p1483, @p1484, @p1485, @p1486, @p1487, @p1488, @p1489, @p1490, @p1491, @p1492, @p1493, @p1494, @p1495, @p1496, @p1497, @p1498, @p1499, @p1500, @p1501, @p1502, @p1503, @p1504, @p1505, @p1506, @p1507, @p1508, @p1509, @p1510, @p1511, 26), (@p1512, @p1513, @p1514, @p1515, @p1516, @p1517, @p1518, @p1519, @p1520, @p1521, @p1522, @p1523, @p1524, @p1525, @p1526, @p1527, @p1528, @p1529, @p1530, @p1531, @p1532, @p1533, @p1534, @p1535, @p1536, @p1537, @p1538, @p1539, @p1540, @p1541, @p1542, @p1543, @p1544, @p1545, @p1546, @p1547, @p1548, @p1549, @p1550, @p1551, @p1552, @p1553, @p1554, @p1555, @p1556, @p1557, @p1558, @p1559, @p1560, @p1561, @p1562, @p1563, @p1564, @p1565, @p1566, @p1567, 27), (@p1568, @p1569, @p1570, @p1571, @p1572, @p1573, @p1574, @p1575, @p1576, @p1577, @p1578, @p1579, @p1580, @p1581, @p1582, @p1583, @p1584, @p1585, @p1586, @p1587, @p1588, @p1589, @p1590, @p1591, @p1592, @p1593, @p1594, @p1595, @p1596, @p1597, @p1598, @p1599, @p1600, @p1601, @p1602, @p1603, @p1604, @p1605, @p1606, @p1607, @p1608, @p1609, @p1610, @p1611, @p1612, @p1613, @p1614, @p1615, @p1616, @p1617, @p1618, @p1619, @p1620, @p1621, @p1622, @p1623, 28), (@p1624, @p1625, @p1626, @p1627, @p1628, @p1629, @p1630, @p1631, @p1632, @p1633, @p1634, @p1635, @p1636, @p1637, @p1638, @p1639, @p1640, @p1641, @p1642, @p1643, @p1644, @p1645, @p1646, @p1647, @p1648, @p1649, @p1650, @p1651, @p1652, @p1653, @p1654, @p1655, @p1656, @p1657, @p1658, @p1659, @p1660, @p1661, @p1662, @p1663, @p1664, @p1665, @p1666, @p1667, @p1668, @p1669, @p1670, @p1671, @p1672, @p1673, @p1674, @p1675, @p1676, @p1677, @p1678, @p1679, 29), (@p1680, @p1681, @p1682, @p1683, @p1684, @p1685, @p1686, @p1687, @p1688, @p1689, @p1690, @p1691, @p1692, @p1693, @p1694, @p1695, @p1696, @p1697, @p1698, @p1699, @p1700, @p1701, @p1702, @p1703, @p1704, @p1705, @p1706, @p1707, @p1708, @p1709, @p1710, @p1711, @p1712, @p1713, @p1714, @p1715, @p1716, @p1717, @p1718, @p1719, @p1720, @p1721, @p1722, @p1723, @p1724, @p1725, @p1726, @p1727, @p1728, @p1729, @p1730, @p1731, @p1732, @p1733, @p1734, @p1735, 30), (@p1736, @p1737, @p1738, @p1739, @p1740, @p1741, @p1742, @p1743, @p1744, @p1745, @p1746, @p1747, @p1748, @p1749, @p1750, @p1751, @p1752, @p1753, @p1754, @p1755, @p1756, @p1757, @p1758, @p1759, @p1760, @p1761, @p1762, @p1763, @p1764, @p1765, @p1766, @p1767, @p1768, @p1769, @p1770, @p1771, @p1772, @p1773, @p1774, @p1775, @p1776, @p1777, @p1778, @p1779, @p1780, @p1781, @p1782, @p1783, @p1784, @p1785, @p1786, @p1787, @p1788, @p1789, @p1790, @p1791, 31), (@p1792, @p1793, @p1794, @p1795, @p1796, @p1797, @p1798, @p1799, @p1800, @p1801, @p1802, @p1803, @p1804, @p1805, @p1806, @p1807, @p1808, @p1809, @p1810, @p1811, @p1812, @p1813, @p1814, @p1815, @p1816, @p1817, @p1818, @p1819, @p1820, @p1821, @p1822, @p1823, @p1824, @p1825, @p1826, @p1827, @p1828, @p1829, @p1830, @p1831, @p1832, @p1833, @p1834, @p1835, @p1836, @p1837, @p1838, @p1839, @p1840, @p1841, @p1842, @p1843, @p1844, @p1845, @p1846, @p1847, 32), (@p1848, @p1849, @p1850, @p1851, @p1852, @p1853, @p1854, @p1855, @p1856, @p1857, @p1858, @p1859, @p1860, @p1861, @p1862, @p1863, @p1864, @p1865, @p1866, @p1867, @p1868, @p1869, @p1870, @p1871, @p1872, @p1873, @p1874, @p1875, @p1876, @p1877, @p1878, @p1879, @p1880, @p1881, @p1882, @p1883, @p1884, @p1885, @p1886, @p1887, @p1888, @p1889, @p1890, @p1891, @p1892, @p1893, @p1894, @p1895, @p1896, @p1897, @p1898, @p1899, @p1900, @p1901, @p1902, @p1903, 33), (@p1904, @p1905, @p1906, @p1907, @p1908, @p1909, @p1910, @p1911, @p1912, @p1913, @p1914, @p1915, @p1916, @p1917, @p1918, @p1919, @p1920, @p1921, @p1922, @p1923, @p1924, @p1925, @p1926, @p1927, @p1928, @p1929, @p1930, @p1931, @p1932, @p1933, @p1934, @p1935, @p1936, @p1937, @p1938, @p1939, @p1940, @p1941, @p1942, @p1943, @p1944, @p1945, @p1946, @p1947, @p1948, @p1949, @p1950, @p1951, @p1952, @p1953, @p1954, @p1955, @p1956, @p1957, @p1958, @p1959, 34), (@p1960, @p1961, @p1962, @p1963, @p1964, @p1965, @p1966, @p1967, @p1968, @p1969, @p1970, @p1971, @p1972, @p1973, @p1974, @p1975, @p1976, @p1977, @p1978, @p1979, @p1980, @p1981, @p1982, @p1983, @p1984, @p1985, @p1986, @p1987, @p1988, @p1989, @p1990, @p1991, @p1992, @p1993, @p1994, @p1995, @p1996, @p1997, @p1998, @p1999, @p2000, @p2001, @p2002, @p2003, @p2004, @p2005, @p2006, @p2007, @p2008, @p2009, @p2010, @p2011, @p2012, @p2013, @p2014, @p2015, 35), (@p2016, @p2017, @p2018, @p2019, @p2020, @p2021, @p2022, @p2023, @p2024, @p2025, @p2026, @p2027, @p2028, @p2029, @p2030, @p2031, @p2032, @p2033, @p2034, @p2035, @p2036, @p2037, @p2038, @p2039, @p2040, @p2041, @p2042, @p2043, @p2044, @p2045, @p2046, @p2047, @p2048, @p2049, @p2050, @p2051, @p2052, @p2053, @p2054, @p2055, @p2056, @p2057, @p2058, @p2059, @p2060, @p2061, @p2062, @p2063, @p2064, @p2065, @p2066, @p2067, @p2068, @p2069, @p2070, @p2071, 36)) AS i ([addressee_cntry_cd], [addressee_city], [addressee_district], [addressee_email], [addressee_full_address], [addressee_home_address], [addressee_name], [addressee_postcode], [addressee_province], [addressee_subdistrict], [addressee_tel], [create_table], [delivery_code], [delivery_recipient_name], [delivery_relation_id], [delivery_status_id], [dest_outlet_id], [dest_outlet_port], [document_number], [item_barcode], [item_cod], [item_gross_weight], [item_height], [item_length], [item_price], [item_width], [lat], [log_id], [long], [outlet_id], [outlet_port], [podUrl], [remark], [scan_cntry_cd], [scan_cntry_postcode], [sender_cntry_cd], [sender_district], [sender_email], [sender_full_address], [sender_home_address], [member_id], [sender_name], [sender_postcode], [sender_province], [sender_subdistrict], [sender_tel], [server_id], [signatureUrl], [state], [status_code], [status_dtm], [timestamp], [transmit_dtm], [user_id], [wckt_id], [wkstn_no], _Position) ON 1=0 WHEN NOT MATCHED THEN INSERT ([addressee_cntry_cd], [addressee_city], [addressee_district], [addressee_email], [addressee_full_address], [addressee_home_address], [addressee_name], [addressee_postcode], [addressee_province], [addressee_subdistrict], [addressee_tel], [create_table], [delivery_code], [delivery_recipient_name], [delivery_relation_id], [delivery_status_id], [dest_outlet_id], [dest_outlet_port], [document_number], [item_barcode], [item_cod], [item_gross_weight], [item_height], [item_length], [item_price], [item_width], [lat], [log_id], [long], [outlet_id], [outlet_port], [podUrl], [remark], [scan_cntry_cd], [scan_cntry_postcode], [sender_cntry_cd], [sender_district], [sender_email], [sender_full_address], [sender_home_address], [member_id], [sender_name], [sender_postcode], [sender_province], [sender_subdistrict], [sender_tel], [server_id], [signatureUrl], [state], [status_code], [status_dtm], [timestamp], [transmit_dtm], [user_id], [wckt_id], [wkstn_no]) VALUES (i.[addressee_cntry_cd], i.[addressee_city], i.[addressee_district], i.[addressee_email], i.[addressee_full_address], i.[addressee_home_address], i.[addressee_name], i.[addressee_postcode], i.[addressee_province], i.[addressee_subdistrict], i.[addressee_tel], i.[create_table], i.[delivery_code], i.[delivery_recipient_name], i.[delivery_relation_id], i.[delivery_status_id], i.[dest_outlet_id], i.[dest_outlet_port], i.[document_number], i.[item_barcode], i.[item_cod], i.[item_gross_weight], i.[item_height], i.[item_length], i.[item_price], i.[item_width], i.[lat], i.[log_id], i.[long], i.[outlet_id], i.[outlet_port], i.[podUrl], i.[remark], i.[scan_cntry_cd], i.[scan_cntry_postcode], i.[sender_cntry_cd], i.[sender_district], i.[sender_email], i.[sender_full_address], i.[sender_home_address], i.[member_id], i.[sender_name], i.[sender_postcode], i.[sender_province], i.[sender_subdistrict], i.[sender_tel], i.[server_id], i.[signatureUrl], i.[state], i.[status_code], i.[status_dtm], i.[timestamp], i.[transmit_dtm], i.[user_id], i.[wckt_id], i.[wkstn_no]) OUTPUT INSERTED.[item_id], i._Position INTO @inserted0;  SELECT [t].[item_id] FROM [raw_data] t INNER JOIN @inserted0 i ON ([t].[item_id] = [i].[item_id]) ORDER BY [i].[_Position];  ",5,5,0,442,2,20
"(@p0 nvarchar(4000),@p1 nvarchar(4000),@p2 nvarchar(4000),@p3 nvarchar(4000),@p4 nvarchar(4000),@p5 nvarchar(4000),@p6 nvarchar(4000),@p7 nvarchar(4000),@p8 nvarchar(4000),@p9 nvarchar(4000),@p10 nvarchar(4000),@p11 datetime2(7),@p12 nvarchar(4000),@p13 nvarchar(4000),@p14 int,@p15 int,@p16 int,@p17 nvarchar(4000),@p18 nvarchar(4000),@p19 nvarchar(4000),@p20 nvarchar(4000),@p21 decimal(18,2),@p22 nvarchar(4000),@p23 nvarchar(4000),@p24 decimal(18,2),@p25 nvarchar(4000),@p26 nvarchar(4000),@p27 nvarchar(4000),@p28 nvarchar(4000),@p29 int,@p30 nvarchar(4000),@p31 nvarchar(4000),@p32 nvarchar(4000),@p33 nvarchar(4000),@p34 nvarchar(4000),@p35 nvarchar(4000),@p36 nvarchar(4000),@p37 nvarchar(4000),@p38 nvarchar(4000),@p39 nvarchar(4000),@p40 int,@p41 nvarchar(4000),@p42 nvarchar(4000),@p43 nvarchar(4000),@p44 nvarchar(4000),@p45 nvarchar(4000),@p46 int,@p47 nvarchar(4000),@p48 int,@p49 int,@p50 datetime2(7),@p51 datetime2(7),@p52 datetime2(7),@p53 nvarchar(4000),@p54 nvarchar(4000),@p55 nvarchar(4000),@p56 nvarchar(4000),@p57 nvarchar(4000),@p58 nvarchar(4000),@p59 nvarchar(4000),@p60 nvarchar(4000),@p61 nvarchar(4000),@p62 nvarchar(4000),@p63 nvarchar(4000),@p64 nvarchar(4000),@p65 nvarchar(4000),@p66 nvarchar(4000),@p67 datetime2(7),@p68 nvarchar(4000),@p69 nvarchar(4000),@p70 int,@p71 int,@p72 int,@p73 nvarchar(4000),@p74 nvarchar(4000),@p75 nvarchar(4000),@p76 nvarchar(4000),@p77 decimal(18,2),@p78 nvarchar(4000),@p79 nvarchar(4000),@p80 decimal(18,2),@p81 nvarchar(4000),@p82 nvarchar(4000),@p83 nvarchar(4000),@p84 nvarchar(4000),@p85 int,@p86 nvarchar(4000),@p87 nvarchar(4000),@p88 nvarchar(4000),@p89 nvarchar(4000),@p90 nvarchar(4000),@p91 nvarchar(4000),@p92 nvarchar(4000),@p93 nvarchar(4000),@p94 nvarchar(4000),@p95 nvarchar(4000),@p96 int,@p97 nvarchar(4000),@p98 nvarchar(4000),@p99 nvarchar(4000),@p100 nvarchar(4000),@p101 nvarchar(4000),@p102 int,@p103 nvarchar(4000),@p104 int,@p105 int,@p106 datetime2(7),@p107 datetime2(7),@p108 datetime2(7),@p109 nvarchar(4000),@p110 nvarchar(4000),@p111 nvarchar(4000),@p112 nvarchar(4000),@p113 nvarchar(4000),@p114 nvarchar(4000),@p115 nvarchar(4000),@p116 nvarchar(4000),@p117 nvarchar(4000),@p118 nvarchar(4000),@p119 nvarchar(4000),@p120 nvarchar(4000),@p121 nvarchar(4000),@p122 nvarchar(4000),@p123 datetime2(7),@p124 nvarchar(4000),@p125 nvarchar(4000),@p126 int,@p127 int,@p128 int,@p129 nvarchar(4000),@p130 nvarchar(4000),@p131 nvarchar(4000),@p132 nvarchar(4000),@p133 decimal(18,2),@p134 nvarchar(4000),@p135 nvarchar(4000),@p136 decimal(18,2),@p137 nvarchar(4000),@p138 nvarchar(4000),@p139 nvarchar(4000),@p140 nvarchar(4000),@p141 int,@p142 nvarchar(4000),@p143 nvarchar(4000),@p144 nvarchar(4000),@p145 nvarchar(4000),@p146 nvarchar(4000),@p147 nvarchar(4000),@p148 nvarchar(4000),@p149 nvarchar(4000),@p150 nvarchar(4000),@p151 nvarchar(4000),@p152 int,@p153 nvarchar(4000),@p154 nvarchar(4000),@p155 nvarchar(4000),@p156 nvarchar(4000),@p157 nvarchar(4000),@p158 int,@p159 nvarchar(4000),@p160 int,@p161 int,@p162 datetime2(7),@p163 datetime2(7),@p164 datetime2(7),@p165 nvarchar(4000),@p166 nvarchar(4000),@p167 nvarchar(4000),@p168 nvarchar(4000),@p169 nvarchar(4000),@p170 nvarchar(4000),@p171 nvarchar(4000),@p172 nvarchar(4000),@p173 nvarchar(4000),@p174 nvarchar(4000),@p175 nvarchar(4000),@p176 nvarchar(4000),@p177 nvarchar(4000),@p178 nvarchar(4000),@p179 datetime2(7),@p180 nvarchar(4000),@p181 nvarchar(4000),@p182 int,@p183 int,@p184 int,@p185 nvarchar(4000),@p186 nvarchar(4000),@p187 nvarchar(4000),@p188 nvarchar(4000),@p189 decimal(18,2),@p190 nvarchar(4000),@p191 nvarchar(4000),@p192 decimal(18,2),@p193 nvarchar(4000),@p194 nvarchar(4000),@p195 nvarchar(4000),@p196 nvarchar(4000),@p197 int,@p198 nvarchar(4000),@p199 nvarchar(4000),@p200 nvarchar(4000),@p201 nvarchar(4000),@p202 nvarchar(4000),@p203 nvarchar(4000),@p204 nvarchar(4000),@p205 nvarchar(4000),@p206 nvarchar(4000),@p207 nvarchar(4000),@p208 int,@p209 nvarchar(4000),@p210 nvarchar(4000),@p211 nvarchar(4000),@p212 nvarchar(4000),@p213 nvarchar(4000),@p214 int,@p215 nvarchar(4000),@p216 int,@p217 int,@p218 datetime2(7),@p219 datetime2(7),@p220 datetime2(7),@p221 nvarchar(4000),@p222 nvarchar(4000),@p223 nvarchar(4000),@p224 nvarchar(4000),@p225 nvarchar(4000),@p226 nvarchar(4000),@p227 nvarchar(4000),@p228 nvarchar(4000),@p229 nvarchar(4000),@p230 nvarchar(4000),@p231 nvarchar(4000),@p232 nvarchar(4000),@p233 nvarchar(4000),@p234 nvarchar(4000),@p235 datetime2(7),@p236 nvarchar(4000),@p237 nvarchar(4000),@p238 int,@p239 int,@p240 int,@p241 nvarchar(4000),@p242 nvarchar(4000),@p243 nvarchar(4000),@p244 nvarchar(4000),@p245 decimal(18,2),@p246 nvarchar(4000),@p247 nvarchar(4000),@p248 decimal(18,2),@p249 nvarchar(4000),@p250 nvarchar(4000),@p251 nvarchar(4000),@p252 nvarchar(4000),@p253 int,@p254 nvarchar(4000),@p255 nvarchar(4000),@p256 nvarchar(4000),@p257 nvarchar(4000),@p258 nvarchar(4000),@p259 nvarchar(4000),@p260 nvarchar(4000),@p261 nvarchar(4000),@p262 nvarchar(4000),@p263 nvarchar(4000),@p264 int,@p265 nvarchar(4000),@p266 nvarchar(4000),@p267 nvarchar(4000),@p268 nvarchar(4000),@p269 nvarchar(4000),@p270 int,@p271 nvarchar(4000),@p272 int,@p273 int,@p274 datetime2(7),@p275 datetime2(7),@p276 datetime2(7),@p277 nvarchar(4000),@p278 nvarchar(4000),@p279 nvarchar(4000),@p280 nvarchar(4000),@p281 nvarchar(4000),@p282 nvarchar(4000),@p283 nvarchar(4000),@p284 nvarchar(4000),@p285 nvarchar(4000),@p286 nvarchar(4000),@p287 nvarchar(4000),@p288 nvarchar(4000),@p289 nvarchar(4000),@p290 nvarchar(4000),@p291 datetime2(7),@p292 nvarchar(4000),@p293 nvarchar(4000),@p294 int,@p295 int,@p296 int,@p297 nvarchar(4000),@p298 nvarchar(4000),@p299 nvarchar(4000),@p300 nvarchar(4000),@p301 decimal(18,2),@p302 nvarchar(4000),@p303 nvarchar(4000),@p304 decimal(18,2),@p305 nvarchar(4000),@p306 nvarchar(4000),@p307 nvarchar(4000),@p308 nvarchar(4000),@p309 int,@p310 nvarchar(4000),@p311 nvarchar(4000),@p312 nvarchar(4000),@p313 nvarchar(4000),@p314 nvarchar(4000),@p315 nvarchar(4000),@p316 nvarchar(4000),@p317 nvarchar(4000),@p318 nvarchar(4000),@p319 nvarchar(4000),@p320 int,@p321 nvarchar(4000),@p322 nvarchar(4000),@p323 nvarchar(4000),@p324 nvarchar(4000),@p325 nvarchar(4000),@p326 int,@p327 nvarchar(4000),@p328 int,@p329 int,@p330 datetime2(7),@p331 datetime2(7),@p332 datetime2(7),@p333 nvarchar(4000),@p334 nvarchar(4000),@p335 nvarchar(4000),@p336 nvarchar(4000),@p337 nvarchar(4000),@p338 nvarchar(4000),@p339 nvarchar(4000),@p340 nvarchar(4000),@p341 nvarchar(4000),@p342 nvarchar(4000),@p343 nvarchar(4000),@p344 nvarchar(4000),@p345 nvarchar(4000),@p346 nvarchar(4000),@p347 datetime2(7),@p348 nvarchar(4000),@p349 nvarchar(4000),@p350 int,@p351 int,@p352 int,@p353 nvarchar(4000),@p354 nvarchar(4000),@p355 nvarchar(4000),@p356 nvarchar(4000),@p357 decimal(18,2),@p358 nvarchar(4000),@p359 nvarchar(4000),@p360 decimal(18,2),@p361 nvarchar(4000),@p362 nvarchar(4000),@p363 nvarchar(4000),@p364 nvarchar(4000),@p365 int,@p366 nvarchar(4000),@p367 nvarchar(4000),@p368 nvarchar(4000),@p369 nvarchar(4000),@p370 nvarchar(4000),@p371 nvarchar(4000),@p372 nvarchar(4000),@p373 nvarchar(4000),@p374 nvarchar(4000),@p375 nvarchar(4000),@p376 int,@p377 nvarchar(4000),@p378 nvarchar(4000),@p379 nvarchar(4000),@p380 nvarchar(4000),@p381 nvarchar(4000),@p382 int,@p383 nvarchar(4000),@p384 int,@p385 int,@p386 datetime2(7),@p387 datetime2(7),@p388 datetime2(7),@p389 nvarchar(4000),@p390 nvarchar(4000),@p391 nvarchar(4000),@p392 nvarchar(4000),@p393 nvarchar(4000),@p394 nvarchar(4000),@p395 nvarchar(4000),@p396 nvarchar(4000),@p397 nvarchar(4000),@p398 nvarchar(4000),@p399 nvarchar(4000),@p400 nvarchar(4000),@p401 nvarchar(4000),@p402 nvarchar(4000),@p403 datetime2(7),@p404 nvarchar(4000),@p405 nvarchar(4000),@p406 int,@p407 int,@p408 int,@p409 nvarchar(4000),@p410 nvarchar(4000),@p411 nvarchar(4000),@p412 nvarchar(4000),@p413 decimal(18,2),@p414 nvarchar(4000),@p415 nvarchar(4000),@p416 decimal(18,2),@p417 nvarchar(4000),@p418 nvarchar(4000),@p419 nvarchar(4000),@p420 nvarchar(4000),@p421 int,@p422 nvarchar(4000),@p423 nvarchar(4000),@p424 nvarchar(4000),@p425 nvarchar(4000),@p426 nvarchar(4000),@p427 nvarchar(4000),@p428 nvarchar(4000),@p429 nvarchar(4000),@p430 nvarchar(4000),@p431 nvarchar(4000),@p432 int,@p433 nvarchar(4000),@p434 nvarchar(4000),@p435 nvarchar(4000),@p436 nvarchar(4000),@p437 nvarchar(4000),@p438 int,@p439 nvarchar(4000),@p440 int,@p441 int,@p442 datetime2(7),@p443 datetime2(7),@p444 datetime2(7),@p445 nvarchar(4000),@p446 nvarchar(4000),@p447 nvarchar(4000),@p448 nvarchar(4000),@p449 nvarchar(4000),@p450 nvarchar(4000),@p451 nvarchar(4000),@p452 nvarchar(4000),@p453 nvarchar(4000),@p454 nvarchar(4000),@p455 nvarchar(4000),@p456 nvarchar(4000),@p457 nvarchar(4000),@p458 nvarchar(4000),@p459 datetime2(7),@p460 nvarchar(4000),@p461 nvarchar(4000),@p462 int,@p463 int,@p464 int,@p465 nvarchar(4000),@p466 nvarchar(4000),@p467 nvarchar(4000),@p468 nvarchar(4000),@p469 decimal(18,2),@p470 nvarchar(4000),@p471 nvarchar(4000),@p472 decimal(18,2),@p473 nvarchar(4000),@p474 nvarchar(4000),@p475 nvarchar(4000),@p476 nvarchar(4000),@p477 int,@p478 nvarchar(4000),@p479 nvarchar(4000),@p480 nvarchar(4000),@p481 nvarchar(4000),@p482 nvarchar(4000),@p483 nvarchar(4000),@p484 nvarchar(4000),@p485 nvarchar(4000),@p486 nvarchar(4000),@p487 nvarchar(4000),@p488 int,@p489 nvarchar(4000),@p490 nvarchar(4000),@p491 nvarchar(4000),@p492 nvarchar(4000),@p493 nvarchar(4000),@p494 int,@p495 nvarchar(4000),@p496 int,@p497 int,@p498 datetime2(7),@p499 datetime2(7),@p500 datetime2(7),@p501 nvarchar(4000),@p502 nvarchar(4000),@p503 nvarchar(4000),@p504 nvarchar(4000),@p505 nvarchar(4000),@p506 nvarchar(4000),@p507 nvarchar(4000),@p508 nvarchar(4000),@p509 nvarchar(4000),@p510 nvarchar(4000),@p511 nvarchar(4000),@p512 nvarchar(4000),@p513 nvarchar(4000),@p514 nvarchar(4000),@p515 datetime2(7),@p516 nvarchar(4000),@p517 nvarchar(4000),@p518 int,@p519 int,@p520 int,@p521 nvarchar(4000),@p522 nvarchar(4000),@p523 nvarchar(4000),@p524 nvarchar(4000),@p525 decimal(18,2),@p526 nvarchar(4000),@p527 nvarchar(4000),@p528 decimal(18,2),@p529 nvarchar(4000),@p530 nvarchar(4000),@p531 nvarchar(4000),@p532 nvarchar(4000),@p533 int,@p534 nvarchar(4000),@p535 nvarchar(4000),@p536 nvarchar(4000),@p537 nvarchar(4000),@p538 nvarchar(4000),@p539 nvarchar(4000),@p540 nvarchar(4000),@p541 nvarchar(4000),@p542 nvarchar(4000),@p543 nvarchar(4000),@p544 int,@p545 nvarchar(4000),@p546 nvarchar(4000),@p547 nvarchar(4000),@p548 nvarchar(4000),@p549 nvarchar(4000),@p550 int,@p551 nvarchar(4000),@p552 int,@p553 int,@p554 datetime2(7),@p555 datetime2(7),@p556 datetime2(7),@p557 nvarchar(4000),@p558 nvarchar(4000),@p559 nvarchar(4000),@p560 nvarchar(4000),@p561 nvarchar(4000),@p562 nvarchar(4000),@p563 nvarchar(4000),@p564 nvarchar(4000),@p565 nvarchar(4000),@p566 nvarchar(4000),@p567 nvarchar(4000),@p568 nvarchar(4000),@p569 nvarchar(4000),@p570 nvarchar(4000),@p571 datetime2(7),@p572 nvarchar(4000),@p573 nvarchar(4000),@p574 int,@p575 int,@p576 int,@p577 nvarchar(4000),@p578 nvarchar(4000),@p579 nvarchar(4000),@p580 nvarchar(4000),@p581 decimal(18,2),@p582 nvarchar(4000),@p583 nvarchar(4000),@p584 decimal(18,2),@p585 nvarchar(4000),@p586 nvarchar(4000),@p587 nvarchar(4000),@p588 nvarchar(4000),@p589 int,@p590 nvarchar(4000),@p591 nvarchar(4000),@p592 nvarchar(4000),@p593 nvarchar(4000),@p594 nvarchar(4000),@p595 nvarchar(4000),@p596 nvarchar(4000),@p597 nvarchar(4000),@p598 nvarchar(4000),@p599 nvarchar(4000),@p600 int,@p601 nvarchar(4000),@p602 nvarchar(4000),@p603 nvarchar(4000),@p604 nvarchar(4000),@p605 nvarchar(4000),@p606 int,@p607 nvarchar(4000),@p608 int,@p609 int,@p610 datetime2(7),@p611 datetime2(7),@p612 datetime2(7),@p613 nvarchar(4000),@p614 nvarchar(4000),@p615 nvarchar(4000),@p616 nvarchar(4000),@p617 nvarchar(4000),@p618 nvarchar(4000),@p619 nvarchar(4000),@p620 nvarchar(4000),@p621 nvarchar(4000),@p622 nvarchar(4000),@p623 nvarchar(4000),@p624 nvarchar(4000),@p625 nvarchar(4000),@p626 nvarchar(4000),@p627 datetime2(7),@p628 nvarchar(4000),@p629 nvarchar(4000),@p630 int,@p631 int,@p632 int,@p633 nvarchar(4000),@p634 nvarchar(4000),@p635 nvarchar(4000),@p636 nvarchar(4000),@p637 decimal(18,2),@p638 nvarchar(4000),@p639 nvarchar(4000),@p640 decimal(18,2),@p641 nvarchar(4000),@p642 nvarchar(4000),@p643 nvarchar(4000),@p644 nvarchar(4000),@p645 int,@p646 nvarchar(4000),@p647 nvarchar(4000),@p648 nvarchar(4000),@p649 nvarchar(4000),@p650 nvarchar(4000),@p651 nvarchar(4000),@p652 nvarchar(4000),@p653 nvarchar(4000),@p654 nvarchar(4000),@p655 nvarchar(4000),@p656 int,@p657 nvarchar(4000),@p658 nvarchar(4000),@p659 nvarchar(4000),@p660 nvarchar(4000),@p661 nvarchar(4000),@p662 int,@p663 nvarchar(4000),@p664 int,@p665 int,@p666 datetime2(7),@p667 datetime2(7),@p668 datetime2(7),@p669 nvarchar(4000),@p670 nvarchar(4000),@p671 nvarchar(4000),@p672 nvarchar(4000),@p673 nvarchar(4000),@p674 nvarchar(4000),@p675 nvarchar(4000),@p676 nvarchar(4000),@p677 nvarchar(4000),@p678 nvarchar(4000),@p679 nvarchar(4000),@p680 nvarchar(4000),@p681 nvarchar(4000),@p682 nvarchar(4000),@p683 datetime2(7),@p684 nvarchar(4000),@p685 nvarchar(4000),@p686 int,@p687 int,@p688 int,@p689 nvarchar(4000),@p690 nvarchar(4000),@p691 nvarchar(4000),@p692 nvarchar(4000),@p693 decimal(18,2),@p694 nvarchar(4000),@p695 nvarchar(4000),@p696 decimal(18,2),@p697 nvarchar(4000),@p698 nvarchar(4000),@p699 nvarchar(4000),@p700 nvarchar(4000),@p701 int,@p702 nvarchar(4000),@p703 nvarchar(4000),@p704 nvarchar(4000),@p705 nvarchar(4000),@p706 nvarchar(4000),@p707 nvarchar(4000),@p708 nvarchar(4000),@p709 nvarchar(4000),@p710 nvarchar(4000),@p711 nvarchar(4000),@p712 int,@p713 nvarchar(4000),@p714 nvarchar(4000),@p715 nvarchar(4000),@p716 nvarchar(4000),@p717 nvarchar(4000),@p718 int,@p719 nvarchar(4000),@p720 int,@p721 int,@p722 datetime2(7),@p723 datetime2(7),@p724 datetime2(7),@p725 nvarchar(4000),@p726 nvarchar(4000),@p727 nvarchar(4000),@p728 nvarchar(4000),@p729 nvarchar(4000),@p730 nvarchar(4000),@p731 nvarchar(4000),@p732 nvarchar(4000),@p733 nvarchar(4000),@p734 nvarchar(4000),@p735 nvarchar(4000),@p736 nvarchar(4000),@p737 nvarchar(4000),@p738 nvarchar(4000),@p739 datetime2(7),@p740 nvarchar(4000),@p741 nvarchar(4000),@p742 int,@p743 int,@p744 int,@p745 nvarchar(4000),@p746 nvarchar(4000),@p747 nvarchar(4000),@p748 nvarchar(4000),@p749 decimal(18,2),@p750 nvarchar(4000),@p751 nvarchar(4000),@p752 decimal(18,2),@p753 nvarchar(4000),@p754 nvarchar(4000),@p755 nvarchar(4000),@p756 nvarchar(4000),@p757 int,@p758 nvarchar(4000),@p759 nvarchar(4000),@p760 nvarchar(4000),@p761 nvarchar(4000),@p762 nvarchar(4000),@p763 nvarchar(4000),@p764 nvarchar(4000),@p765 nvarchar(4000),@p766 nvarchar(4000),@p767 nvarchar(4000),@p768 int,@p769 nvarchar(4000),@p770 nvarchar(4000),@p771 nvarchar(4000),@p772 nvarchar(4000),@p773 nvarchar(4000),@p774 int,@p775 nvarchar(4000),@p776 int,@p777 int,@p778 datetime2(7),@p779 datetime2(7),@p780 datetime2(7),@p781 nvarchar(4000),@p782 nvarchar(4000),@p783 nvarchar(4000),@p784 nvarchar(4000),@p785 nvarchar(4000),@p786 nvarchar(4000),@p787 nvarchar(4000),@p788 nvarchar(4000),@p789 nvarchar(4000),@p790 nvarchar(4000),@p791 nvarchar(4000),@p792 nvarchar(4000),@p793 nvarchar(4000),@p794 nvarchar(4000),@p795 datetime2(7),@p796 nvarchar(4000),@p797 nvarchar(4000),@p798 int,@p799 int,@p800 int,@p801 nvarchar(4000),@p802 nvarchar(4000),@p803 nvarchar(4000),@p804 nvarchar(4000),@p805 decimal(18,2),@p806 nvarchar(4000),@p807 nvarchar(4000),@p808 decimal(18,2),@p809 nvarchar(4000),@p810 nvarchar(4000),@p811 nvarchar(4000),@p812 nvarchar(4000),@p813 int,@p814 nvarchar(4000),@p815 nvarchar(4000),@p816 nvarchar(4000),@p817 nvarchar(4000),@p818 nvarchar(4000),@p819 nvarchar(4000),@p820 nvarchar(4000),@p821 nvarchar(4000),@p822 nvarchar(4000),@p823 nvarchar(4000),@p824 int,@p825 nvarchar(4000),@p826 nvarchar(4000),@p827 nvarchar(4000),@p828 nvarchar(4000),@p829 nvarchar(4000),@p830 int,@p831 nvarchar(4000),@p832 int,@p833 int,@p834 datetime2(7),@p835 datetime2(7),@p836 datetime2(7),@p837 nvarchar(4000),@p838 nvarchar(4000),@p839 nvarchar(4000),@p840 nvarchar(4000),@p841 nvarchar(4000),@p842 nvarchar(4000),@p843 nvarchar(4000),@p844 nvarchar(4000),@p845 nvarchar(4000),@p846 nvarchar(4000),@p847 nvarchar(4000),@p848 nvarchar(4000),@p849 nvarchar(4000),@p850 nvarchar(4000),@p851 datetime2(7),@p852 nvarchar(4000),@p853 nvarchar(4000),@p854 int,@p855 int,@p856 int,@p857 nvarchar(4000),@p858 nvarchar(4000),@p859 nvarchar(4000),@p860 decimal(18,2),@p861 decimal(18,2),@p862 nvarchar(4000),@p863 nvarchar(4000),@p864 decimal(18,2),@p865 nvarchar(4000),@p866 nvarchar(4000),@p867 nvarchar(4000),@p868 nvarchar(4000),@p869 int,@p870 nvarchar(4000),@p871 nvarchar(4000),@p872 nvarchar(4000),@p873 nvarchar(4000),@p874 nvarchar(4000),@p875 nvarchar(4000),@p876 nvarchar(4000),@p877 nvarchar(4000),@p878 nvarchar(4000),@p879 nvarchar(4000),@p880 int,@p881 nvarchar(4000),@p882 nvarchar(4000),@p883 nvarchar(4000),@p884 nvarchar(4000),@p885 nvarchar(4000),@p886 int,@p887 nvarchar(4000),@p888 int,@p889 int,@p890 datetime2(7),@p891 datetime2(7),@p892 datetime2(7),@p893 nvarchar(4000),@p894 nvarchar(4000),@p895 nvarchar(4000),@p896 nvarchar(4000),@p897 nvarchar(4000),@p898 nvarchar(4000),@p899 nvarchar(4000),@p900 nvarchar(4000),@p901 nvarchar(4000),@p902 nvarchar(4000),@p903 nvarchar(4000),@p904 nvarchar(4000),@p905 nvarchar(4000),@p906 nvarchar(4000),@p907 datetime2(7),@p908 nvarchar(4000),@p909 nvarchar(4000),@p910 int,@p911 int,@p912 int,@p913 nvarchar(4000),@p914 nvarchar(4000),@p915 nvarchar(4000),@p916 decimal(18,2),@p917 decimal(18,2),@p918 nvarchar(4000),@p919 nvarchar(4000),@p920 decimal(18,2),@p921 nvarchar(4000),@p922 nvarchar(4000),@p923 nvarchar(4000),@p924 nvarchar(4000),@p925 int,@p926 nvarchar(4000),@p927 nvarchar(4000),@p928 nvarchar(4000),@p929 nvarchar(4000),@p930 nvarchar(4000),@p931 nvarchar(4000),@p932 nvarchar(4000),@p933 nvarchar(4000),@p934 nvarchar(4000),@p935 nvarchar(4000),@p936 int,@p937 nvarchar(4000),@p938 nvarchar(4000),@p939 nvarchar(4000),@p940 nvarchar(4000),@p941 nvarchar(4000),@p942 int,@p943 nvarchar(4000),@p944 int,@p945 int,@p946 datetime2(7),@p947 datetime2(7),@p948 datetime2(7),@p949 nvarchar(4000),@p950 nvarchar(4000),@p951 nvarchar(4000),@p952 nvarchar(4000),@p953 nvarchar(4000),@p954 nvarchar(4000),@p955 nvarchar(4000),@p956 nvarchar(4000),@p957 nvarchar(4000),@p958 nvarchar(4000),@p959 nvarchar(4000),@p960 nvarchar(4000),@p961 nvarchar(4000),@p962 nvarchar(4000),@p963 datetime2(7),@p964 nvarchar(4000),@p965 nvarchar(4000),@p966 int,@p967 int,@p968 int,@p969 nvarchar(4000),@p970 nvarchar(4000),@p971 nvarchar(4000),@p972 decimal(18,2),@p973 decimal(18,2),@p974 nvarchar(4000),@p975 nvarchar(4000),@p976 decimal(18,2),@p977 nvarchar(4000),@p978 nvarchar(4000),@p979 nvarchar(4000),@p980 nvarchar(4000),@p981 int,@p982 nvarchar(4000),@p983 nvarchar(4000),@p984 nvarchar(4000),@p985 nvarchar(4000),@p986 nvarchar(4000),@p987 nvarchar(4000),@p988 nvarchar(4000),@p989 nvarchar(4000),@p990 nvarchar(4000),@p991 nvarchar(4000),@p992 int,@p993 nvarchar(4000),@p994 nvarchar(4000),@p995 nvarchar(4000),@p996 nvarchar(4000),@p997 nvarchar(4000),@p998 int,@p999 nvarchar(4000),@p1000 int,@p1001 int,@p1002 datetime2(7),@p1003 datetime2(7),@p1004 datetime2(7),@p1005 nvarchar(4000),@p1006 nvarchar(4000),@p1007 nvarchar(4000),@p1008 nvarchar(4000),@p1009 nvarchar(4000),@p1010 nvarchar(4000),@p1011 nvarchar(4000),@p1012 nvarchar(4000),@p1013 nvarchar(4000),@p1014 nvarchar(4000),@p1015 nvarchar(4000),@p1016 nvarchar(4000),@p1017 nvarchar(4000),@p1018 nvarchar(4000),@p1019 datetime2(7),@p1020 nvarchar(4000),@p1021 nvarchar(4000),@p1022 int,@p1023 int,@p1024 int,@p1025 nvarchar(4000),@p1026 nvarchar(4000),@p1027 nvarchar(4000),@p1028 decimal(18,2),@p1029 decimal(18,2),@p1030 nvarchar(4000),@p1031 nvarchar(4000),@p1032 decimal(18,2),@p1033 nvarchar(4000),@p1034 nvarchar(4000),@p1035 nvarchar(4000),@p1036 nvarchar(4000),@p1037 int,@p1038 nvarchar(4000),@p1039 nvarchar(4000),@p1040 nvarchar(4000),@p1041 nvarchar(4000),@p1042 nvarchar(4000),@p1043 nvarchar(4000),@p1044 nvarchar(4000),@p1045 nvarchar(4000),@p1046 nvarchar(4000),@p1047 nvarchar(4000),@p1048 int,@p1049 nvarchar(4000),@p1050 nvarchar(4000),@p1051 nvarchar(4000),@p1052 nvarchar(4000),@p1053 nvarchar(4000),@p1054 int,@p1055 nvarchar(4000),@p1056 int,@p1057 int,@p1058 datetime2(7),@p1059 datetime2(7),@p1060 datetime2(7),@p1061 nvarchar(4000),@p1062 nvarchar(4000),@p1063 nvarchar(4000),@p1064 nvarchar(4000),@p1065 nvarchar(4000),@p1066 nvarchar(4000),@p1067 nvarchar(4000),@p1068 nvarchar(4000),@p1069 nvarchar(4000),@p1070 nvarchar(4000),@p1071 nvarchar(4000),@p1072 nvarchar(4000),@p1073 nvarchar(4000),@p1074 nvarchar(4000),@p1075 datetime2(7),@p1076 nvarchar(4000),@p1077 nvarchar(4000),@p1078 int,@p1079 int,@p1080 int,@p1081 nvarchar(4000),@p1082 nvarchar(4000),@p1083 nvarchar(4000),@p1084 decimal(18,2),@p1085 decimal(18,2),@p1086 nvarchar(4000),@p1087 nvarchar(4000),@p1088 decimal(18,2),@p1089 nvarchar(4000),@p1090 nvarchar(4000),@p1091 nvarchar(4000),@p1092 nvarchar(4000),@p1093 int,@p1094 nvarchar(4000),@p1095 nvarchar(4000),@p1096 nvarchar(4000),@p1097 nvarchar(4000),@p1098 nvarchar(4000),@p1099 nvarchar(4000),@p1100 nvarchar(4000),@p1101 nvarchar(4000),@p1102 nvarchar(4000),@p1103 nvarchar(4000),@p1104 int,@p1105 nvarchar(4000),@p1106 nvarchar(4000),@p1107 nvarchar(4000),@p1108 nvarchar(4000),@p1109 nvarchar(4000),@p1110 int,@p1111 nvarchar(4000),@p1112 int,@p1113 int,@p1114 datetime2(7),@p1115 datetime2(7),@p1116 datetime2(7),@p1117 nvarchar(4000),@p1118 nvarchar(4000),@p1119 nvarchar(4000),@p1120 nvarchar(4000),@p1121 nvarchar(4000),@p1122 nvarchar(4000),@p1123 nvarchar(4000),@p1124 nvarchar(4000),@p1125 nvarchar(4000),@p1126 nvarchar(4000),@p1127 nvarchar(4000),@p1128 nvarchar(4000),@p1129 nvarchar(4000),@p1130 nvarchar(4000),@p1131 datetime2(7),@p1132 nvarchar(4000),@p1133 nvarchar(4000),@p1134 int,@p1135 int,@p1136 int,@p1137 nvarchar(4000),@p1138 nvarchar(4000),@p1139 nvarchar(4000),@p1140 decimal(18,2),@p1141 decimal(18,2),@p1142 nvarchar(4000),@p1143 nvarchar(4000),@p1144 decimal(18,2),@p1145 nvarchar(4000),@p1146 nvarchar(4000),@p1147 nvarchar(4000),@p1148 nvarchar(4000),@p1149 int,@p1150 nvarchar(4000),@p1151 nvarchar(4000),@p1152 nvarchar(4000),@p1153 nvarchar(4000),@p1154 nvarchar(4000),@p1155 nvarchar(4000),@p1156 nvarchar(4000),@p1157 nvarchar(4000),@p1158 nvarchar(4000),@p1159 nvarchar(4000),@p1160 int,@p1161 nvarchar(4000),@p1162 nvarchar(4000),@p1163 nvarchar(4000),@p1164 nvarchar(4000),@p1165 nvarchar(4000),@p1166 int,@p1167 nvarchar(4000),@p1168 int,@p1169 int,@p1170 datetime2(7),@p1171 datetime2(7),@p1172 datetime2(7),@p1173 nvarchar(4000),@p1174 nvarchar(4000),@p1175 nvarchar(4000),@p1176 nvarchar(4000),@p1177 nvarchar(4000),@p1178 nvarchar(4000),@p1179 nvarchar(4000),@p1180 nvarchar(4000),@p1181 nvarchar(4000),@p1182 nvarchar(4000),@p1183 nvarchar(4000),@p1184 nvarchar(4000),@p1185 nvarchar(4000),@p1186 nvarchar(4000),@p1187 datetime2(7),@p1188 nvarchar(4000),@p1189 nvarchar(4000),@p1190 int,@p1191 int,@p1192 int,@p1193 nvarchar(4000),@p1194 nvarchar(4000),@p1195 nvarchar(4000),@p1196 decimal(18,2),@p1197 decimal(18,2),@p1198 nvarchar(4000),@p1199 nvarchar(4000),@p1200 decimal(18,2),@p1201 nvarchar(4000),@p1202 nvarchar(4000),@p1203 nvarchar(4000),@p1204 nvarchar(4000),@p1205 int,@p1206 nvarchar(4000),@p1207 nvarchar(4000),@p1208 nvarchar(4000),@p1209 nvarchar(4000),@p1210 nvarchar(4000),@p1211 nvarchar(4000),@p1212 nvarchar(4000),@p1213 nvarchar(4000),@p1214 nvarchar(4000),@p1215 nvarchar(4000),@p1216 int,@p1217 nvarchar(4000),@p1218 nvarchar(4000),@p1219 nvarchar(4000),@p1220 nvarchar(4000),@p1221 nvarchar(4000),@p1222 int,@p1223 nvarchar(4000),@p1224 int,@p1225 int,@p1226 datetime2(7),@p1227 datetime2(7),@p1228 datetime2(7),@p1229 nvarchar(4000),@p1230 nvarchar(4000),@p1231 nvarchar(4000),@p1232 nvarchar(4000),@p1233 nvarchar(4000),@p1234 nvarchar(4000),@p1235 nvarchar(4000),@p1236 nvarchar(4000),@p1237 nvarchar(4000),@p1238 nvarchar(4000),@p1239 nvarchar(4000),@p1240 nvarchar(4000),@p1241 nvarchar(4000),@p1242 nvarchar(4000),@p1243 datetime2(7),@p1244 nvarchar(4000),@p1245 nvarchar(4000),@p1246 int,@p1247 int,@p1248 int,@p1249 nvarchar(4000),@p1250 nvarchar(4000),@p1251 nvarchar(4000),@p1252 nvarchar(4000),@p1253 decimal(18,2),@p1254 nvarchar(4000),@p1255 nvarchar(4000),@p1256 decimal(18,2),@p1257 nvarchar(4000),@p1258 nvarchar(4000),@p1259 nvarchar(4000),@p1260 nvarchar(4000),@p1261 int,@p1262 nvarchar(4000),@p1263 nvarchar(4000),@p1264 nvarchar(4000),@p1265 nvarchar(4000),@p1266 nvarchar(4000),@p1267 nvarchar(4000),@p1268 nvarchar(4000),@p1269 nvarchar(4000),@p1270 nvarchar(4000),@p1271 nvarchar(4000),@p1272 int,@p1273 nvarchar(4000),@p1274 nvarchar(4000),@p1275 nvarchar(4000),@p1276 nvarchar(4000),@p1277 nvarchar(4000),@p1278 int,@p1279 nvarchar(4000),@p1280 int,@p1281 int,@p1282 datetime2(7),@p1283 datetime2(7),@p1284 datetime2(7),@p1285 nvarchar(4000),@p1286 nvarchar(4000),@p1287 nvarchar(4000),@p1288 nvarchar(4000),@p1289 nvarchar(4000),@p1290 nvarchar(4000),@p1291 nvarchar(4000),@p1292 nvarchar(4000),@p1293 nvarchar(4000),@p1294 nvarchar(4000),@p1295 nvarchar(4000),@p1296 nvarchar(4000),@p1297 nvarchar(4000),@p1298 nvarchar(4000),@p1299 datetime2(7),@p1300 nvarchar(4000),@p1301 nvarchar(4000),@p1302 int,@p1303 int,@p1304 int,@p1305 nvarchar(4000),@p1306 nvarchar(4000),@p1307 nvarchar(4000),@p1308 decimal(18,2),@p1309 decimal(18,2),@p1310 nvarchar(4000),@p1311 nvarchar(4000),@p1312 decimal(18,2),@p1313 nvarchar(4000),@p1314 nvarchar(4000),@p1315 nvarchar(4000),@p1316 nvarchar(4000),@p1317 int,@p1318 nvarchar(4000),@p1319 nvarchar(4000),@p1320 nvarchar(4000),@p1321 nvarchar(4000),@p1322 nvarchar(4000),@p1323 nvarchar(4000),@p1324 nvarchar(4000),@p1325 nvarchar(4000),@p1326 nvarchar(4000),@p1327 nvarchar(4000),@p1328 int,@p1329 nvarchar(4000),@p1330 nvarchar(4000),@p1331 nvarchar(4000),@p1332 nvarchar(4000),@p1333 nvarchar(4000),@p1334 int,@p1335 nvarchar(4000),@p1336 int,@p1337 int,@p1338 datetime2(7),@p1339 datetime2(7),@p1340 datetime2(7),@p1341 nvarchar(4000),@p1342 nvarchar(4000),@p1343 nvarchar(4000),@p1344 nvarchar(4000),@p1345 nvarchar(4000),@p1346 nvarchar(4000),@p1347 nvarchar(4000),@p1348 nvarchar(4000),@p1349 nvarchar(4000),@p1350 nvarchar(4000),@p1351 nvarchar(4000),@p1352 nvarchar(4000),@p1353 nvarchar(4000),@p1354 nvarchar(4000),@p1355 datetime2(7),@p1356 nvarchar(4000),@p1357 nvarchar(4000),@p1358 int,@p1359 int,@p1360 int,@p1361 nvarchar(4000),@p1362 nvarchar(4000),@p1363 nvarchar(4000),@p1364 decimal(18,2),@p1365 decimal(18,2),@p1366 nvarchar(4000),@p1367 nvarchar(4000),@p1368 decimal(18,2),@p1369 nvarchar(4000),@p1370 nvarchar(4000),@p1371 nvarchar(4000),@p1372 nvarchar(4000),@p1373 int,@p1374 nvarchar(4000),@p1375 nvarchar(4000),@p1376 nvarchar(4000),@p1377 nvarchar(4000),@p1378 nvarchar(4000),@p1379 nvarchar(4000),@p1380 nvarchar(4000),@p1381 nvarchar(4000),@p1382 nvarchar(4000),@p1383 nvarchar(4000),@p1384 int,@p1385 nvarchar(4000),@p1386 nvarchar(4000),@p1387 nvarchar(4000),@p1388 nvarchar(4000),@p1389 nvarchar(4000),@p1390 int,@p1391 nvarchar(4000),@p1392 int,@p1393 int,@p1394 datetime2(7),@p1395 datetime2(7),@p1396 datetime2(7),@p1397 nvarchar(4000),@p1398 nvarchar(4000),@p1399 nvarchar(4000),@p1400 nvarchar(4000),@p1401 nvarchar(4000),@p1402 nvarchar(4000),@p1403 nvarchar(4000),@p1404 nvarchar(4000),@p1405 nvarchar(4000),@p1406 nvarchar(4000),@p1407 nvarchar(4000),@p1408 nvarchar(4000),@p1409 nvarchar(4000),@p1410 nvarchar(4000),@p1411 datetime2(7),@p1412 nvarchar(4000),@p1413 nvarchar(4000),@p1414 int,@p1415 int,@p1416 int,@p1417 nvarchar(4000),@p1418 nvarchar(4000),@p1419 nvarchar(4000),@p1420 decimal(18,2),@p1421 decimal(18,2),@p1422 nvarchar(4000),@p1423 nvarchar(4000),@p1424 decimal(18,2),@p1425 nvarchar(4000),@p1426 nvarchar(4000),@p1427 nvarchar(4000),@p1428 nvarchar(4000),@p1429 int,@p1430 nvarchar(4000),@p1431 nvarchar(4000),@p1432 nvarchar(4000),@p1433 nvarchar(4000),@p1434 nvarchar(4000),@p1435 nvarchar(4000),@p1436 nvarchar(4000),@p1437 nvarchar(4000),@p1438 nvarchar(4000),@p1439 nvarchar(4000),@p1440 int,@p1441 nvarchar(4000),@p1442 nvarchar(4000),@p1443 nvarchar(4000),@p1444 nvarchar(4000),@p1445 nvarchar(4000),@p1446 int,@p1447 nvarchar(4000),@p1448 int,@p1449 int,@p1450 datetime2(7),@p1451 datetime2(7),@p1452 datetime2(7),@p1453 nvarchar(4000),@p1454 nvarchar(4000),@p1455 nvarchar(4000),@p1456 nvarchar(4000),@p1457 nvarchar(4000),@p1458 nvarchar(4000),@p1459 nvarchar(4000),@p1460 nvarchar(4000),@p1461 nvarchar(4000),@p1462 nvarchar(4000),@p1463 nvarchar(4000),@p1464 nvarchar(4000),@p1465 nvarchar(4000),@p1466 nvarchar(4000),@p1467 datetime2(7),@p1468 nvarchar(4000),@p1469 nvarchar(4000),@p1470 int,@p1471 int,@p1472 int,@p1473 nvarchar(4000),@p1474 nvarchar(4000),@p1475 nvarchar(4000),@p1476 decimal(18,2),@p1477 decimal(18,2),@p1478 nvarchar(4000),@p1479 nvarchar(4000),@p1480 decimal(18,2),@p1481 nvarchar(4000),@p1482 nvarchar(4000),@p1483 nvarchar(4000),@p1484 nvarchar(4000),@p1485 int,@p1486 nvarchar(4000),@p1487 nvarchar(4000),@p1488 nvarchar(4000),@p1489 nvarchar(4000),@p1490 nvarchar(4000),@p1491 nvarchar(4000),@p1492 nvarchar(4000),@p1493 nvarchar(4000),@p1494 nvarchar(4000),@p1495 nvarchar(4000),@p1496 int,@p1497 nvarchar(4000),@p1498 nvarchar(4000),@p1499 nvarchar(4000),@p1500 nvarchar(4000),@p1501 nvarchar(4000),@p1502 int,@p1503 nvarchar(4000),@p1504 int,@p1505 int,@p1506 datetime2(7),@p1507 datetime2(7),@p1508 datetime2(7),@p1509 nvarchar(4000),@p1510 nvarchar(4000),@p1511 nvarchar(4000),@p1512 nvarchar(4000),@p1513 nvarchar(4000),@p1514 nvarchar(4000),@p1515 nvarchar(4000),@p1516 nvarchar(4000),@p1517 nvarchar(4000),@p1518 nvarchar(4000),@p1519 nvarchar(4000),@p1520 nvarchar(4000),@p1521 nvarchar(4000),@p1522 nvarchar(4000),@p1523 datetime2(7),@p1524 nvarchar(4000),@p1525 nvarchar(4000),@p1526 int,@p1527 int,@p1528 int,@p1529 nvarchar(4000),@p1530 nvarchar(4000),@p1531 nvarchar(4000),@p1532 decimal(18,2),@p1533 decimal(18,2),@p1534 nvarchar(4000),@p1535 nvarchar(4000),@p1536 decimal(18,2),@p1537 nvarchar(4000),@p1538 nvarchar(4000),@p1539 nvarchar(4000),@p1540 nvarchar(4000),@p1541 int,@p1542 nvarchar(4000),@p1543 nvarchar(4000),@p1544 nvarchar(4000),@p1545 nvarchar(4000),@p1546 nvarchar(4000),@p1547 nvarchar(4000),@p1548 nvarchar(4000),@p1549 nvarchar(4000),@p1550 nvarchar(4000),@p1551 nvarchar(4000),@p1552 int,@p1553 nvarchar(4000),@p1554 nvarchar(4000),@p1555 nvarchar(4000),@p1556 nvarchar(4000),@p1557 nvarchar(4000),@p1558 int,@p1559 nvarchar(4000),@p1560 int,@p1561 int,@p1562 datetime2(7),@p1563 datetime2(7),@p1564 datetime2(7),@p1565 nvarchar(4000),@p1566 nvarchar(4000),@p1567 nvarchar(4000),@p1568 nvarchar(4000),@p1569 nvarchar(4000),@p1570 nvarchar(4000),@p1571 nvarchar(4000),@p1572 nvarchar(4000),@p1573 nvarchar(4000),@p1574 nvarchar(4000),@p1575 nvarchar(4000),@p1576 nvarchar(4000),@p1577 nvarchar(4000),@p1578 nvarchar(4000),@p1579 datetime2(7),@p1580 nvarchar(4000),@p1581 nvarchar(4000),@p1582 int,@p1583 int,@p1584 int,@p1585 nvarchar(4000),@p1586 nvarchar(4000),@p1587 nvarchar(4000),@p1588 decimal(18,2),@p1589 decimal(18,2),@p1590 nvarchar(4000),@p1591 nvarchar(4000),@p1592 decimal(18,2),@p1593 nvarchar(4000),@p1594 nvarchar(4000),@p1595 nvarchar(4000),@p1596 nvarchar(4000),@p1597 int,@p1598 nvarchar(4000),@p1599 nvarchar(4000),@p1600 nvarchar(4000),@p1601 nvarchar(4000),@p1602 nvarchar(4000),@p1603 nvarchar(4000),@p1604 nvarchar(4000),@p1605 nvarchar(4000),@p1606 nvarchar(4000),@p1607 nvarchar(4000),@p1608 int,@p1609 nvarchar(4000),@p1610 nvarchar(4000),@p1611 nvarchar(4000),@p1612 nvarchar(4000),@p1613 nvarchar(4000),@p1614 int,@p1615 nvarchar(4000),@p1616 int,@p1617 int,@p1618 datetime2(7),@p1619 datetime2(7),@p1620 datetime2(7),@p1621 nvarchar(4000),@p1622 nvarchar(4000),@p1623 nvarchar(4000),@p1624 nvarchar(4000),@p1625 nvarchar(4000),@p1626 nvarchar(4000),@p1627 nvarchar(4000),@p1628 nvarchar(4000),@p1629 nvarchar(4000),@p1630 nvarchar(4000),@p1631 nvarchar(4000),@p1632 nvarchar(4000),@p1633 nvarchar(4000),@p1634 nvarchar(4000),@p1635 datetime2(7),@p1636 nvarchar(4000),@p1637 nvarchar(4000),@p1638 int,@p1639 int,@p1640 int,@p1641 nvarchar(4000),@p1642 nvarchar(4000),@p1643 nvarchar(4000),@p1644 decimal(18,2),@p1645 decimal(18,2),@p1646 nvarchar(4000),@p1647 nvarchar(4000),@p1648 decimal(18,2),@p1649 nvarchar(4000),@p1650 nvarchar(4000),@p1651 nvarchar(4000),@p1652 nvarchar(4000),@p1653 int,@p1654 nvarchar(4000),@p1655 nvarchar(4000),@p1656 nvarchar(4000),@p1657 nvarchar(4000),@p1658 nvarchar(4000),@p1659 nvarchar(4000),@p1660 nvarchar(4000),@p1661 nvarchar(4000),@p1662 nvarchar(4000),@p1663 nvarchar(4000),@p1664 int,@p1665 nvarchar(4000),@p1666 nvarchar(4000),@p1667 nvarchar(4000),@p1668 nvarchar(4000),@p1669 nvarchar(4000),@p1670 int,@p1671 nvarchar(4000),@p1672 int,@p1673 int,@p1674 datetime2(7),@p1675 datetime2(7),@p1676 datetime2(7),@p1677 nvarchar(4000),@p1678 nvarchar(4000),@p1679 nvarchar(4000),@p1680 nvarchar(4000),@p1681 nvarchar(4000),@p1682 nvarchar(4000),@p1683 nvarchar(4000),@p1684 nvarchar(4000),@p1685 nvarchar(4000),@p1686 nvarchar(4000),@p1687 nvarchar(4000),@p1688 nvarchar(4000),@p1689 nvarchar(4000),@p1690 nvarchar(4000),@p1691 datetime2(7),@p1692 nvarchar(4000),@p1693 nvarchar(4000),@p1694 int,@p1695 int,@p1696 int,@p1697 nvarchar(4000),@p1698 nvarchar(4000),@p1699 nvarchar(4000),@p1700 decimal(18,2),@p1701 decimal(18,2),@p1702 nvarchar(4000),@p1703 nvarchar(4000),@p1704 decimal(18,2),@p1705 nvarchar(4000),@p1706 nvarchar(4000),@p1707 nvarchar(4000),@p1708 nvarchar(4000),@p1709 int,@p1710 nvarchar(4000),@p1711 nvarchar(4000),@p1712 nvarchar(4000),@p1713 nvarchar(4000),@p1714 nvarchar(4000),@p1715 nvarchar(4000),@p1716 nvarchar(4000),@p1717 nvarchar(4000),@p1718 nvarchar(4000),@p1719 nvarchar(4000),@p1720 int,@p1721 nvarchar(4000),@p1722 nvarchar(4000),@p1723 nvarchar(4000),@p1724 nvarchar(4000),@p1725 nvarchar(4000),@p1726 int,@p1727 nvarchar(4000),@p1728 int,@p1729 int,@p1730 datetime2(7),@p1731 datetime2(7),@p1732 datetime2(7),@p1733 nvarchar(4000),@p1734 nvarchar(4000),@p1735 nvarchar(4000),@p1736 nvarchar(4000),@p1737 nvarchar(4000),@p1738 nvarchar(4000),@p1739 nvarchar(4000),@p1740 nvarchar(4000),@p1741 nvarchar(4000),@p1742 nvarchar(4000),@p1743 nvarchar(4000),@p1744 nvarchar(4000),@p1745 nvarchar(4000),@p1746 nvarchar(4000),@p1747 datetime2(7),@p1748 nvarchar(4000),@p1749 nvarchar(4000),@p1750 int,@p1751 int,@p1752 int,@p1753 nvarchar(4000),@p1754 nvarchar(4000),@p1755 nvarchar(4000),@p1756 decimal(18,2),@p1757 decimal(18,2),@p1758 nvarchar(4000),@p1759 nvarchar(4000),@p1760 decimal(18,2),@p1761 nvarchar(4000),@p1762 nvarchar(4000),@p1763 nvarchar(4000),@p1764 nvarchar(4000),@p1765 int,@p1766 nvarchar(4000),@p1767 nvarchar(4000),@p1768 nvarchar(4000),@p1769 nvarchar(4000),@p1770 nvarchar(4000),@p1771 nvarchar(4000),@p1772 nvarchar(4000),@p1773 nvarchar(4000),@p1774 nvarchar(4000),@p1775 nvarchar(4000),@p1776 int,@p1777 nvarchar(4000),@p1778 nvarchar(4000),@p1779 nvarchar(4000),@p1780 nvarchar(4000),@p1781 nvarchar(4000),@p1782 int,@p1783 nvarchar(4000),@p1784 int,@p1785 int,@p1786 datetime2(7),@p1787 datetime2(7),@p1788 datetime2(7),@p1789 nvarchar(4000),@p1790 nvarchar(4000),@p1791 nvarchar(4000),@p1792 nvarchar(4000),@p1793 nvarchar(4000),@p1794 nvarchar(4000),@p1795 nvarchar(4000),@p1796 nvarchar(4000),@p1797 nvarchar(4000),@p1798 nvarchar(4000),@p1799 nvarchar(4000),@p1800 nvarchar(4000),@p1801 nvarchar(4000),@p1802 nvarchar(4000),@p1803 datetime2(7),@p1804 nvarchar(4000),@p1805 nvarchar(4000),@p1806 int,@p1807 int,@p1808 int,@p1809 nvarchar(4000),@p1810 nvarchar(4000),@p1811 nvarchar(4000),@p1812 decimal(18,2),@p1813 decimal(18,2),@p1814 nvarchar(4000),@p1815 nvarchar(4000),@p1816 decimal(18,2),@p1817 nvarchar(4000),@p1818 nvarchar(4000),@p1819 nvarchar(4000),@p1820 nvarchar(4000),@p1821 int,@p1822 nvarchar(4000),@p1823 nvarchar(4000),@p1824 nvarchar(4000),@p1825 nvarchar(4000),@p1826 nvarchar(4000),@p1827 nvarchar(4000),@p1828 nvarchar(4000),@p1829 nvarchar(4000),@p1830 nvarchar(4000),@p1831 nvarchar(4000),@p1832 int,@p1833 nvarchar(4000),@p1834 nvarchar(4000),@p1835 nvarchar(4000),@p1836 nvarchar(4000),@p1837 nvarchar(4000),@p1838 int,@p1839 nvarchar(4000),@p1840 int,@p1841 int,@p1842 datetime2(7),@p1843 datetime2(7),@p1844 datetime2(7),@p1845 nvarchar(4000),@p1846 nvarchar(4000),@p1847 nvarchar(4000),@p1848 nvarchar(4000),@p1849 nvarchar(4000),@p1850 nvarchar(4000),@p1851 nvarchar(4000),@p1852 nvarchar(4000),@p1853 nvarchar(4000),@p1854 nvarchar(4000),@p1855 nvarchar(4000),@p1856 nvarchar(4000),@p1857 nvarchar(4000),@p1858 nvarchar(4000),@p1859 datetime2(7),@p1860 nvarchar(4000),@p1861 nvarchar(4000),@p1862 int,@p1863 int,@p1864 int,@p1865 nvarchar(4000),@p1866 nvarchar(4000),@p1867 nvarchar(4000),@p1868 decimal(18,2),@p1869 decimal(18,2),@p1870 nvarchar(4000),@p1871 nvarchar(4000),@p1872 decimal(18,2),@p1873 nvarchar(4000),@p1874 nvarchar(4000),@p1875 nvarchar(4000),@p1876 nvarchar(4000),@p1877 int,@p1878 nvarchar(4000),@p1879 nvarchar(4000),@p1880 nvarchar(4000),@p1881 nvarchar(4000),@p1882 nvarchar(4000),@p1883 nvarchar(4000),@p1884 nvarchar(4000),@p1885 nvarchar(4000),@p1886 nvarchar(4000),@p1887 nvarchar(4000),@p1888 int,@p1889 nvarchar(4000),@p1890 nvarchar(4000),@p1891 nvarchar(4000),@p1892 nvarchar(4000),@p1893 nvarchar(4000),@p1894 int,@p1895 nvarchar(4000),@p1896 int,@p1897 int,@p1898 datetime2(7),@p1899 datetime2(7),@p1900 datetime2(7),@p1901 nvarchar(4000),@p1902 nvarchar(4000),@p1903 nvarchar(4000),@p1904 nvarchar(4000),@p1905 nvarchar(4000),@p1906 nvarchar(4000),@p1907 nvarchar(4000),@p1908 nvarchar(4000),@p1909 nvarchar(4000),@p1910 nvarchar(4000),@p1911 nvarchar(4000),@p1912 nvarchar(4000),@p1913 nvarchar(4000),@p1914 nvarchar(4000),@p1915 datetime2(7),@p1916 nvarchar(4000),@p1917 nvarchar(4000),@p1918 int,@p1919 int,@p1920 int,@p1921 nvarchar(4000),@p1922 nvarchar(4000),@p1923 nvarchar(4000),@p1924 decimal(18,2),@p1925 decimal(18,2),@p1926 nvarchar(4000),@p1927 nvarchar(4000),@p1928 decimal(18,2),@p1929 nvarchar(4000),@p1930 nvarchar(4000),@p1931 nvarchar(4000),@p1932 nvarchar(4000),@p1933 int,@p1934 nvarchar(4000),@p1935 nvarchar(4000),@p1936 nvarchar(4000),@p1937 nvarchar(4000),@p1938 nvarchar(4000),@p1939 nvarchar(4000),@p1940 nvarchar(4000),@p1941 nvarchar(4000),@p1942 nvarchar(4000),@p1943 nvarchar(4000),@p1944 int,@p1945 nvarchar(4000),@p1946 nvarchar(4000),@p1947 nvarchar(4000),@p1948 nvarchar(4000),@p1949 nvarchar(4000),@p1950 int,@p1951 nvarchar(4000),@p1952 int,@p1953 int,@p1954 datetime2(7),@p1955 datetime2(7),@p1956 datetime2(7),@p1957 nvarchar(4000),@p1958 nvarchar(4000),@p1959 nvarchar(4000),@p1960 nvarchar(4000),@p1961 nvarchar(4000),@p1962 nvarchar(4000),@p1963 nvarchar(4000),@p1964 nvarchar(4000),@p1965 nvarchar(4000),@p1966 nvarchar(4000),@p1967 nvarchar(4000),@p1968 nvarchar(4000),@p1969 nvarchar(4000),@p1970 nvarchar(4000),@p1971 datetime2(7),@p1972 nvarchar(4000),@p1973 nvarchar(4000),@p1974 int,@p1975 int,@p1976 int,@p1977 nvarchar(4000),@p1978 nvarchar(4000),@p1979 nvarchar(4000),@p1980 decimal(18,2),@p1981 decimal(18,2),@p1982 nvarchar(4000),@p1983 nvarchar(4000),@p1984 decimal(18,2),@p1985 nvarchar(4000),@p1986 nvarchar(4000),@p1987 nvarchar(4000),@p1988 nvarchar(4000),@p1989 int,@p1990 nvarchar(4000),@p1991 nvarchar(4000),@p1992 nvarchar(4000),@p1993 nvarchar(4000),@p1994 nvarchar(4000),@p1995 nvarchar(4000),@p1996 nvarchar(4000),@p1997 nvarchar(4000),@p1998 nvarchar(4000),@p1999 nvarchar(4000),@p2000 int,@p2001 nvarchar(4000),@p2002 nvarchar(4000),@p2003 nvarchar(4000),@p2004 nvarchar(4000),@p2005 nvarchar(4000),@p2006 int,@p2007 nvarchar(4000),@p2008 int,@p2009 int,@p2010 datetime2(7),@p2011 datetime2(7),@p2012 datetime2(7),@p2013 nvarchar(4000),@p2014 nvarchar(4000),@p2015 nvarchar(4000),@p2016 nvarchar(4000),@p2017 nvarchar(4000),@p2018 nvarchar(4000),@p2019 nvarchar(4000),@p2020 nvarchar(4000),@p2021 nvarchar(4000),@p2022 nvarchar(4000),@p2023 nvarchar(4000),@p2024 nvarchar(4000),@p2025 nvarchar(4000),@p2026 nvarchar(4000),@p2027 datetime2(7),@p2028 nvarchar(4000),@p2029 nvarchar(4000),@p2030 int,@p2031 int,@p2032 int,@p2033 nvarchar(4000),@p2034 nvarchar(4000),@p2035 nvarchar(4000),@p2036 nvarchar(4000),@p2037 decimal(18,2),@p2038 nvarchar(4000),@p2039 nvarchar(4000),@p2040 decimal(18,2),@p2041 nvarchar(4000),@p2042 nvarchar(4000),@p2043 nvarchar(4000),@p2044 nvarchar(4000),@p2045 int,@p2046 nvarchar(4000),@p2047 nvarchar(4000),@p2048 nvarchar(4000),@p2049 nvarchar(4000),@p2050 nvarchar(4000),@p2051 nvarchar(4000),@p2052 nvarchar(4000),@p2053 nvarchar(4000),@p2054 nvarchar(4000),@p2055 nvarchar(4000),@p2056 int,@p2057 nvarchar(4000),@p2058 nvarchar(4000),@p2059 nvarchar(4000),@p2060 nvarchar(4000),@p2061 nvarchar(4000),@p2062 int,@p2063 nvarchar(4000),@p2064 int,@p2065 int,@p2066 datetime2(7),@p2067 datetime2(7),@p2068 datetime2(7),@p2069 nvarchar(4000),@p2070 nvarchar(4000),@p2071 nvarchar(4000))SET NOCOUNT ON; DECLARE @inserted0 TABLE ([item_id] int, [_Position] [int]); MERGE [raw_data] USING ( VALUES (@p0, @p1, @p2, @p3, @p4, @p5, @p6, @p7, @p8, @p9, @p10, @p11, @p12, @p13, @p14, @p15, @p16, @p17, @p18, @p19, @p20, @p21, @p22, @p23, @p24, @p25, @p26, @p27, @p28, @p29, @p30, @p31, @p32, @p33, @p34, @p35, @p36, @p37, @p38, @p39, @p40, @p41, @p42, @p43, @p44, @p45, @p46, @p47, @p48, @p49, @p50, @p51, @p52, @p53, @p54, @p55, 0), (@p56, @p57, @p58, @p59, @p60, @p61, @p62, @p63, @p64, @p65, @p66, @p67, @p68, @p69, @p70, @p71, @p72, @p73, @p74, @p75, @p76, @p77, @p78, @p79, @p80, @p81, @p82, @p83, @p84, @p85, @p86, @p87, @p88, @p89, @p90, @p91, @p92, @p93, @p94, @p95, @p96, @p97, @p98, @p99, @p100, @p101, @p102, @p103, @p104, @p105, @p106, @p107, @p108, @p109, @p110, @p111, 1), (@p112, @p113, @p114, @p115, @p116, @p117, @p118, @p119, @p120, @p121, @p122, @p123, @p124, @p125, @p126, @p127, @p128, @p129, @p130, @p131, @p132, @p133, @p134, @p135, @p136, @p137, @p138, @p139, @p140, @p141, @p142, @p143, @p144, @p145, @p146, @p147, @p148, @p149, @p150, @p151, @p152, @p153, @p154, @p155, @p156, @p157, @p158, @p159, @p160, @p161, @p162, @p163, @p164, @p165, @p166, @p167, 2), (@p168, @p169, @p170, @p171, @p172, @p173, @p174, @p175, @p176, @p177, @p178, @p179, @p180, @p181, @p182, @p183, @p184, @p185, @p186, @p187, @p188, @p189, @p190, @p191, @p192, @p193, @p194, @p195, @p196, @p197, @p198, @p199, @p200, @p201, @p202, @p203, @p204, @p205, @p206, @p207, @p208, @p209, @p210, @p211, @p212, @p213, @p214, @p215, @p216, @p217, @p218, @p219, @p220, @p221, @p222, @p223, 3), (@p224, @p225, @p226, @p227, @p228, @p229, @p230, @p231, @p232, @p233, @p234, @p235, @p236, @p237, @p238, @p239, @p240, @p241, @p242, @p243, @p244, @p245, @p246, @p247, @p248, @p249, @p250, @p251, @p252, @p253, @p254, @p255, @p256, @p257, @p258, @p259, @p260, @p261, @p262, @p263, @p264, @p265, @p266, @p267, @p268, @p269, @p270, @p271, @p272, @p273, @p274, @p275, @p276, @p277, @p278, @p279, 4), (@p280, @p281, @p282, @p283, @p284, @p285, @p286, @p287, @p288, @p289, @p290, @p291, @p292, @p293, @p294, @p295, @p296, @p297, @p298, @p299, @p300, @p301, @p302, @p303, @p304, @p305, @p306, @p307, @p308, @p309, @p310, @p311, @p312, @p313, @p314, @p315, @p316, @p317, @p318, @p319, @p320, @p321, @p322, @p323, @p324, @p325, @p326, @p327, @p328, @p329, @p330, @p331, @p332, @p333, @p334, @p335, 5), (@p336, @p337, @p338, @p339, @p340, @p341, @p342, @p343, @p344, @p345, @p346, @p347, @p348, @p349, @p350, @p351, @p352, @p353, @p354, @p355, @p356, @p357, @p358, @p359, @p360, @p361, @p362, @p363, @p364, @p365, @p366, @p367, @p368, @p369, @p370, @p371, @p372, @p373, @p374, @p375, @p376, @p377, @p378, @p379, @p380, @p381, @p382, @p383, @p384, @p385, @p386, @p387, @p388, @p389, @p390, @p391, 6), (@p392, @p393, @p394, @p395, @p396, @p397, @p398, @p399, @p400, @p401, @p402, @p403, @p404, @p405, @p406, @p407, @p408, @p409, @p410, @p411, @p412, @p413, @p414, @p415, @p416, @p417, @p418, @p419, @p420, @p421, @p422, @p423, @p424, @p425, @p426, @p427, @p428, @p429, @p430, @p431, @p432, @p433, @p434, @p435, @p436, @p437, @p438, @p439, @p440, @p441, @p442, @p443, @p444, @p445, @p446, @p447, 7), (@p448, @p449, @p450, @p451, @p452, @p453, @p454, @p455, @p456, @p457, @p458, @p459, @p460, @p461, @p462, @p463, @p464, @p465, @p466, @p467, @p468, @p469, @p470, @p471, @p472, @p473, @p474, @p475, @p476, @p477, @p478, @p479, @p480, @p481, @p482, @p483, @p484, @p485, @p486, @p487, @p488, @p489, @p490, @p491, @p492, @p493, @p494, @p495, @p496, @p497, @p498, @p499, @p500, @p501, @p502, @p503, 8), (@p504, @p505, @p506, @p507, @p508, @p509, @p510, @p511, @p512, @p513, @p514, @p515, @p516, @p517, @p518, @p519, @p520, @p521, @p522, @p523, @p524, @p525, @p526, @p527, @p528, @p529, @p530, @p531, @p532, @p533, @p534, @p535, @p536, @p537, @p538, @p539, @p540, @p541, @p542, @p543, @p544, @p545, @p546, @p547, @p548, @p549, @p550, @p551, @p552, @p553, @p554, @p555, @p556, @p557, @p558, @p559, 9), (@p560, @p561, @p562, @p563, @p564, @p565, @p566, @p567, @p568, @p569, @p570, @p571, @p572, @p573, @p574, @p575, @p576, @p577, @p578, @p579, @p580, @p581, @p582, @p583, @p584, @p585, @p586, @p587, @p588, @p589, @p590, @p591, @p592, @p593, @p594, @p595, @p596, @p597, @p598, @p599, @p600, @p601, @p602, @p603, @p604, @p605, @p606, @p607, @p608, @p609, @p610, @p611, @p612, @p613, @p614, @p615, 10), (@p616, @p617, @p618, @p619, @p620, @p621, @p622, @p623, @p624, @p625, @p626, @p627, @p628, @p629, @p630, @p631, @p632, @p633, @p634, @p635, @p636, @p637, @p638, @p639, @p640, @p641, @p642, @p643, @p644, @p645, @p646, @p647, @p648, @p649, @p650, @p651, @p652, @p653, @p654, @p655, @p656, @p657, @p658, @p659, @p660, @p661, @p662, @p663, @p664, @p665, @p666, @p667, @p668, @p669, @p670, @p671, 11), (@p672, @p673, @p674, @p675, @p676, @p677, @p678, @p679, @p680, @p681, @p682, @p683, @p684, @p685, @p686, @p687, @p688, @p689, @p690, @p691, @p692, @p693, @p694, @p695, @p696, @p697, @p698, @p699, @p700, @p701, @p702, @p703, @p704, @p705, @p706, @p707, @p708, @p709, @p710, @p711, @p712, @p713, @p714, @p715, @p716, @p717, @p718, @p719, @p720, @p721, @p722, @p723, @p724, @p725, @p726, @p727, 12), (@p728, @p729, @p730, @p731, @p732, @p733, @p734, @p735, @p736, @p737, @p738, @p739, @p740, @p741, @p742, @p743, @p744, @p745, @p746, @p747, @p748, @p749, @p750, @p751, @p752, @p753, @p754, @p755, @p756, @p757, @p758, @p759, @p760, @p761, @p762, @p763, @p764, @p765, @p766, @p767, @p768, @p769, @p770, @p771, @p772, @p773, @p774, @p775, @p776, @p777, @p778, @p779, @p780, @p781, @p782, @p783, 13), (@p784, @p785, @p786, @p787, @p788, @p789, @p790, @p791, @p792, @p793, @p794, @p795, @p796, @p797, @p798, @p799, @p800, @p801, @p802, @p803, @p804, @p805, @p806, @p807, @p808, @p809, @p810, @p811, @p812, @p813, @p814, @p815, @p816, @p817, @p818, @p819, @p820, @p821, @p822, @p823, @p824, @p825, @p826, @p827, @p828, @p829, @p830, @p831, @p832, @p833, @p834, @p835, @p836, @p837, @p838, @p839, 14), (@p840, @p841, @p842, @p843, @p844, @p845, @p846, @p847, @p848, @p849, @p850, @p851, @p852, @p853, @p854, @p855, @p856, @p857, @p858, @p859, @p860, @p861, @p862, @p863, @p864, @p865, @p866, @p867, @p868, @p869, @p870, @p871, @p872, @p873, @p874, @p875, @p876, @p877, @p878, @p879, @p880, @p881, @p882, @p883, @p884, @p885, @p886, @p887, @p888, @p889, @p890, @p891, @p892, @p893, @p894, @p895, 15), (@p896, @p897, @p898, @p899, @p900, @p901, @p902, @p903, @p904, @p905, @p906, @p907, @p908, @p909, @p910, @p911, @p912, @p913, @p914, @p915, @p916, @p917, @p918, @p919, @p920, @p921, @p922, @p923, @p924, @p925, @p926, @p927, @p928, @p929, @p930, @p931, @p932, @p933, @p934, @p935, @p936, @p937, @p938, @p939, @p940, @p941, @p942, @p943, @p944, @p945, @p946, @p947, @p948, @p949, @p950, @p951, 16), (@p952, @p953, @p954, @p955, @p956, @p957, @p958, @p959, @p960, @p961, @p962, @p963, @p964, @p965, @p966, @p967, @p968, @p969, @p970, @p971, @p972, @p973, @p974, @p975, @p976, @p977, @p978, @p979, @p980, @p981, @p982, @p983, @p984, @p985, @p986, @p987, @p988, @p989, @p990, @p991, @p992, @p993, @p994, @p995, @p996, @p997, @p998, @p999, @p1000, @p1001, @p1002, @p1003, @p1004, @p1005, @p1006, @p1007, 17), (@p1008, @p1009, @p1010, @p1011, @p1012, @p1013, @p1014, @p1015, @p1016, @p1017, @p1018, @p1019, @p1020, @p1021, @p1022, @p1023, @p1024, @p1025, @p1026, @p1027, @p1028, @p1029, @p1030, @p1031, @p1032, @p1033, @p1034, @p1035, @p1036, @p1037, @p1038, @p1039, @p1040, @p1041, @p1042, @p1043, @p1044, @p1045, @p1046, @p1047, @p1048, @p1049, @p1050, @p1051, @p1052, @p1053, @p1054, @p1055, @p1056, @p1057, @p1058, @p1059, @p1060, @p1061, @p1062, @p1063, 18), (@p1064, @p1065, @p1066, @p1067, @p1068, @p1069, @p1070, @p1071, @p1072, @p1073, @p1074, @p1075, @p1076, @p1077, @p1078, @p1079, @p1080, @p1081, @p1082, @p1083, @p1084, @p1085, @p1086, @p1087, @p1088, @p1089, @p1090, @p1091, @p1092, @p1093, @p1094, @p1095, @p1096, @p1097, @p1098, @p1099, @p1100, @p1101, @p1102, @p1103, @p1104, @p1105, @p1106, @p1107, @p1108, @p1109, @p1110, @p1111, @p1112, @p1113, @p1114, @p1115, @p1116, @p1117, @p1118, @p1119, 19), (@p1120, @p1121, @p1122, @p1123, @p1124, @p1125, @p1126, @p1127, @p1128, @p1129, @p1130, @p1131, @p1132, @p1133, @p1134, @p1135, @p1136, @p1137, @p1138, @p1139, @p1140, @p1141, @p1142, @p1143, @p1144, @p1145, @p1146, @p1147, @p1148, @p1149, @p1150, @p1151, @p1152, @p1153, @p1154, @p1155, @p1156, @p1157, @p1158, @p1159, @p1160, @p1161, @p1162, @p1163, @p1164, @p1165, @p1166, @p1167, @p1168, @p1169, @p1170, @p1171, @p1172, @p1173, @p1174, @p1175, 20), (@p1176, @p1177, @p1178, @p1179, @p1180, @p1181, @p1182, @p1183, @p1184, @p1185, @p1186, @p1187, @p1188, @p1189, @p1190, @p1191, @p1192, @p1193, @p1194, @p1195, @p1196, @p1197, @p1198, @p1199, @p1200, @p1201, @p1202, @p1203, @p1204, @p1205, @p1206, @p1207, @p1208, @p1209, @p1210, @p1211, @p1212, @p1213, @p1214, @p1215, @p1216, @p1217, @p1218, @p1219, @p1220, @p1221, @p1222, @p1223, @p1224, @p1225, @p1226, @p1227, @p1228, @p1229, @p1230, @p1231, 21), (@p1232, @p1233, @p1234, @p1235, @p1236, @p1237, @p1238, @p1239, @p1240, @p1241, @p1242, @p1243, @p1244, @p1245, @p1246, @p1247, @p1248, @p1249, @p1250, @p1251, @p1252, @p1253, @p1254, @p1255, @p1256, @p1257, @p1258, @p1259, @p1260, @p1261, @p1262, @p1263, @p1264, @p1265, @p1266, @p1267, @p1268, @p1269, @p1270, @p1271, @p1272, @p1273, @p1274, @p1275, @p1276, @p1277, @p1278, @p1279, @p1280, @p1281, @p1282, @p1283, @p1284, @p1285, @p1286, @p1287, 22), (@p1288, @p1289, @p1290, @p1291, @p1292, @p1293, @p1294, @p1295, @p1296, @p1297, @p1298, @p1299, @p1300, @p1301, @p1302, @p1303, @p1304, @p1305, @p1306, @p1307, @p1308, @p1309, @p1310, @p1311, @p1312, @p1313, @p1314, @p1315, @p1316, @p1317, @p1318, @p1319, @p1320, @p1321, @p1322, @p1323, @p1324, @p1325, @p1326, @p1327, @p1328, @p1329, @p1330, @p1331, @p1332, @p1333, @p1334, @p1335, @p1336, @p1337, @p1338, @p1339, @p1340, @p1341, @p1342, @p1343, 23), (@p1344, @p1345, @p1346, @p1347, @p1348, @p1349, @p1350, @p1351, @p1352, @p1353, @p1354, @p1355, @p1356, @p1357, @p1358, @p1359, @p1360, @p1361, @p1362, @p1363, @p1364, @p1365, @p1366, @p1367, @p1368, @p1369, @p1370, @p1371, @p1372, @p1373, @p1374, @p1375, @p1376, @p1377, @p1378, @p1379, @p1380, @p1381, @p1382, @p1383, @p1384, @p1385, @p1386, @p1387, @p1388, @p1389, @p1390, @p1391, @p1392, @p1393, @p1394, @p1395, @p1396, @p1397, @p1398, @p1399, 24), (@p1400, @p1401, @p1402, @p1403, @p1404, @p1405, @p1406, @p1407, @p1408, @p1409, @p1410, @p1411, @p1412, @p1413, @p1414, @p1415, @p1416, @p1417, @p1418, @p1419, @p1420, @p1421, @p1422, @p1423, @p1424, @p1425, @p1426, @p1427, @p1428, @p1429, @p1430, @p1431, @p1432, @p1433, @p1434, @p1435, @p1436, @p1437, @p1438, @p1439, @p1440, @p1441, @p1442, @p1443, @p1444, @p1445, @p1446, @p1447, @p1448, @p1449, @p1450, @p1451, @p1452, @p1453, @p1454, @p1455, 25), (@p1456, @p1457, @p1458, @p1459, @p1460, @p1461, @p1462, @p1463, @p1464, @p1465, @p1466, @p1467, @p1468, @p1469, @p1470, @p1471, @p1472, @p1473, @p1474, @p1475, @p1476, @p1477, @p1478, @p1479, @p1480, @p1481, @p1482, @p1483, @p1484, @p1485, @p1486, @p1487, @p1488, @p1489, @p1490, @p1491, @p1492, @p1493, @p1494, @p1495, @p1496, @p1497, @p1498, @p1499, @p1500, @p1501, @p1502, @p1503, @p1504, @p1505, @p1506, @p1507, @p1508, @p1509, @p1510, @p1511, 26), (@p1512, @p1513, @p1514, @p1515, @p1516, @p1517, @p1518, @p1519, @p1520, @p1521, @p1522, @p1523, @p1524, @p1525, @p1526, @p1527, @p1528, @p1529, @p1530, @p1531, @p1532, @p1533, @p1534, @p1535, @p1536, @p1537, @p1538, @p1539, @p1540, @p1541, @p1542, @p1543, @p1544, @p1545, @p1546, @p1547, @p1548, @p1549, @p1550, @p1551, @p1552, @p1553, @p1554, @p1555, @p1556, @p1557, @p1558, @p1559, @p1560, @p1561, @p1562, @p1563, @p1564, @p1565, @p1566, @p1567, 27), (@p1568, @p1569, @p1570, @p1571, @p1572, @p1573, @p1574, @p1575, @p1576, @p1577, @p1578, @p1579, @p1580, @p1581, @p1582, @p1583, @p1584, @p1585, @p1586, @p1587, @p1588, @p1589, @p1590, @p1591, @p1592, @p1593, @p1594, @p1595, @p1596, @p1597, @p1598, @p1599, @p1600, @p1601, @p1602, @p1603, @p1604, @p1605, @p1606, @p1607, @p1608, @p1609, @p1610, @p1611, @p1612, @p1613, @p1614, @p1615, @p1616, @p1617, @p1618, @p1619, @p1620, @p1621, @p1622, @p1623, 28), (@p1624, @p1625, @p1626, @p1627, @p1628, @p1629, @p1630, @p1631, @p1632, @p1633, @p1634, @p1635, @p1636, @p1637, @p1638, @p1639, @p1640, @p1641, @p1642, @p1643, @p1644, @p1645, @p1646, @p1647, @p1648, @p1649, @p1650, @p1651, @p1652, @p1653, @p1654, @p1655, @p1656, @p1657, @p1658, @p1659, @p1660, @p1661, @p1662, @p1663, @p1664, @p1665, @p1666, @p1667, @p1668, @p1669, @p1670, @p1671, @p1672, @p1673, @p1674, @p1675, @p1676, @p1677, @p1678, @p1679, 29), (@p1680, @p1681, @p1682, @p1683, @p1684, @p1685, @p1686, @p1687, @p1688, @p1689, @p1690, @p1691, @p1692, @p1693, @p1694, @p1695, @p1696, @p1697, @p1698, @p1699, @p1700, @p1701, @p1702, @p1703, @p1704, @p1705, @p1706, @p1707, @p1708, @p1709, @p1710, @p1711, @p1712, @p1713, @p1714, @p1715, @p1716, @p1717, @p1718, @p1719, @p1720, @p1721, @p1722, @p1723, @p1724, @p1725, @p1726, @p1727, @p1728, @p1729, @p1730, @p1731, @p1732, @p1733, @p1734, @p1735, 30), (@p1736, @p1737, @p1738, @p1739, @p1740, @p1741, @p1742, @p1743, @p1744, @p1745, @p1746, @p1747, @p1748, @p1749, @p1750, @p1751, @p1752, @p1753, @p1754, @p1755, @p1756, @p1757, @p1758, @p1759, @p1760, @p1761, @p1762, @p1763, @p1764, @p1765, @p1766, @p1767, @p1768, @p1769, @p1770, @p1771, @p1772, @p1773, @p1774, @p1775, @p1776, @p1777, @p1778, @p1779, @p1780, @p1781, @p1782, @p1783, @p1784, @p1785, @p1786, @p1787, @p1788, @p1789, @p1790, @p1791, 31), (@p1792, @p1793, @p1794, @p1795, @p1796, @p1797, @p1798, @p1799, @p1800, @p1801, @p1802, @p1803, @p1804, @p1805, @p1806, @p1807, @p1808, @p1809, @p1810, @p1811, @p1812, @p1813, @p1814, @p1815, @p1816, @p1817, @p1818, @p1819, @p1820, @p1821, @p1822, @p1823, @p1824, @p1825, @p1826, @p1827, @p1828, @p1829, @p1830, @p1831, @p1832, @p1833, @p1834, @p1835, @p1836, @p1837, @p1838, @p1839, @p1840, @p1841, @p1842, @p1843, @p1844, @p1845, @p1846, @p1847, 32), (@p1848, @p1849, @p1850, @p1851, @p1852, @p1853, @p1854, @p1855, @p1856, @p1857, @p1858, @p1859, @p1860, @p1861, @p1862, @p1863, @p1864, @p1865, @p1866, @p1867, @p1868, @p1869, @p1870, @p1871, @p1872, @p1873, @p1874, @p1875, @p1876, @p1877, @p1878, @p1879, @p1880, @p1881, @p1882, @p1883, @p1884, @p1885, @p1886, @p1887, @p1888, @p1889, @p1890, @p1891, @p1892, @p1893, @p1894, @p1895, @p1896, @p1897, @p1898, @p1899, @p1900, @p1901, @p1902, @p1903, 33), (@p1904, @p1905, @p1906, @p1907, @p1908, @p1909, @p1910, @p1911, @p1912, @p1913, @p1914, @p1915, @p1916, @p1917, @p1918, @p1919, @p1920, @p1921, @p1922, @p1923, @p1924, @p1925, @p1926, @p1927, @p1928, @p1929, @p1930, @p1931, @p1932, @p1933, @p1934, @p1935, @p1936, @p1937, @p1938, @p1939, @p1940, @p1941, @p1942, @p1943, @p1944, @p1945, @p1946, @p1947, @p1948, @p1949, @p1950, @p1951, @p1952, @p1953, @p1954, @p1955, @p1956, @p1957, @p1958, @p1959, 34), (@p1960, @p1961, @p1962, @p1963, @p1964, @p1965, @p1966, @p1967, @p1968, @p1969, @p1970, @p1971, @p1972, @p1973, @p1974, @p1975, @p1976, @p1977, @p1978, @p1979, @p1980, @p1981, @p1982, @p1983, @p1984, @p1985, @p1986, @p1987, @p1988, @p1989, @p1990, @p1991, @p1992, @p1993, @p1994, @p1995, @p1996, @p1997, @p1998, @p1999, @p2000, @p2001, @p2002, @p2003, @p2004, @p2005, @p2006, @p2007, @p2008, @p2009, @p2010, @p2011, @p2012, @p2013, @p2014, @p2015, 35), (@p2016, @p2017, @p2018, @p2019, @p2020, @p2021, @p2022, @p2023, @p2024, @p2025, @p2026, @p2027, @p2028, @p2029, @p2030, @p2031, @p2032, @p2033, @p2034, @p2035, @p2036, @p2037, @p2038, @p2039, @p2040, @p2041, @p2042, @p2043, @p2044, @p2045, @p2046, @p2047, @p2048, @p2049, @p2050, @p2051, @p2052, @p2053, @p2054, @p2055, @p2056, @p2057, @p2058, @p2059, @p2060, @p2061, @p2062, @p2063, @p2064, @p2065, @p2066, @p2067, @p2068, @p2069, @p2070, @p2071, 36)) AS i ([addressee_cntry_cd], [addressee_city], [addressee_district], [addressee_email], [addressee_full_address], [addressee_home_address], [addressee_name], [addressee_postcode], [addressee_province], [addressee_subdistrict], [addressee_tel], [create_table], [delivery_code], [delivery_recipient_name], [delivery_relation_id], [delivery_status_id], [dest_outlet_id], [dest_outlet_port], [document_number], [item_barcode], [item_cod], [item_gross_weight], [item_height], [item_length], [item_price], [item_width], [lat], [log_id], [long], [outlet_id], [outlet_port], [podUrl], [remark], [scan_cntry_cd], [scan_cntry_postcode], [sender_cntry_cd], [sender_district], [sender_email], [sender_full_address], [sender_home_address], [member_id], [sender_name], [sender_postcode], [sender_province], [sender_subdistrict], [sender_tel], [server_id], [signatureUrl], [state], [status_code], [status_dtm], [timestamp], [transmit_dtm], [user_id], [wckt_id], [wkstn_no], _Position) ON 1=0 WHEN NOT MATCHED THEN INSERT ([addressee_cntry_cd], [addressee_city], [addressee_district], [addressee_email], [addressee_full_address], [addressee_home_address], [addressee_name], [addressee_postcode], [addressee_province], [addressee_subdistrict], [addressee_tel], [create_table], [delivery_code], [delivery_recipient_name], [delivery_relation_id], [delivery_status_id], [dest_outlet_id], [dest_outlet_port], [document_number], [item_barcode], [item_cod], [item_gross_weight], [item_height], [item_length], [item_price], [item_width], [lat], [log_id], [long], [outlet_id], [outlet_port], [podUrl], [remark], [scan_cntry_cd], [scan_cntry_postcode], [sender_cntry_cd], [sender_district], [sender_email], [sender_full_address], [sender_home_address], [member_id], [sender_name], [sender_postcode], [sender_province], [sender_subdistrict], [sender_tel], [server_id], [signatureUrl], [state], [status_code], [status_dtm], [timestamp], [transmit_dtm], [user_id], [wckt_id], [wkstn_no]) VALUES (i.[addressee_cntry_cd], i.[addressee_city], i.[addressee_district], i.[addressee_email], i.[addressee_full_address], i.[addressee_home_address], i.[addressee_name], i.[addressee_postcode], i.[addressee_province], i.[addressee_subdistrict], i.[addressee_tel], i.[create_table], i.[delivery_code], i.[delivery_recipient_name], i.[delivery_relation_id], i.[delivery_status_id], i.[dest_outlet_id], i.[dest_outlet_port], i.[document_number], i.[item_barcode], i.[item_cod], i.[item_gross_weight], i.[item_height], i.[item_length], i.[item_price], i.[item_width], i.[lat], i.[log_id], i.[long], i.[outlet_id], i.[outlet_port], i.[podUrl], i.[remark], i.[scan_cntry_cd], i.[scan_cntry_postcode], i.[sender_cntry_cd], i.[sender_district], i.[sender_email], i.[sender_full_address], i.[sender_home_address], i.[member_id], i.[sender_name], i.[sender_postcode], i.[sender_province], i.[sender_subdistrict], i.[sender_tel], i.[server_id], i.[signatureUrl], i.[state], i.[status_code], i.[status_dtm], i.[timestamp], i.[transmit_dtm], i.[user_id], i.[wckt_id], i.[wkstn_no]) OUTPUT INSERTED.[item_id], i._Position INTO @inserted0;  SELECT [t].[item_id] FROM [raw_data] t INNER JOIN @inserted0 i ON ([t].[item_id] = [i].[item_id]) ORDER BY [i].[_Position];  ",4,4,0,439,3,4
"(@p0 nvarchar(4000),@p1 nvarchar(4000),@p2 nvarchar(4000),@p3 nvarchar(4000),@p4 nvarchar(4000),@p5 nvarchar(4000),@p6 nvarchar(4000),@p7 nvarchar(4000),@p8 nvarchar(4000),@p9 nvarchar(4000),@p10 nvarchar(4000),@p11 datetime2(7),@p12 nvarchar(4000),@p13 nvarchar(4000),@p14 int,@p15 int,@p16 int,@p17 nvarchar(4000),@p18 nvarchar(4000),@p19 nvarchar(4000),@p20 decimal(18,2),@p21 decimal(18,2),@p22 nvarchar(4000),@p23 nvarchar(4000),@p24 decimal(18,2),@p25 nvarchar(4000),@p26 nvarchar(4000),@p27 nvarchar(4000),@p28 nvarchar(4000),@p29 int,@p30 nvarchar(4000),@p31 nvarchar(4000),@p32 nvarchar(4000),@p33 nvarchar(4000),@p34 nvarchar(4000),@p35 nvarchar(4000),@p36 nvarchar(4000),@p37 nvarchar(4000),@p38 nvarchar(4000),@p39 nvarchar(4000),@p40 int,@p41 nvarchar(4000),@p42 nvarchar(4000),@p43 nvarchar(4000),@p44 nvarchar(4000),@p45 nvarchar(4000),@p46 int,@p47 nvarchar(4000),@p48 int,@p49 int,@p50 datetime2(7),@p51 datetime2(7),@p52 datetime2(7),@p53 nvarchar(4000),@p54 nvarchar(4000),@p55 nvarchar(4000),@p56 nvarchar(4000),@p57 nvarchar(4000),@p58 nvarchar(4000),@p59 nvarchar(4000),@p60 nvarchar(4000),@p61 nvarchar(4000),@p62 nvarchar(4000),@p63 nvarchar(4000),@p64 nvarchar(4000),@p65 nvarchar(4000),@p66 nvarchar(4000),@p67 datetime2(7),@p68 nvarchar(4000),@p69 nvarchar(4000),@p70 int,@p71 int,@p72 int,@p73 nvarchar(4000),@p74 nvarchar(4000),@p75 nvarchar(4000),@p76 decimal(18,2),@p77 decimal(18,2),@p78 nvarchar(4000),@p79 nvarchar(4000),@p80 decimal(18,2),@p81 nvarchar(4000),@p82 nvarchar(4000),@p83 nvarchar(4000),@p84 nvarchar(4000),@p85 int,@p86 nvarchar(4000),@p87 nvarchar(4000),@p88 nvarchar(4000),@p89 nvarchar(4000),@p90 nvarchar(4000),@p91 nvarchar(4000),@p92 nvarchar(4000),@p93 nvarchar(4000),@p94 nvarchar(4000),@p95 nvarchar(4000),@p96 int,@p97 nvarchar(4000),@p98 nvarchar(4000),@p99 nvarchar(4000),@p100 nvarchar(4000),@p101 nvarchar(4000),@p102 int,@p103 nvarchar(4000),@p104 int,@p105 int,@p106 datetime2(7),@p107 datetime2(7),@p108 datetime2(7),@p109 nvarchar(4000),@p110 nvarchar(4000),@p111 nvarchar(4000),@p112 nvarchar(4000),@p113 nvarchar(4000),@p114 nvarchar(4000),@p115 nvarchar(4000),@p116 nvarchar(4000),@p117 nvarchar(4000),@p118 nvarchar(4000),@p119 nvarchar(4000),@p120 nvarchar(4000),@p121 nvarchar(4000),@p122 nvarchar(4000),@p123 datetime2(7),@p124 nvarchar(4000),@p125 nvarchar(4000),@p126 int,@p127 int,@p128 int,@p129 nvarchar(4000),@p130 nvarchar(4000),@p131 nvarchar(4000),@p132 decimal(18,2),@p133 decimal(18,2),@p134 nvarchar(4000),@p135 nvarchar(4000),@p136 decimal(18,2),@p137 nvarchar(4000),@p138 nvarchar(4000),@p139 nvarchar(4000),@p140 nvarchar(4000),@p141 int,@p142 nvarchar(4000),@p143 nvarchar(4000),@p144 nvarchar(4000),@p145 nvarchar(4000),@p146 nvarchar(4000),@p147 nvarchar(4000),@p148 nvarchar(4000),@p149 nvarchar(4000),@p150 nvarchar(4000),@p151 nvarchar(4000),@p152 int,@p153 nvarchar(4000),@p154 nvarchar(4000),@p155 nvarchar(4000),@p156 nvarchar(4000),@p157 nvarchar(4000),@p158 int,@p159 nvarchar(4000),@p160 int,@p161 int,@p162 datetime2(7),@p163 datetime2(7),@p164 datetime2(7),@p165 nvarchar(4000),@p166 nvarchar(4000),@p167 nvarchar(4000),@p168 nvarchar(4000),@p169 nvarchar(4000),@p170 nvarchar(4000),@p171 nvarchar(4000),@p172 nvarchar(4000),@p173 nvarchar(4000),@p174 nvarchar(4000),@p175 nvarchar(4000),@p176 nvarchar(4000),@p177 nvarchar(4000),@p178 nvarchar(4000),@p179 datetime2(7),@p180 nvarchar(4000),@p181 nvarchar(4000),@p182 int,@p183 int,@p184 int,@p185 nvarchar(4000),@p186 nvarchar(4000),@p187 nvarchar(4000),@p188 decimal(18,2),@p189 decimal(18,2),@p190 nvarchar(4000),@p191 nvarchar(4000),@p192 decimal(18,2),@p193 nvarchar(4000),@p194 nvarchar(4000),@p195 nvarchar(4000),@p196 nvarchar(4000),@p197 int,@p198 nvarchar(4000),@p199 nvarchar(4000),@p200 nvarchar(4000),@p201 nvarchar(4000),@p202 nvarchar(4000),@p203 nvarchar(4000),@p204 nvarchar(4000),@p205 nvarchar(4000),@p206 nvarchar(4000),@p207 nvarchar(4000),@p208 int,@p209 nvarchar(4000),@p210 nvarchar(4000),@p211 nvarchar(4000),@p212 nvarchar(4000),@p213 nvarchar(4000),@p214 int,@p215 nvarchar(4000),@p216 int,@p217 int,@p218 datetime2(7),@p219 datetime2(7),@p220 datetime2(7),@p221 nvarchar(4000),@p222 nvarchar(4000),@p223 nvarchar(4000),@p224 nvarchar(4000),@p225 nvarchar(4000),@p226 nvarchar(4000),@p227 nvarchar(4000),@p228 nvarchar(4000),@p229 nvarchar(4000),@p230 nvarchar(4000),@p231 nvarchar(4000),@p232 nvarchar(4000),@p233 nvarchar(4000),@p234 nvarchar(4000),@p235 datetime2(7),@p236 nvarchar(4000),@p237 nvarchar(4000),@p238 int,@p239 int,@p240 int,@p241 nvarchar(4000),@p242 nvarchar(4000),@p243 nvarchar(4000),@p244 decimal(18,2),@p245 decimal(18,2),@p246 nvarchar(4000),@p247 nvarchar(4000),@p248 decimal(18,2),@p249 nvarchar(4000),@p250 nvarchar(4000),@p251 nvarchar(4000),@p252 nvarchar(4000),@p253 int,@p254 nvarchar(4000),@p255 nvarchar(4000),@p256 nvarchar(4000),@p257 nvarchar(4000),@p258 nvarchar(4000),@p259 nvarchar(4000),@p260 nvarchar(4000),@p261 nvarchar(4000),@p262 nvarchar(4000),@p263 nvarchar(4000),@p264 int,@p265 nvarchar(4000),@p266 nvarchar(4000),@p267 nvarchar(4000),@p268 nvarchar(4000),@p269 nvarchar(4000),@p270 int,@p271 nvarchar(4000),@p272 int,@p273 int,@p274 datetime2(7),@p275 datetime2(7),@p276 datetime2(7),@p277 nvarchar(4000),@p278 nvarchar(4000),@p279 nvarchar(4000),@p280 nvarchar(4000),@p281 nvarchar(4000),@p282 nvarchar(4000),@p283 nvarchar(4000),@p284 nvarchar(4000),@p285 nvarchar(4000),@p286 nvarchar(4000),@p287 nvarchar(4000),@p288 nvarchar(4000),@p289 nvarchar(4000),@p290 nvarchar(4000),@p291 datetime2(7),@p292 nvarchar(4000),@p293 nvarchar(4000),@p294 int,@p295 int,@p296 int,@p297 nvarchar(4000),@p298 nvarchar(4000),@p299 nvarchar(4000),@p300 decimal(18,2),@p301 decimal(18,2),@p302 nvarchar(4000),@p303 nvarchar(4000),@p304 decimal(18,2),@p305 nvarchar(4000),@p306 nvarchar(4000),@p307 nvarchar(4000),@p308 nvarchar(4000),@p309 int,@p310 nvarchar(4000),@p311 nvarchar(4000),@p312 nvarchar(4000),@p313 nvarchar(4000),@p314 nvarchar(4000),@p315 nvarchar(4000),@p316 nvarchar(4000),@p317 nvarchar(4000),@p318 nvarchar(4000),@p319 nvarchar(4000),@p320 int,@p321 nvarchar(4000),@p322 nvarchar(4000),@p323 nvarchar(4000),@p324 nvarchar(4000),@p325 nvarchar(4000),@p326 int,@p327 nvarchar(4000),@p328 int,@p329 int,@p330 datetime2(7),@p331 datetime2(7),@p332 datetime2(7),@p333 nvarchar(4000),@p334 nvarchar(4000),@p335 nvarchar(4000),@p336 nvarchar(4000),@p337 nvarchar(4000),@p338 nvarchar(4000),@p339 nvarchar(4000),@p340 nvarchar(4000),@p341 nvarchar(4000),@p342 nvarchar(4000),@p343 nvarchar(4000),@p344 nvarchar(4000),@p345 nvarchar(4000),@p346 nvarchar(4000),@p347 datetime2(7),@p348 nvarchar(4000),@p349 nvarchar(4000),@p350 int,@p351 int,@p352 int,@p353 nvarchar(4000),@p354 nvarchar(4000),@p355 nvarchar(4000),@p356 decimal(18,2),@p357 decimal(18,2),@p358 nvarchar(4000),@p359 nvarchar(4000),@p360 decimal(18,2),@p361 nvarchar(4000),@p362 nvarchar(4000),@p363 nvarchar(4000),@p364 nvarchar(4000),@p365 int,@p366 nvarchar(4000),@p367 nvarchar(4000),@p368 nvarchar(4000),@p369 nvarchar(4000),@p370 nvarchar(4000),@p371 nvarchar(4000),@p372 nvarchar(4000),@p373 nvarchar(4000),@p374 nvarchar(4000),@p375 nvarchar(4000),@p376 int,@p377 nvarchar(4000),@p378 nvarchar(4000),@p379 nvarchar(4000),@p380 nvarchar(4000),@p381 nvarchar(4000),@p382 int,@p383 nvarchar(4000),@p384 int,@p385 int,@p386 datetime2(7),@p387 datetime2(7),@p388 datetime2(7),@p389 nvarchar(4000),@p390 nvarchar(4000),@p391 nvarchar(4000),@p392 nvarchar(4000),@p393 nvarchar(4000),@p394 nvarchar(4000),@p395 nvarchar(4000),@p396 nvarchar(4000),@p397 nvarchar(4000),@p398 nvarchar(4000),@p399 nvarchar(4000),@p400 nvarchar(4000),@p401 nvarchar(4000),@p402 nvarchar(4000),@p403 datetime2(7),@p404 nvarchar(4000),@p405 nvarchar(4000),@p406 int,@p407 int,@p408 int,@p409 nvarchar(4000),@p410 nvarchar(4000),@p411 nvarchar(4000),@p412 decimal(18,2),@p413 decimal(18,2),@p414 nvarchar(4000),@p415 nvarchar(4000),@p416 decimal(18,2),@p417 nvarchar(4000),@p418 nvarchar(4000),@p419 nvarchar(4000),@p420 nvarchar(4000),@p421 int,@p422 nvarchar(4000),@p423 nvarchar(4000),@p424 nvarchar(4000),@p425 nvarchar(4000),@p426 nvarchar(4000),@p427 nvarchar(4000),@p428 nvarchar(4000),@p429 nvarchar(4000),@p430 nvarchar(4000),@p431 nvarchar(4000),@p432 int,@p433 nvarchar(4000),@p434 nvarchar(4000),@p435 nvarchar(4000),@p436 nvarchar(4000),@p437 nvarchar(4000),@p438 int,@p439 nvarchar(4000),@p440 int,@p441 int,@p442 datetime2(7),@p443 datetime2(7),@p444 datetime2(7),@p445 nvarchar(4000),@p446 nvarchar(4000),@p447 nvarchar(4000),@p448 nvarchar(4000),@p449 nvarchar(4000),@p450 nvarchar(4000),@p451 nvarchar(4000),@p452 nvarchar(4000),@p453 nvarchar(4000),@p454 nvarchar(4000),@p455 nvarchar(4000),@p456 nvarchar(4000),@p457 nvarchar(4000),@p458 nvarchar(4000),@p459 datetime2(7),@p460 nvarchar(4000),@p461 nvarchar(4000),@p462 int,@p463 int,@p464 int,@p465 nvarchar(4000),@p466 nvarchar(4000),@p467 nvarchar(4000),@p468 decimal(18,2),@p469 decimal(18,2),@p470 nvarchar(4000),@p471 nvarchar(4000),@p472 decimal(18,2),@p473 nvarchar(4000),@p474 nvarchar(4000),@p475 nvarchar(4000),@p476 nvarchar(4000),@p477 int,@p478 nvarchar(4000),@p479 nvarchar(4000),@p480 nvarchar(4000),@p481 nvarchar(4000),@p482 nvarchar(4000),@p483 nvarchar(4000),@p484 nvarchar(4000),@p485 nvarchar(4000),@p486 nvarchar(4000),@p487 nvarchar(4000),@p488 int,@p489 nvarchar(4000),@p490 nvarchar(4000),@p491 nvarchar(4000),@p492 nvarchar(4000),@p493 nvarchar(4000),@p494 int,@p495 nvarchar(4000),@p496 int,@p497 int,@p498 datetime2(7),@p499 datetime2(7),@p500 datetime2(7),@p501 nvarchar(4000),@p502 nvarchar(4000),@p503 nvarchar(4000),@p504 nvarchar(4000),@p505 nvarchar(4000),@p506 nvarchar(4000),@p507 nvarchar(4000),@p508 nvarchar(4000),@p509 nvarchar(4000),@p510 nvarchar(4000),@p511 nvarchar(4000),@p512 nvarchar(4000),@p513 nvarchar(4000),@p514 nvarchar(4000),@p515 datetime2(7),@p516 nvarchar(4000),@p517 nvarchar(4000),@p518 int,@p519 int,@p520 int,@p521 nvarchar(4000),@p522 nvarchar(4000),@p523 nvarchar(4000),@p524 decimal(18,2),@p525 decimal(18,2),@p526 nvarchar(4000),@p527 nvarchar(4000),@p528 decimal(18,2),@p529 nvarchar(4000),@p530 nvarchar(4000),@p531 nvarchar(4000),@p532 nvarchar(4000),@p533 int,@p534 nvarchar(4000),@p535 nvarchar(4000),@p536 nvarchar(4000),@p537 nvarchar(4000),@p538 nvarchar(4000),@p539 nvarchar(4000),@p540 nvarchar(4000),@p541 nvarchar(4000),@p542 nvarchar(4000),@p543 nvarchar(4000),@p544 int,@p545 nvarchar(4000),@p546 nvarchar(4000),@p547 nvarchar(4000),@p548 nvarchar(4000),@p549 nvarchar(4000),@p550 int,@p551 nvarchar(4000),@p552 int,@p553 int,@p554 datetime2(7),@p555 datetime2(7),@p556 datetime2(7),@p557 nvarchar(4000),@p558 nvarchar(4000),@p559 nvarchar(4000),@p560 nvarchar(4000),@p561 nvarchar(4000),@p562 nvarchar(4000),@p563 nvarchar(4000),@p564 nvarchar(4000),@p565 nvarchar(4000),@p566 nvarchar(4000),@p567 nvarchar(4000),@p568 nvarchar(4000),@p569 nvarchar(4000),@p570 nvarchar(4000),@p571 datetime2(7),@p572 nvarchar(4000),@p573 nvarchar(4000),@p574 int,@p575 int,@p576 int,@p577 nvarchar(4000),@p578 nvarchar(4000),@p579 nvarchar(4000),@p580 decimal(18,2),@p581 decimal(18,2),@p582 nvarchar(4000),@p583 nvarchar(4000),@p584 decimal(18,2),@p585 nvarchar(4000),@p586 nvarchar(4000),@p587 nvarchar(4000),@p588 nvarchar(4000),@p589 int,@p590 nvarchar(4000),@p591 nvarchar(4000),@p592 nvarchar(4000),@p593 nvarchar(4000),@p594 nvarchar(4000),@p595 nvarchar(4000),@p596 nvarchar(4000),@p597 nvarchar(4000),@p598 nvarchar(4000),@p599 nvarchar(4000),@p600 int,@p601 nvarchar(4000),@p602 nvarchar(4000),@p603 nvarchar(4000),@p604 nvarchar(4000),@p605 nvarchar(4000),@p606 int,@p607 nvarchar(4000),@p608 int,@p609 int,@p610 datetime2(7),@p611 datetime2(7),@p612 datetime2(7),@p613 nvarchar(4000),@p614 nvarchar(4000),@p615 nvarchar(4000),@p616 nvarchar(4000),@p617 nvarchar(4000),@p618 nvarchar(4000),@p619 nvarchar(4000),@p620 nvarchar(4000),@p621 nvarchar(4000),@p622 nvarchar(4000),@p623 nvarchar(4000),@p624 nvarchar(4000),@p625 nvarchar(4000),@p626 nvarchar(4000),@p627 datetime2(7),@p628 nvarchar(4000),@p629 nvarchar(4000),@p630 int,@p631 int,@p632 int,@p633 nvarchar(4000),@p634 nvarchar(4000),@p635 nvarchar(4000),@p636 decimal(18,2),@p637 decimal(18,2),@p638 nvarchar(4000),@p639 nvarchar(4000),@p640 decimal(18,2),@p641 nvarchar(4000),@p642 nvarchar(4000),@p643 nvarchar(4000),@p644 nvarchar(4000),@p645 int,@p646 nvarchar(4000),@p647 nvarchar(4000),@p648 nvarchar(4000),@p649 nvarchar(4000),@p650 nvarchar(4000),@p651 nvarchar(4000),@p652 nvarchar(4000),@p653 nvarchar(4000),@p654 nvarchar(4000),@p655 nvarchar(4000),@p656 int,@p657 nvarchar(4000),@p658 nvarchar(4000),@p659 nvarchar(4000),@p660 nvarchar(4000),@p661 nvarchar(4000),@p662 int,@p663 nvarchar(4000),@p664 int,@p665 int,@p666 datetime2(7),@p667 datetime2(7),@p668 datetime2(7),@p669 nvarchar(4000),@p670 nvarchar(4000),@p671 nvarchar(4000),@p672 nvarchar(4000),@p673 nvarchar(4000),@p674 nvarchar(4000),@p675 nvarchar(4000),@p676 nvarchar(4000),@p677 nvarchar(4000),@p678 nvarchar(4000),@p679 nvarchar(4000),@p680 nvarchar(4000),@p681 nvarchar(4000),@p682 nvarchar(4000),@p683 datetime2(7),@p684 nvarchar(4000),@p685 nvarchar(4000),@p686 int,@p687 int,@p688 int,@p689 nvarchar(4000),@p690 nvarchar(4000),@p691 nvarchar(4000),@p692 decimal(18,2),@p693 decimal(18,2),@p694 nvarchar(4000),@p695 nvarchar(4000),@p696 decimal(18,2),@p697 nvarchar(4000),@p698 nvarchar(4000),@p699 nvarchar(4000),@p700 nvarchar(4000),@p701 int,@p702 nvarchar(4000),@p703 nvarchar(4000),@p704 nvarchar(4000),@p705 nvarchar(4000),@p706 nvarchar(4000),@p707 nvarchar(4000),@p708 nvarchar(4000),@p709 nvarchar(4000),@p710 nvarchar(4000),@p711 nvarchar(4000),@p712 int,@p713 nvarchar(4000),@p714 nvarchar(4000),@p715 nvarchar(4000),@p716 nvarchar(4000),@p717 nvarchar(4000),@p718 int,@p719 nvarchar(4000),@p720 int,@p721 int,@p722 datetime2(7),@p723 datetime2(7),@p724 datetime2(7),@p725 nvarchar(4000),@p726 nvarchar(4000),@p727 nvarchar(4000),@p728 nvarchar(4000),@p729 nvarchar(4000),@p730 nvarchar(4000),@p731 nvarchar(4000),@p732 nvarchar(4000),@p733 nvarchar(4000),@p734 nvarchar(4000),@p735 nvarchar(4000),@p736 nvarchar(4000),@p737 nvarchar(4000),@p738 nvarchar(4000),@p739 datetime2(7),@p740 nvarchar(4000),@p741 nvarchar(4000),@p742 int,@p743 int,@p744 int,@p745 nvarchar(4000),@p746 nvarchar(4000),@p747 nvarchar(4000),@p748 decimal(18,2),@p749 decimal(18,2),@p750 nvarchar(4000),@p751 nvarchar(4000),@p752 decimal(18,2),@p753 nvarchar(4000),@p754 nvarchar(4000),@p755 nvarchar(4000),@p756 nvarchar(4000),@p757 int,@p758 nvarchar(4000),@p759 nvarchar(4000),@p760 nvarchar(4000),@p761 nvarchar(4000),@p762 nvarchar(4000),@p763 nvarchar(4000),@p764 nvarchar(4000),@p765 nvarchar(4000),@p766 nvarchar(4000),@p767 nvarchar(4000),@p768 int,@p769 nvarchar(4000),@p770 nvarchar(4000),@p771 nvarchar(4000),@p772 nvarchar(4000),@p773 nvarchar(4000),@p774 int,@p775 nvarchar(4000),@p776 int,@p777 int,@p778 datetime2(7),@p779 datetime2(7),@p780 datetime2(7),@p781 nvarchar(4000),@p782 nvarchar(4000),@p783 nvarchar(4000),@p784 nvarchar(4000),@p785 nvarchar(4000),@p786 nvarchar(4000),@p787 nvarchar(4000),@p788 nvarchar(4000),@p789 nvarchar(4000),@p790 nvarchar(4000),@p791 nvarchar(4000),@p792 nvarchar(4000),@p793 nvarchar(4000),@p794 nvarchar(4000),@p795 datetime2(7),@p796 nvarchar(4000),@p797 nvarchar(4000),@p798 int,@p799 int,@p800 int,@p801 nvarchar(4000),@p802 nvarchar(4000),@p803 nvarchar(4000),@p804 decimal(18,2),@p805 decimal(18,2),@p806 nvarchar(4000),@p807 nvarchar(4000),@p808 decimal(18,2),@p809 nvarchar(4000),@p810 nvarchar(4000),@p811 nvarchar(4000),@p812 nvarchar(4000),@p813 int,@p814 nvarchar(4000),@p815 nvarchar(4000),@p816 nvarchar(4000),@p817 nvarchar(4000),@p818 nvarchar(4000),@p819 nvarchar(4000),@p820 nvarchar(4000),@p821 nvarchar(4000),@p822 nvarchar(4000),@p823 nvarchar(4000),@p824 int,@p825 nvarchar(4000),@p826 nvarchar(4000),@p827 nvarchar(4000),@p828 nvarchar(4000),@p829 nvarchar(4000),@p830 int,@p831 nvarchar(4000),@p832 int,@p833 int,@p834 datetime2(7),@p835 datetime2(7),@p836 datetime2(7),@p837 nvarchar(4000),@p838 nvarchar(4000),@p839 nvarchar(4000),@p840 nvarchar(4000),@p841 nvarchar(4000),@p842 nvarchar(4000),@p843 nvarchar(4000),@p844 nvarchar(4000),@p845 nvarchar(4000),@p846 nvarchar(4000),@p847 nvarchar(4000),@p848 nvarchar(4000),@p849 nvarchar(4000),@p850 nvarchar(4000),@p851 datetime2(7),@p852 nvarchar(4000),@p853 nvarchar(4000),@p854 int,@p855 int,@p856 int,@p857 nvarchar(4000),@p858 nvarchar(4000),@p859 nvarchar(4000),@p860 decimal(18,2),@p861 decimal(18,2),@p862 nvarchar(4000),@p863 nvarchar(4000),@p864 decimal(18,2),@p865 nvarchar(4000),@p866 nvarchar(4000),@p867 nvarchar(4000),@p868 nvarchar(4000),@p869 int,@p870 nvarchar(4000),@p871 nvarchar(4000),@p872 nvarchar(4000),@p873 nvarchar(4000),@p874 nvarchar(4000),@p875 nvarchar(4000),@p876 nvarchar(4000),@p877 nvarchar(4000),@p878 nvarchar(4000),@p879 nvarchar(4000),@p880 int,@p881 nvarchar(4000),@p882 nvarchar(4000),@p883 nvarchar(4000),@p884 nvarchar(4000),@p885 nvarchar(4000),@p886 int,@p887 nvarchar(4000),@p888 int,@p889 int,@p890 datetime2(7),@p891 datetime2(7),@p892 datetime2(7),@p893 nvarchar(4000),@p894 nvarchar(4000),@p895 nvarchar(4000),@p896 nvarchar(4000),@p897 nvarchar(4000),@p898 nvarchar(4000),@p899 nvarchar(4000),@p900 nvarchar(4000),@p901 nvarchar(4000),@p902 nvarchar(4000),@p903 nvarchar(4000),@p904 nvarchar(4000),@p905 nvarchar(4000),@p906 nvarchar(4000),@p907 datetime2(7),@p908 nvarchar(4000),@p909 nvarchar(4000),@p910 int,@p911 int,@p912 int,@p913 nvarchar(4000),@p914 nvarchar(4000),@p915 nvarchar(4000),@p916 decimal(18,2),@p917 decimal(18,2),@p918 nvarchar(4000),@p919 nvarchar(4000),@p920 decimal(18,2),@p921 nvarchar(4000),@p922 nvarchar(4000),@p923 nvarchar(4000),@p924 nvarchar(4000),@p925 int,@p926 nvarchar(4000),@p927 nvarchar(4000),@p928 nvarchar(4000),@p929 nvarchar(4000),@p930 nvarchar(4000),@p931 nvarchar(4000),@p932 nvarchar(4000),@p933 nvarchar(4000),@p934 nvarchar(4000),@p935 nvarchar(4000),@p936 int,@p937 nvarchar(4000),@p938 nvarchar(4000),@p939 nvarchar(4000),@p940 nvarchar(4000),@p941 nvarchar(4000),@p942 int,@p943 nvarchar(4000),@p944 int,@p945 int,@p946 datetime2(7),@p947 datetime2(7),@p948 datetime2(7),@p949 nvarchar(4000),@p950 nvarchar(4000),@p951 nvarchar(4000),@p952 nvarchar(4000),@p953 nvarchar(4000),@p954 nvarchar(4000),@p955 nvarchar(4000),@p956 nvarchar(4000),@p957 nvarchar(4000),@p958 nvarchar(4000),@p959 nvarchar(4000),@p960 nvarchar(4000),@p961 nvarchar(4000),@p962 nvarchar(4000),@p963 datetime2(7),@p964 nvarchar(4000),@p965 nvarchar(4000),@p966 int,@p967 int,@p968 int,@p969 nvarchar(4000),@p970 nvarchar(4000),@p971 nvarchar(4000),@p972 decimal(18,2),@p973 decimal(18,2),@p974 nvarchar(4000),@p975 nvarchar(4000),@p976 decimal(18,2),@p977 nvarchar(4000),@p978 nvarchar(4000),@p979 nvarchar(4000),@p980 nvarchar(4000),@p981 int,@p982 nvarchar(4000),@p983 nvarchar(4000),@p984 nvarchar(4000),@p985 nvarchar(4000),@p986 nvarchar(4000),@p987 nvarchar(4000),@p988 nvarchar(4000),@p989 nvarchar(4000),@p990 nvarchar(4000),@p991 nvarchar(4000),@p992 int,@p993 nvarchar(4000),@p994 nvarchar(4000),@p995 nvarchar(4000),@p996 nvarchar(4000),@p997 nvarchar(4000),@p998 int,@p999 nvarchar(4000),@p1000 int,@p1001 int,@p1002 datetime2(7),@p1003 datetime2(7),@p1004 datetime2(7),@p1005 nvarchar(4000),@p1006 nvarchar(4000),@p1007 nvarchar(4000),@p1008 nvarchar(4000),@p1009 nvarchar(4000),@p1010 nvarchar(4000),@p1011 nvarchar(4000),@p1012 nvarchar(4000),@p1013 nvarchar(4000),@p1014 nvarchar(4000),@p1015 nvarchar(4000),@p1016 nvarchar(4000),@p1017 nvarchar(4000),@p1018 nvarchar(4000),@p1019 datetime2(7),@p1020 nvarchar(4000),@p1021 nvarchar(4000),@p1022 int,@p1023 int,@p1024 int,@p1025 nvarchar(4000),@p1026 nvarchar(4000),@p1027 nvarchar(4000),@p1028 decimal(18,2),@p1029 decimal(18,2),@p1030 nvarchar(4000),@p1031 nvarchar(4000),@p1032 decimal(18,2),@p1033 nvarchar(4000),@p1034 nvarchar(4000),@p1035 nvarchar(4000),@p1036 nvarchar(4000),@p1037 int,@p1038 nvarchar(4000),@p1039 nvarchar(4000),@p1040 nvarchar(4000),@p1041 nvarchar(4000),@p1042 nvarchar(4000),@p1043 nvarchar(4000),@p1044 nvarchar(4000),@p1045 nvarchar(4000),@p1046 nvarchar(4000),@p1047 nvarchar(4000),@p1048 int,@p1049 nvarchar(4000),@p1050 nvarchar(4000),@p1051 nvarchar(4000),@p1052 nvarchar(4000),@p1053 nvarchar(4000),@p1054 int,@p1055 nvarchar(4000),@p1056 int,@p1057 int,@p1058 datetime2(7),@p1059 datetime2(7),@p1060 datetime2(7),@p1061 nvarchar(4000),@p1062 nvarchar(4000),@p1063 nvarchar(4000),@p1064 nvarchar(4000),@p1065 nvarchar(4000),@p1066 nvarchar(4000),@p1067 nvarchar(4000),@p1068 nvarchar(4000),@p1069 nvarchar(4000),@p1070 nvarchar(4000),@p1071 nvarchar(4000),@p1072 nvarchar(4000),@p1073 nvarchar(4000),@p1074 nvarchar(4000),@p1075 datetime2(7),@p1076 nvarchar(4000),@p1077 nvarchar(4000),@p1078 int,@p1079 int,@p1080 int,@p1081 nvarchar(4000),@p1082 nvarchar(4000),@p1083 nvarchar(4000),@p1084 nvarchar(4000),@p1085 decimal(18,2),@p1086 nvarchar(4000),@p1087 nvarchar(4000),@p1088 decimal(18,2),@p1089 nvarchar(4000),@p1090 nvarchar(4000),@p1091 nvarchar(4000),@p1092 nvarchar(4000),@p1093 int,@p1094 nvarchar(4000),@p1095 nvarchar(4000),@p1096 nvarchar(4000),@p1097 nvarchar(4000),@p1098 nvarchar(4000),@p1099 nvarchar(4000),@p1100 nvarchar(4000),@p1101 nvarchar(4000),@p1102 nvarchar(4000),@p1103 nvarchar(4000),@p1104 int,@p1105 nvarchar(4000),@p1106 nvarchar(4000),@p1107 nvarchar(4000),@p1108 nvarchar(4000),@p1109 nvarchar(4000),@p1110 int,@p1111 nvarchar(4000),@p1112 int,@p1113 int,@p1114 datetime2(7),@p1115 datetime2(7),@p1116 datetime2(7),@p1117 nvarchar(4000),@p1118 nvarchar(4000),@p1119 nvarchar(4000),@p1120 nvarchar(4000),@p1121 nvarchar(4000),@p1122 nvarchar(4000),@p1123 nvarchar(4000),@p1124 nvarchar(4000),@p1125 nvarchar(4000),@p1126 nvarchar(4000),@p1127 nvarchar(4000),@p1128 nvarchar(4000),@p1129 nvarchar(4000),@p1130 nvarchar(4000),@p1131 datetime2(7),@p1132 nvarchar(4000),@p1133 nvarchar(4000),@p1134 int,@p1135 int,@p1136 int,@p1137 nvarchar(4000),@p1138 nvarchar(4000),@p1139 nvarchar(4000),@p1140 nvarchar(4000),@p1141 decimal(18,2),@p1142 nvarchar(4000),@p1143 nvarchar(4000),@p1144 decimal(18,2),@p1145 nvarchar(4000),@p1146 nvarchar(4000),@p1147 nvarchar(4000),@p1148 nvarchar(4000),@p1149 int,@p1150 nvarchar(4000),@p1151 nvarchar(4000),@p1152 nvarchar(4000),@p1153 nvarchar(4000),@p1154 nvarchar(4000),@p1155 nvarchar(4000),@p1156 nvarchar(4000),@p1157 nvarchar(4000),@p1158 nvarchar(4000),@p1159 nvarchar(4000),@p1160 int,@p1161 nvarchar(4000),@p1162 nvarchar(4000),@p1163 nvarchar(4000),@p1164 nvarchar(4000),@p1165 nvarchar(4000),@p1166 int,@p1167 nvarchar(4000),@p1168 int,@p1169 int,@p1170 datetime2(7),@p1171 datetime2(7),@p1172 datetime2(7),@p1173 nvarchar(4000),@p1174 nvarchar(4000),@p1175 nvarchar(4000),@p1176 nvarchar(4000),@p1177 nvarchar(4000),@p1178 nvarchar(4000),@p1179 nvarchar(4000),@p1180 nvarchar(4000),@p1181 nvarchar(4000),@p1182 nvarchar(4000),@p1183 nvarchar(4000),@p1184 nvarchar(4000),@p1185 nvarchar(4000),@p1186 nvarchar(4000),@p1187 datetime2(7),@p1188 nvarchar(4000),@p1189 nvarchar(4000),@p1190 int,@p1191 int,@p1192 int,@p1193 nvarchar(4000),@p1194 nvarchar(4000),@p1195 nvarchar(4000),@p1196 nvarchar(4000),@p1197 decimal(18,2),@p1198 nvarchar(4000),@p1199 nvarchar(4000),@p1200 decimal(18,2),@p1201 nvarchar(4000),@p1202 nvarchar(4000),@p1203 nvarchar(4000),@p1204 nvarchar(4000),@p1205 int,@p1206 nvarchar(4000),@p1207 nvarchar(4000),@p1208 nvarchar(4000),@p1209 nvarchar(4000),@p1210 nvarchar(4000),@p1211 nvarchar(4000),@p1212 nvarchar(4000),@p1213 nvarchar(4000),@p1214 nvarchar(4000),@p1215 nvarchar(4000),@p1216 int,@p1217 nvarchar(4000),@p1218 nvarchar(4000),@p1219 nvarchar(4000),@p1220 nvarchar(4000),@p1221 nvarchar(4000),@p1222 int,@p1223 nvarchar(4000),@p1224 int,@p1225 int,@p1226 datetime2(7),@p1227 datetime2(7),@p1228 datetime2(7),@p1229 nvarchar(4000),@p1230 nvarchar(4000),@p1231 nvarchar(4000),@p1232 nvarchar(4000),@p1233 nvarchar(4000),@p1234 nvarchar(4000),@p1235 nvarchar(4000),@p1236 nvarchar(4000),@p1237 nvarchar(4000),@p1238 nvarchar(4000),@p1239 nvarchar(4000),@p1240 nvarchar(4000),@p1241 nvarchar(4000),@p1242 nvarchar(4000),@p1243 datetime2(7),@p1244 nvarchar(4000),@p1245 nvarchar(4000),@p1246 int,@p1247 int,@p1248 int,@p1249 nvarchar(4000),@p1250 nvarchar(4000),@p1251 nvarchar(4000),@p1252 nvarchar(4000),@p1253 decimal(18,2),@p1254 nvarchar(4000),@p1255 nvarchar(4000),@p1256 decimal(18,2),@p1257 nvarchar(4000),@p1258 nvarchar(4000),@p1259 nvarchar(4000),@p1260 nvarchar(4000),@p1261 int,@p1262 nvarchar(4000),@p1263 nvarchar(4000),@p1264 nvarchar(4000),@p1265 nvarchar(4000),@p1266 nvarchar(4000),@p1267 nvarchar(4000),@p1268 nvarchar(4000),@p1269 nvarchar(4000),@p1270 nvarchar(4000),@p1271 nvarchar(4000),@p1272 int,@p1273 nvarchar(4000),@p1274 nvarchar(4000),@p1275 nvarchar(4000),@p1276 nvarchar(4000),@p1277 nvarchar(4000),@p1278 int,@p1279 nvarchar(4000),@p1280 int,@p1281 int,@p1282 datetime2(7),@p1283 datetime2(7),@p1284 datetime2(7),@p1285 nvarchar(4000),@p1286 nvarchar(4000),@p1287 nvarchar(4000),@p1288 nvarchar(4000),@p1289 nvarchar(4000),@p1290 nvarchar(4000),@p1291 nvarchar(4000),@p1292 nvarchar(4000),@p1293 nvarchar(4000),@p1294 nvarchar(4000),@p1295 nvarchar(4000),@p1296 nvarchar(4000),@p1297 nvarchar(4000),@p1298 nvarchar(4000),@p1299 datetime2(7),@p1300 nvarchar(4000),@p1301 nvarchar(4000),@p1302 int,@p1303 int,@p1304 int,@p1305 nvarchar(4000),@p1306 nvarchar(4000),@p1307 nvarchar(4000),@p1308 nvarchar(4000),@p1309 decimal(18,2),@p1310 nvarchar(4000),@p1311 nvarchar(4000),@p1312 decimal(18,2),@p1313 nvarchar(4000),@p1314 nvarchar(4000),@p1315 nvarchar(4000),@p1316 nvarchar(4000),@p1317 int,@p1318 nvarchar(4000),@p1319 nvarchar(4000),@p1320 nvarchar(4000),@p1321 nvarchar(4000),@p1322 nvarchar(4000),@p1323 nvarchar(4000),@p1324 nvarchar(4000),@p1325 nvarchar(4000),@p1326 nvarchar(4000),@p1327 nvarchar(4000),@p1328 int,@p1329 nvarchar(4000),@p1330 nvarchar(4000),@p1331 nvarchar(4000),@p1332 nvarchar(4000),@p1333 nvarchar(4000),@p1334 int,@p1335 nvarchar(4000),@p1336 int,@p1337 int,@p1338 datetime2(7),@p1339 datetime2(7),@p1340 datetime2(7),@p1341 nvarchar(4000),@p1342 nvarchar(4000),@p1343 nvarchar(4000),@p1344 nvarchar(4000),@p1345 nvarchar(4000),@p1346 nvarchar(4000),@p1347 nvarchar(4000),@p1348 nvarchar(4000),@p1349 nvarchar(4000),@p1350 nvarchar(4000),@p1351 nvarchar(4000),@p1352 nvarchar(4000),@p1353 nvarchar(4000),@p1354 nvarchar(4000),@p1355 datetime2(7),@p1356 nvarchar(4000),@p1357 nvarchar(4000),@p1358 int,@p1359 int,@p1360 int,@p1361 nvarchar(4000),@p1362 nvarchar(4000),@p1363 nvarchar(4000),@p1364 nvarchar(4000),@p1365 decimal(18,2),@p1366 nvarchar(4000),@p1367 nvarchar(4000),@p1368 decimal(18,2),@p1369 nvarchar(4000),@p1370 nvarchar(4000),@p1371 nvarchar(4000),@p1372 nvarchar(4000),@p1373 int,@p1374 nvarchar(4000),@p1375 nvarchar(4000),@p1376 nvarchar(4000),@p1377 nvarchar(4000),@p1378 nvarchar(4000),@p1379 nvarchar(4000),@p1380 nvarchar(4000),@p1381 nvarchar(4000),@p1382 nvarchar(4000),@p1383 nvarchar(4000),@p1384 int,@p1385 nvarchar(4000),@p1386 nvarchar(4000),@p1387 nvarchar(4000),@p1388 nvarchar(4000),@p1389 nvarchar(4000),@p1390 int,@p1391 nvarchar(4000),@p1392 int,@p1393 int,@p1394 datetime2(7),@p1395 datetime2(7),@p1396 datetime2(7),@p1397 nvarchar(4000),@p1398 nvarchar(4000),@p1399 nvarchar(4000),@p1400 nvarchar(4000),@p1401 nvarchar(4000),@p1402 nvarchar(4000),@p1403 nvarchar(4000),@p1404 nvarchar(4000),@p1405 nvarchar(4000),@p1406 nvarchar(4000),@p1407 nvarchar(4000),@p1408 nvarchar(4000),@p1409 nvarchar(4000),@p1410 nvarchar(4000),@p1411 datetime2(7),@p1412 nvarchar(4000),@p1413 nvarchar(4000),@p1414 int,@p1415 int,@p1416 int,@p1417 nvarchar(4000),@p1418 nvarchar(4000),@p1419 nvarchar(4000),@p1420 nvarchar(4000),@p1421 decimal(18,2),@p1422 nvarchar(4000),@p1423 nvarchar(4000),@p1424 decimal(18,2),@p1425 nvarchar(4000),@p1426 nvarchar(4000),@p1427 nvarchar(4000),@p1428 nvarchar(4000),@p1429 int,@p1430 nvarchar(4000),@p1431 nvarchar(4000),@p1432 nvarchar(4000),@p1433 nvarchar(4000),@p1434 nvarchar(4000),@p1435 nvarchar(4000),@p1436 nvarchar(4000),@p1437 nvarchar(4000),@p1438 nvarchar(4000),@p1439 nvarchar(4000),@p1440 int,@p1441 nvarchar(4000),@p1442 nvarchar(4000),@p1443 nvarchar(4000),@p1444 nvarchar(4000),@p1445 nvarchar(4000),@p1446 int,@p1447 nvarchar(4000),@p1448 int,@p1449 int,@p1450 datetime2(7),@p1451 datetime2(7),@p1452 datetime2(7),@p1453 nvarchar(4000),@p1454 nvarchar(4000),@p1455 nvarchar(4000),@p1456 nvarchar(4000),@p1457 nvarchar(4000),@p1458 nvarchar(4000),@p1459 nvarchar(4000),@p1460 nvarchar(4000),@p1461 nvarchar(4000),@p1462 nvarchar(4000),@p1463 nvarchar(4000),@p1464 nvarchar(4000),@p1465 nvarchar(4000),@p1466 nvarchar(4000),@p1467 datetime2(7),@p1468 nvarchar(4000),@p1469 nvarchar(4000),@p1470 int,@p1471 int,@p1472 int,@p1473 nvarchar(4000),@p1474 nvarchar(4000),@p1475 nvarchar(4000),@p1476 nvarchar(4000),@p1477 decimal(18,2),@p1478 nvarchar(4000),@p1479 nvarchar(4000),@p1480 decimal(18,2),@p1481 nvarchar(4000),@p1482 nvarchar(4000),@p1483 nvarchar(4000),@p1484 nvarchar(4000),@p1485 int,@p1486 nvarchar(4000),@p1487 nvarchar(4000),@p1488 nvarchar(4000),@p1489 nvarchar(4000),@p1490 nvarchar(4000),@p1491 nvarchar(4000),@p1492 nvarchar(4000),@p1493 nvarchar(4000),@p1494 nvarchar(4000),@p1495 nvarchar(4000),@p1496 int,@p1497 nvarchar(4000),@p1498 nvarchar(4000),@p1499 nvarchar(4000),@p1500 nvarchar(4000),@p1501 nvarchar(4000),@p1502 int,@p1503 nvarchar(4000),@p1504 int,@p1505 int,@p1506 datetime2(7),@p1507 datetime2(7),@p1508 datetime2(7),@p1509 nvarchar(4000),@p1510 nvarchar(4000),@p1511 nvarchar(4000),@p1512 nvarchar(4000),@p1513 nvarchar(4000),@p1514 nvarchar(4000),@p1515 nvarchar(4000),@p1516 nvarchar(4000),@p1517 nvarchar(4000),@p1518 nvarchar(4000),@p1519 nvarchar(4000),@p1520 nvarchar(4000),@p1521 nvarchar(4000),@p1522 nvarchar(4000),@p1523 datetime2(7),@p1524 nvarchar(4000),@p1525 nvarchar(4000),@p1526 int,@p1527 int,@p1528 int,@p1529 nvarchar(4000),@p1530 nvarchar(4000),@p1531 nvarchar(4000),@p1532 nvarchar(4000),@p1533 decimal(18,2),@p1534 nvarchar(4000),@p1535 nvarchar(4000),@p1536 decimal(18,2),@p1537 nvarchar(4000),@p1538 nvarchar(4000),@p1539 nvarchar(4000),@p1540 nvarchar(4000),@p1541 int,@p1542 nvarchar(4000),@p1543 nvarchar(4000),@p1544 nvarchar(4000),@p1545 nvarchar(4000),@p1546 nvarchar(4000),@p1547 nvarchar(4000),@p1548 nvarchar(4000),@p1549 nvarchar(4000),@p1550 nvarchar(4000),@p1551 nvarchar(4000),@p1552 int,@p1553 nvarchar(4000),@p1554 nvarchar(4000),@p1555 nvarchar(4000),@p1556 nvarchar(4000),@p1557 nvarchar(4000),@p1558 int,@p1559 nvarchar(4000),@p1560 int,@p1561 int,@p1562 datetime2(7),@p1563 datetime2(7),@p1564 datetime2(7),@p1565 nvarchar(4000),@p1566 nvarchar(4000),@p1567 nvarchar(4000),@p1568 nvarchar(4000),@p1569 nvarchar(4000),@p1570 nvarchar(4000),@p1571 nvarchar(4000),@p1572 nvarchar(4000),@p1573 nvarchar(4000),@p1574 nvarchar(4000),@p1575 nvarchar(4000),@p1576 nvarchar(4000),@p1577 nvarchar(4000),@p1578 nvarchar(4000),@p1579 datetime2(7),@p1580 nvarchar(4000),@p1581 nvarchar(4000),@p1582 int,@p1583 int,@p1584 int,@p1585 nvarchar(4000),@p1586 nvarchar(4000),@p1587 nvarchar(4000),@p1588 nvarchar(4000),@p1589 decimal(18,2),@p1590 nvarchar(4000),@p1591 nvarchar(4000),@p1592 decimal(18,2),@p1593 nvarchar(4000),@p1594 nvarchar(4000),@p1595 nvarchar(4000),@p1596 nvarchar(4000),@p1597 int,@p1598 nvarchar(4000),@p1599 nvarchar(4000),@p1600 nvarchar(4000),@p1601 nvarchar(4000),@p1602 nvarchar(4000),@p1603 nvarchar(4000),@p1604 nvarchar(4000),@p1605 nvarchar(4000),@p1606 nvarchar(4000),@p1607 nvarchar(4000),@p1608 int,@p1609 nvarchar(4000),@p1610 nvarchar(4000),@p1611 nvarchar(4000),@p1612 nvarchar(4000),@p1613 nvarchar(4000),@p1614 int,@p1615 nvarchar(4000),@p1616 int,@p1617 int,@p1618 datetime2(7),@p1619 datetime2(7),@p1620 datetime2(7),@p1621 nvarchar(4000),@p1622 nvarchar(4000),@p1623 nvarchar(4000),@p1624 nvarchar(4000),@p1625 nvarchar(4000),@p1626 nvarchar(4000),@p1627 nvarchar(4000),@p1628 nvarchar(4000),@p1629 nvarchar(4000),@p1630 nvarchar(4000),@p1631 nvarchar(4000),@p1632 nvarchar(4000),@p1633 nvarchar(4000),@p1634 nvarchar(4000),@p1635 datetime2(7),@p1636 nvarchar(4000),@p1637 nvarchar(4000),@p1638 int,@p1639 int,@p1640 int,@p1641 nvarchar(4000),@p1642 nvarchar(4000),@p1643 nvarchar(4000),@p1644 nvarchar(4000),@p1645 decimal(18,2),@p1646 nvarchar(4000),@p1647 nvarchar(4000),@p1648 decimal(18,2),@p1649 nvarchar(4000),@p1650 nvarchar(4000),@p1651 nvarchar(4000),@p1652 nvarchar(4000),@p1653 int,@p1654 nvarchar(4000),@p1655 nvarchar(4000),@p1656 nvarchar(4000),@p1657 nvarchar(4000),@p1658 nvarchar(4000),@p1659 nvarchar(4000),@p1660 nvarchar(4000),@p1661 nvarchar(4000),@p1662 nvarchar(4000),@p1663 nvarchar(4000),@p1664 int,@p1665 nvarchar(4000),@p1666 nvarchar(4000),@p1667 nvarchar(4000),@p1668 nvarchar(4000),@p1669 nvarchar(4000),@p1670 int,@p1671 nvarchar(4000),@p1672 int,@p1673 int,@p1674 datetime2(7),@p1675 datetime2(7),@p1676 datetime2(7),@p1677 nvarchar(4000),@p1678 nvarchar(4000),@p1679 nvarchar(4000),@p1680 nvarchar(4000),@p1681 nvarchar(4000),@p1682 nvarchar(4000),@p1683 nvarchar(4000),@p1684 nvarchar(4000),@p1685 nvarchar(4000),@p1686 nvarchar(4000),@p1687 nvarchar(4000),@p1688 nvarchar(4000),@p1689 nvarchar(4000),@p1690 nvarchar(4000),@p1691 datetime2(7),@p1692 nvarchar(4000),@p1693 nvarchar(4000),@p1694 int,@p1695 int,@p1696 int,@p1697 nvarchar(4000),@p1698 nvarchar(4000),@p1699 nvarchar(4000),@p1700 nvarchar(4000),@p1701 decimal(18,2),@p1702 nvarchar(4000),@p1703 nvarchar(4000),@p1704 decimal(18,2),@p1705 nvarchar(4000),@p1706 nvarchar(4000),@p1707 nvarchar(4000),@p1708 nvarchar(4000),@p1709 int,@p1710 nvarchar(4000),@p1711 nvarchar(4000),@p1712 nvarchar(4000),@p1713 nvarchar(4000),@p1714 nvarchar(4000),@p1715 nvarchar(4000),@p1716 nvarchar(4000),@p1717 nvarchar(4000),@p1718 nvarchar(4000),@p1719 nvarchar(4000),@p1720 int,@p1721 nvarchar(4000),@p1722 nvarchar(4000),@p1723 nvarchar(4000),@p1724 nvarchar(4000),@p1725 nvarchar(4000),@p1726 int,@p1727 nvarchar(4000),@p1728 int,@p1729 int,@p1730 datetime2(7),@p1731 datetime2(7),@p1732 datetime2(7),@p1733 nvarchar(4000),@p1734 nvarchar(4000),@p1735 nvarchar(4000),@p1736 nvarchar(4000),@p1737 nvarchar(4000),@p1738 nvarchar(4000),@p1739 nvarchar(4000),@p1740 nvarchar(4000),@p1741 nvarchar(4000),@p1742 nvarchar(4000),@p1743 nvarchar(4000),@p1744 nvarchar(4000),@p1745 nvarchar(4000),@p1746 nvarchar(4000),@p1747 datetime2(7),@p1748 nvarchar(4000),@p1749 nvarchar(4000),@p1750 int,@p1751 int,@p1752 int,@p1753 nvarchar(4000),@p1754 nvarchar(4000),@p1755 nvarchar(4000),@p1756 nvarchar(4000),@p1757 decimal(18,2),@p1758 nvarchar(4000),@p1759 nvarchar(4000),@p1760 decimal(18,2),@p1761 nvarchar(4000),@p1762 nvarchar(4000),@p1763 nvarchar(4000),@p1764 nvarchar(4000),@p1765 int,@p1766 nvarchar(4000),@p1767 nvarchar(4000),@p1768 nvarchar(4000),@p1769 nvarchar(4000),@p1770 nvarchar(4000),@p1771 nvarchar(4000),@p1772 nvarchar(4000),@p1773 nvarchar(4000),@p1774 nvarchar(4000),@p1775 nvarchar(4000),@p1776 int,@p1777 nvarchar(4000),@p1778 nvarchar(4000),@p1779 nvarchar(4000),@p1780 nvarchar(4000),@p1781 nvarchar(4000),@p1782 int,@p1783 nvarchar(4000),@p1784 int,@p1785 int,@p1786 datetime2(7),@p1787 datetime2(7),@p1788 datetime2(7),@p1789 nvarchar(4000),@p1790 nvarchar(4000),@p1791 nvarchar(4000),@p1792 nvarchar(4000),@p1793 nvarchar(4000),@p1794 nvarchar(4000),@p1795 nvarchar(4000),@p1796 nvarchar(4000),@p1797 nvarchar(4000),@p1798 nvarchar(4000),@p1799 nvarchar(4000),@p1800 nvarchar(4000),@p1801 nvarchar(4000),@p1802 nvarchar(4000),@p1803 datetime2(7),@p1804 nvarchar(4000),@p1805 nvarchar(4000),@p1806 int,@p1807 int,@p1808 int,@p1809 nvarchar(4000),@p1810 nvarchar(4000),@p1811 nvarchar(4000),@p1812 nvarchar(4000),@p1813 decimal(18,2),@p1814 nvarchar(4000),@p1815 nvarchar(4000),@p1816 decimal(18,2),@p1817 nvarchar(4000),@p1818 nvarchar(4000),@p1819 nvarchar(4000),@p1820 nvarchar(4000),@p1821 int,@p1822 nvarchar(4000),@p1823 nvarchar(4000),@p1824 nvarchar(4000),@p1825 nvarchar(4000),@p1826 nvarchar(4000),@p1827 nvarchar(4000),@p1828 nvarchar(4000),@p1829 nvarchar(4000),@p1830 nvarchar(4000),@p1831 nvarchar(4000),@p1832 int,@p1833 nvarchar(4000),@p1834 nvarchar(4000),@p1835 nvarchar(4000),@p1836 nvarchar(4000),@p1837 nvarchar(4000),@p1838 int,@p1839 nvarchar(4000),@p1840 int,@p1841 int,@p1842 datetime2(7),@p1843 datetime2(7),@p1844 datetime2(7),@p1845 nvarchar(4000),@p1846 nvarchar(4000),@p1847 nvarchar(4000),@p1848 nvarchar(4000),@p1849 nvarchar(4000),@p1850 nvarchar(4000),@p1851 nvarchar(4000),@p1852 nvarchar(4000),@p1853 nvarchar(4000),@p1854 nvarchar(4000),@p1855 nvarchar(4000),@p1856 nvarchar(4000),@p1857 nvarchar(4000),@p1858 nvarchar(4000),@p1859 datetime2(7),@p1860 nvarchar(4000),@p1861 nvarchar(4000),@p1862 int,@p1863 int,@p1864 int,@p1865 nvarchar(4000),@p1866 nvarchar(4000),@p1867 nvarchar(4000),@p1868 nvarchar(4000),@p1869 decimal(18,2),@p1870 nvarchar(4000),@p1871 nvarchar(4000),@p1872 decimal(18,2),@p1873 nvarchar(4000),@p1874 nvarchar(4000),@p1875 nvarchar(4000),@p1876 nvarchar(4000),@p1877 int,@p1878 nvarchar(4000),@p1879 nvarchar(4000),@p1880 nvarchar(4000),@p1881 nvarchar(4000),@p1882 nvarchar(4000),@p1883 nvarchar(4000),@p1884 nvarchar(4000),@p1885 nvarchar(4000),@p1886 nvarchar(4000),@p1887 nvarchar(4000),@p1888 int,@p1889 nvarchar(4000),@p1890 nvarchar(4000),@p1891 nvarchar(4000),@p1892 nvarchar(4000),@p1893 nvarchar(4000),@p1894 int,@p1895 nvarchar(4000),@p1896 int,@p1897 int,@p1898 datetime2(7),@p1899 datetime2(7),@p1900 datetime2(7),@p1901 nvarchar(4000),@p1902 nvarchar(4000),@p1903 nvarchar(4000),@p1904 nvarchar(4000),@p1905 nvarchar(4000),@p1906 nvarchar(4000),@p1907 nvarchar(4000),@p1908 nvarchar(4000),@p1909 nvarchar(4000),@p1910 nvarchar(4000),@p1911 nvarchar(4000),@p1912 nvarchar(4000),@p1913 nvarchar(4000),@p1914 nvarchar(4000),@p1915 datetime2(7),@p1916 nvarchar(4000),@p1917 nvarchar(4000),@p1918 int,@p1919 int,@p1920 int,@p1921 nvarchar(4000),@p1922 nvarchar(4000),@p1923 nvarchar(4000),@p1924 nvarchar(4000),@p1925 decimal(18,2),@p1926 nvarchar(4000),@p1927 nvarchar(4000),@p1928 decimal(18,2),@p1929 nvarchar(4000),@p1930 nvarchar(4000),@p1931 nvarchar(4000),@p1932 nvarchar(4000),@p1933 int,@p1934 nvarchar(4000),@p1935 nvarchar(4000),@p1936 nvarchar(4000),@p1937 nvarchar(4000),@p1938 nvarchar(4000),@p1939 nvarchar(4000),@p1940 nvarchar(4000),@p1941 nvarchar(4000),@p1942 nvarchar(4000),@p1943 nvarchar(4000),@p1944 int,@p1945 nvarchar(4000),@p1946 nvarchar(4000),@p1947 nvarchar(4000),@p1948 nvarchar(4000),@p1949 nvarchar(4000),@p1950 int,@p1951 nvarchar(4000),@p1952 int,@p1953 int,@p1954 datetime2(7),@p1955 datetime2(7),@p1956 datetime2(7),@p1957 nvarchar(4000),@p1958 nvarchar(4000),@p1959 nvarchar(4000),@p1960 nvarchar(4000),@p1961 nvarchar(4000),@p1962 nvarchar(4000),@p1963 nvarchar(4000),@p1964 nvarchar(4000),@p1965 nvarchar(4000),@p1966 nvarchar(4000),@p1967 nvarchar(4000),@p1968 nvarchar(4000),@p1969 nvarchar(4000),@p1970 nvarchar(4000),@p1971 datetime2(7),@p1972 nvarchar(4000),@p1973 nvarchar(4000),@p1974 int,@p1975 int,@p1976 int,@p1977 nvarchar(4000),@p1978 nvarchar(4000),@p1979 nvarchar(4000),@p1980 nvarchar(4000),@p1981 decimal(18,2),@p1982 nvarchar(4000),@p1983 nvarchar(4000),@p1984 decimal(18,2),@p1985 nvarchar(4000),@p1986 nvarchar(4000),@p1987 nvarchar(4000),@p1988 nvarchar(4000),@p1989 int,@p1990 nvarchar(4000),@p1991 nvarchar(4000),@p1992 nvarchar(4000),@p1993 nvarchar(4000),@p1994 nvarchar(4000),@p1995 nvarchar(4000),@p1996 nvarchar(4000),@p1997 nvarchar(4000),@p1998 nvarchar(4000),@p1999 nvarchar(4000),@p2000 int,@p2001 nvarchar(4000),@p2002 nvarchar(4000),@p2003 nvarchar(4000),@p2004 nvarchar(4000),@p2005 nvarchar(4000),@p2006 int,@p2007 nvarchar(4000),@p2008 int,@p2009 int,@p2010 datetime2(7),@p2011 datetime2(7),@p2012 datetime2(7),@p2013 nvarchar(4000),@p2014 nvarchar(4000),@p2015 nvarchar(4000),@p2016 nvarchar(4000),@p2017 nvarchar(4000),@p2018 nvarchar(4000),@p2019 nvarchar(4000),@p2020 nvarchar(4000),@p2021 nvarchar(4000),@p2022 nvarchar(4000),@p2023 nvarchar(4000),@p2024 nvarchar(4000),@p2025 nvarchar(4000),@p2026 nvarchar(4000),@p2027 datetime2(7),@p2028 nvarchar(4000),@p2029 nvarchar(4000),@p2030 int,@p2031 int,@p2032 int,@p2033 nvarchar(4000),@p2034 nvarchar(4000),@p2035 nvarchar(4000),@p2036 nvarchar(4000),@p2037 decimal(18,2),@p2038 nvarchar(4000),@p2039 nvarchar(4000),@p2040 decimal(18,2),@p2041 nvarchar(4000),@p2042 nvarchar(4000),@p2043 nvarchar(4000),@p2044 nvarchar(4000),@p2045 int,@p2046 nvarchar(4000),@p2047 nvarchar(4000),@p2048 nvarchar(4000),@p2049 nvarchar(4000),@p2050 nvarchar(4000),@p2051 nvarchar(4000),@p2052 nvarchar(4000),@p2053 nvarchar(4000),@p2054 nvarchar(4000),@p2055 nvarchar(4000),@p2056 int,@p2057 nvarchar(4000),@p2058 nvarchar(4000),@p2059 nvarchar(4000),@p2060 nvarchar(4000),@p2061 nvarchar(4000),@p2062 int,@p2063 nvarchar(4000),@p2064 int,@p2065 int,@p2066 datetime2(7),@p2067 datetime2(7),@p2068 datetime2(7),@p2069 nvarchar(4000),@p2070 nvarchar(4000),@p2071 nvarchar(4000))SET NOCOUNT ON; DECLARE @inserted0 TABLE ([item_id] int, [_Position] [int]); MERGE [raw_data] USING ( VALUES (@p0, @p1, @p2, @p3, @p4, @p5, @p6, @p7, @p8, @p9, @p10, @p11, @p12, @p13, @p14, @p15, @p16, @p17, @p18, @p19, @p20, @p21, @p22, @p23, @p24, @p25, @p26, @p27, @p28, @p29, @p30, @p31, @p32, @p33, @p34, @p35, @p36, @p37, @p38, @p39, @p40, @p41, @p42, @p43, @p44, @p45, @p46, @p47, @p48, @p49, @p50, @p51, @p52, @p53, @p54, @p55, 0), (@p56, @p57, @p58, @p59, @p60, @p61, @p62, @p63, @p64, @p65, @p66, @p67, @p68, @p69, @p70, @p71, @p72, @p73, @p74, @p75, @p76, @p77, @p78, @p79, @p80, @p81, @p82, @p83, @p84, @p85, @p86, @p87, @p88, @p89, @p90, @p91, @p92, @p93, @p94, @p95, @p96, @p97, @p98, @p99, @p100, @p101, @p102, @p103, @p104, @p105, @p106, @p107, @p108, @p109, @p110, @p111, 1), (@p112, @p113, @p114, @p115, @p116, @p117, @p118, @p119, @p120, @p121, @p122, @p123, @p124, @p125, @p126, @p127, @p128, @p129, @p130, @p131, @p132, @p133, @p134, @p135, @p136, @p137, @p138, @p139, @p140, @p141, @p142, @p143, @p144, @p145, @p146, @p147, @p148, @p149, @p150, @p151, @p152, @p153, @p154, @p155, @p156, @p157, @p158, @p159, @p160, @p161, @p162, @p163, @p164, @p165, @p166, @p167, 2), (@p168, @p169, @p170, @p171, @p172, @p173, @p174, @p175, @p176, @p177, @p178, @p179, @p180, @p181, @p182, @p183, @p184, @p185, @p186, @p187, @p188, @p189, @p190, @p191, @p192, @p193, @p194, @p195, @p196, @p197, @p198, @p199, @p200, @p201, @p202, @p203, @p204, @p205, @p206, @p207, @p208, @p209, @p210, @p211, @p212, @p213, @p214, @p215, @p216, @p217, @p218, @p219, @p220, @p221, @p222, @p223, 3), (@p224, @p225, @p226, @p227, @p228, @p229, @p230, @p231, @p232, @p233, @p234, @p235, @p236, @p237, @p238, @p239, @p240, @p241, @p242, @p243, @p244, @p245, @p246, @p247, @p248, @p249, @p250, @p251, @p252, @p253, @p254, @p255, @p256, @p257, @p258, @p259, @p260, @p261, @p262, @p263, @p264, @p265, @p266, @p267, @p268, @p269, @p270, @p271, @p272, @p273, @p274, @p275, @p276, @p277, @p278, @p279, 4), (@p280, @p281, @p282, @p283, @p284, @p285, @p286, @p287, @p288, @p289, @p290, @p291, @p292, @p293, @p294, @p295, @p296, @p297, @p298, @p299, @p300, @p301, @p302, @p303, @p304, @p305, @p306, @p307, @p308, @p309, @p310, @p311, @p312, @p313, @p314, @p315, @p316, @p317, @p318, @p319, @p320, @p321, @p322, @p323, @p324, @p325, @p326, @p327, @p328, @p329, @p330, @p331, @p332, @p333, @p334, @p335, 5), (@p336, @p337, @p338, @p339, @p340, @p341, @p342, @p343, @p344, @p345, @p346, @p347, @p348, @p349, @p350, @p351, @p352, @p353, @p354, @p355, @p356, @p357, @p358, @p359, @p360, @p361, @p362, @p363, @p364, @p365, @p366, @p367, @p368, @p369, @p370, @p371, @p372, @p373, @p374, @p375, @p376, @p377, @p378, @p379, @p380, @p381, @p382, @p383, @p384, @p385, @p386, @p387, @p388, @p389, @p390, @p391, 6), (@p392, @p393, @p394, @p395, @p396, @p397, @p398, @p399, @p400, @p401, @p402, @p403, @p404, @p405, @p406, @p407, @p408, @p409, @p410, @p411, @p412, @p413, @p414, @p415, @p416, @p417, @p418, @p419, @p420, @p421, @p422, @p423, @p424, @p425, @p426, @p427, @p428, @p429, @p430, @p431, @p432, @p433, @p434, @p435, @p436, @p437, @p438, @p439, @p440, @p441, @p442, @p443, @p444, @p445, @p446, @p447, 7), (@p448, @p449, @p450, @p451, @p452, @p453, @p454, @p455, @p456, @p457, @p458, @p459, @p460, @p461, @p462, @p463, @p464, @p465, @p466, @p467, @p468, @p469, @p470, @p471, @p472, @p473, @p474, @p475, @p476, @p477, @p478, @p479, @p480, @p481, @p482, @p483, @p484, @p485, @p486, @p487, @p488, @p489, @p490, @p491, @p492, @p493, @p494, @p495, @p496, @p497, @p498, @p499, @p500, @p501, @p502, @p503, 8), (@p504, @p505, @p506, @p507, @p508, @p509, @p510, @p511, @p512, @p513, @p514, @p515, @p516, @p517, @p518, @p519, @p520, @p521, @p522, @p523, @p524, @p525, @p526, @p527, @p528, @p529, @p530, @p531, @p532, @p533, @p534, @p535, @p536, @p537, @p538, @p539, @p540, @p541, @p542, @p543, @p544, @p545, @p546, @p547, @p548, @p549, @p550, @p551, @p552, @p553, @p554, @p555, @p556, @p557, @p558, @p559, 9), (@p560, @p561, @p562, @p563, @p564, @p565, @p566, @p567, @p568, @p569, @p570, @p571, @p572, @p573, @p574, @p575, @p576, @p577, @p578, @p579, @p580, @p581, @p582, @p583, @p584, @p585, @p586, @p587, @p588, @p589, @p590, @p591, @p592, @p593, @p594, @p595, @p596, @p597, @p598, @p599, @p600, @p601, @p602, @p603, @p604, @p605, @p606, @p607, @p608, @p609, @p610, @p611, @p612, @p613, @p614, @p615, 10), (@p616, @p617, @p618, @p619, @p620, @p621, @p622, @p623, @p624, @p625, @p626, @p627, @p628, @p629, @p630, @p631, @p632, @p633, @p634, @p635, @p636, @p637, @p638, @p639, @p640, @p641, @p642, @p643, @p644, @p645, @p646, @p647, @p648, @p649, @p650, @p651, @p652, @p653, @p654, @p655, @p656, @p657, @p658, @p659, @p660, @p661, @p662, @p663, @p664, @p665, @p666, @p667, @p668, @p669, @p670, @p671, 11), (@p672, @p673, @p674, @p675, @p676, @p677, @p678, @p679, @p680, @p681, @p682, @p683, @p684, @p685, @p686, @p687, @p688, @p689, @p690, @p691, @p692, @p693, @p694, @p695, @p696, @p697, @p698, @p699, @p700, @p701, @p702, @p703, @p704, @p705, @p706, @p707, @p708, @p709, @p710, @p711, @p712, @p713, @p714, @p715, @p716, @p717, @p718, @p719, @p720, @p721, @p722, @p723, @p724, @p725, @p726, @p727, 12), (@p728, @p729, @p730, @p731, @p732, @p733, @p734, @p735, @p736, @p737, @p738, @p739, @p740, @p741, @p742, @p743, @p744, @p745, @p746, @p747, @p748, @p749, @p750, @p751, @p752, @p753, @p754, @p755, @p756, @p757, @p758, @p759, @p760, @p761, @p762, @p763, @p764, @p765, @p766, @p767, @p768, @p769, @p770, @p771, @p772, @p773, @p774, @p775, @p776, @p777, @p778, @p779, @p780, @p781, @p782, @p783, 13), (@p784, @p785, @p786, @p787, @p788, @p789, @p790, @p791, @p792, @p793, @p794, @p795, @p796, @p797, @p798, @p799, @p800, @p801, @p802, @p803, @p804, @p805, @p806, @p807, @p808, @p809, @p810, @p811, @p812, @p813, @p814, @p815, @p816, @p817, @p818, @p819, @p820, @p821, @p822, @p823, @p824, @p825, @p826, @p827, @p828, @p829, @p830, @p831, @p832, @p833, @p834, @p835, @p836, @p837, @p838, @p839, 14), (@p840, @p841, @p842, @p843, @p844, @p845, @p846, @p847, @p848, @p849, @p850, @p851, @p852, @p853, @p854, @p855, @p856, @p857, @p858, @p859, @p860, @p861, @p862, @p863, @p864, @p865, @p866, @p867, @p868, @p869, @p870, @p871, @p872, @p873, @p874, @p875, @p876, @p877, @p878, @p879, @p880, @p881, @p882, @p883, @p884, @p885, @p886, @p887, @p888, @p889, @p890, @p891, @p892, @p893, @p894, @p895, 15), (@p896, @p897, @p898, @p899, @p900, @p901, @p902, @p903, @p904, @p905, @p906, @p907, @p908, @p909, @p910, @p911, @p912, @p913, @p914, @p915, @p916, @p917, @p918, @p919, @p920, @p921, @p922, @p923, @p924, @p925, @p926, @p927, @p928, @p929, @p930, @p931, @p932, @p933, @p934, @p935, @p936, @p937, @p938, @p939, @p940, @p941, @p942, @p943, @p944, @p945, @p946, @p947, @p948, @p949, @p950, @p951, 16), (@p952, @p953, @p954, @p955, @p956, @p957, @p958, @p959, @p960, @p961, @p962, @p963, @p964, @p965, @p966, @p967, @p968, @p969, @p970, @p971, @p972, @p973, @p974, @p975, @p976, @p977, @p978, @p979, @p980, @p981, @p982, @p983, @p984, @p985, @p986, @p987, @p988, @p989, @p990, @p991, @p992, @p993, @p994, @p995, @p996, @p997, @p998, @p999, @p1000, @p1001, @p1002, @p1003, @p1004, @p1005, @p1006, @p1007, 17), (@p1008, @p1009, @p1010, @p1011, @p1012, @p1013, @p1014, @p1015, @p1016, @p1017, @p1018, @p1019, @p1020, @p1021, @p1022, @p1023, @p1024, @p1025, @p1026, @p1027, @p1028, @p1029, @p1030, @p1031, @p1032, @p1033, @p1034, @p1035, @p1036, @p1037, @p1038, @p1039, @p1040, @p1041, @p1042, @p1043, @p1044, @p1045, @p1046, @p1047, @p1048, @p1049, @p1050, @p1051, @p1052, @p1053, @p1054, @p1055, @p1056, @p1057, @p1058, @p1059, @p1060, @p1061, @p1062, @p1063, 18), (@p1064, @p1065, @p1066, @p1067, @p1068, @p1069, @p1070, @p1071, @p1072, @p1073, @p1074, @p1075, @p1076, @p1077, @p1078, @p1079, @p1080, @p1081, @p1082, @p1083, @p1084, @p1085, @p1086, @p1087, @p1088, @p1089, @p1090, @p1091, @p1092, @p1093, @p1094, @p1095, @p1096, @p1097, @p1098, @p1099, @p1100, @p1101, @p1102, @p1103, @p1104, @p1105, @p1106, @p1107, @p1108, @p1109, @p1110, @p1111, @p1112, @p1113, @p1114, @p1115, @p1116, @p1117, @p1118, @p1119, 19), (@p1120, @p1121, @p1122, @p1123, @p1124, @p1125, @p1126, @p1127, @p1128, @p1129, @p1130, @p1131, @p1132, @p1133, @p1134, @p1135, @p1136, @p1137, @p1138, @p1139, @p1140, @p1141, @p1142, @p1143, @p1144, @p1145, @p1146, @p1147, @p1148, @p1149, @p1150, @p1151, @p1152, @p1153, @p1154, @p1155, @p1156, @p1157, @p1158, @p1159, @p1160, @p1161, @p1162, @p1163, @p1164, @p1165, @p1166, @p1167, @p1168, @p1169, @p1170, @p1171, @p1172, @p1173, @p1174, @p1175, 20), (@p1176, @p1177, @p1178, @p1179, @p1180, @p1181, @p1182, @p1183, @p1184, @p1185, @p1186, @p1187, @p1188, @p1189, @p1190, @p1191, @p1192, @p1193, @p1194, @p1195, @p1196, @p1197, @p1198, @p1199, @p1200, @p1201, @p1202, @p1203, @p1204, @p1205, @p1206, @p1207, @p1208, @p1209, @p1210, @p1211, @p1212, @p1213, @p1214, @p1215, @p1216, @p1217, @p1218, @p1219, @p1220, @p1221, @p1222, @p1223, @p1224, @p1225, @p1226, @p1227, @p1228, @p1229, @p1230, @p1231, 21), (@p1232, @p1233, @p1234, @p1235, @p1236, @p1237, @p1238, @p1239, @p1240, @p1241, @p1242, @p1243, @p1244, @p1245, @p1246, @p1247, @p1248, @p1249, @p1250, @p1251, @p1252, @p1253, @p1254, @p1255, @p1256, @p1257, @p1258, @p1259, @p1260, @p1261, @p1262, @p1263, @p1264, @p1265, @p1266, @p1267, @p1268, @p1269, @p1270, @p1271, @p1272, @p1273, @p1274, @p1275, @p1276, @p1277, @p1278, @p1279, @p1280, @p1281, @p1282, @p1283, @p1284, @p1285, @p1286, @p1287, 22), (@p1288, @p1289, @p1290, @p1291, @p1292, @p1293, @p1294, @p1295, @p1296, @p1297, @p1298, @p1299, @p1300, @p1301, @p1302, @p1303, @p1304, @p1305, @p1306, @p1307, @p1308, @p1309, @p1310, @p1311, @p1312, @p1313, @p1314, @p1315, @p1316, @p1317, @p1318, @p1319, @p1320, @p1321, @p1322, @p1323, @p1324, @p1325, @p1326, @p1327, @p1328, @p1329, @p1330, @p1331, @p1332, @p1333, @p1334, @p1335, @p1336, @p1337, @p1338, @p1339, @p1340, @p1341, @p1342, @p1343, 23), (@p1344, @p1345, @p1346, @p1347, @p1348, @p1349, @p1350, @p1351, @p1352, @p1353, @p1354, @p1355, @p1356, @p1357, @p1358, @p1359, @p1360, @p1361, @p1362, @p1363, @p1364, @p1365, @p1366, @p1367, @p1368, @p1369, @p1370, @p1371, @p1372, @p1373, @p1374, @p1375, @p1376, @p1377, @p1378, @p1379, @p1380, @p1381, @p1382, @p1383, @p1384, @p1385, @p1386, @p1387, @p1388, @p1389, @p1390, @p1391, @p1392, @p1393, @p1394, @p1395, @p1396, @p1397, @p1398, @p1399, 24), (@p1400, @p1401, @p1402, @p1403, @p1404, @p1405, @p1406, @p1407, @p1408, @p1409, @p1410, @p1411, @p1412, @p1413, @p1414, @p1415, @p1416, @p1417, @p1418, @p1419, @p1420, @p1421, @p1422, @p1423, @p1424, @p1425, @p1426, @p1427, @p1428, @p1429, @p1430, @p1431, @p1432, @p1433, @p1434, @p1435, @p1436, @p1437, @p1438, @p1439, @p1440, @p1441, @p1442, @p1443, @p1444, @p1445, @p1446, @p1447, @p1448, @p1449, @p1450, @p1451, @p1452, @p1453, @p1454, @p1455, 25), (@p1456, @p1457, @p1458, @p1459, @p1460, @p1461, @p1462, @p1463, @p1464, @p1465, @p1466, @p1467, @p1468, @p1469, @p1470, @p1471, @p1472, @p1473, @p1474, @p1475, @p1476, @p1477, @p1478, @p1479, @p1480, @p1481, @p1482, @p1483, @p1484, @p1485, @p1486, @p1487, @p1488, @p1489, @p1490, @p1491, @p1492, @p1493, @p1494, @p1495, @p1496, @p1497, @p1498, @p1499, @p1500, @p1501, @p1502, @p1503, @p1504, @p1505, @p1506, @p1507, @p1508, @p1509, @p1510, @p1511, 26), (@p1512, @p1513, @p1514, @p1515, @p1516, @p1517, @p1518, @p1519, @p1520, @p1521, @p1522, @p1523, @p1524, @p1525, @p1526, @p1527, @p1528, @p1529, @p1530, @p1531, @p1532, @p1533, @p1534, @p1535, @p1536, @p1537, @p1538, @p1539, @p1540, @p1541, @p1542, @p1543, @p1544, @p1545, @p1546, @p1547, @p1548, @p1549, @p1550, @p1551, @p1552, @p1553, @p1554, @p1555, @p1556, @p1557, @p1558, @p1559, @p1560, @p1561, @p1562, @p1563, @p1564, @p1565, @p1566, @p1567, 27), (@p1568, @p1569, @p1570, @p1571, @p1572, @p1573, @p1574, @p1575, @p1576, @p1577, @p1578, @p1579, @p1580, @p1581, @p1582, @p1583, @p1584, @p1585, @p1586, @p1587, @p1588, @p1589, @p1590, @p1591, @p1592, @p1593, @p1594, @p1595, @p1596, @p1597, @p1598, @p1599, @p1600, @p1601, @p1602, @p1603, @p1604, @p1605, @p1606, @p1607, @p1608, @p1609, @p1610, @p1611, @p1612, @p1613, @p1614, @p1615, @p1616, @p1617, @p1618, @p1619, @p1620, @p1621, @p1622, @p1623, 28), (@p1624, @p1625, @p1626, @p1627, @p1628, @p1629, @p1630, @p1631, @p1632, @p1633, @p1634, @p1635, @p1636, @p1637, @p1638, @p1639, @p1640, @p1641, @p1642, @p1643, @p1644, @p1645, @p1646, @p1647, @p1648, @p1649, @p1650, @p1651, @p1652, @p1653, @p1654, @p1655, @p1656, @p1657, @p1658, @p1659, @p1660, @p1661, @p1662, @p1663, @p1664, @p1665, @p1666, @p1667, @p1668, @p1669, @p1670, @p1671, @p1672, @p1673, @p1674, @p1675, @p1676, @p1677, @p1678, @p1679, 29), (@p1680, @p1681, @p1682, @p1683, @p1684, @p1685, @p1686, @p1687, @p1688, @p1689, @p1690, @p1691, @p1692, @p1693, @p1694, @p1695, @p1696, @p1697, @p1698, @p1699, @p1700, @p1701, @p1702, @p1703, @p1704, @p1705, @p1706, @p1707, @p1708, @p1709, @p1710, @p1711, @p1712, @p1713, @p1714, @p1715, @p1716, @p1717, @p1718, @p1719, @p1720, @p1721, @p1722, @p1723, @p1724, @p1725, @p1726, @p1727, @p1728, @p1729, @p1730, @p1731, @p1732, @p1733, @p1734, @p1735, 30), (@p1736, @p1737, @p1738, @p1739, @p1740, @p1741, @p1742, @p1743, @p1744, @p1745, @p1746, @p1747, @p1748, @p1749, @p1750, @p1751, @p1752, @p1753, @p1754, @p1755, @p1756, @p1757, @p1758, @p1759, @p1760, @p1761, @p1762, @p1763, @p1764, @p1765, @p1766, @p1767, @p1768, @p1769, @p1770, @p1771, @p1772, @p1773, @p1774, @p1775, @p1776, @p1777, @p1778, @p1779, @p1780, @p1781, @p1782, @p1783, @p1784, @p1785, @p1786, @p1787, @p1788, @p1789, @p1790, @p1791, 31), (@p1792, @p1793, @p1794, @p1795, @p1796, @p1797, @p1798, @p1799, @p1800, @p1801, @p1802, @p1803, @p1804, @p1805, @p1806, @p1807, @p1808, @p1809, @p1810, @p1811, @p1812, @p1813, @p1814, @p1815, @p1816, @p1817, @p1818, @p1819, @p1820, @p1821, @p1822, @p1823, @p1824, @p1825, @p1826, @p1827, @p1828, @p1829, @p1830, @p1831, @p1832, @p1833, @p1834, @p1835, @p1836, @p1837, @p1838, @p1839, @p1840, @p1841, @p1842, @p1843, @p1844, @p1845, @p1846, @p1847, 32), (@p1848, @p1849, @p1850, @p1851, @p1852, @p1853, @p1854, @p1855, @p1856, @p1857, @p1858, @p1859, @p1860, @p1861, @p1862, @p1863, @p1864, @p1865, @p1866, @p1867, @p1868, @p1869, @p1870, @p1871, @p1872, @p1873, @p1874, @p1875, @p1876, @p1877, @p1878, @p1879, @p1880, @p1881, @p1882, @p1883, @p1884, @p1885, @p1886, @p1887, @p1888, @p1889, @p1890, @p1891, @p1892, @p1893, @p1894, @p1895, @p1896, @p1897, @p1898, @p1899, @p1900, @p1901, @p1902, @p1903, 33), (@p1904, @p1905, @p1906, @p1907, @p1908, @p1909, @p1910, @p1911, @p1912, @p1913, @p1914, @p1915, @p1916, @p1917, @p1918, @p1919, @p1920, @p1921, @p1922, @p1923, @p1924, @p1925, @p1926, @p1927, @p1928, @p1929, @p1930, @p1931, @p1932, @p1933, @p1934, @p1935, @p1936, @p1937, @p1938, @p1939, @p1940, @p1941, @p1942, @p1943, @p1944, @p1945, @p1946, @p1947, @p1948, @p1949, @p1950, @p1951, @p1952, @p1953, @p1954, @p1955, @p1956, @p1957, @p1958, @p1959, 34), (@p1960, @p1961, @p1962, @p1963, @p1964, @p1965, @p1966, @p1967, @p1968, @p1969, @p1970, @p1971, @p1972, @p1973, @p1974, @p1975, @p1976, @p1977, @p1978, @p1979, @p1980, @p1981, @p1982, @p1983, @p1984, @p1985, @p1986, @p1987, @p1988, @p1989, @p1990, @p1991, @p1992, @p1993, @p1994, @p1995, @p1996, @p1997, @p1998, @p1999, @p2000, @p2001, @p2002, @p2003, @p2004, @p2005, @p2006, @p2007, @p2008, @p2009, @p2010, @p2011, @p2012, @p2013, @p2014, @p2015, 35), (@p2016, @p2017, @p2018, @p2019, @p2020, @p2021, @p2022, @p2023, @p2024, @p2025, @p2026, @p2027, @p2028, @p2029, @p2030, @p2031, @p2032, @p2033, @p2034, @p2035, @p2036, @p2037, @p2038, @p2039, @p2040, @p2041, @p2042, @p2043, @p2044, @p2045, @p2046, @p2047, @p2048, @p2049, @p2050, @p2051, @p2052, @p2053, @p2054, @p2055, @p2056, @p2057, @p2058, @p2059, @p2060, @p2061, @p2062, @p2063, @p2064, @p2065, @p2066, @p2067, @p2068, @p2069, @p2070, @p2071, 36)) AS i ([addressee_cntry_cd], [addressee_city], [addressee_district], [addressee_email], [addressee_full_address], [addressee_home_address], [addressee_name], [addressee_postcode], [addressee_province], [addressee_subdistrict], [addressee_tel], [create_table], [delivery_code], [delivery_recipient_name], [delivery_relation_id], [delivery_status_id], [dest_outlet_id], [dest_outlet_port], [document_number], [item_barcode], [item_cod], [item_gross_weight], [item_height], [item_length], [item_price], [item_width], [lat], [log_id], [long], [outlet_id], [outlet_port], [podUrl], [remark], [scan_cntry_cd], [scan_cntry_postcode], [sender_cntry_cd], [sender_district], [sender_email], [sender_full_address], [sender_home_address], [member_id], [sender_name], [sender_postcode], [sender_province], [sender_subdistrict], [sender_tel], [server_id], [signatureUrl], [state], [status_code], [status_dtm], [timestamp], [transmit_dtm], [user_id], [wckt_id], [wkstn_no], _Position) ON 1=0 WHEN NOT MATCHED THEN INSERT ([addressee_cntry_cd], [addressee_city], [addressee_district], [addressee_email], [addressee_full_address], [addressee_home_address], [addressee_name], [addressee_postcode], [addressee_province], [addressee_subdistrict], [addressee_tel], [create_table], [delivery_code], [delivery_recipient_name], [delivery_relation_id], [delivery_status_id], [dest_outlet_id], [dest_outlet_port], [document_number], [item_barcode], [item_cod], [item_gross_weight], [item_height], [item_length], [item_price], [item_width], [lat], [log_id], [long], [outlet_id], [outlet_port], [podUrl], [remark], [scan_cntry_cd], [scan_cntry_postcode], [sender_cntry_cd], [sender_district], [sender_email], [sender_full_address], [sender_home_address], [member_id], [sender_name], [sender_postcode], [sender_province], [sender_subdistrict], [sender_tel], [server_id], [signatureUrl], [state], [status_code], [status_dtm], [timestamp], [transmit_dtm], [user_id], [wckt_id], [wkstn_no]) VALUES (i.[addressee_cntry_cd], i.[addressee_city], i.[addressee_district], i.[addressee_email], i.[addressee_full_address], i.[addressee_home_address], i.[addressee_name], i.[addressee_postcode], i.[addressee_province], i.[addressee_subdistrict], i.[addressee_tel], i.[create_table], i.[delivery_code], i.[delivery_recipient_name], i.[delivery_relation_id], i.[delivery_status_id], i.[dest_outlet_id], i.[dest_outlet_port], i.[document_number], i.[item_barcode], i.[item_cod], i.[item_gross_weight], i.[item_height], i.[item_length], i.[item_price], i.[item_width], i.[lat], i.[log_id], i.[long], i.[outlet_id], i.[outlet_port], i.[podUrl], i.[remark], i.[scan_cntry_cd], i.[scan_cntry_postcode], i.[sender_cntry_cd], i.[sender_district], i.[sender_email], i.[sender_full_address], i.[sender_home_address], i.[member_id], i.[sender_name], i.[sender_postcode], i.[sender_province], i.[sender_subdistrict], i.[sender_tel], i.[server_id], i.[signatureUrl], i.[state], i.[status_code], i.[status_dtm], i.[timestamp], i.[transmit_dtm], i.[user_id], i.[wckt_id], i.[wkstn_no]) OUTPUT INSERTED.[item_id], i._Position INTO @inserted0;  SELECT [t].[item_id] FROM [raw_data] t INNER JOIN @inserted0 i ON ([t].[item_id] = [i].[item_id]) ORDER BY [i].[_Position];  ",4,4,0,434,3,9
"(@p0 nvarchar(4000),@p1 nvarchar(4000),@p2 nvarchar(4000),@p3 nvarchar(4000),@p4 nvarchar(4000),@p5 nvarchar(4000),@p6 nvarchar(4000),@p7 nvarchar(4000),@p8 nvarchar(4000),@p9 nvarchar(4000),@p10 nvarchar(4000),@p11 datetime2(7),@p12 nvarchar(4000),@p13 nvarchar(4000),@p14 int,@p15 int,@p16 int,@p17 nvarchar(4000),@p18 nvarchar(4000),@p19 nvarchar(4000),@p20 nvarchar(4000),@p21 nvarchar(4000),@p22 nvarchar(4000),@p23 nvarchar(4000),@p24 nvarchar(4000),@p25 nvarchar(4000),@p26 nvarchar(4000),@p27 nvarchar(4000),@p28 nvarchar(4000),@p29 int,@p30 nvarchar(4000),@p31 nvarchar(4000),@p32 nvarchar(4000),@p33 nvarchar(4000),@p34 nvarchar(4000),@p35 nvarchar(4000),@p36 nvarchar(4000),@p37 nvarchar(4000),@p38 nvarchar(4000),@p39 nvarchar(4000),@p40 int,@p41 nvarchar(4000),@p42 nvarchar(4000),@p43 nvarchar(4000),@p44 nvarchar(4000),@p45 nvarchar(4000),@p46 int,@p47 nvarchar(4000),@p48 int,@p49 int,@p50 datetime2(7),@p51 datetime2(7),@p52 datetime2(7),@p53 nvarchar(4000),@p54 nvarchar(4000),@p55 nvarchar(4000),@p56 nvarchar(4000),@p57 nvarchar(4000),@p58 nvarchar(4000),@p59 nvarchar(4000),@p60 nvarchar(4000),@p61 nvarchar(4000),@p62 nvarchar(4000),@p63 nvarchar(4000),@p64 nvarchar(4000),@p65 nvarchar(4000),@p66 nvarchar(4000),@p67 datetime2(7),@p68 nvarchar(4000),@p69 nvarchar(4000),@p70 int,@p71 int,@p72 int,@p73 nvarchar(4000),@p74 nvarchar(4000),@p75 nvarchar(4000),@p76 nvarchar(4000),@p77 nvarchar(4000),@p78 nvarchar(4000),@p79 nvarchar(4000),@p80 nvarchar(4000),@p81 nvarchar(4000),@p82 nvarchar(4000),@p83 nvarchar(4000),@p84 nvarchar(4000),@p85 int,@p86 nvarchar(4000),@p87 nvarchar(4000),@p88 nvarchar(4000),@p89 nvarchar(4000),@p90 nvarchar(4000),@p91 nvarchar(4000),@p92 nvarchar(4000),@p93 nvarchar(4000),@p94 nvarchar(4000),@p95 nvarchar(4000),@p96 int,@p97 nvarchar(4000),@p98 nvarchar(4000),@p99 nvarchar(4000),@p100 nvarchar(4000),@p101 nvarchar(4000),@p102 int,@p103 nvarchar(4000),@p104 int,@p105 int,@p106 datetime2(7),@p107 datetime2(7),@p108 datetime2(7),@p109 nvarchar(4000),@p110 nvarchar(4000),@p111 nvarchar(4000),@p112 nvarchar(4000),@p113 nvarchar(4000),@p114 nvarchar(4000),@p115 nvarchar(4000),@p116 nvarchar(4000),@p117 nvarchar(4000),@p118 nvarchar(4000),@p119 nvarchar(4000),@p120 nvarchar(4000),@p121 nvarchar(4000),@p122 nvarchar(4000),@p123 datetime2(7),@p124 nvarchar(4000),@p125 nvarchar(4000),@p126 int,@p127 int,@p128 int,@p129 nvarchar(4000),@p130 nvarchar(4000),@p131 nvarchar(4000),@p132 nvarchar(4000),@p133 nvarchar(4000),@p134 nvarchar(4000),@p135 nvarchar(4000),@p136 nvarchar(4000),@p137 nvarchar(4000),@p138 nvarchar(4000),@p139 nvarchar(4000),@p140 nvarchar(4000),@p141 int,@p142 nvarchar(4000),@p143 nvarchar(4000),@p144 nvarchar(4000),@p145 nvarchar(4000),@p146 nvarchar(4000),@p147 nvarchar(4000),@p148 nvarchar(4000),@p149 nvarchar(4000),@p150 nvarchar(4000),@p151 nvarchar(4000),@p152 int,@p153 nvarchar(4000),@p154 nvarchar(4000),@p155 nvarchar(4000),@p156 nvarchar(4000),@p157 nvarchar(4000),@p158 int,@p159 nvarchar(4000),@p160 int,@p161 int,@p162 datetime2(7),@p163 datetime2(7),@p164 datetime2(7),@p165 nvarchar(4000),@p166 nvarchar(4000),@p167 nvarchar(4000),@p168 nvarchar(4000),@p169 nvarchar(4000),@p170 nvarchar(4000),@p171 nvarchar(4000),@p172 nvarchar(4000),@p173 nvarchar(4000),@p174 nvarchar(4000),@p175 nvarchar(4000),@p176 nvarchar(4000),@p177 nvarchar(4000),@p178 nvarchar(4000),@p179 datetime2(7),@p180 nvarchar(4000),@p181 nvarchar(4000),@p182 int,@p183 int,@p184 int,@p185 nvarchar(4000),@p186 nvarchar(4000),@p187 nvarchar(4000),@p188 nvarchar(4000),@p189 nvarchar(4000),@p190 nvarchar(4000),@p191 nvarchar(4000),@p192 nvarchar(4000),@p193 nvarchar(4000),@p194 nvarchar(4000),@p195 nvarchar(4000),@p196 nvarchar(4000),@p197 int,@p198 nvarchar(4000),@p199 nvarchar(4000),@p200 nvarchar(4000),@p201 nvarchar(4000),@p202 nvarchar(4000),@p203 nvarchar(4000),@p204 nvarchar(4000),@p205 nvarchar(4000),@p206 nvarchar(4000),@p207 nvarchar(4000),@p208 int,@p209 nvarchar(4000),@p210 nvarchar(4000),@p211 nvarchar(4000),@p212 nvarchar(4000),@p213 nvarchar(4000),@p214 int,@p215 nvarchar(4000),@p216 int,@p217 int,@p218 datetime2(7),@p219 datetime2(7),@p220 datetime2(7),@p221 nvarchar(4000),@p222 nvarchar(4000),@p223 nvarchar(4000),@p224 nvarchar(4000),@p225 nvarchar(4000),@p226 nvarchar(4000),@p227 nvarchar(4000),@p228 nvarchar(4000),@p229 nvarchar(4000),@p230 nvarchar(4000),@p231 nvarchar(4000),@p232 nvarchar(4000),@p233 nvarchar(4000),@p234 nvarchar(4000),@p235 datetime2(7),@p236 nvarchar(4000),@p237 nvarchar(4000),@p238 int,@p239 int,@p240 int,@p241 nvarchar(4000),@p242 nvarchar(4000),@p243 nvarchar(4000),@p244 nvarchar(4000),@p245 nvarchar(4000),@p246 nvarchar(4000),@p247 nvarchar(4000),@p248 nvarchar(4000),@p249 nvarchar(4000),@p250 nvarchar(4000),@p251 nvarchar(4000),@p252 nvarchar(4000),@p253 int,@p254 nvarchar(4000),@p255 nvarchar(4000),@p256 nvarchar(4000),@p257 nvarchar(4000),@p258 nvarchar(4000),@p259 nvarchar(4000),@p260 nvarchar(4000),@p261 nvarchar(4000),@p262 nvarchar(4000),@p263 nvarchar(4000),@p264 int,@p265 nvarchar(4000),@p266 nvarchar(4000),@p267 nvarchar(4000),@p268 nvarchar(4000),@p269 nvarchar(4000),@p270 int,@p271 nvarchar(4000),@p272 int,@p273 int,@p274 datetime2(7),@p275 datetime2(7),@p276 datetime2(7),@p277 nvarchar(4000),@p278 nvarchar(4000),@p279 nvarchar(4000),@p280 nvarchar(4000),@p281 nvarchar(4000),@p282 nvarchar(4000),@p283 nvarchar(4000),@p284 nvarchar(4000),@p285 nvarchar(4000),@p286 nvarchar(4000),@p287 nvarchar(4000),@p288 nvarchar(4000),@p289 nvarchar(4000),@p290 nvarchar(4000),@p291 datetime2(7),@p292 nvarchar(4000),@p293 nvarchar(4000),@p294 int,@p295 int,@p296 int,@p297 nvarchar(4000),@p298 nvarchar(4000),@p299 nvarchar(4000),@p300 nvarchar(4000),@p301 nvarchar(4000),@p302 nvarchar(4000),@p303 nvarchar(4000),@p304 nvarchar(4000),@p305 nvarchar(4000),@p306 nvarchar(4000),@p307 nvarchar(4000),@p308 nvarchar(4000),@p309 int,@p310 nvarchar(4000),@p311 nvarchar(4000),@p312 nvarchar(4000),@p313 nvarchar(4000),@p314 nvarchar(4000),@p315 nvarchar(4000),@p316 nvarchar(4000),@p317 nvarchar(4000),@p318 nvarchar(4000),@p319 nvarchar(4000),@p320 int,@p321 nvarchar(4000),@p322 nvarchar(4000),@p323 nvarchar(4000),@p324 nvarchar(4000),@p325 nvarchar(4000),@p326 int,@p327 nvarchar(4000),@p328 int,@p329 int,@p330 datetime2(7),@p331 datetime2(7),@p332 datetime2(7),@p333 nvarchar(4000),@p334 nvarchar(4000),@p335 nvarchar(4000),@p336 nvarchar(4000),@p337 nvarchar(4000),@p338 nvarchar(4000),@p339 nvarchar(4000),@p340 nvarchar(4000),@p341 nvarchar(4000),@p342 nvarchar(4000),@p343 nvarchar(4000),@p344 nvarchar(4000),@p345 nvarchar(4000),@p346 nvarchar(4000),@p347 datetime2(7),@p348 nvarchar(4000),@p349 nvarchar(4000),@p350 int,@p351 int,@p352 int,@p353 nvarchar(4000),@p354 nvarchar(4000),@p355 nvarchar(4000),@p356 nvarchar(4000),@p357 nvarchar(4000),@p358 nvarchar(4000),@p359 nvarchar(4000),@p360 nvarchar(4000),@p361 nvarchar(4000),@p362 nvarchar(4000),@p363 nvarchar(4000),@p364 nvarchar(4000),@p365 int,@p366 nvarchar(4000),@p367 nvarchar(4000),@p368 nvarchar(4000),@p369 nvarchar(4000),@p370 nvarchar(4000),@p371 nvarchar(4000),@p372 nvarchar(4000),@p373 nvarchar(4000),@p374 nvarchar(4000),@p375 nvarchar(4000),@p376 int,@p377 nvarchar(4000),@p378 nvarchar(4000),@p379 nvarchar(4000),@p380 nvarchar(4000),@p381 nvarchar(4000),@p382 int,@p383 nvarchar(4000),@p384 int,@p385 int,@p386 datetime2(7),@p387 datetime2(7),@p388 datetime2(7),@p389 nvarchar(4000),@p390 nvarchar(4000),@p391 nvarchar(4000),@p392 nvarchar(4000),@p393 nvarchar(4000),@p394 nvarchar(4000),@p395 nvarchar(4000),@p396 nvarchar(4000),@p397 nvarchar(4000),@p398 nvarchar(4000),@p399 nvarchar(4000),@p400 nvarchar(4000),@p401 nvarchar(4000),@p402 nvarchar(4000),@p403 datetime2(7),@p404 nvarchar(4000),@p405 nvarchar(4000),@p406 int,@p407 int,@p408 int,@p409 nvarchar(4000),@p410 nvarchar(4000),@p411 nvarchar(4000),@p412 nvarchar(4000),@p413 nvarchar(4000),@p414 nvarchar(4000),@p415 nvarchar(4000),@p416 nvarchar(4000),@p417 nvarchar(4000),@p418 nvarchar(4000),@p419 nvarchar(4000),@p420 nvarchar(4000),@p421 int,@p422 nvarchar(4000),@p423 nvarchar(4000),@p424 nvarchar(4000),@p425 nvarchar(4000),@p426 nvarchar(4000),@p427 nvarchar(4000),@p428 nvarchar(4000),@p429 nvarchar(4000),@p430 nvarchar(4000),@p431 nvarchar(4000),@p432 int,@p433 nvarchar(4000),@p434 nvarchar(4000),@p435 nvarchar(4000),@p436 nvarchar(4000),@p437 nvarchar(4000),@p438 int,@p439 nvarchar(4000),@p440 int,@p441 int,@p442 datetime2(7),@p443 datetime2(7),@p444 datetime2(7),@p445 nvarchar(4000),@p446 nvarchar(4000),@p447 nvarchar(4000),@p448 nvarchar(4000),@p449 nvarchar(4000),@p450 nvarchar(4000),@p451 nvarchar(4000),@p452 nvarchar(4000),@p453 nvarchar(4000),@p454 nvarchar(4000),@p455 nvarchar(4000),@p456 nvarchar(4000),@p457 nvarchar(4000),@p458 nvarchar(4000),@p459 datetime2(7),@p460 nvarchar(4000),@p461 nvarchar(4000),@p462 int,@p463 int,@p464 int,@p465 nvarchar(4000),@p466 nvarchar(4000),@p467 nvarchar(4000),@p468 nvarchar(4000),@p469 nvarchar(4000),@p470 nvarchar(4000),@p471 nvarchar(4000),@p472 nvarchar(4000),@p473 nvarchar(4000),@p474 nvarchar(4000),@p475 nvarchar(4000),@p476 nvarchar(4000),@p477 int,@p478 nvarchar(4000),@p479 nvarchar(4000),@p480 nvarchar(4000),@p481 nvarchar(4000),@p482 nvarchar(4000),@p483 nvarchar(4000),@p484 nvarchar(4000),@p485 nvarchar(4000),@p486 nvarchar(4000),@p487 nvarchar(4000),@p488 int,@p489 nvarchar(4000),@p490 nvarchar(4000),@p491 nvarchar(4000),@p492 nvarchar(4000),@p493 nvarchar(4000),@p494 int,@p495 nvarchar(4000),@p496 int,@p497 int,@p498 datetime2(7),@p499 datetime2(7),@p500 datetime2(7),@p501 nvarchar(4000),@p502 nvarchar(4000),@p503 nvarchar(4000),@p504 nvarchar(4000),@p505 nvarchar(4000),@p506 nvarchar(4000),@p507 nvarchar(4000),@p508 nvarchar(4000),@p509 nvarchar(4000),@p510 nvarchar(4000),@p511 nvarchar(4000),@p512 nvarchar(4000),@p513 nvarchar(4000),@p514 nvarchar(4000),@p515 datetime2(7),@p516 nvarchar(4000),@p517 nvarchar(4000),@p518 int,@p519 int,@p520 int,@p521 nvarchar(4000),@p522 nvarchar(4000),@p523 nvarchar(4000),@p524 nvarchar(4000),@p525 nvarchar(4000),@p526 nvarchar(4000),@p527 nvarchar(4000),@p528 nvarchar(4000),@p529 nvarchar(4000),@p530 nvarchar(4000),@p531 nvarchar(4000),@p532 nvarchar(4000),@p533 int,@p534 nvarchar(4000),@p535 nvarchar(4000),@p536 nvarchar(4000),@p537 nvarchar(4000),@p538 nvarchar(4000),@p539 nvarchar(4000),@p540 nvarchar(4000),@p541 nvarchar(4000),@p542 nvarchar(4000),@p543 nvarchar(4000),@p544 int,@p545 nvarchar(4000),@p546 nvarchar(4000),@p547 nvarchar(4000),@p548 nvarchar(4000),@p549 nvarchar(4000),@p550 int,@p551 nvarchar(4000),@p552 int,@p553 int,@p554 datetime2(7),@p555 datetime2(7),@p556 datetime2(7),@p557 nvarchar(4000),@p558 nvarchar(4000),@p559 nvarchar(4000),@p560 nvarchar(4000),@p561 nvarchar(4000),@p562 nvarchar(4000),@p563 nvarchar(4000),@p564 nvarchar(4000),@p565 nvarchar(4000),@p566 nvarchar(4000),@p567 nvarchar(4000),@p568 nvarchar(4000),@p569 nvarchar(4000),@p570 nvarchar(4000),@p571 datetime2(7),@p572 nvarchar(4000),@p573 nvarchar(4000),@p574 int,@p575 int,@p576 int,@p577 nvarchar(4000),@p578 nvarchar(4000),@p579 nvarchar(4000),@p580 nvarchar(4000),@p581 nvarchar(4000),@p582 nvarchar(4000),@p583 nvarchar(4000),@p584 nvarchar(4000),@p585 nvarchar(4000),@p586 nvarchar(4000),@p587 nvarchar(4000),@p588 nvarchar(4000),@p589 int,@p590 nvarchar(4000),@p591 nvarchar(4000),@p592 nvarchar(4000),@p593 nvarchar(4000),@p594 nvarchar(4000),@p595 nvarchar(4000),@p596 nvarchar(4000),@p597 nvarchar(4000),@p598 nvarchar(4000),@p599 nvarchar(4000),@p600 int,@p601 nvarchar(4000),@p602 nvarchar(4000),@p603 nvarchar(4000),@p604 nvarchar(4000),@p605 nvarchar(4000),@p606 int,@p607 nvarchar(4000),@p608 int,@p609 int,@p610 datetime2(7),@p611 datetime2(7),@p612 datetime2(7),@p613 nvarchar(4000),@p614 nvarchar(4000),@p615 nvarchar(4000),@p616 nvarchar(4000),@p617 nvarchar(4000),@p618 nvarchar(4000),@p619 nvarchar(4000),@p620 nvarchar(4000),@p621 nvarchar(4000),@p622 nvarchar(4000),@p623 nvarchar(4000),@p624 nvarchar(4000),@p625 nvarchar(4000),@p626 nvarchar(4000),@p627 datetime2(7),@p628 nvarchar(4000),@p629 nvarchar(4000),@p630 int,@p631 int,@p632 int,@p633 nvarchar(4000),@p634 nvarchar(4000),@p635 nvarchar(4000),@p636 nvarchar(4000),@p637 nvarchar(4000),@p638 nvarchar(4000),@p639 nvarchar(4000),@p640 nvarchar(4000),@p641 nvarchar(4000),@p642 nvarchar(4000),@p643 nvarchar(4000),@p644 nvarchar(4000),@p645 int,@p646 nvarchar(4000),@p647 nvarchar(4000),@p648 nvarchar(4000),@p649 nvarchar(4000),@p650 nvarchar(4000),@p651 nvarchar(4000),@p652 nvarchar(4000),@p653 nvarchar(4000),@p654 nvarchar(4000),@p655 nvarchar(4000),@p656 int,@p657 nvarchar(4000),@p658 nvarchar(4000),@p659 nvarchar(4000),@p660 nvarchar(4000),@p661 nvarchar(4000),@p662 int,@p663 nvarchar(4000),@p664 int,@p665 int,@p666 datetime2(7),@p667 datetime2(7),@p668 datetime2(7),@p669 nvarchar(4000),@p670 nvarchar(4000),@p671 nvarchar(4000),@p672 nvarchar(4000),@p673 nvarchar(4000),@p674 nvarchar(4000),@p675 nvarchar(4000),@p676 nvarchar(4000),@p677 nvarchar(4000),@p678 nvarchar(4000),@p679 nvarchar(4000),@p680 nvarchar(4000),@p681 nvarchar(4000),@p682 nvarchar(4000),@p683 datetime2(7),@p684 nvarchar(4000),@p685 nvarchar(4000),@p686 int,@p687 int,@p688 int,@p689 nvarchar(4000),@p690 nvarchar(4000),@p691 nvarchar(4000),@p692 nvarchar(4000),@p693 nvarchar(4000),@p694 nvarchar(4000),@p695 nvarchar(4000),@p696 nvarchar(4000),@p697 nvarchar(4000),@p698 nvarchar(4000),@p699 nvarchar(4000),@p700 nvarchar(4000),@p701 int,@p702 nvarchar(4000),@p703 nvarchar(4000),@p704 nvarchar(4000),@p705 nvarchar(4000),@p706 nvarchar(4000),@p707 nvarchar(4000),@p708 nvarchar(4000),@p709 nvarchar(4000),@p710 nvarchar(4000),@p711 nvarchar(4000),@p712 int,@p713 nvarchar(4000),@p714 nvarchar(4000),@p715 nvarchar(4000),@p716 nvarchar(4000),@p717 nvarchar(4000),@p718 int,@p719 nvarchar(4000),@p720 int,@p721 int,@p722 datetime2(7),@p723 datetime2(7),@p724 datetime2(7),@p725 nvarchar(4000),@p726 nvarchar(4000),@p727 nvarchar(4000),@p728 nvarchar(4000),@p729 nvarchar(4000),@p730 nvarchar(4000),@p731 nvarchar(4000),@p732 nvarchar(4000),@p733 nvarchar(4000),@p734 nvarchar(4000),@p735 nvarchar(4000),@p736 nvarchar(4000),@p737 nvarchar(4000),@p738 nvarchar(4000),@p739 datetime2(7),@p740 nvarchar(4000),@p741 nvarchar(4000),@p742 int,@p743 int,@p744 int,@p745 nvarchar(4000),@p746 nvarchar(4000),@p747 nvarchar(4000),@p748 nvarchar(4000),@p749 nvarchar(4000),@p750 nvarchar(4000),@p751 nvarchar(4000),@p752 nvarchar(4000),@p753 nvarchar(4000),@p754 nvarchar(4000),@p755 nvarchar(4000),@p756 nvarchar(4000),@p757 int,@p758 nvarchar(4000),@p759 nvarchar(4000),@p760 nvarchar(4000),@p761 nvarchar(4000),@p762 nvarchar(4000),@p763 nvarchar(4000),@p764 nvarchar(4000),@p765 nvarchar(4000),@p766 nvarchar(4000),@p767 nvarchar(4000),@p768 int,@p769 nvarchar(4000),@p770 nvarchar(4000),@p771 nvarchar(4000),@p772 nvarchar(4000),@p773 nvarchar(4000),@p774 int,@p775 nvarchar(4000),@p776 int,@p777 int,@p778 datetime2(7),@p779 datetime2(7),@p780 datetime2(7),@p781 nvarchar(4000),@p782 nvarchar(4000),@p783 nvarchar(4000),@p784 nvarchar(4000),@p785 nvarchar(4000),@p786 nvarchar(4000),@p787 nvarchar(4000),@p788 nvarchar(4000),@p789 nvarchar(4000),@p790 nvarchar(4000),@p791 nvarchar(4000),@p792 nvarchar(4000),@p793 nvarchar(4000),@p794 nvarchar(4000),@p795 datetime2(7),@p796 nvarchar(4000),@p797 nvarchar(4000),@p798 int,@p799 int,@p800 int,@p801 nvarchar(4000),@p802 nvarchar(4000),@p803 nvarchar(4000),@p804 nvarchar(4000),@p805 nvarchar(4000),@p806 nvarchar(4000),@p807 nvarchar(4000),@p808 nvarchar(4000),@p809 nvarchar(4000),@p810 nvarchar(4000),@p811 nvarchar(4000),@p812 nvarchar(4000),@p813 int,@p814 nvarchar(4000),@p815 nvarchar(4000),@p816 nvarchar(4000),@p817 nvarchar(4000),@p818 nvarchar(4000),@p819 nvarchar(4000),@p820 nvarchar(4000),@p821 nvarchar(4000),@p822 nvarchar(4000),@p823 nvarchar(4000),@p824 int,@p825 nvarchar(4000),@p826 nvarchar(4000),@p827 nvarchar(4000),@p828 nvarchar(4000),@p829 nvarchar(4000),@p830 int,@p831 nvarchar(4000),@p832 int,@p833 int,@p834 datetime2(7),@p835 datetime2(7),@p836 datetime2(7),@p837 nvarchar(4000),@p838 nvarchar(4000),@p839 nvarchar(4000),@p840 nvarchar(4000),@p841 nvarchar(4000),@p842 nvarchar(4000),@p843 nvarchar(4000),@p844 nvarchar(4000),@p845 nvarchar(4000),@p846 nvarchar(4000),@p847 nvarchar(4000),@p848 nvarchar(4000),@p849 nvarchar(4000),@p850 nvarchar(4000),@p851 datetime2(7),@p852 nvarchar(4000),@p853 nvarchar(4000),@p854 int,@p855 int,@p856 int,@p857 nvarchar(4000),@p858 nvarchar(4000),@p859 nvarchar(4000),@p860 nvarchar(4000),@p861 nvarchar(4000),@p862 nvarchar(4000),@p863 nvarchar(4000),@p864 nvarchar(4000),@p865 nvarchar(4000),@p866 nvarchar(4000),@p867 nvarchar(4000),@p868 nvarchar(4000),@p869 int,@p870 nvarchar(4000),@p871 nvarchar(4000),@p872 nvarchar(4000),@p873 nvarchar(4000),@p874 nvarchar(4000),@p875 nvarchar(4000),@p876 nvarchar(4000),@p877 nvarchar(4000),@p878 nvarchar(4000),@p879 nvarchar(4000),@p880 int,@p881 nvarchar(4000),@p882 nvarchar(4000),@p883 nvarchar(4000),@p884 nvarchar(4000),@p885 nvarchar(4000),@p886 int,@p887 nvarchar(4000),@p888 int,@p889 int,@p890 datetime2(7),@p891 datetime2(7),@p892 datetime2(7),@p893 nvarchar(4000),@p894 nvarchar(4000),@p895 nvarchar(4000),@p896 nvarchar(4000),@p897 nvarchar(4000),@p898 nvarchar(4000),@p899 nvarchar(4000),@p900 nvarchar(4000),@p901 nvarchar(4000),@p902 nvarchar(4000),@p903 nvarchar(4000),@p904 nvarchar(4000),@p905 nvarchar(4000),@p906 nvarchar(4000),@p907 datetime2(7),@p908 nvarchar(4000),@p909 nvarchar(4000),@p910 int,@p911 int,@p912 int,@p913 nvarchar(4000),@p914 nvarchar(4000),@p915 nvarchar(4000),@p916 nvarchar(4000),@p917 nvarchar(4000),@p918 nvarchar(4000),@p919 nvarchar(4000),@p920 nvarchar(4000),@p921 nvarchar(4000),@p922 nvarchar(4000),@p923 nvarchar(4000),@p924 nvarchar(4000),@p925 int,@p926 nvarchar(4000),@p927 nvarchar(4000),@p928 nvarchar(4000),@p929 nvarchar(4000),@p930 nvarchar(4000),@p931 nvarchar(4000),@p932 nvarchar(4000),@p933 nvarchar(4000),@p934 nvarchar(4000),@p935 nvarchar(4000),@p936 int,@p937 nvarchar(4000),@p938 nvarchar(4000),@p939 nvarchar(4000),@p940 nvarchar(4000),@p941 nvarchar(4000),@p942 int,@p943 nvarchar(4000),@p944 int,@p945 int,@p946 datetime2(7),@p947 datetime2(7),@p948 datetime2(7),@p949 nvarchar(4000),@p950 nvarchar(4000),@p951 nvarchar(4000),@p952 nvarchar(4000),@p953 nvarchar(4000),@p954 nvarchar(4000),@p955 nvarchar(4000),@p956 nvarchar(4000),@p957 nvarchar(4000),@p958 nvarchar(4000),@p959 nvarchar(4000),@p960 nvarchar(4000),@p961 nvarchar(4000),@p962 nvarchar(4000),@p963 datetime2(7),@p964 nvarchar(4000),@p965 nvarchar(4000),@p966 int,@p967 int,@p968 int,@p969 nvarchar(4000),@p970 nvarchar(4000),@p971 nvarchar(4000),@p972 nvarchar(4000),@p973 nvarchar(4000),@p974 nvarchar(4000),@p975 nvarchar(4000),@p976 nvarchar(4000),@p977 nvarchar(4000),@p978 nvarchar(4000),@p979 nvarchar(4000),@p980 nvarchar(4000),@p981 int,@p982 nvarchar(4000),@p983 nvarchar(4000),@p984 nvarchar(4000),@p985 nvarchar(4000),@p986 nvarchar(4000),@p987 nvarchar(4000),@p988 nvarchar(4000),@p989 nvarchar(4000),@p990 nvarchar(4000),@p991 nvarchar(4000),@p992 int,@p993 nvarchar(4000),@p994 nvarchar(4000),@p995 nvarchar(4000),@p996 nvarchar(4000),@p997 nvarchar(4000),@p998 int,@p999 nvarchar(4000),@p1000 int,@p1001 int,@p1002 datetime2(7),@p1003 datetime2(7),@p1004 datetime2(7),@p1005 nvarchar(4000),@p1006 nvarchar(4000),@p1007 nvarchar(4000),@p1008 nvarchar(4000),@p1009 nvarchar(4000),@p1010 nvarchar(4000),@p1011 nvarchar(4000),@p1012 nvarchar(4000),@p1013 nvarchar(4000),@p1014 nvarchar(4000),@p1015 nvarchar(4000),@p1016 nvarchar(4000),@p1017 nvarchar(4000),@p1018 nvarchar(4000),@p1019 datetime2(7),@p1020 nvarchar(4000),@p1021 nvarchar(4000),@p1022 int,@p1023 int,@p1024 int,@p1025 nvarchar(4000),@p1026 nvarchar(4000),@p1027 nvarchar(4000),@p1028 nvarchar(4000),@p1029 nvarchar(4000),@p1030 nvarchar(4000),@p1031 nvarchar(4000),@p1032 nvarchar(4000),@p1033 nvarchar(4000),@p1034 nvarchar(4000),@p1035 nvarchar(4000),@p1036 nvarchar(4000),@p1037 int,@p1038 nvarchar(4000),@p1039 nvarchar(4000),@p1040 nvarchar(4000),@p1041 nvarchar(4000),@p1042 nvarchar(4000),@p1043 nvarchar(4000),@p1044 nvarchar(4000),@p1045 nvarchar(4000),@p1046 nvarchar(4000),@p1047 nvarchar(4000),@p1048 int,@p1049 nvarchar(4000),@p1050 nvarchar(4000),@p1051 nvarchar(4000),@p1052 nvarchar(4000),@p1053 nvarchar(4000),@p1054 int,@p1055 nvarchar(4000),@p1056 int,@p1057 int,@p1058 datetime2(7),@p1059 datetime2(7),@p1060 datetime2(7),@p1061 nvarchar(4000),@p1062 nvarchar(4000),@p1063 nvarchar(4000),@p1064 nvarchar(4000),@p1065 nvarchar(4000),@p1066 nvarchar(4000),@p1067 nvarchar(4000),@p1068 nvarchar(4000),@p1069 nvarchar(4000),@p1070 nvarchar(4000),@p1071 nvarchar(4000),@p1072 nvarchar(4000),@p1073 nvarchar(4000),@p1074 nvarchar(4000),@p1075 datetime2(7),@p1076 nvarchar(4000),@p1077 nvarchar(4000),@p1078 int,@p1079 int,@p1080 int,@p1081 nvarchar(4000),@p1082 nvarchar(4000),@p1083 nvarchar(4000),@p1084 nvarchar(4000),@p1085 nvarchar(4000),@p1086 nvarchar(4000),@p1087 nvarchar(4000),@p1088 nvarchar(4000),@p1089 nvarchar(4000),@p1090 nvarchar(4000),@p1091 nvarchar(4000),@p1092 nvarchar(4000),@p1093 int,@p1094 nvarchar(4000),@p1095 nvarchar(4000),@p1096 nvarchar(4000),@p1097 nvarchar(4000),@p1098 nvarchar(4000),@p1099 nvarchar(4000),@p1100 nvarchar(4000),@p1101 nvarchar(4000),@p1102 nvarchar(4000),@p1103 nvarchar(4000),@p1104 int,@p1105 nvarchar(4000),@p1106 nvarchar(4000),@p1107 nvarchar(4000),@p1108 nvarchar(4000),@p1109 nvarchar(4000),@p1110 int,@p1111 nvarchar(4000),@p1112 int,@p1113 int,@p1114 datetime2(7),@p1115 datetime2(7),@p1116 datetime2(7),@p1117 nvarchar(4000),@p1118 nvarchar(4000),@p1119 nvarchar(4000),@p1120 nvarchar(4000),@p1121 nvarchar(4000),@p1122 nvarchar(4000),@p1123 nvarchar(4000),@p1124 nvarchar(4000),@p1125 nvarchar(4000),@p1126 nvarchar(4000),@p1127 nvarchar(4000),@p1128 nvarchar(4000),@p1129 nvarchar(4000),@p1130 nvarchar(4000),@p1131 datetime2(7),@p1132 nvarchar(4000),@p1133 nvarchar(4000),@p1134 int,@p1135 int,@p1136 int,@p1137 nvarchar(4000),@p1138 nvarchar(4000),@p1139 nvarchar(4000),@p1140 nvarchar(4000),@p1141 nvarchar(4000),@p1142 nvarchar(4000),@p1143 nvarchar(4000),@p1144 nvarchar(4000),@p1145 nvarchar(4000),@p1146 nvarchar(4000),@p1147 nvarchar(4000),@p1148 nvarchar(4000),@p1149 int,@p1150 nvarchar(4000),@p1151 nvarchar(4000),@p1152 nvarchar(4000),@p1153 nvarchar(4000),@p1154 nvarchar(4000),@p1155 nvarchar(4000),@p1156 nvarchar(4000),@p1157 nvarchar(4000),@p1158 nvarchar(4000),@p1159 nvarchar(4000),@p1160 int,@p1161 nvarchar(4000),@p1162 nvarchar(4000),@p1163 nvarchar(4000),@p1164 nvarchar(4000),@p1165 nvarchar(4000),@p1166 int,@p1167 nvarchar(4000),@p1168 int,@p1169 int,@p1170 datetime2(7),@p1171 datetime2(7),@p1172 datetime2(7),@p1173 nvarchar(4000),@p1174 nvarchar(4000),@p1175 nvarchar(4000),@p1176 nvarchar(4000),@p1177 nvarchar(4000),@p1178 nvarchar(4000),@p1179 nvarchar(4000),@p1180 nvarchar(4000),@p1181 nvarchar(4000),@p1182 nvarchar(4000),@p1183 nvarchar(4000),@p1184 nvarchar(4000),@p1185 nvarchar(4000),@p1186 nvarchar(4000),@p1187 datetime2(7),@p1188 nvarchar(4000),@p1189 nvarchar(4000),@p1190 int,@p1191 int,@p1192 int,@p1193 nvarchar(4000),@p1194 nvarchar(4000),@p1195 nvarchar(4000),@p1196 nvarchar(4000),@p1197 nvarchar(4000),@p1198 nvarchar(4000),@p1199 nvarchar(4000),@p1200 nvarchar(4000),@p1201 nvarchar(4000),@p1202 nvarchar(4000),@p1203 nvarchar(4000),@p1204 nvarchar(4000),@p1205 int,@p1206 nvarchar(4000),@p1207 nvarchar(4000),@p1208 nvarchar(4000),@p1209 nvarchar(4000),@p1210 nvarchar(4000),@p1211 nvarchar(4000),@p1212 nvarchar(4000),@p1213 nvarchar(4000),@p1214 nvarchar(4000),@p1215 nvarchar(4000),@p1216 int,@p1217 nvarchar(4000),@p1218 nvarchar(4000),@p1219 nvarchar(4000),@p1220 nvarchar(4000),@p1221 nvarchar(4000),@p1222 int,@p1223 nvarchar(4000),@p1224 int,@p1225 int,@p1226 datetime2(7),@p1227 datetime2(7),@p1228 datetime2(7),@p1229 nvarchar(4000),@p1230 nvarchar(4000),@p1231 nvarchar(4000),@p1232 nvarchar(4000),@p1233 nvarchar(4000),@p1234 nvarchar(4000),@p1235 nvarchar(4000),@p1236 nvarchar(4000),@p1237 nvarchar(4000),@p1238 nvarchar(4000),@p1239 nvarchar(4000),@p1240 nvarchar(4000),@p1241 nvarchar(4000),@p1242 nvarchar(4000),@p1243 datetime2(7),@p1244 nvarchar(4000),@p1245 nvarchar(4000),@p1246 int,@p1247 int,@p1248 int,@p1249 nvarchar(4000),@p1250 nvarchar(4000),@p1251 nvarchar(4000),@p1252 nvarchar(4000),@p1253 nvarchar(4000),@p1254 nvarchar(4000),@p1255 nvarchar(4000),@p1256 nvarchar(4000),@p1257 nvarchar(4000),@p1258 nvarchar(4000),@p1259 nvarchar(4000),@p1260 nvarchar(4000),@p1261 int,@p1262 nvarchar(4000),@p1263 nvarchar(4000),@p1264 nvarchar(4000),@p1265 nvarchar(4000),@p1266 nvarchar(4000),@p1267 nvarchar(4000),@p1268 nvarchar(4000),@p1269 nvarchar(4000),@p1270 nvarchar(4000),@p1271 nvarchar(4000),@p1272 int,@p1273 nvarchar(4000),@p1274 nvarchar(4000),@p1275 nvarchar(4000),@p1276 nvarchar(4000),@p1277 nvarchar(4000),@p1278 int,@p1279 nvarchar(4000),@p1280 int,@p1281 int,@p1282 datetime2(7),@p1283 datetime2(7),@p1284 datetime2(7),@p1285 nvarchar(4000),@p1286 nvarchar(4000),@p1287 nvarchar(4000),@p1288 nvarchar(4000),@p1289 nvarchar(4000),@p1290 nvarchar(4000),@p1291 nvarchar(4000),@p1292 nvarchar(4000),@p1293 nvarchar(4000),@p1294 nvarchar(4000),@p1295 nvarchar(4000),@p1296 nvarchar(4000),@p1297 nvarchar(4000),@p1298 nvarchar(4000),@p1299 datetime2(7),@p1300 nvarchar(4000),@p1301 nvarchar(4000),@p1302 int,@p1303 int,@p1304 int,@p1305 nvarchar(4000),@p1306 nvarchar(4000),@p1307 nvarchar(4000),@p1308 nvarchar(4000),@p1309 nvarchar(4000),@p1310 nvarchar(4000),@p1311 nvarchar(4000),@p1312 nvarchar(4000),@p1313 nvarchar(4000),@p1314 nvarchar(4000),@p1315 nvarchar(4000),@p1316 nvarchar(4000),@p1317 int,@p1318 nvarchar(4000),@p1319 nvarchar(4000),@p1320 nvarchar(4000),@p1321 nvarchar(4000),@p1322 nvarchar(4000),@p1323 nvarchar(4000),@p1324 nvarchar(4000),@p1325 nvarchar(4000),@p1326 nvarchar(4000),@p1327 nvarchar(4000),@p1328 int,@p1329 nvarchar(4000),@p1330 nvarchar(4000),@p1331 nvarchar(4000),@p1332 nvarchar(4000),@p1333 nvarchar(4000),@p1334 int,@p1335 nvarchar(4000),@p1336 int,@p1337 int,@p1338 datetime2(7),@p1339 datetime2(7),@p1340 datetime2(7),@p1341 nvarchar(4000),@p1342 nvarchar(4000),@p1343 nvarchar(4000),@p1344 nvarchar(4000),@p1345 nvarchar(4000),@p1346 nvarchar(4000),@p1347 nvarchar(4000),@p1348 nvarchar(4000),@p1349 nvarchar(4000),@p1350 nvarchar(4000),@p1351 nvarchar(4000),@p1352 nvarchar(4000),@p1353 nvarchar(4000),@p1354 nvarchar(4000),@p1355 datetime2(7),@p1356 nvarchar(4000),@p1357 nvarchar(4000),@p1358 int,@p1359 int,@p1360 int,@p1361 nvarchar(4000),@p1362 nvarchar(4000),@p1363 nvarchar(4000),@p1364 nvarchar(4000),@p1365 nvarchar(4000),@p1366 nvarchar(4000),@p1367 nvarchar(4000),@p1368 nvarchar(4000),@p1369 nvarchar(4000),@p1370 nvarchar(4000),@p1371 nvarchar(4000),@p1372 nvarchar(4000),@p1373 int,@p1374 nvarchar(4000),@p1375 nvarchar(4000),@p1376 nvarchar(4000),@p1377 nvarchar(4000),@p1378 nvarchar(4000),@p1379 nvarchar(4000),@p1380 nvarchar(4000),@p1381 nvarchar(4000),@p1382 nvarchar(4000),@p1383 nvarchar(4000),@p1384 int,@p1385 nvarchar(4000),@p1386 nvarchar(4000),@p1387 nvarchar(4000),@p1388 nvarchar(4000),@p1389 nvarchar(4000),@p1390 int,@p1391 nvarchar(4000),@p1392 int,@p1393 int,@p1394 datetime2(7),@p1395 datetime2(7),@p1396 datetime2(7),@p1397 nvarchar(4000),@p1398 nvarchar(4000),@p1399 nvarchar(4000),@p1400 nvarchar(4000),@p1401 nvarchar(4000),@p1402 nvarchar(4000),@p1403 nvarchar(4000),@p1404 nvarchar(4000),@p1405 nvarchar(4000),@p1406 nvarchar(4000),@p1407 nvarchar(4000),@p1408 nvarchar(4000),@p1409 nvarchar(4000),@p1410 nvarchar(4000),@p1411 datetime2(7),@p1412 nvarchar(4000),@p1413 nvarchar(4000),@p1414 int,@p1415 int,@p1416 int,@p1417 nvarchar(4000),@p1418 nvarchar(4000),@p1419 nvarchar(4000),@p1420 nvarchar(4000),@p1421 nvarchar(4000),@p1422 nvarchar(4000),@p1423 nvarchar(4000),@p1424 nvarchar(4000),@p1425 nvarchar(4000),@p1426 nvarchar(4000),@p1427 nvarchar(4000),@p1428 nvarchar(4000),@p1429 int,@p1430 nvarchar(4000),@p1431 nvarchar(4000),@p1432 nvarchar(4000),@p1433 nvarchar(4000),@p1434 nvarchar(4000),@p1435 nvarchar(4000),@p1436 nvarchar(4000),@p1437 nvarchar(4000),@p1438 nvarchar(4000),@p1439 nvarchar(4000),@p1440 int,@p1441 nvarchar(4000),@p1442 nvarchar(4000),@p1443 nvarchar(4000),@p1444 nvarchar(4000),@p1445 nvarchar(4000),@p1446 int,@p1447 nvarchar(4000),@p1448 int,@p1449 int,@p1450 datetime2(7),@p1451 datetime2(7),@p1452 datetime2(7),@p1453 nvarchar(4000),@p1454 nvarchar(4000),@p1455 nvarchar(4000),@p1456 nvarchar(4000),@p1457 nvarchar(4000),@p1458 nvarchar(4000),@p1459 nvarchar(4000),@p1460 nvarchar(4000),@p1461 nvarchar(4000),@p1462 nvarchar(4000),@p1463 nvarchar(4000),@p1464 nvarchar(4000),@p1465 nvarchar(4000),@p1466 nvarchar(4000),@p1467 datetime2(7),@p1468 nvarchar(4000),@p1469 nvarchar(4000),@p1470 int,@p1471 int,@p1472 int,@p1473 nvarchar(4000),@p1474 nvarchar(4000),@p1475 nvarchar(4000),@p1476 nvarchar(4000),@p1477 nvarchar(4000),@p1478 nvarchar(4000),@p1479 nvarchar(4000),@p1480 nvarchar(4000),@p1481 nvarchar(4000),@p1482 nvarchar(4000),@p1483 nvarchar(4000),@p1484 nvarchar(4000),@p1485 int,@p1486 nvarchar(4000),@p1487 nvarchar(4000),@p1488 nvarchar(4000),@p1489 nvarchar(4000),@p1490 nvarchar(4000),@p1491 nvarchar(4000),@p1492 nvarchar(4000),@p1493 nvarchar(4000),@p1494 nvarchar(4000),@p1495 nvarchar(4000),@p1496 int,@p1497 nvarchar(4000),@p1498 nvarchar(4000),@p1499 nvarchar(4000),@p1500 nvarchar(4000),@p1501 nvarchar(4000),@p1502 int,@p1503 nvarchar(4000),@p1504 int,@p1505 int,@p1506 datetime2(7),@p1507 datetime2(7),@p1508 datetime2(7),@p1509 nvarchar(4000),@p1510 nvarchar(4000),@p1511 nvarchar(4000),@p1512 nvarchar(4000),@p1513 nvarchar(4000),@p1514 nvarchar(4000),@p1515 nvarchar(4000),@p1516 nvarchar(4000),@p1517 nvarchar(4000),@p1518 nvarchar(4000),@p1519 nvarchar(4000),@p1520 nvarchar(4000),@p1521 nvarchar(4000),@p1522 nvarchar(4000),@p1523 datetime2(7),@p1524 nvarchar(4000),@p1525 nvarchar(4000),@p1526 int,@p1527 int,@p1528 int,@p1529 nvarchar(4000),@p1530 nvarchar(4000),@p1531 nvarchar(4000),@p1532 nvarchar(4000),@p1533 nvarchar(4000),@p1534 nvarchar(4000),@p1535 nvarchar(4000),@p1536 nvarchar(4000),@p1537 nvarchar(4000),@p1538 nvarchar(4000),@p1539 nvarchar(4000),@p1540 nvarchar(4000),@p1541 int,@p1542 nvarchar(4000),@p1543 nvarchar(4000),@p1544 nvarchar(4000),@p1545 nvarchar(4000),@p1546 nvarchar(4000),@p1547 nvarchar(4000),@p1548 nvarchar(4000),@p1549 nvarchar(4000),@p1550 nvarchar(4000),@p1551 nvarchar(4000),@p1552 int,@p1553 nvarchar(4000),@p1554 nvarchar(4000),@p1555 nvarchar(4000),@p1556 nvarchar(4000),@p1557 nvarchar(4000),@p1558 int,@p1559 nvarchar(4000),@p1560 int,@p1561 int,@p1562 datetime2(7),@p1563 datetime2(7),@p1564 datetime2(7),@p1565 nvarchar(4000),@p1566 nvarchar(4000),@p1567 nvarchar(4000),@p1568 nvarchar(4000),@p1569 nvarchar(4000),@p1570 nvarchar(4000),@p1571 nvarchar(4000),@p1572 nvarchar(4000),@p1573 nvarchar(4000),@p1574 nvarchar(4000),@p1575 nvarchar(4000),@p1576 nvarchar(4000),@p1577 nvarchar(4000),@p1578 nvarchar(4000),@p1579 datetime2(7),@p1580 nvarchar(4000),@p1581 nvarchar(4000),@p1582 int,@p1583 int,@p1584 int,@p1585 nvarchar(4000),@p1586 nvarchar(4000),@p1587 nvarchar(4000),@p1588 nvarchar(4000),@p1589 nvarchar(4000),@p1590 nvarchar(4000),@p1591 nvarchar(4000),@p1592 nvarchar(4000),@p1593 nvarchar(4000),@p1594 nvarchar(4000),@p1595 nvarchar(4000),@p1596 nvarchar(4000),@p1597 int,@p1598 nvarchar(4000),@p1599 nvarchar(4000),@p1600 nvarchar(4000),@p1601 nvarchar(4000),@p1602 nvarchar(4000),@p1603 nvarchar(4000),@p1604 nvarchar(4000),@p1605 nvarchar(4000),@p1606 nvarchar(4000),@p1607 nvarchar(4000),@p1608 int,@p1609 nvarchar(4000),@p1610 nvarchar(4000),@p1611 nvarchar(4000),@p1612 nvarchar(4000),@p1613 nvarchar(4000),@p1614 int,@p1615 nvarchar(4000),@p1616 int,@p1617 int,@p1618 datetime2(7),@p1619 datetime2(7),@p1620 datetime2(7),@p1621 nvarchar(4000),@p1622 nvarchar(4000),@p1623 nvarchar(4000),@p1624 nvarchar(4000),@p1625 nvarchar(4000),@p1626 nvarchar(4000),@p1627 nvarchar(4000),@p1628 nvarchar(4000),@p1629 nvarchar(4000),@p1630 nvarchar(4000),@p1631 nvarchar(4000),@p1632 nvarchar(4000),@p1633 nvarchar(4000),@p1634 nvarchar(4000),@p1635 datetime2(7),@p1636 nvarchar(4000),@p1637 nvarchar(4000),@p1638 int,@p1639 int,@p1640 int,@p1641 nvarchar(4000),@p1642 nvarchar(4000),@p1643 nvarchar(4000),@p1644 nvarchar(4000),@p1645 nvarchar(4000),@p1646 nvarchar(4000),@p1647 nvarchar(4000),@p1648 nvarchar(4000),@p1649 nvarchar(4000),@p1650 nvarchar(4000),@p1651 nvarchar(4000),@p1652 nvarchar(4000),@p1653 int,@p1654 nvarchar(4000),@p1655 nvarchar(4000),@p1656 nvarchar(4000),@p1657 nvarchar(4000),@p1658 nvarchar(4000),@p1659 nvarchar(4000),@p1660 nvarchar(4000),@p1661 nvarchar(4000),@p1662 nvarchar(4000),@p1663 nvarchar(4000),@p1664 int,@p1665 nvarchar(4000),@p1666 nvarchar(4000),@p1667 nvarchar(4000),@p1668 nvarchar(4000),@p1669 nvarchar(4000),@p1670 int,@p1671 nvarchar(4000),@p1672 int,@p1673 int,@p1674 datetime2(7),@p1675 datetime2(7),@p1676 datetime2(7),@p1677 nvarchar(4000),@p1678 nvarchar(4000),@p1679 nvarchar(4000),@p1680 nvarchar(4000),@p1681 nvarchar(4000),@p1682 nvarchar(4000),@p1683 nvarchar(4000),@p1684 nvarchar(4000),@p1685 nvarchar(4000),@p1686 nvarchar(4000),@p1687 nvarchar(4000),@p1688 nvarchar(4000),@p1689 nvarchar(4000),@p1690 nvarchar(4000),@p1691 datetime2(7),@p1692 nvarchar(4000),@p1693 nvarchar(4000),@p1694 int,@p1695 int,@p1696 int,@p1697 nvarchar(4000),@p1698 nvarchar(4000),@p1699 nvarchar(4000),@p1700 nvarchar(4000),@p1701 nvarchar(4000),@p1702 nvarchar(4000),@p1703 nvarchar(4000),@p1704 nvarchar(4000),@p1705 nvarchar(4000),@p1706 nvarchar(4000),@p1707 nvarchar(4000),@p1708 nvarchar(4000),@p1709 int,@p1710 nvarchar(4000),@p1711 nvarchar(4000),@p1712 nvarchar(4000),@p1713 nvarchar(4000),@p1714 nvarchar(4000),@p1715 nvarchar(4000),@p1716 nvarchar(4000),@p1717 nvarchar(4000),@p1718 nvarchar(4000),@p1719 nvarchar(4000),@p1720 int,@p1721 nvarchar(4000),@p1722 nvarchar(4000),@p1723 nvarchar(4000),@p1724 nvarchar(4000),@p1725 nvarchar(4000),@p1726 int,@p1727 nvarchar(4000),@p1728 int,@p1729 int,@p1730 datetime2(7),@p1731 datetime2(7),@p1732 datetime2(7),@p1733 nvarchar(4000),@p1734 nvarchar(4000),@p1735 nvarchar(4000),@p1736 nvarchar(4000),@p1737 nvarchar(4000),@p1738 nvarchar(4000),@p1739 nvarchar(4000),@p1740 nvarchar(4000),@p1741 nvarchar(4000),@p1742 nvarchar(4000),@p1743 nvarchar(4000),@p1744 nvarchar(4000),@p1745 nvarchar(4000),@p1746 nvarchar(4000),@p1747 datetime2(7),@p1748 nvarchar(4000),@p1749 nvarchar(4000),@p1750 int,@p1751 int,@p1752 int,@p1753 nvarchar(4000),@p1754 nvarchar(4000),@p1755 nvarchar(4000),@p1756 nvarchar(4000),@p1757 nvarchar(4000),@p1758 nvarchar(4000),@p1759 nvarchar(4000),@p1760 nvarchar(4000),@p1761 nvarchar(4000),@p1762 nvarchar(4000),@p1763 nvarchar(4000),@p1764 nvarchar(4000),@p1765 int,@p1766 nvarchar(4000),@p1767 nvarchar(4000),@p1768 nvarchar(4000),@p1769 nvarchar(4000),@p1770 nvarchar(4000),@p1771 nvarchar(4000),@p1772 nvarchar(4000),@p1773 nvarchar(4000),@p1774 nvarchar(4000),@p1775 nvarchar(4000),@p1776 int,@p1777 nvarchar(4000),@p1778 nvarchar(4000),@p1779 nvarchar(4000),@p1780 nvarchar(4000),@p1781 nvarchar(4000),@p1782 int,@p1783 nvarchar(4000),@p1784 int,@p1785 int,@p1786 datetime2(7),@p1787 datetime2(7),@p1788 datetime2(7),@p1789 nvarchar(4000),@p1790 nvarchar(4000),@p1791 nvarchar(4000),@p1792 nvarchar(4000),@p1793 nvarchar(4000),@p1794 nvarchar(4000),@p1795 nvarchar(4000),@p1796 nvarchar(4000),@p1797 nvarchar(4000),@p1798 nvarchar(4000),@p1799 nvarchar(4000),@p1800 nvarchar(4000),@p1801 nvarchar(4000),@p1802 nvarchar(4000),@p1803 datetime2(7),@p1804 nvarchar(4000),@p1805 nvarchar(4000),@p1806 int,@p1807 int,@p1808 int,@p1809 nvarchar(4000),@p1810 nvarchar(4000),@p1811 nvarchar(4000),@p1812 nvarchar(4000),@p1813 nvarchar(4000),@p1814 nvarchar(4000),@p1815 nvarchar(4000),@p1816 nvarchar(4000),@p1817 nvarchar(4000),@p1818 nvarchar(4000),@p1819 nvarchar(4000),@p1820 nvarchar(4000),@p1821 int,@p1822 nvarchar(4000),@p1823 nvarchar(4000),@p1824 nvarchar(4000),@p1825 nvarchar(4000),@p1826 nvarchar(4000),@p1827 nvarchar(4000),@p1828 nvarchar(4000),@p1829 nvarchar(4000),@p1830 nvarchar(4000),@p1831 nvarchar(4000),@p1832 int,@p1833 nvarchar(4000),@p1834 nvarchar(4000),@p1835 nvarchar(4000),@p1836 nvarchar(4000),@p1837 nvarchar(4000),@p1838 int,@p1839 nvarchar(4000),@p1840 int,@p1841 int,@p1842 datetime2(7),@p1843 datetime2(7),@p1844 datetime2(7),@p1845 nvarchar(4000),@p1846 nvarchar(4000),@p1847 nvarchar(4000),@p1848 nvarchar(4000),@p1849 nvarchar(4000),@p1850 nvarchar(4000),@p1851 nvarchar(4000),@p1852 nvarchar(4000),@p1853 nvarchar(4000),@p1854 nvarchar(4000),@p1855 nvarchar(4000),@p1856 nvarchar(4000),@p1857 nvarchar(4000),@p1858 nvarchar(4000),@p1859 datetime2(7),@p1860 nvarchar(4000),@p1861 nvarchar(4000),@p1862 int,@p1863 int,@p1864 int,@p1865 nvarchar(4000),@p1866 nvarchar(4000),@p1867 nvarchar(4000),@p1868 nvarchar(4000),@p1869 nvarchar(4000),@p1870 nvarchar(4000),@p1871 nvarchar(4000),@p1872 nvarchar(4000),@p1873 nvarchar(4000),@p1874 nvarchar(4000),@p1875 nvarchar(4000),@p1876 nvarchar(4000),@p1877 int,@p1878 nvarchar(4000),@p1879 nvarchar(4000),@p1880 nvarchar(4000),@p1881 nvarchar(4000),@p1882 nvarchar(4000),@p1883 nvarchar(4000),@p1884 nvarchar(4000),@p1885 nvarchar(4000),@p1886 nvarchar(4000),@p1887 nvarchar(4000),@p1888 int,@p1889 nvarchar(4000),@p1890 nvarchar(4000),@p1891 nvarchar(4000),@p1892 nvarchar(4000),@p1893 nvarchar(4000),@p1894 int,@p1895 nvarchar(4000),@p1896 int,@p1897 int,@p1898 datetime2(7),@p1899 datetime2(7),@p1900 datetime2(7),@p1901 nvarchar(4000),@p1902 nvarchar(4000),@p1903 nvarchar(4000),@p1904 nvarchar(4000),@p1905 nvarchar(4000),@p1906 nvarchar(4000),@p1907 nvarchar(4000),@p1908 nvarchar(4000),@p1909 nvarchar(4000),@p1910 nvarchar(4000),@p1911 nvarchar(4000),@p1912 nvarchar(4000),@p1913 nvarchar(4000),@p1914 nvarchar(4000),@p1915 datetime2(7),@p1916 nvarchar(4000),@p1917 nvarchar(4000),@p1918 int,@p1919 int,@p1920 int,@p1921 nvarchar(4000),@p1922 nvarchar(4000),@p1923 nvarchar(4000),@p1924 nvarchar(4000),@p1925 nvarchar(4000),@p1926 nvarchar(4000),@p1927 nvarchar(4000),@p1928 nvarchar(4000),@p1929 nvarchar(4000),@p1930 nvarchar(4000),@p1931 nvarchar(4000),@p1932 nvarchar(4000),@p1933 int,@p1934 nvarchar(4000),@p1935 nvarchar(4000),@p1936 nvarchar(4000),@p1937 nvarchar(4000),@p1938 nvarchar(4000),@p1939 nvarchar(4000),@p1940 nvarchar(4000),@p1941 nvarchar(4000),@p1942 nvarchar(4000),@p1943 nvarchar(4000),@p1944 int,@p1945 nvarchar(4000),@p1946 nvarchar(4000),@p1947 nvarchar(4000),@p1948 nvarchar(4000),@p1949 nvarchar(4000),@p1950 int,@p1951 nvarchar(4000),@p1952 int,@p1953 int,@p1954 datetime2(7),@p1955 datetime2(7),@p1956 datetime2(7),@p1957 nvarchar(4000),@p1958 nvarchar(4000),@p1959 nvarchar(4000),@p1960 nvarchar(4000),@p1961 nvarchar(4000),@p1962 nvarchar(4000),@p1963 nvarchar(4000),@p1964 nvarchar(4000),@p1965 nvarchar(4000),@p1966 nvarchar(4000),@p1967 nvarchar(4000),@p1968 nvarchar(4000),@p1969 nvarchar(4000),@p1970 nvarchar(4000),@p1971 datetime2(7),@p1972 nvarchar(4000),@p1973 nvarchar(4000),@p1974 int,@p1975 int,@p1976 int,@p1977 nvarchar(4000),@p1978 nvarchar(4000),@p1979 nvarchar(4000),@p1980 nvarchar(4000),@p1981 nvarchar(4000),@p1982 nvarchar(4000),@p1983 nvarchar(4000),@p1984 nvarchar(4000),@p1985 nvarchar(4000),@p1986 nvarchar(4000),@p1987 nvarchar(4000),@p1988 nvarchar(4000),@p1989 int,@p1990 nvarchar(4000),@p1991 nvarchar(4000),@p1992 nvarchar(4000),@p1993 nvarchar(4000),@p1994 nvarchar(4000),@p1995 nvarchar(4000),@p1996 nvarchar(4000),@p1997 nvarchar(4000),@p1998 nvarchar(4000),@p1999 nvarchar(4000),@p2000 int,@p2001 nvarchar(4000),@p2002 nvarchar(4000),@p2003 nvarchar(4000),@p2004 nvarchar(4000),@p2005 nvarchar(4000),@p2006 int,@p2007 nvarchar(4000),@p2008 int,@p2009 int,@p2010 datetime2(7),@p2011 datetime2(7),@p2012 datetime2(7),@p2013 nvarchar(4000),@p2014 nvarchar(4000),@p2015 nvarchar(4000),@p2016 nvarchar(4000),@p2017 nvarchar(4000),@p2018 nvarchar(4000),@p2019 nvarchar(4000),@p2020 nvarchar(4000),@p2021 nvarchar(4000),@p2022 nvarchar(4000),@p2023 nvarchar(4000),@p2024 nvarchar(4000),@p2025 nvarchar(4000),@p2026 nvarchar(4000),@p2027 datetime2(7),@p2028 nvarchar(4000),@p2029 nvarchar(4000),@p2030 int,@p2031 int,@p2032 int,@p2033 nvarchar(4000),@p2034 nvarchar(4000),@p2035 nvarchar(4000),@p2036 nvarchar(4000),@p2037 nvarchar(4000),@p2038 nvarchar(4000),@p2039 nvarchar(4000),@p2040 nvarchar(4000),@p2041 nvarchar(4000),@p2042 nvarchar(4000),@p2043 nvarchar(4000),@p2044 nvarchar(4000),@p2045 int,@p2046 nvarchar(4000),@p2047 nvarchar(4000),@p2048 nvarchar(4000),@p2049 nvarchar(4000),@p2050 nvarchar(4000),@p2051 nvarchar(4000),@p2052 nvarchar(4000),@p2053 nvarchar(4000),@p2054 nvarchar(4000),@p2055 nvarchar(4000),@p2056 int,@p2057 nvarchar(4000),@p2058 nvarchar(4000),@p2059 nvarchar(4000),@p2060 nvarchar(4000),@p2061 nvarchar(4000),@p2062 int,@p2063 nvarchar(4000),@p2064 int,@p2065 int,@p2066 datetime2(7),@p2067 datetime2(7),@p2068 datetime2(7),@p2069 nvarchar(4000),@p2070 nvarchar(4000),@p2071 nvarchar(4000))SET NOCOUNT ON; DECLARE @inserted0 TABLE ([item_id] int, [_Position] [int]); MERGE [raw_data] USING ( VALUES (@p0, @p1, @p2, @p3, @p4, @p5, @p6, @p7, @p8, @p9, @p10, @p11, @p12, @p13, @p14, @p15, @p16, @p17, @p18, @p19, @p20, @p21, @p22, @p23, @p24, @p25, @p26, @p27, @p28, @p29, @p30, @p31, @p32, @p33, @p34, @p35, @p36, @p37, @p38, @p39, @p40, @p41, @p42, @p43, @p44, @p45, @p46, @p47, @p48, @p49, @p50, @p51, @p52, @p53, @p54, @p55, 0), (@p56, @p57, @p58, @p59, @p60, @p61, @p62, @p63, @p64, @p65, @p66, @p67, @p68, @p69, @p70, @p71, @p72, @p73, @p74, @p75, @p76, @p77, @p78, @p79, @p80, @p81, @p82, @p83, @p84, @p85, @p86, @p87, @p88, @p89, @p90, @p91, @p92, @p93, @p94, @p95, @p96, @p97, @p98, @p99, @p100, @p101, @p102, @p103, @p104, @p105, @p106, @p107, @p108, @p109, @p110, @p111, 1), (@p112, @p113, @p114, @p115, @p116, @p117, @p118, @p119, @p120, @p121, @p122, @p123, @p124, @p125, @p126, @p127, @p128, @p129, @p130, @p131, @p132, @p133, @p134, @p135, @p136, @p137, @p138, @p139, @p140, @p141, @p142, @p143, @p144, @p145, @p146, @p147, @p148, @p149, @p150, @p151, @p152, @p153, @p154, @p155, @p156, @p157, @p158, @p159, @p160, @p161, @p162, @p163, @p164, @p165, @p166, @p167, 2), (@p168, @p169, @p170, @p171, @p172, @p173, @p174, @p175, @p176, @p177, @p178, @p179, @p180, @p181, @p182, @p183, @p184, @p185, @p186, @p187, @p188, @p189, @p190, @p191, @p192, @p193, @p194, @p195, @p196, @p197, @p198, @p199, @p200, @p201, @p202, @p203, @p204, @p205, @p206, @p207, @p208, @p209, @p210, @p211, @p212, @p213, @p214, @p215, @p216, @p217, @p218, @p219, @p220, @p221, @p222, @p223, 3), (@p224, @p225, @p226, @p227, @p228, @p229, @p230, @p231, @p232, @p233, @p234, @p235, @p236, @p237, @p238, @p239, @p240, @p241, @p242, @p243, @p244, @p245, @p246, @p247, @p248, @p249, @p250, @p251, @p252, @p253, @p254, @p255, @p256, @p257, @p258, @p259, @p260, @p261, @p262, @p263, @p264, @p265, @p266, @p267, @p268, @p269, @p270, @p271, @p272, @p273, @p274, @p275, @p276, @p277, @p278, @p279, 4), (@p280, @p281, @p282, @p283, @p284, @p285, @p286, @p287, @p288, @p289, @p290, @p291, @p292, @p293, @p294, @p295, @p296, @p297, @p298, @p299, @p300, @p301, @p302, @p303, @p304, @p305, @p306, @p307, @p308, @p309, @p310, @p311, @p312, @p313, @p314, @p315, @p316, @p317, @p318, @p319, @p320, @p321, @p322, @p323, @p324, @p325, @p326, @p327, @p328, @p329, @p330, @p331, @p332, @p333, @p334, @p335, 5), (@p336, @p337, @p338, @p339, @p340, @p341, @p342, @p343, @p344, @p345, @p346, @p347, @p348, @p349, @p350, @p351, @p352, @p353, @p354, @p355, @p356, @p357, @p358, @p359, @p360, @p361, @p362, @p363, @p364, @p365, @p366, @p367, @p368, @p369, @p370, @p371, @p372, @p373, @p374, @p375, @p376, @p377, @p378, @p379, @p380, @p381, @p382, @p383, @p384, @p385, @p386, @p387, @p388, @p389, @p390, @p391, 6), (@p392, @p393, @p394, @p395, @p396, @p397, @p398, @p399, @p400, @p401, @p402, @p403, @p404, @p405, @p406, @p407, @p408, @p409, @p410, @p411, @p412, @p413, @p414, @p415, @p416, @p417, @p418, @p419, @p420, @p421, @p422, @p423, @p424, @p425, @p426, @p427, @p428, @p429, @p430, @p431, @p432, @p433, @p434, @p435, @p436, @p437, @p438, @p439, @p440, @p441, @p442, @p443, @p444, @p445, @p446, @p447, 7), (@p448, @p449, @p450, @p451, @p452, @p453, @p454, @p455, @p456, @p457, @p458, @p459, @p460, @p461, @p462, @p463, @p464, @p465, @p466, @p467, @p468, @p469, @p470, @p471, @p472, @p473, @p474, @p475, @p476, @p477, @p478, @p479, @p480, @p481, @p482, @p483, @p484, @p485, @p486, @p487, @p488, @p489, @p490, @p491, @p492, @p493, @p494, @p495, @p496, @p497, @p498, @p499, @p500, @p501, @p502, @p503, 8), (@p504, @p505, @p506, @p507, @p508, @p509, @p510, @p511, @p512, @p513, @p514, @p515, @p516, @p517, @p518, @p519, @p520, @p521, @p522, @p523, @p524, @p525, @p526, @p527, @p528, @p529, @p530, @p531, @p532, @p533, @p534, @p535, @p536, @p537, @p538, @p539, @p540, @p541, @p542, @p543, @p544, @p545, @p546, @p547, @p548, @p549, @p550, @p551, @p552, @p553, @p554, @p555, @p556, @p557, @p558, @p559, 9), (@p560, @p561, @p562, @p563, @p564, @p565, @p566, @p567, @p568, @p569, @p570, @p571, @p572, @p573, @p574, @p575, @p576, @p577, @p578, @p579, @p580, @p581, @p582, @p583, @p584, @p585, @p586, @p587, @p588, @p589, @p590, @p591, @p592, @p593, @p594, @p595, @p596, @p597, @p598, @p599, @p600, @p601, @p602, @p603, @p604, @p605, @p606, @p607, @p608, @p609, @p610, @p611, @p612, @p613, @p614, @p615, 10), (@p616, @p617, @p618, @p619, @p620, @p621, @p622, @p623, @p624, @p625, @p626, @p627, @p628, @p629, @p630, @p631, @p632, @p633, @p634, @p635, @p636, @p637, @p638, @p639, @p640, @p641, @p642, @p643, @p644, @p645, @p646, @p647, @p648, @p649, @p650, @p651, @p652, @p653, @p654, @p655, @p656, @p657, @p658, @p659, @p660, @p661, @p662, @p663, @p664, @p665, @p666, @p667, @p668, @p669, @p670, @p671, 11), (@p672, @p673, @p674, @p675, @p676, @p677, @p678, @p679, @p680, @p681, @p682, @p683, @p684, @p685, @p686, @p687, @p688, @p689, @p690, @p691, @p692, @p693, @p694, @p695, @p696, @p697, @p698, @p699, @p700, @p701, @p702, @p703, @p704, @p705, @p706, @p707, @p708, @p709, @p710, @p711, @p712, @p713, @p714, @p715, @p716, @p717, @p718, @p719, @p720, @p721, @p722, @p723, @p724, @p725, @p726, @p727, 12), (@p728, @p729, @p730, @p731, @p732, @p733, @p734, @p735, @p736, @p737, @p738, @p739, @p740, @p741, @p742, @p743, @p744, @p745, @p746, @p747, @p748, @p749, @p750, @p751, @p752, @p753, @p754, @p755, @p756, @p757, @p758, @p759, @p760, @p761, @p762, @p763, @p764, @p765, @p766, @p767, @p768, @p769, @p770, @p771, @p772, @p773, @p774, @p775, @p776, @p777, @p778, @p779, @p780, @p781, @p782, @p783, 13), (@p784, @p785, @p786, @p787, @p788, @p789, @p790, @p791, @p792, @p793, @p794, @p795, @p796, @p797, @p798, @p799, @p800, @p801, @p802, @p803, @p804, @p805, @p806, @p807, @p808, @p809, @p810, @p811, @p812, @p813, @p814, @p815, @p816, @p817, @p818, @p819, @p820, @p821, @p822, @p823, @p824, @p825, @p826, @p827, @p828, @p829, @p830, @p831, @p832, @p833, @p834, @p835, @p836, @p837, @p838, @p839, 14), (@p840, @p841, @p842, @p843, @p844, @p845, @p846, @p847, @p848, @p849, @p850, @p851, @p852, @p853, @p854, @p855, @p856, @p857, @p858, @p859, @p860, @p861, @p862, @p863, @p864, @p865, @p866, @p867, @p868, @p869, @p870, @p871, @p872, @p873, @p874, @p875, @p876, @p877, @p878, @p879, @p880, @p881, @p882, @p883, @p884, @p885, @p886, @p887, @p888, @p889, @p890, @p891, @p892, @p893, @p894, @p895, 15), (@p896, @p897, @p898, @p899, @p900, @p901, @p902, @p903, @p904, @p905, @p906, @p907, @p908, @p909, @p910, @p911, @p912, @p913, @p914, @p915, @p916, @p917, @p918, @p919, @p920, @p921, @p922, @p923, @p924, @p925, @p926, @p927, @p928, @p929, @p930, @p931, @p932, @p933, @p934, @p935, @p936, @p937, @p938, @p939, @p940, @p941, @p942, @p943, @p944, @p945, @p946, @p947, @p948, @p949, @p950, @p951, 16), (@p952, @p953, @p954, @p955, @p956, @p957, @p958, @p959, @p960, @p961, @p962, @p963, @p964, @p965, @p966, @p967, @p968, @p969, @p970, @p971, @p972, @p973, @p974, @p975, @p976, @p977, @p978, @p979, @p980, @p981, @p982, @p983, @p984, @p985, @p986, @p987, @p988, @p989, @p990, @p991, @p992, @p993, @p994, @p995, @p996, @p997, @p998, @p999, @p1000, @p1001, @p1002, @p1003, @p1004, @p1005, @p1006, @p1007, 17), (@p1008, @p1009, @p1010, @p1011, @p1012, @p1013, @p1014, @p1015, @p1016, @p1017, @p1018, @p1019, @p1020, @p1021, @p1022, @p1023, @p1024, @p1025, @p1026, @p1027, @p1028, @p1029, @p1030, @p1031, @p1032, @p1033, @p1034, @p1035, @p1036, @p1037, @p1038, @p1039, @p1040, @p1041, @p1042, @p1043, @p1044, @p1045, @p1046, @p1047, @p1048, @p1049, @p1050, @p1051, @p1052, @p1053, @p1054, @p1055, @p1056, @p1057, @p1058, @p1059, @p1060, @p1061, @p1062, @p1063, 18), (@p1064, @p1065, @p1066, @p1067, @p1068, @p1069, @p1070, @p1071, @p1072, @p1073, @p1074, @p1075, @p1076, @p1077, @p1078, @p1079, @p1080, @p1081, @p1082, @p1083, @p1084, @p1085, @p1086, @p1087, @p1088, @p1089, @p1090, @p1091, @p1092, @p1093, @p1094, @p1095, @p1096, @p1097, @p1098, @p1099, @p1100, @p1101, @p1102, @p1103, @p1104, @p1105, @p1106, @p1107, @p1108, @p1109, @p1110, @p1111, @p1112, @p1113, @p1114, @p1115, @p1116, @p1117, @p1118, @p1119, 19), (@p1120, @p1121, @p1122, @p1123, @p1124, @p1125, @p1126, @p1127, @p1128, @p1129, @p1130, @p1131, @p1132, @p1133, @p1134, @p1135, @p1136, @p1137, @p1138, @p1139, @p1140, @p1141, @p1142, @p1143, @p1144, @p1145, @p1146, @p1147, @p1148, @p1149, @p1150, @p1151, @p1152, @p1153, @p1154, @p1155, @p1156, @p1157, @p1158, @p1159, @p1160, @p1161, @p1162, @p1163, @p1164, @p1165, @p1166, @p1167, @p1168, @p1169, @p1170, @p1171, @p1172, @p1173, @p1174, @p1175, 20), (@p1176, @p1177, @p1178, @p1179, @p1180, @p1181, @p1182, @p1183, @p1184, @p1185, @p1186, @p1187, @p1188, @p1189, @p1190, @p1191, @p1192, @p1193, @p1194, @p1195, @p1196, @p1197, @p1198, @p1199, @p1200, @p1201, @p1202, @p1203, @p1204, @p1205, @p1206, @p1207, @p1208, @p1209, @p1210, @p1211, @p1212, @p1213, @p1214, @p1215, @p1216, @p1217, @p1218, @p1219, @p1220, @p1221, @p1222, @p1223, @p1224, @p1225, @p1226, @p1227, @p1228, @p1229, @p1230, @p1231, 21), (@p1232, @p1233, @p1234, @p1235, @p1236, @p1237, @p1238, @p1239, @p1240, @p1241, @p1242, @p1243, @p1244, @p1245, @p1246, @p1247, @p1248, @p1249, @p1250, @p1251, @p1252, @p1253, @p1254, @p1255, @p1256, @p1257, @p1258, @p1259, @p1260, @p1261, @p1262, @p1263, @p1264, @p1265, @p1266, @p1267, @p1268, @p1269, @p1270, @p1271, @p1272, @p1273, @p1274, @p1275, @p1276, @p1277, @p1278, @p1279, @p1280, @p1281, @p1282, @p1283, @p1284, @p1285, @p1286, @p1287, 22), (@p1288, @p1289, @p1290, @p1291, @p1292, @p1293, @p1294, @p1295, @p1296, @p1297, @p1298, @p1299, @p1300, @p1301, @p1302, @p1303, @p1304, @p1305, @p1306, @p1307, @p1308, @p1309, @p1310, @p1311, @p1312, @p1313, @p1314, @p1315, @p1316, @p1317, @p1318, @p1319, @p1320, @p1321, @p1322, @p1323, @p1324, @p1325, @p1326, @p1327, @p1328, @p1329, @p1330, @p1331, @p1332, @p1333, @p1334, @p1335, @p1336, @p1337, @p1338, @p1339, @p1340, @p1341, @p1342, @p1343, 23), (@p1344, @p1345, @p1346, @p1347, @p1348, @p1349, @p1350, @p1351, @p1352, @p1353, @p1354, @p1355, @p1356, @p1357, @p1358, @p1359, @p1360, @p1361, @p1362, @p1363, @p1364, @p1365, @p1366, @p1367, @p1368, @p1369, @p1370, @p1371, @p1372, @p1373, @p1374, @p1375, @p1376, @p1377, @p1378, @p1379, @p1380, @p1381, @p1382, @p1383, @p1384, @p1385, @p1386, @p1387, @p1388, @p1389, @p1390, @p1391, @p1392, @p1393, @p1394, @p1395, @p1396, @p1397, @p1398, @p1399, 24), (@p1400, @p1401, @p1402, @p1403, @p1404, @p1405, @p1406, @p1407, @p1408, @p1409, @p1410, @p1411, @p1412, @p1413, @p1414, @p1415, @p1416, @p1417, @p1418, @p1419, @p1420, @p1421, @p1422, @p1423, @p1424, @p1425, @p1426, @p1427, @p1428, @p1429, @p1430, @p1431, @p1432, @p1433, @p1434, @p1435, @p1436, @p1437, @p1438, @p1439, @p1440, @p1441, @p1442, @p1443, @p1444, @p1445, @p1446, @p1447, @p1448, @p1449, @p1450, @p1451, @p1452, @p1453, @p1454, @p1455, 25), (@p1456, @p1457, @p1458, @p1459, @p1460, @p1461, @p1462, @p1463, @p1464, @p1465, @p1466, @p1467, @p1468, @p1469, @p1470, @p1471, @p1472, @p1473, @p1474, @p1475, @p1476, @p1477, @p1478, @p1479, @p1480, @p1481, @p1482, @p1483, @p1484, @p1485, @p1486, @p1487, @p1488, @p1489, @p1490, @p1491, @p1492, @p1493, @p1494, @p1495, @p1496, @p1497, @p1498, @p1499, @p1500, @p1501, @p1502, @p1503, @p1504, @p1505, @p1506, @p1507, @p1508, @p1509, @p1510, @p1511, 26), (@p1512, @p1513, @p1514, @p1515, @p1516, @p1517, @p1518, @p1519, @p1520, @p1521, @p1522, @p1523, @p1524, @p1525, @p1526, @p1527, @p1528, @p1529, @p1530, @p1531, @p1532, @p1533, @p1534, @p1535, @p1536, @p1537, @p1538, @p1539, @p1540, @p1541, @p1542, @p1543, @p1544, @p1545, @p1546, @p1547, @p1548, @p1549, @p1550, @p1551, @p1552, @p1553, @p1554, @p1555, @p1556, @p1557, @p1558, @p1559, @p1560, @p1561, @p1562, @p1563, @p1564, @p1565, @p1566, @p1567, 27), (@p1568, @p1569, @p1570, @p1571, @p1572, @p1573, @p1574, @p1575, @p1576, @p1577, @p1578, @p1579, @p1580, @p1581, @p1582, @p1583, @p1584, @p1585, @p1586, @p1587, @p1588, @p1589, @p1590, @p1591, @p1592, @p1593, @p1594, @p1595, @p1596, @p1597, @p1598, @p1599, @p1600, @p1601, @p1602, @p1603, @p1604, @p1605, @p1606, @p1607, @p1608, @p1609, @p1610, @p1611, @p1612, @p1613, @p1614, @p1615, @p1616, @p1617, @p1618, @p1619, @p1620, @p1621, @p1622, @p1623, 28), (@p1624, @p1625, @p1626, @p1627, @p1628, @p1629, @p1630, @p1631, @p1632, @p1633, @p1634, @p1635, @p1636, @p1637, @p1638, @p1639, @p1640, @p1641, @p1642, @p1643, @p1644, @p1645, @p1646, @p1647, @p1648, @p1649, @p1650, @p1651, @p1652, @p1653, @p1654, @p1655, @p1656, @p1657, @p1658, @p1659, @p1660, @p1661, @p1662, @p1663, @p1664, @p1665, @p1666, @p1667, @p1668, @p1669, @p1670, @p1671, @p1672, @p1673, @p1674, @p1675, @p1676, @p1677, @p1678, @p1679, 29), (@p1680, @p1681, @p1682, @p1683, @p1684, @p1685, @p1686, @p1687, @p1688, @p1689, @p1690, @p1691, @p1692, @p1693, @p1694, @p1695, @p1696, @p1697, @p1698, @p1699, @p1700, @p1701, @p1702, @p1703, @p1704, @p1705, @p1706, @p1707, @p1708, @p1709, @p1710, @p1711, @p1712, @p1713, @p1714, @p1715, @p1716, @p1717, @p1718, @p1719, @p1720, @p1721, @p1722, @p1723, @p1724, @p1725, @p1726, @p1727, @p1728, @p1729, @p1730, @p1731, @p1732, @p1733, @p1734, @p1735, 30), (@p1736, @p1737, @p1738, @p1739, @p1740, @p1741, @p1742, @p1743, @p1744, @p1745, @p1746, @p1747, @p1748, @p1749, @p1750, @p1751, @p1752, @p1753, @p1754, @p1755, @p1756, @p1757, @p1758, @p1759, @p1760, @p1761, @p1762, @p1763, @p1764, @p1765, @p1766, @p1767, @p1768, @p1769, @p1770, @p1771, @p1772, @p1773, @p1774, @p1775, @p1776, @p1777, @p1778, @p1779, @p1780, @p1781, @p1782, @p1783, @p1784, @p1785, @p1786, @p1787, @p1788, @p1789, @p1790, @p1791, 31), (@p1792, @p1793, @p1794, @p1795, @p1796, @p1797, @p1798, @p1799, @p1800, @p1801, @p1802, @p1803, @p1804, @p1805, @p1806, @p1807, @p1808, @p1809, @p1810, @p1811, @p1812, @p1813, @p1814, @p1815, @p1816, @p1817, @p1818, @p1819, @p1820, @p1821, @p1822, @p1823, @p1824, @p1825, @p1826, @p1827, @p1828, @p1829, @p1830, @p1831, @p1832, @p1833, @p1834, @p1835, @p1836, @p1837, @p1838, @p1839, @p1840, @p1841, @p1842, @p1843, @p1844, @p1845, @p1846, @p1847, 32), (@p1848, @p1849, @p1850, @p1851, @p1852, @p1853, @p1854, @p1855, @p1856, @p1857, @p1858, @p1859, @p1860, @p1861, @p1862, @p1863, @p1864, @p1865, @p1866, @p1867, @p1868, @p1869, @p1870, @p1871, @p1872, @p1873, @p1874, @p1875, @p1876, @p1877, @p1878, @p1879, @p1880, @p1881, @p1882, @p1883, @p1884, @p1885, @p1886, @p1887, @p1888, @p1889, @p1890, @p1891, @p1892, @p1893, @p1894, @p1895, @p1896, @p1897, @p1898, @p1899, @p1900, @p1901, @p1902, @p1903, 33), (@p1904, @p1905, @p1906, @p1907, @p1908, @p1909, @p1910, @p1911, @p1912, @p1913, @p1914, @p1915, @p1916, @p1917, @p1918, @p1919, @p1920, @p1921, @p1922, @p1923, @p1924, @p1925, @p1926, @p1927, @p1928, @p1929, @p1930, @p1931, @p1932, @p1933, @p1934, @p1935, @p1936, @p1937, @p1938, @p1939, @p1940, @p1941, @p1942, @p1943, @p1944, @p1945, @p1946, @p1947, @p1948, @p1949, @p1950, @p1951, @p1952, @p1953, @p1954, @p1955, @p1956, @p1957, @p1958, @p1959, 34), (@p1960, @p1961, @p1962, @p1963, @p1964, @p1965, @p1966, @p1967, @p1968, @p1969, @p1970, @p1971, @p1972, @p1973, @p1974, @p1975, @p1976, @p1977, @p1978, @p1979, @p1980, @p1981, @p1982, @p1983, @p1984, @p1985, @p1986, @p1987, @p1988, @p1989, @p1990, @p1991, @p1992, @p1993, @p1994, @p1995, @p1996, @p1997, @p1998, @p1999, @p2000, @p2001, @p2002, @p2003, @p2004, @p2005, @p2006, @p2007, @p2008, @p2009, @p2010, @p2011, @p2012, @p2013, @p2014, @p2015, 35), (@p2016, @p2017, @p2018, @p2019, @p2020, @p2021, @p2022, @p2023, @p2024, @p2025, @p2026, @p2027, @p2028, @p2029, @p2030, @p2031, @p2032, @p2033, @p2034, @p2035, @p2036, @p2037, @p2038, @p2039, @p2040, @p2041, @p2042, @p2043, @p2044, @p2045, @p2046, @p2047, @p2048, @p2049, @p2050, @p2051, @p2052, @p2053, @p2054, @p2055, @p2056, @p2057, @p2058, @p2059, @p2060, @p2061, @p2062, @p2063, @p2064, @p2065, @p2066, @p2067, @p2068, @p2069, @p2070, @p2071, 36)) AS i ([addressee_cntry_cd], [addressee_city], [addressee_district], [addressee_email], [addressee_full_address], [addressee_home_address], [addressee_name], [addressee_postcode], [addressee_province], [addressee_subdistrict], [addressee_tel], [create_table], [delivery_code], [delivery_recipient_name], [delivery_relation_id], [delivery_status_id], [dest_outlet_id], [dest_outlet_port], [document_number], [item_barcode], [item_cod], [item_gross_weight], [item_height], [item_length], [item_price], [item_width], [lat], [log_id], [long], [outlet_id], [outlet_port], [podUrl], [remark], [scan_cntry_cd], [scan_cntry_postcode], [sender_cntry_cd], [sender_district], [sender_email], [sender_full_address], [sender_home_address], [member_id], [sender_name], [sender_postcode], [sender_province], [sender_subdistrict], [sender_tel], [server_id], [signatureUrl], [state], [status_code], [status_dtm], [timestamp], [transmit_dtm], [user_id], [wckt_id], [wkstn_no], _Position) ON 1=0 WHEN NOT MATCHED THEN INSERT ([addressee_cntry_cd], [addressee_city], [addressee_district], [addressee_email], [addressee_full_address], [addressee_home_address], [addressee_name], [addressee_postcode], [addressee_province], [addressee_subdistrict], [addressee_tel], [create_table], [delivery_code], [delivery_recipient_name], [delivery_relation_id], [delivery_status_id], [dest_outlet_id], [dest_outlet_port], [document_number], [item_barcode], [item_cod], [item_gross_weight], [item_height], [item_length], [item_price], [item_width], [lat], [log_id], [long], [outlet_id], [outlet_port], [podUrl], [remark], [scan_cntry_cd], [scan_cntry_postcode], [sender_cntry_cd], [sender_district], [sender_email], [sender_full_address], [sender_home_address], [member_id], [sender_name], [sender_postcode], [sender_province], [sender_subdistrict], [sender_tel], [server_id], [signatureUrl], [state], [status_code], [status_dtm], [timestamp], [transmit_dtm], [user_id], [wckt_id], [wkstn_no]) VALUES (i.[addressee_cntry_cd], i.[addressee_city], i.[addressee_district], i.[addressee_email], i.[addressee_full_address], i.[addressee_home_address], i.[addressee_name], i.[addressee_postcode], i.[addressee_province], i.[addressee_subdistrict], i.[addressee_tel], i.[create_table], i.[delivery_code], i.[delivery_recipient_name], i.[delivery_relation_id], i.[delivery_status_id], i.[dest_outlet_id], i.[dest_outlet_port], i.[document_number], i.[item_barcode], i.[item_cod], i.[item_gross_weight], i.[item_height], i.[item_length], i.[item_price], i.[item_width], i.[lat], i.[log_id], i.[long], i.[outlet_id], i.[outlet_port], i.[podUrl], i.[remark], i.[scan_cntry_cd], i.[scan_cntry_postcode], i.[sender_cntry_cd], i.[sender_district], i.[sender_email], i.[sender_full_address], i.[sender_home_address], i.[member_id], i.[sender_name], i.[sender_postcode], i.[sender_province], i.[sender_subdistrict], i.[sender_tel], i.[server_id], i.[signatureUrl], i.[state], i.[status_code], i.[status_dtm], i.[timestamp], i.[transmit_dtm], i.[user_id], i.[wckt_id], i.[wkstn_no]) OUTPUT INSERTED.[item_id], i._Position INTO @inserted0;  SELECT [t].[item_id] FROM [raw_data] t INNER JOIN @inserted0 i ON ([t].[item_id] = [i].[item_id]) ORDER BY [i].[_Position];  ",4,2,2,379,12,1235660
"(@p0 nvarchar(4000),@p1 nvarchar(4000),@p2 nvarchar(4000),@p3 nvarchar(4000),@p4 nvarchar(4000),@p5 nvarchar(4000),@p6 nvarchar(4000),@p7 nvarchar(4000),@p8 nvarchar(4000),@p9 nvarchar(4000),@p10 nvarchar(4000),@p11 datetime2(7),@p12 nvarchar(4000),@p13 nvarchar(4000),@p14 int,@p15 int,@p16 int,@p17 nvarchar(4000),@p18 nvarchar(4000),@p19 nvarchar(4000),@p20 nvarchar(4000),@p21 decimal(18,2),@p22 nvarchar(4000),@p23 nvarchar(4000),@p24 decimal(18,2),@p25 nvarchar(4000),@p26 nvarchar(4000),@p27 nvarchar(4000),@p28 nvarchar(4000),@p29 int,@p30 nvarchar(4000),@p31 nvarchar(4000),@p32 nvarchar(4000),@p33 nvarchar(4000),@p34 nvarchar(4000),@p35 nvarchar(4000),@p36 nvarchar(4000),@p37 nvarchar(4000),@p38 nvarchar(4000),@p39 nvarchar(4000),@p40 int,@p41 nvarchar(4000),@p42 nvarchar(4000),@p43 nvarchar(4000),@p44 nvarchar(4000),@p45 nvarchar(4000),@p46 int,@p47 nvarchar(4000),@p48 int,@p49 int,@p50 datetime2(7),@p51 datetime2(7),@p52 datetime2(7),@p53 nvarchar(4000),@p54 nvarchar(4000),@p55 nvarchar(4000),@p56 nvarchar(4000),@p57 nvarchar(4000),@p58 nvarchar(4000),@p59 nvarchar(4000),@p60 nvarchar(4000),@p61 nvarchar(4000),@p62 nvarchar(4000),@p63 nvarchar(4000),@p64 nvarchar(4000),@p65 nvarchar(4000),@p66 nvarchar(4000),@p67 datetime2(7),@p68 nvarchar(4000),@p69 nvarchar(4000),@p70 int,@p71 int,@p72 int,@p73 nvarchar(4000),@p74 nvarchar(4000),@p75 nvarchar(4000),@p76 nvarchar(4000),@p77 decimal(18,2),@p78 nvarchar(4000),@p79 nvarchar(4000),@p80 decimal(18,2),@p81 nvarchar(4000),@p82 nvarchar(4000),@p83 nvarchar(4000),@p84 nvarchar(4000),@p85 int,@p86 nvarchar(4000),@p87 nvarchar(4000),@p88 nvarchar(4000),@p89 nvarchar(4000),@p90 nvarchar(4000),@p91 nvarchar(4000),@p92 nvarchar(4000),@p93 nvarchar(4000),@p94 nvarchar(4000),@p95 nvarchar(4000),@p96 int,@p97 nvarchar(4000),@p98 nvarchar(4000),@p99 nvarchar(4000),@p100 nvarchar(4000),@p101 nvarchar(4000),@p102 int,@p103 nvarchar(4000),@p104 int,@p105 int,@p106 datetime2(7),@p107 datetime2(7),@p108 datetime2(7),@p109 nvarchar(4000),@p110 nvarchar(4000),@p111 nvarchar(4000),@p112 nvarchar(4000),@p113 nvarchar(4000),@p114 nvarchar(4000),@p115 nvarchar(4000),@p116 nvarchar(4000),@p117 nvarchar(4000),@p118 nvarchar(4000),@p119 nvarchar(4000),@p120 nvarchar(4000),@p121 nvarchar(4000),@p122 nvarchar(4000),@p123 datetime2(7),@p124 nvarchar(4000),@p125 nvarchar(4000),@p126 int,@p127 int,@p128 int,@p129 nvarchar(4000),@p130 nvarchar(4000),@p131 nvarchar(4000),@p132 decimal(18,2),@p133 decimal(18,2),@p134 nvarchar(4000),@p135 nvarchar(4000),@p136 decimal(18,2),@p137 nvarchar(4000),@p138 nvarchar(4000),@p139 nvarchar(4000),@p140 nvarchar(4000),@p141 int,@p142 nvarchar(4000),@p143 nvarchar(4000),@p144 nvarchar(4000),@p145 nvarchar(4000),@p146 nvarchar(4000),@p147 nvarchar(4000),@p148 nvarchar(4000),@p149 nvarchar(4000),@p150 nvarchar(4000),@p151 nvarchar(4000),@p152 int,@p153 nvarchar(4000),@p154 nvarchar(4000),@p155 nvarchar(4000),@p156 nvarchar(4000),@p157 nvarchar(4000),@p158 int,@p159 nvarchar(4000),@p160 int,@p161 int,@p162 datetime2(7),@p163 datetime2(7),@p164 datetime2(7),@p165 nvarchar(4000),@p166 nvarchar(4000),@p167 nvarchar(4000),@p168 nvarchar(4000),@p169 nvarchar(4000),@p170 nvarchar(4000),@p171 nvarchar(4000),@p172 nvarchar(4000),@p173 nvarchar(4000),@p174 nvarchar(4000),@p175 nvarchar(4000),@p176 nvarchar(4000),@p177 nvarchar(4000),@p178 nvarchar(4000),@p179 datetime2(7),@p180 nvarchar(4000),@p181 nvarchar(4000),@p182 int,@p183 int,@p184 int,@p185 nvarchar(4000),@p186 nvarchar(4000),@p187 nvarchar(4000),@p188 nvarchar(4000),@p189 decimal(18,2),@p190 nvarchar(4000),@p191 nvarchar(4000),@p192 decimal(18,2),@p193 nvarchar(4000),@p194 nvarchar(4000),@p195 nvarchar(4000),@p196 nvarchar(4000),@p197 int,@p198 nvarchar(4000),@p199 nvarchar(4000),@p200 nvarchar(4000),@p201 nvarchar(4000),@p202 nvarchar(4000),@p203 nvarchar(4000),@p204 nvarchar(4000),@p205 nvarchar(4000),@p206 nvarchar(4000),@p207 nvarchar(4000),@p208 int,@p209 nvarchar(4000),@p210 nvarchar(4000),@p211 nvarchar(4000),@p212 nvarchar(4000),@p213 nvarchar(4000),@p214 int,@p215 nvarchar(4000),@p216 int,@p217 int,@p218 datetime2(7),@p219 datetime2(7),@p220 datetime2(7),@p221 nvarchar(4000),@p222 nvarchar(4000),@p223 nvarchar(4000),@p224 nvarchar(4000),@p225 nvarchar(4000),@p226 nvarchar(4000),@p227 nvarchar(4000),@p228 nvarchar(4000),@p229 nvarchar(4000),@p230 nvarchar(4000),@p231 nvarchar(4000),@p232 nvarchar(4000),@p233 nvarchar(4000),@p234 nvarchar(4000),@p235 datetime2(7),@p236 nvarchar(4000),@p237 nvarchar(4000),@p238 int,@p239 int,@p240 int,@p241 nvarchar(4000),@p242 nvarchar(4000),@p243 nvarchar(4000),@p244 decimal(18,2),@p245 decimal(18,2),@p246 nvarchar(4000),@p247 nvarchar(4000),@p248 decimal(18,2),@p249 nvarchar(4000),@p250 nvarchar(4000),@p251 nvarchar(4000),@p252 nvarchar(4000),@p253 int,@p254 nvarchar(4000),@p255 nvarchar(4000),@p256 nvarchar(4000),@p257 nvarchar(4000),@p258 nvarchar(4000),@p259 nvarchar(4000),@p260 nvarchar(4000),@p261 nvarchar(4000),@p262 nvarchar(4000),@p263 nvarchar(4000),@p264 int,@p265 nvarchar(4000),@p266 nvarchar(4000),@p267 nvarchar(4000),@p268 nvarchar(4000),@p269 nvarchar(4000),@p270 int,@p271 nvarchar(4000),@p272 int,@p273 int,@p274 datetime2(7),@p275 datetime2(7),@p276 datetime2(7),@p277 nvarchar(4000),@p278 nvarchar(4000),@p279 nvarchar(4000),@p280 nvarchar(4000),@p281 nvarchar(4000),@p282 nvarchar(4000),@p283 nvarchar(4000),@p284 nvarchar(4000),@p285 nvarchar(4000),@p286 nvarchar(4000),@p287 nvarchar(4000),@p288 nvarchar(4000),@p289 nvarchar(4000),@p290 nvarchar(4000),@p291 datetime2(7),@p292 nvarchar(4000),@p293 nvarchar(4000),@p294 int,@p295 int,@p296 int,@p297 nvarchar(4000),@p298 nvarchar(4000),@p299 nvarchar(4000),@p300 nvarchar(4000),@p301 decimal(18,2),@p302 nvarchar(4000),@p303 nvarchar(4000),@p304 decimal(18,2),@p305 nvarchar(4000),@p306 nvarchar(4000),@p307 nvarchar(4000),@p308 nvarchar(4000),@p309 int,@p310 nvarchar(4000),@p311 nvarchar(4000),@p312 nvarchar(4000),@p313 nvarchar(4000),@p314 nvarchar(4000),@p315 nvarchar(4000),@p316 nvarchar(4000),@p317 nvarchar(4000),@p318 nvarchar(4000),@p319 nvarchar(4000),@p320 int,@p321 nvarchar(4000),@p322 nvarchar(4000),@p323 nvarchar(4000),@p324 nvarchar(4000),@p325 nvarchar(4000),@p326 int,@p327 nvarchar(4000),@p328 int,@p329 int,@p330 datetime2(7),@p331 datetime2(7),@p332 datetime2(7),@p333 nvarchar(4000),@p334 nvarchar(4000),@p335 nvarchar(4000),@p336 nvarchar(4000),@p337 nvarchar(4000),@p338 nvarchar(4000),@p339 nvarchar(4000),@p340 nvarchar(4000),@p341 nvarchar(4000),@p342 nvarchar(4000),@p343 nvarchar(4000),@p344 nvarchar(4000),@p345 nvarchar(4000),@p346 nvarchar(4000),@p347 datetime2(7),@p348 nvarchar(4000),@p349 nvarchar(4000),@p350 int,@p351 int,@p352 int,@p353 nvarchar(4000),@p354 nvarchar(4000),@p355 nvarchar(4000),@p356 decimal(18,2),@p357 decimal(18,2),@p358 nvarchar(4000),@p359 nvarchar(4000),@p360 decimal(18,2),@p361 nvarchar(4000),@p362 nvarchar(4000),@p363 nvarchar(4000),@p364 nvarchar(4000),@p365 int,@p366 nvarchar(4000),@p367 nvarchar(4000),@p368 nvarchar(4000),@p369 nvarchar(4000),@p370 nvarchar(4000),@p371 nvarchar(4000),@p372 nvarchar(4000),@p373 nvarchar(4000),@p374 nvarchar(4000),@p375 nvarchar(4000),@p376 int,@p377 nvarchar(4000),@p378 nvarchar(4000),@p379 nvarchar(4000),@p380 nvarchar(4000),@p381 nvarchar(4000),@p382 int,@p383 nvarchar(4000),@p384 int,@p385 int,@p386 datetime2(7),@p387 datetime2(7),@p388 datetime2(7),@p389 nvarchar(4000),@p390 nvarchar(4000),@p391 nvarchar(4000),@p392 nvarchar(4000),@p393 nvarchar(4000),@p394 nvarchar(4000),@p395 nvarchar(4000),@p396 nvarchar(4000),@p397 nvarchar(4000),@p398 nvarchar(4000),@p399 nvarchar(4000),@p400 nvarchar(4000),@p401 nvarchar(4000),@p402 nvarchar(4000),@p403 datetime2(7),@p404 nvarchar(4000),@p405 nvarchar(4000),@p406 int,@p407 int,@p408 int,@p409 nvarchar(4000),@p410 nvarchar(4000),@p411 nvarchar(4000),@p412 nvarchar(4000),@p413 decimal(18,2),@p414 nvarchar(4000),@p415 nvarchar(4000),@p416 decimal(18,2),@p417 nvarchar(4000),@p418 nvarchar(4000),@p419 nvarchar(4000),@p420 nvarchar(4000),@p421 int,@p422 nvarchar(4000),@p423 nvarchar(4000),@p424 nvarchar(4000),@p425 nvarchar(4000),@p426 nvarchar(4000),@p427 nvarchar(4000),@p428 nvarchar(4000),@p429 nvarchar(4000),@p430 nvarchar(4000),@p431 nvarchar(4000),@p432 int,@p433 nvarchar(4000),@p434 nvarchar(4000),@p435 nvarchar(4000),@p436 nvarchar(4000),@p437 nvarchar(4000),@p438 int,@p439 nvarchar(4000),@p440 int,@p441 int,@p442 datetime2(7),@p443 datetime2(7),@p444 datetime2(7),@p445 nvarchar(4000),@p446 nvarchar(4000),@p447 nvarchar(4000),@p448 nvarchar(4000),@p449 nvarchar(4000),@p450 nvarchar(4000),@p451 nvarchar(4000),@p452 nvarchar(4000),@p453 nvarchar(4000),@p454 nvarchar(4000),@p455 nvarchar(4000),@p456 nvarchar(4000),@p457 nvarchar(4000),@p458 nvarchar(4000),@p459 datetime2(7),@p460 nvarchar(4000),@p461 nvarchar(4000),@p462 int,@p463 int,@p464 int,@p465 nvarchar(4000),@p466 nvarchar(4000),@p467 nvarchar(4000),@p468 decimal(18,2),@p469 decimal(18,2),@p470 nvarchar(4000),@p471 nvarchar(4000),@p472 decimal(18,2),@p473 nvarchar(4000),@p474 nvarchar(4000),@p475 nvarchar(4000),@p476 nvarchar(4000),@p477 int,@p478 nvarchar(4000),@p479 nvarchar(4000),@p480 nvarchar(4000),@p481 nvarchar(4000),@p482 nvarchar(4000),@p483 nvarchar(4000),@p484 nvarchar(4000),@p485 nvarchar(4000),@p486 nvarchar(4000),@p487 nvarchar(4000),@p488 int,@p489 nvarchar(4000),@p490 nvarchar(4000),@p491 nvarchar(4000),@p492 nvarchar(4000),@p493 nvarchar(4000),@p494 int,@p495 nvarchar(4000),@p496 int,@p497 int,@p498 datetime2(7),@p499 datetime2(7),@p500 datetime2(7),@p501 nvarchar(4000),@p502 nvarchar(4000),@p503 nvarchar(4000),@p504 nvarchar(4000),@p505 nvarchar(4000),@p506 nvarchar(4000),@p507 nvarchar(4000),@p508 nvarchar(4000),@p509 nvarchar(4000),@p510 nvarchar(4000),@p511 nvarchar(4000),@p512 nvarchar(4000),@p513 nvarchar(4000),@p514 nvarchar(4000),@p515 datetime2(7),@p516 nvarchar(4000),@p517 nvarchar(4000),@p518 int,@p519 int,@p520 int,@p521 nvarchar(4000),@p522 nvarchar(4000),@p523 nvarchar(4000),@p524 nvarchar(4000),@p525 decimal(18,2),@p526 nvarchar(4000),@p527 nvarchar(4000),@p528 decimal(18,2),@p529 nvarchar(4000),@p530 nvarchar(4000),@p531 nvarchar(4000),@p532 nvarchar(4000),@p533 int,@p534 nvarchar(4000),@p535 nvarchar(4000),@p536 nvarchar(4000),@p537 nvarchar(4000),@p538 nvarchar(4000),@p539 nvarchar(4000),@p540 nvarchar(4000),@p541 nvarchar(4000),@p542 nvarchar(4000),@p543 nvarchar(4000),@p544 int,@p545 nvarchar(4000),@p546 nvarchar(4000),@p547 nvarchar(4000),@p548 nvarchar(4000),@p549 nvarchar(4000),@p550 int,@p551 nvarchar(4000),@p552 int,@p553 int,@p554 datetime2(7),@p555 datetime2(7),@p556 datetime2(7),@p557 nvarchar(4000),@p558 nvarchar(4000),@p559 nvarchar(4000),@p560 nvarchar(4000),@p561 nvarchar(4000),@p562 nvarchar(4000),@p563 nvarchar(4000),@p564 nvarchar(4000),@p565 nvarchar(4000),@p566 nvarchar(4000),@p567 nvarchar(4000),@p568 nvarchar(4000),@p569 nvarchar(4000),@p570 nvarchar(4000),@p571 datetime2(7),@p572 nvarchar(4000),@p573 nvarchar(4000),@p574 int,@p575 int,@p576 int,@p577 nvarchar(4000),@p578 nvarchar(4000),@p579 nvarchar(4000),@p580 decimal(18,2),@p581 decimal(18,2),@p582 nvarchar(4000),@p583 nvarchar(4000),@p584 decimal(18,2),@p585 nvarchar(4000),@p586 nvarchar(4000),@p587 nvarchar(4000),@p588 nvarchar(4000),@p589 int,@p590 nvarchar(4000),@p591 nvarchar(4000),@p592 nvarchar(4000),@p593 nvarchar(4000),@p594 nvarchar(4000),@p595 nvarchar(4000),@p596 nvarchar(4000),@p597 nvarchar(4000),@p598 nvarchar(4000),@p599 nvarchar(4000),@p600 int,@p601 nvarchar(4000),@p602 nvarchar(4000),@p603 nvarchar(4000),@p604 nvarchar(4000),@p605 nvarchar(4000),@p606 int,@p607 nvarchar(4000),@p608 int,@p609 int,@p610 datetime2(7),@p611 datetime2(7),@p612 datetime2(7),@p613 nvarchar(4000),@p614 nvarchar(4000),@p615 nvarchar(4000),@p616 nvarchar(4000),@p617 nvarchar(4000),@p618 nvarchar(4000),@p619 nvarchar(4000),@p620 nvarchar(4000),@p621 nvarchar(4000),@p622 nvarchar(4000),@p623 nvarchar(4000),@p624 nvarchar(4000),@p625 nvarchar(4000),@p626 nvarchar(4000),@p627 datetime2(7),@p628 nvarchar(4000),@p629 nvarchar(4000),@p630 int,@p631 int,@p632 int,@p633 nvarchar(4000),@p634 nvarchar(4000),@p635 nvarchar(4000),@p636 nvarchar(4000),@p637 decimal(18,2),@p638 nvarchar(4000),@p639 nvarchar(4000),@p640 decimal(18,2),@p641 nvarchar(4000),@p642 nvarchar(4000),@p643 nvarchar(4000),@p644 nvarchar(4000),@p645 int,@p646 nvarchar(4000),@p647 nvarchar(4000),@p648 nvarchar(4000),@p649 nvarchar(4000),@p650 nvarchar(4000),@p651 nvarchar(4000),@p652 nvarchar(4000),@p653 nvarchar(4000),@p654 nvarchar(4000),@p655 nvarchar(4000),@p656 int,@p657 nvarchar(4000),@p658 nvarchar(4000),@p659 nvarchar(4000),@p660 nvarchar(4000),@p661 nvarchar(4000),@p662 int,@p663 nvarchar(4000),@p664 int,@p665 int,@p666 datetime2(7),@p667 datetime2(7),@p668 datetime2(7),@p669 nvarchar(4000),@p670 nvarchar(4000),@p671 nvarchar(4000),@p672 nvarchar(4000),@p673 nvarchar(4000),@p674 nvarchar(4000),@p675 nvarchar(4000),@p676 nvarchar(4000),@p677 nvarchar(4000),@p678 nvarchar(4000),@p679 nvarchar(4000),@p680 nvarchar(4000),@p681 nvarchar(4000),@p682 nvarchar(4000),@p683 datetime2(7),@p684 nvarchar(4000),@p685 nvarchar(4000),@p686 int,@p687 int,@p688 int,@p689 nvarchar(4000),@p690 nvarchar(4000),@p691 nvarchar(4000),@p692 decimal(18,2),@p693 decimal(18,2),@p694 nvarchar(4000),@p695 nvarchar(4000),@p696 decimal(18,2),@p697 nvarchar(4000),@p698 nvarchar(4000),@p699 nvarchar(4000),@p700 nvarchar(4000),@p701 int,@p702 nvarchar(4000),@p703 nvarchar(4000),@p704 nvarchar(4000),@p705 nvarchar(4000),@p706 nvarchar(4000),@p707 nvarchar(4000),@p708 nvarchar(4000),@p709 nvarchar(4000),@p710 nvarchar(4000),@p711 nvarchar(4000),@p712 int,@p713 nvarchar(4000),@p714 nvarchar(4000),@p715 nvarchar(4000),@p716 nvarchar(4000),@p717 nvarchar(4000),@p718 int,@p719 nvarchar(4000),@p720 int,@p721 int,@p722 datetime2(7),@p723 datetime2(7),@p724 datetime2(7),@p725 nvarchar(4000),@p726 nvarchar(4000),@p727 nvarchar(4000),@p728 nvarchar(4000),@p729 nvarchar(4000),@p730 nvarchar(4000),@p731 nvarchar(4000),@p732 nvarchar(4000),@p733 nvarchar(4000),@p734 nvarchar(4000),@p735 nvarchar(4000),@p736 nvarchar(4000),@p737 nvarchar(4000),@p738 nvarchar(4000),@p739 datetime2(7),@p740 nvarchar(4000),@p741 nvarchar(4000),@p742 int,@p743 int,@p744 int,@p745 nvarchar(4000),@p746 nvarchar(4000),@p747 nvarchar(4000),@p748 nvarchar(4000),@p749 decimal(18,2),@p750 nvarchar(4000),@p751 nvarchar(4000),@p752 decimal(18,2),@p753 nvarchar(4000),@p754 nvarchar(4000),@p755 nvarchar(4000),@p756 nvarchar(4000),@p757 int,@p758 nvarchar(4000),@p759 nvarchar(4000),@p760 nvarchar(4000),@p761 nvarchar(4000),@p762 nvarchar(4000),@p763 nvarchar(4000),@p764 nvarchar(4000),@p765 nvarchar(4000),@p766 nvarchar(4000),@p767 nvarchar(4000),@p768 int,@p769 nvarchar(4000),@p770 nvarchar(4000),@p771 nvarchar(4000),@p772 nvarchar(4000),@p773 nvarchar(4000),@p774 int,@p775 nvarchar(4000),@p776 int,@p777 int,@p778 datetime2(7),@p779 datetime2(7),@p780 datetime2(7),@p781 nvarchar(4000),@p782 nvarchar(4000),@p783 nvarchar(4000),@p784 nvarchar(4000),@p785 nvarchar(4000),@p786 nvarchar(4000),@p787 nvarchar(4000),@p788 nvarchar(4000),@p789 nvarchar(4000),@p790 nvarchar(4000),@p791 nvarchar(4000),@p792 nvarchar(4000),@p793 nvarchar(4000),@p794 nvarchar(4000),@p795 datetime2(7),@p796 nvarchar(4000),@p797 nvarchar(4000),@p798 int,@p799 int,@p800 int,@p801 nvarchar(4000),@p802 nvarchar(4000),@p803 nvarchar(4000),@p804 nvarchar(4000),@p805 decimal(18,2),@p806 nvarchar(4000),@p807 nvarchar(4000),@p808 decimal(18,2),@p809 nvarchar(4000),@p810 nvarchar(4000),@p811 nvarchar(4000),@p812 nvarchar(4000),@p813 int,@p814 nvarchar(4000),@p815 nvarchar(4000),@p816 nvarchar(4000),@p817 nvarchar(4000),@p818 nvarchar(4000),@p819 nvarchar(4000),@p820 nvarchar(4000),@p821 nvarchar(4000),@p822 nvarchar(4000),@p823 nvarchar(4000),@p824 int,@p825 nvarchar(4000),@p826 nvarchar(4000),@p827 nvarchar(4000),@p828 nvarchar(4000),@p829 nvarchar(4000),@p830 int,@p831 nvarchar(4000),@p832 int,@p833 int,@p834 datetime2(7),@p835 datetime2(7),@p836 datetime2(7),@p837 nvarchar(4000),@p838 nvarchar(4000),@p839 nvarchar(4000),@p840 nvarchar(4000),@p841 nvarchar(4000),@p842 nvarchar(4000),@p843 nvarchar(4000),@p844 nvarchar(4000),@p845 nvarchar(4000),@p846 nvarchar(4000),@p847 nvarchar(4000),@p848 nvarchar(4000),@p849 nvarchar(4000),@p850 nvarchar(4000),@p851 datetime2(7),@p852 nvarchar(4000),@p853 nvarchar(4000),@p854 int,@p855 int,@p856 int,@p857 nvarchar(4000),@p858 nvarchar(4000),@p859 nvarchar(4000),@p860 decimal(18,2),@p861 decimal(18,2),@p862 nvarchar(4000),@p863 nvarchar(4000),@p864 decimal(18,2),@p865 nvarchar(4000),@p866 nvarchar(4000),@p867 nvarchar(4000),@p868 nvarchar(4000),@p869 int,@p870 nvarchar(4000),@p871 nvarchar(4000),@p872 nvarchar(4000),@p873 nvarchar(4000),@p874 nvarchar(4000),@p875 nvarchar(4000),@p876 nvarchar(4000),@p877 nvarchar(4000),@p878 nvarchar(4000),@p879 nvarchar(4000),@p880 int,@p881 nvarchar(4000),@p882 nvarchar(4000),@p883 nvarchar(4000),@p884 nvarchar(4000),@p885 nvarchar(4000),@p886 int,@p887 nvarchar(4000),@p888 int,@p889 int,@p890 datetime2(7),@p891 datetime2(7),@p892 datetime2(7),@p893 nvarchar(4000),@p894 nvarchar(4000),@p895 nvarchar(4000),@p896 nvarchar(4000),@p897 nvarchar(4000),@p898 nvarchar(4000),@p899 nvarchar(4000),@p900 nvarchar(4000),@p901 nvarchar(4000),@p902 nvarchar(4000),@p903 nvarchar(4000),@p904 nvarchar(4000),@p905 nvarchar(4000),@p906 nvarchar(4000),@p907 datetime2(7),@p908 nvarchar(4000),@p909 nvarchar(4000),@p910 int,@p911 int,@p912 int,@p913 nvarchar(4000),@p914 nvarchar(4000),@p915 nvarchar(4000),@p916 decimal(18,2),@p917 decimal(18,2),@p918 nvarchar(4000),@p919 nvarchar(4000),@p920 decimal(18,2),@p921 nvarchar(4000),@p922 nvarchar(4000),@p923 nvarchar(4000),@p924 nvarchar(4000),@p925 int,@p926 nvarchar(4000),@p927 nvarchar(4000),@p928 nvarchar(4000),@p929 nvarchar(4000),@p930 nvarchar(4000),@p931 nvarchar(4000),@p932 nvarchar(4000),@p933 nvarchar(4000),@p934 nvarchar(4000),@p935 nvarchar(4000),@p936 int,@p937 nvarchar(4000),@p938 nvarchar(4000),@p939 nvarchar(4000),@p940 nvarchar(4000),@p941 nvarchar(4000),@p942 int,@p943 nvarchar(4000),@p944 int,@p945 int,@p946 datetime2(7),@p947 datetime2(7),@p948 datetime2(7),@p949 nvarchar(4000),@p950 nvarchar(4000),@p951 nvarchar(4000),@p952 nvarchar(4000),@p953 nvarchar(4000),@p954 nvarchar(4000),@p955 nvarchar(4000),@p956 nvarchar(4000),@p957 nvarchar(4000),@p958 nvarchar(4000),@p959 nvarchar(4000),@p960 nvarchar(4000),@p961 nvarchar(4000),@p962 nvarchar(4000),@p963 datetime2(7),@p964 nvarchar(4000),@p965 nvarchar(4000),@p966 int,@p967 int,@p968 int,@p969 nvarchar(4000),@p970 nvarchar(4000),@p971 nvarchar(4000),@p972 nvarchar(4000),@p973 decimal(18,2),@p974 nvarchar(4000),@p975 nvarchar(4000),@p976 decimal(18,2),@p977 nvarchar(4000),@p978 nvarchar(4000),@p979 nvarchar(4000),@p980 nvarchar(4000),@p981 int,@p982 nvarchar(4000),@p983 nvarchar(4000),@p984 nvarchar(4000),@p985 nvarchar(4000),@p986 nvarchar(4000),@p987 nvarchar(4000),@p988 nvarchar(4000),@p989 nvarchar(4000),@p990 nvarchar(4000),@p991 nvarchar(4000),@p992 int,@p993 nvarchar(4000),@p994 nvarchar(4000),@p995 nvarchar(4000),@p996 nvarchar(4000),@p997 nvarchar(4000),@p998 int,@p999 nvarchar(4000),@p1000 int,@p1001 int,@p1002 datetime2(7),@p1003 datetime2(7),@p1004 datetime2(7),@p1005 nvarchar(4000),@p1006 nvarchar(4000),@p1007 nvarchar(4000),@p1008 nvarchar(4000),@p1009 nvarchar(4000),@p1010 nvarchar(4000),@p1011 nvarchar(4000),@p1012 nvarchar(4000),@p1013 nvarchar(4000),@p1014 nvarchar(4000),@p1015 nvarchar(4000),@p1016 nvarchar(4000),@p1017 nvarchar(4000),@p1018 nvarchar(4000),@p1019 datetime2(7),@p1020 nvarchar(4000),@p1021 nvarchar(4000),@p1022 int,@p1023 int,@p1024 int,@p1025 nvarchar(4000),@p1026 nvarchar(4000),@p1027 nvarchar(4000),@p1028 decimal(18,2),@p1029 decimal(18,2),@p1030 nvarchar(4000),@p1031 nvarchar(4000),@p1032 decimal(18,2),@p1033 nvarchar(4000),@p1034 nvarchar(4000),@p1035 nvarchar(4000),@p1036 nvarchar(4000),@p1037 int,@p1038 nvarchar(4000),@p1039 nvarchar(4000),@p1040 nvarchar(4000),@p1041 nvarchar(4000),@p1042 nvarchar(4000),@p1043 nvarchar(4000),@p1044 nvarchar(4000),@p1045 nvarchar(4000),@p1046 nvarchar(4000),@p1047 nvarchar(4000),@p1048 int,@p1049 nvarchar(4000),@p1050 nvarchar(4000),@p1051 nvarchar(4000),@p1052 nvarchar(4000),@p1053 nvarchar(4000),@p1054 int,@p1055 nvarchar(4000),@p1056 int,@p1057 int,@p1058 datetime2(7),@p1059 datetime2(7),@p1060 datetime2(7),@p1061 nvarchar(4000),@p1062 nvarchar(4000),@p1063 nvarchar(4000),@p1064 nvarchar(4000),@p1065 nvarchar(4000),@p1066 nvarchar(4000),@p1067 nvarchar(4000),@p1068 nvarchar(4000),@p1069 nvarchar(4000),@p1070 nvarchar(4000),@p1071 nvarchar(4000),@p1072 nvarchar(4000),@p1073 nvarchar(4000),@p1074 nvarchar(4000),@p1075 datetime2(7),@p1076 nvarchar(4000),@p1077 nvarchar(4000),@p1078 int,@p1079 int,@p1080 int,@p1081 nvarchar(4000),@p1082 nvarchar(4000),@p1083 nvarchar(4000),@p1084 nvarchar(4000),@p1085 decimal(18,2),@p1086 nvarchar(4000),@p1087 nvarchar(4000),@p1088 decimal(18,2),@p1089 nvarchar(4000),@p1090 nvarchar(4000),@p1091 nvarchar(4000),@p1092 nvarchar(4000),@p1093 int,@p1094 nvarchar(4000),@p1095 nvarchar(4000),@p1096 nvarchar(4000),@p1097 nvarchar(4000),@p1098 nvarchar(4000),@p1099 nvarchar(4000),@p1100 nvarchar(4000),@p1101 nvarchar(4000),@p1102 nvarchar(4000),@p1103 nvarchar(4000),@p1104 int,@p1105 nvarchar(4000),@p1106 nvarchar(4000),@p1107 nvarchar(4000),@p1108 nvarchar(4000),@p1109 nvarchar(4000),@p1110 int,@p1111 nvarchar(4000),@p1112 int,@p1113 int,@p1114 datetime2(7),@p1115 datetime2(7),@p1116 datetime2(7),@p1117 nvarchar(4000),@p1118 nvarchar(4000),@p1119 nvarchar(4000),@p1120 nvarchar(4000),@p1121 nvarchar(4000),@p1122 nvarchar(4000),@p1123 nvarchar(4000),@p1124 nvarchar(4000),@p1125 nvarchar(4000),@p1126 nvarchar(4000),@p1127 nvarchar(4000),@p1128 nvarchar(4000),@p1129 nvarchar(4000),@p1130 nvarchar(4000),@p1131 datetime2(7),@p1132 nvarchar(4000),@p1133 nvarchar(4000),@p1134 int,@p1135 int,@p1136 int,@p1137 nvarchar(4000),@p1138 nvarchar(4000),@p1139 nvarchar(4000),@p1140 nvarchar(4000),@p1141 decimal(18,2),@p1142 nvarchar(4000),@p1143 nvarchar(4000),@p1144 decimal(18,2),@p1145 nvarchar(4000),@p1146 nvarchar(4000),@p1147 nvarchar(4000),@p1148 nvarchar(4000),@p1149 int,@p1150 nvarchar(4000),@p1151 nvarchar(4000),@p1152 nvarchar(4000),@p1153 nvarchar(4000),@p1154 nvarchar(4000),@p1155 nvarchar(4000),@p1156 nvarchar(4000),@p1157 nvarchar(4000),@p1158 nvarchar(4000),@p1159 nvarchar(4000),@p1160 int,@p1161 nvarchar(4000),@p1162 nvarchar(4000),@p1163 nvarchar(4000),@p1164 nvarchar(4000),@p1165 nvarchar(4000),@p1166 int,@p1167 nvarchar(4000),@p1168 int,@p1169 int,@p1170 datetime2(7),@p1171 datetime2(7),@p1172 datetime2(7),@p1173 nvarchar(4000),@p1174 nvarchar(4000),@p1175 nvarchar(4000),@p1176 nvarchar(4000),@p1177 nvarchar(4000),@p1178 nvarchar(4000),@p1179 nvarchar(4000),@p1180 nvarchar(4000),@p1181 nvarchar(4000),@p1182 nvarchar(4000),@p1183 nvarchar(4000),@p1184 nvarchar(4000),@p1185 nvarchar(4000),@p1186 nvarchar(4000),@p1187 datetime2(7),@p1188 nvarchar(4000),@p1189 nvarchar(4000),@p1190 int,@p1191 int,@p1192 int,@p1193 nvarchar(4000),@p1194 nvarchar(4000),@p1195 nvarchar(4000),@p1196 decimal(18,2),@p1197 decimal(18,2),@p1198 nvarchar(4000),@p1199 nvarchar(4000),@p1200 decimal(18,2),@p1201 nvarchar(4000),@p1202 nvarchar(4000),@p1203 nvarchar(4000),@p1204 nvarchar(4000),@p1205 int,@p1206 nvarchar(4000),@p1207 nvarchar(4000),@p1208 nvarchar(4000),@p1209 nvarchar(4000),@p1210 nvarchar(4000),@p1211 nvarchar(4000),@p1212 nvarchar(4000),@p1213 nvarchar(4000),@p1214 nvarchar(4000),@p1215 nvarchar(4000),@p1216 int,@p1217 nvarchar(4000),@p1218 nvarchar(4000),@p1219 nvarchar(4000),@p1220 nvarchar(4000),@p1221 nvarchar(4000),@p1222 int,@p1223 nvarchar(4000),@p1224 int,@p1225 int,@p1226 datetime2(7),@p1227 datetime2(7),@p1228 datetime2(7),@p1229 nvarchar(4000),@p1230 nvarchar(4000),@p1231 nvarchar(4000),@p1232 nvarchar(4000),@p1233 nvarchar(4000),@p1234 nvarchar(4000),@p1235 nvarchar(4000),@p1236 nvarchar(4000),@p1237 nvarchar(4000),@p1238 nvarchar(4000),@p1239 nvarchar(4000),@p1240 nvarchar(4000),@p1241 nvarchar(4000),@p1242 nvarchar(4000),@p1243 datetime2(7),@p1244 nvarchar(4000),@p1245 nvarchar(4000),@p1246 int,@p1247 int,@p1248 int,@p1249 nvarchar(4000),@p1250 nvarchar(4000),@p1251 nvarchar(4000),@p1252 nvarchar(4000),@p1253 decimal(18,2),@p1254 nvarchar(4000),@p1255 nvarchar(4000),@p1256 decimal(18,2),@p1257 nvarchar(4000),@p1258 nvarchar(4000),@p1259 nvarchar(4000),@p1260 nvarchar(4000),@p1261 int,@p1262 nvarchar(4000),@p1263 nvarchar(4000),@p1264 nvarchar(4000),@p1265 nvarchar(4000),@p1266 nvarchar(4000),@p1267 nvarchar(4000),@p1268 nvarchar(4000),@p1269 nvarchar(4000),@p1270 nvarchar(4000),@p1271 nvarchar(4000),@p1272 int,@p1273 nvarchar(4000),@p1274 nvarchar(4000),@p1275 nvarchar(4000),@p1276 nvarchar(4000),@p1277 nvarchar(4000),@p1278 int,@p1279 nvarchar(4000),@p1280 int,@p1281 int,@p1282 datetime2(7),@p1283 datetime2(7),@p1284 datetime2(7),@p1285 nvarchar(4000),@p1286 nvarchar(4000),@p1287 nvarchar(4000),@p1288 nvarchar(4000),@p1289 nvarchar(4000),@p1290 nvarchar(4000),@p1291 nvarchar(4000),@p1292 nvarchar(4000),@p1293 nvarchar(4000),@p1294 nvarchar(4000),@p1295 nvarchar(4000),@p1296 nvarchar(4000),@p1297 nvarchar(4000),@p1298 nvarchar(4000),@p1299 datetime2(7),@p1300 nvarchar(4000),@p1301 nvarchar(4000),@p1302 int,@p1303 int,@p1304 int,@p1305 nvarchar(4000),@p1306 nvarchar(4000),@p1307 nvarchar(4000),@p1308 decimal(18,2),@p1309 decimal(18,2),@p1310 nvarchar(4000),@p1311 nvarchar(4000),@p1312 decimal(18,2),@p1313 nvarchar(4000),@p1314 nvarchar(4000),@p1315 nvarchar(4000),@p1316 nvarchar(4000),@p1317 int,@p1318 nvarchar(4000),@p1319 nvarchar(4000),@p1320 nvarchar(4000),@p1321 nvarchar(4000),@p1322 nvarchar(4000),@p1323 nvarchar(4000),@p1324 nvarchar(4000),@p1325 nvarchar(4000),@p1326 nvarchar(4000),@p1327 nvarchar(4000),@p1328 int,@p1329 nvarchar(4000),@p1330 nvarchar(4000),@p1331 nvarchar(4000),@p1332 nvarchar(4000),@p1333 nvarchar(4000),@p1334 int,@p1335 nvarchar(4000),@p1336 int,@p1337 int,@p1338 datetime2(7),@p1339 datetime2(7),@p1340 datetime2(7),@p1341 nvarchar(4000),@p1342 nvarchar(4000),@p1343 nvarchar(4000),@p1344 nvarchar(4000),@p1345 nvarchar(4000),@p1346 nvarchar(4000),@p1347 nvarchar(4000),@p1348 nvarchar(4000),@p1349 nvarchar(4000),@p1350 nvarchar(4000),@p1351 nvarchar(4000),@p1352 nvarchar(4000),@p1353 nvarchar(4000),@p1354 nvarchar(4000),@p1355 datetime2(7),@p1356 nvarchar(4000),@p1357 nvarchar(4000),@p1358 int,@p1359 int,@p1360 int,@p1361 nvarchar(4000),@p1362 nvarchar(4000),@p1363 nvarchar(4000),@p1364 nvarchar(4000),@p1365 decimal(18,2),@p1366 nvarchar(4000),@p1367 nvarchar(4000),@p1368 decimal(18,2),@p1369 nvarchar(4000),@p1370 nvarchar(4000),@p1371 nvarchar(4000),@p1372 nvarchar(4000),@p1373 int,@p1374 nvarchar(4000),@p1375 nvarchar(4000),@p1376 nvarchar(4000),@p1377 nvarchar(4000),@p1378 nvarchar(4000),@p1379 nvarchar(4000),@p1380 nvarchar(4000),@p1381 nvarchar(4000),@p1382 nvarchar(4000),@p1383 nvarchar(4000),@p1384 int,@p1385 nvarchar(4000),@p1386 nvarchar(4000),@p1387 nvarchar(4000),@p1388 nvarchar(4000),@p1389 nvarchar(4000),@p1390 int,@p1391 nvarchar(4000),@p1392 int,@p1393 int,@p1394 datetime2(7),@p1395 datetime2(7),@p1396 datetime2(7),@p1397 nvarchar(4000),@p1398 nvarchar(4000),@p1399 nvarchar(4000),@p1400 nvarchar(4000),@p1401 nvarchar(4000),@p1402 nvarchar(4000),@p1403 nvarchar(4000),@p1404 nvarchar(4000),@p1405 nvarchar(4000),@p1406 nvarchar(4000),@p1407 nvarchar(4000),@p1408 nvarchar(4000),@p1409 nvarchar(4000),@p1410 nvarchar(4000),@p1411 datetime2(7),@p1412 nvarchar(4000),@p1413 nvarchar(4000),@p1414 int,@p1415 int,@p1416 int,@p1417 nvarchar(4000),@p1418 nvarchar(4000),@p1419 nvarchar(4000),@p1420 decimal(18,2),@p1421 decimal(18,2),@p1422 nvarchar(4000),@p1423 nvarchar(4000),@p1424 decimal(18,2),@p1425 nvarchar(4000),@p1426 nvarchar(4000),@p1427 nvarchar(4000),@p1428 nvarchar(4000),@p1429 int,@p1430 nvarchar(4000),@p1431 nvarchar(4000),@p1432 nvarchar(4000),@p1433 nvarchar(4000),@p1434 nvarchar(4000),@p1435 nvarchar(4000),@p1436 nvarchar(4000),@p1437 nvarchar(4000),@p1438 nvarchar(4000),@p1439 nvarchar(4000),@p1440 int,@p1441 nvarchar(4000),@p1442 nvarchar(4000),@p1443 nvarchar(4000),@p1444 nvarchar(4000),@p1445 nvarchar(4000),@p1446 int,@p1447 nvarchar(4000),@p1448 int,@p1449 int,@p1450 datetime2(7),@p1451 datetime2(7),@p1452 datetime2(7),@p1453 nvarchar(4000),@p1454 nvarchar(4000),@p1455 nvarchar(4000),@p1456 nvarchar(4000),@p1457 nvarchar(4000),@p1458 nvarchar(4000),@p1459 nvarchar(4000),@p1460 nvarchar(4000),@p1461 nvarchar(4000),@p1462 nvarchar(4000),@p1463 nvarchar(4000),@p1464 nvarchar(4000),@p1465 nvarchar(4000),@p1466 nvarchar(4000),@p1467 datetime2(7),@p1468 nvarchar(4000),@p1469 nvarchar(4000),@p1470 int,@p1471 int,@p1472 int,@p1473 nvarchar(4000),@p1474 nvarchar(4000),@p1475 nvarchar(4000),@p1476 nvarchar(4000),@p1477 decimal(18,2),@p1478 nvarchar(4000),@p1479 nvarchar(4000),@p1480 decimal(18,2),@p1481 nvarchar(4000),@p1482 nvarchar(4000),@p1483 nvarchar(4000),@p1484 nvarchar(4000),@p1485 int,@p1486 nvarchar(4000),@p1487 nvarchar(4000),@p1488 nvarchar(4000),@p1489 nvarchar(4000),@p1490 nvarchar(4000),@p1491 nvarchar(4000),@p1492 nvarchar(4000),@p1493 nvarchar(4000),@p1494 nvarchar(4000),@p1495 nvarchar(4000),@p1496 int,@p1497 nvarchar(4000),@p1498 nvarchar(4000),@p1499 nvarchar(4000),@p1500 nvarchar(4000),@p1501 nvarchar(4000),@p1502 int,@p1503 nvarchar(4000),@p1504 int,@p1505 int,@p1506 datetime2(7),@p1507 datetime2(7),@p1508 datetime2(7),@p1509 nvarchar(4000),@p1510 nvarchar(4000),@p1511 nvarchar(4000),@p1512 nvarchar(4000),@p1513 nvarchar(4000),@p1514 nvarchar(4000),@p1515 nvarchar(4000),@p1516 nvarchar(4000),@p1517 nvarchar(4000),@p1518 nvarchar(4000),@p1519 nvarchar(4000),@p1520 nvarchar(4000),@p1521 nvarchar(4000),@p1522 nvarchar(4000),@p1523 datetime2(7),@p1524 nvarchar(4000),@p1525 nvarchar(4000),@p1526 int,@p1527 int,@p1528 int,@p1529 nvarchar(4000),@p1530 nvarchar(4000),@p1531 nvarchar(4000),@p1532 decimal(18,2),@p1533 decimal(18,2),@p1534 nvarchar(4000),@p1535 nvarchar(4000),@p1536 decimal(18,2),@p1537 nvarchar(4000),@p1538 nvarchar(4000),@p1539 nvarchar(4000),@p1540 nvarchar(4000),@p1541 int,@p1542 nvarchar(4000),@p1543 nvarchar(4000),@p1544 nvarchar(4000),@p1545 nvarchar(4000),@p1546 nvarchar(4000),@p1547 nvarchar(4000),@p1548 nvarchar(4000),@p1549 nvarchar(4000),@p1550 nvarchar(4000),@p1551 nvarchar(4000),@p1552 int,@p1553 nvarchar(4000),@p1554 nvarchar(4000),@p1555 nvarchar(4000),@p1556 nvarchar(4000),@p1557 nvarchar(4000),@p1558 int,@p1559 nvarchar(4000),@p1560 int,@p1561 int,@p1562 datetime2(7),@p1563 datetime2(7),@p1564 datetime2(7),@p1565 nvarchar(4000),@p1566 nvarchar(4000),@p1567 nvarchar(4000),@p1568 nvarchar(4000),@p1569 nvarchar(4000),@p1570 nvarchar(4000),@p1571 nvarchar(4000),@p1572 nvarchar(4000),@p1573 nvarchar(4000),@p1574 nvarchar(4000),@p1575 nvarchar(4000),@p1576 nvarchar(4000),@p1577 nvarchar(4000),@p1578 nvarchar(4000),@p1579 datetime2(7),@p1580 nvarchar(4000),@p1581 nvarchar(4000),@p1582 int,@p1583 int,@p1584 int,@p1585 nvarchar(4000),@p1586 nvarchar(4000),@p1587 nvarchar(4000),@p1588 decimal(18,2),@p1589 decimal(18,2),@p1590 nvarchar(4000),@p1591 nvarchar(4000),@p1592 decimal(18,2),@p1593 nvarchar(4000),@p1594 nvarchar(4000),@p1595 nvarchar(4000),@p1596 nvarchar(4000),@p1597 int,@p1598 nvarchar(4000),@p1599 nvarchar(4000),@p1600 nvarchar(4000),@p1601 nvarchar(4000),@p1602 nvarchar(4000),@p1603 nvarchar(4000),@p1604 nvarchar(4000),@p1605 nvarchar(4000),@p1606 nvarchar(4000),@p1607 nvarchar(4000),@p1608 int,@p1609 nvarchar(4000),@p1610 nvarchar(4000),@p1611 nvarchar(4000),@p1612 nvarchar(4000),@p1613 nvarchar(4000),@p1614 int,@p1615 nvarchar(4000),@p1616 int,@p1617 int,@p1618 datetime2(7),@p1619 datetime2(7),@p1620 datetime2(7),@p1621 nvarchar(4000),@p1622 nvarchar(4000),@p1623 nvarchar(4000),@p1624 nvarchar(4000),@p1625 nvarchar(4000),@p1626 nvarchar(4000),@p1627 nvarchar(4000),@p1628 nvarchar(4000),@p1629 nvarchar(4000),@p1630 nvarchar(4000),@p1631 nvarchar(4000),@p1632 nvarchar(4000),@p1633 nvarchar(4000),@p1634 nvarchar(4000),@p1635 datetime2(7),@p1636 nvarchar(4000),@p1637 nvarchar(4000),@p1638 int,@p1639 int,@p1640 int,@p1641 nvarchar(4000),@p1642 nvarchar(4000),@p1643 nvarchar(4000),@p1644 nvarchar(4000),@p1645 decimal(18,2),@p1646 nvarchar(4000),@p1647 nvarchar(4000),@p1648 decimal(18,2),@p1649 nvarchar(4000),@p1650 nvarchar(4000),@p1651 nvarchar(4000),@p1652 nvarchar(4000),@p1653 int,@p1654 nvarchar(4000),@p1655 nvarchar(4000),@p1656 nvarchar(4000),@p1657 nvarchar(4000),@p1658 nvarchar(4000),@p1659 nvarchar(4000),@p1660 nvarchar(4000),@p1661 nvarchar(4000),@p1662 nvarchar(4000),@p1663 nvarchar(4000),@p1664 int,@p1665 nvarchar(4000),@p1666 nvarchar(4000),@p1667 nvarchar(4000),@p1668 nvarchar(4000),@p1669 nvarchar(4000),@p1670 int,@p1671 nvarchar(4000),@p1672 int,@p1673 int,@p1674 datetime2(7),@p1675 datetime2(7),@p1676 datetime2(7),@p1677 nvarchar(4000),@p1678 nvarchar(4000),@p1679 nvarchar(4000),@p1680 nvarchar(4000),@p1681 nvarchar(4000),@p1682 nvarchar(4000),@p1683 nvarchar(4000),@p1684 nvarchar(4000),@p1685 nvarchar(4000),@p1686 nvarchar(4000),@p1687 nvarchar(4000),@p1688 nvarchar(4000),@p1689 nvarchar(4000),@p1690 nvarchar(4000),@p1691 datetime2(7),@p1692 nvarchar(4000),@p1693 nvarchar(4000),@p1694 int,@p1695 int,@p1696 int,@p1697 nvarchar(4000),@p1698 nvarchar(4000),@p1699 nvarchar(4000),@p1700 nvarchar(4000),@p1701 decimal(18,2),@p1702 nvarchar(4000),@p1703 nvarchar(4000),@p1704 decimal(18,2),@p1705 nvarchar(4000),@p1706 nvarchar(4000),@p1707 nvarchar(4000),@p1708 nvarchar(4000),@p1709 int,@p1710 nvarchar(4000),@p1711 nvarchar(4000),@p1712 nvarchar(4000),@p1713 nvarchar(4000),@p1714 nvarchar(4000),@p1715 nvarchar(4000),@p1716 nvarchar(4000),@p1717 nvarchar(4000),@p1718 nvarchar(4000),@p1719 nvarchar(4000),@p1720 int,@p1721 nvarchar(4000),@p1722 nvarchar(4000),@p1723 nvarchar(4000),@p1724 nvarchar(4000),@p1725 nvarchar(4000),@p1726 int,@p1727 nvarchar(4000),@p1728 int,@p1729 int,@p1730 datetime2(7),@p1731 datetime2(7),@p1732 datetime2(7),@p1733 nvarchar(4000),@p1734 nvarchar(4000),@p1735 nvarchar(4000),@p1736 nvarchar(4000),@p1737 nvarchar(4000),@p1738 nvarchar(4000),@p1739 nvarchar(4000),@p1740 nvarchar(4000),@p1741 nvarchar(4000),@p1742 nvarchar(4000),@p1743 nvarchar(4000),@p1744 nvarchar(4000),@p1745 nvarchar(4000),@p1746 nvarchar(4000),@p1747 datetime2(7),@p1748 nvarchar(4000),@p1749 nvarchar(4000),@p1750 int,@p1751 int,@p1752 int,@p1753 nvarchar(4000),@p1754 nvarchar(4000),@p1755 nvarchar(4000),@p1756 nvarchar(4000),@p1757 decimal(18,2),@p1758 nvarchar(4000),@p1759 nvarchar(4000),@p1760 decimal(18,2),@p1761 nvarchar(4000),@p1762 nvarchar(4000),@p1763 nvarchar(4000),@p1764 nvarchar(4000),@p1765 int,@p1766 nvarchar(4000),@p1767 nvarchar(4000),@p1768 nvarchar(4000),@p1769 nvarchar(4000),@p1770 nvarchar(4000),@p1771 nvarchar(4000),@p1772 nvarchar(4000),@p1773 nvarchar(4000),@p1774 nvarchar(4000),@p1775 nvarchar(4000),@p1776 int,@p1777 nvarchar(4000),@p1778 nvarchar(4000),@p1779 nvarchar(4000),@p1780 nvarchar(4000),@p1781 nvarchar(4000),@p1782 int,@p1783 nvarchar(4000),@p1784 int,@p1785 int,@p1786 datetime2(7),@p1787 datetime2(7),@p1788 datetime2(7),@p1789 nvarchar(4000),@p1790 nvarchar(4000),@p1791 nvarchar(4000),@p1792 nvarchar(4000),@p1793 nvarchar(4000),@p1794 nvarchar(4000),@p1795 nvarchar(4000),@p1796 nvarchar(4000),@p1797 nvarchar(4000),@p1798 nvarchar(4000),@p1799 nvarchar(4000),@p1800 nvarchar(4000),@p1801 nvarchar(4000),@p1802 nvarchar(4000),@p1803 datetime2(7),@p1804 nvarchar(4000),@p1805 nvarchar(4000),@p1806 int,@p1807 int,@p1808 int,@p1809 nvarchar(4000),@p1810 nvarchar(4000),@p1811 nvarchar(4000),@p1812 nvarchar(4000),@p1813 decimal(18,2),@p1814 nvarchar(4000),@p1815 nvarchar(4000),@p1816 decimal(18,2),@p1817 nvarchar(4000),@p1818 nvarchar(4000),@p1819 nvarchar(4000),@p1820 nvarchar(4000),@p1821 int,@p1822 nvarchar(4000),@p1823 nvarchar(4000),@p1824 nvarchar(4000),@p1825 nvarchar(4000),@p1826 nvarchar(4000),@p1827 nvarchar(4000),@p1828 nvarchar(4000),@p1829 nvarchar(4000),@p1830 nvarchar(4000),@p1831 nvarchar(4000),@p1832 int,@p1833 nvarchar(4000),@p1834 nvarchar(4000),@p1835 nvarchar(4000),@p1836 nvarchar(4000),@p1837 nvarchar(4000),@p1838 int,@p1839 nvarchar(4000),@p1840 int,@p1841 int,@p1842 datetime2(7),@p1843 datetime2(7),@p1844 datetime2(7),@p1845 nvarchar(4000),@p1846 nvarchar(4000),@p1847 nvarchar(4000),@p1848 nvarchar(4000),@p1849 nvarchar(4000),@p1850 nvarchar(4000),@p1851 nvarchar(4000),@p1852 nvarchar(4000),@p1853 nvarchar(4000),@p1854 nvarchar(4000),@p1855 nvarchar(4000),@p1856 nvarchar(4000),@p1857 nvarchar(4000),@p1858 nvarchar(4000),@p1859 datetime2(7),@p1860 nvarchar(4000),@p1861 nvarchar(4000),@p1862 int,@p1863 int,@p1864 int,@p1865 nvarchar(4000),@p1866 nvarchar(4000),@p1867 nvarchar(4000),@p1868 decimal(18,2),@p1869 decimal(18,2),@p1870 nvarchar(4000),@p1871 nvarchar(4000),@p1872 decimal(18,2),@p1873 nvarchar(4000),@p1874 nvarchar(4000),@p1875 nvarchar(4000),@p1876 nvarchar(4000),@p1877 int,@p1878 nvarchar(4000),@p1879 nvarchar(4000),@p1880 nvarchar(4000),@p1881 nvarchar(4000),@p1882 nvarchar(4000),@p1883 nvarchar(4000),@p1884 nvarchar(4000),@p1885 nvarchar(4000),@p1886 nvarchar(4000),@p1887 nvarchar(4000),@p1888 int,@p1889 nvarchar(4000),@p1890 nvarchar(4000),@p1891 nvarchar(4000),@p1892 nvarchar(4000),@p1893 nvarchar(4000),@p1894 int,@p1895 nvarchar(4000),@p1896 int,@p1897 int,@p1898 datetime2(7),@p1899 datetime2(7),@p1900 datetime2(7),@p1901 nvarchar(4000),@p1902 nvarchar(4000),@p1903 nvarchar(4000),@p1904 nvarchar(4000),@p1905 nvarchar(4000),@p1906 nvarchar(4000),@p1907 nvarchar(4000),@p1908 nvarchar(4000),@p1909 nvarchar(4000),@p1910 nvarchar(4000),@p1911 nvarchar(4000),@p1912 nvarchar(4000),@p1913 nvarchar(4000),@p1914 nvarchar(4000),@p1915 datetime2(7),@p1916 nvarchar(4000),@p1917 nvarchar(4000),@p1918 int,@p1919 int,@p1920 int,@p1921 nvarchar(4000),@p1922 nvarchar(4000),@p1923 nvarchar(4000),@p1924 nvarchar(4000),@p1925 decimal(18,2),@p1926 nvarchar(4000),@p1927 nvarchar(4000),@p1928 decimal(18,2),@p1929 nvarchar(4000),@p1930 nvarchar(4000),@p1931 nvarchar(4000),@p1932 nvarchar(4000),@p1933 int,@p1934 nvarchar(4000),@p1935 nvarchar(4000),@p1936 nvarchar(4000),@p1937 nvarchar(4000),@p1938 nvarchar(4000),@p1939 nvarchar(4000),@p1940 nvarchar(4000),@p1941 nvarchar(4000),@p1942 nvarchar(4000),@p1943 nvarchar(4000),@p1944 int,@p1945 nvarchar(4000),@p1946 nvarchar(4000),@p1947 nvarchar(4000),@p1948 nvarchar(4000),@p1949 nvarchar(4000),@p1950 int,@p1951 nvarchar(4000),@p1952 int,@p1953 int,@p1954 datetime2(7),@p1955 datetime2(7),@p1956 datetime2(7),@p1957 nvarchar(4000),@p1958 nvarchar(4000),@p1959 nvarchar(4000),@p1960 nvarchar(4000),@p1961 nvarchar(4000),@p1962 nvarchar(4000),@p1963 nvarchar(4000),@p1964 nvarchar(4000),@p1965 nvarchar(4000),@p1966 nvarchar(4000),@p1967 nvarchar(4000),@p1968 nvarchar(4000),@p1969 nvarchar(4000),@p1970 nvarchar(4000),@p1971 datetime2(7),@p1972 nvarchar(4000),@p1973 nvarchar(4000),@p1974 int,@p1975 int,@p1976 int,@p1977 nvarchar(4000),@p1978 nvarchar(4000),@p1979 nvarchar(4000),@p1980 decimal(18,2),@p1981 decimal(18,2),@p1982 nvarchar(4000),@p1983 nvarchar(4000),@p1984 decimal(18,2),@p1985 nvarchar(4000),@p1986 nvarchar(4000),@p1987 nvarchar(4000),@p1988 nvarchar(4000),@p1989 int,@p1990 nvarchar(4000),@p1991 nvarchar(4000),@p1992 nvarchar(4000),@p1993 nvarchar(4000),@p1994 nvarchar(4000),@p1995 nvarchar(4000),@p1996 nvarchar(4000),@p1997 nvarchar(4000),@p1998 nvarchar(4000),@p1999 nvarchar(4000),@p2000 int,@p2001 nvarchar(4000),@p2002 nvarchar(4000),@p2003 nvarchar(4000),@p2004 nvarchar(4000),@p2005 nvarchar(4000),@p2006 int,@p2007 nvarchar(4000),@p2008 int,@p2009 int,@p2010 datetime2(7),@p2011 datetime2(7),@p2012 datetime2(7),@p2013 nvarchar(4000),@p2014 nvarchar(4000),@p2015 nvarchar(4000),@p2016 nvarchar(4000),@p2017 nvarchar(4000),@p2018 nvarchar(4000),@p2019 nvarchar(4000),@p2020 nvarchar(4000),@p2021 nvarchar(4000),@p2022 nvarchar(4000),@p2023 nvarchar(4000),@p2024 nvarchar(4000),@p2025 nvarchar(4000),@p2026 nvarchar(4000),@p2027 datetime2(7),@p2028 nvarchar(4000),@p2029 nvarchar(4000),@p2030 int,@p2031 int,@p2032 int,@p2033 nvarchar(4000),@p2034 nvarchar(4000),@p2035 nvarchar(4000),@p2036 nvarchar(4000),@p2037 decimal(18,2),@p2038 nvarchar(4000),@p2039 nvarchar(4000),@p2040 decimal(18,2),@p2041 nvarchar(4000),@p2042 nvarchar(4000),@p2043 nvarchar(4000),@p2044 nvarchar(4000),@p2045 int,@p2046 nvarchar(4000),@p2047 nvarchar(4000),@p2048 nvarchar(4000),@p2049 nvarchar(4000),@p2050 nvarchar(4000),@p2051 nvarchar(4000),@p2052 nvarchar(4000),@p2053 nvarchar(4000),@p2054 nvarchar(4000),@p2055 nvarchar(4000),@p2056 int,@p2057 nvarchar(4000),@p2058 nvarchar(4000),@p2059 nvarchar(4000),@p2060 nvarchar(4000),@p2061 nvarchar(4000),@p2062 int,@p2063 nvarchar(4000),@p2064 int,@p2065 int,@p2066 datetime2(7),@p2067 datetime2(7),@p2068 datetime2(7),@p2069 nvarchar(4000),@p2070 nvarchar(4000),@p2071 nvarchar(4000))SET NOCOUNT ON; DECLARE @inserted0 TABLE ([item_id] int, [_Position] [int]); MERGE [raw_data] USING ( VALUES (@p0, @p1, @p2, @p3, @p4, @p5, @p6, @p7, @p8, @p9, @p10, @p11, @p12, @p13, @p14, @p15, @p16, @p17, @p18, @p19, @p20, @p21, @p22, @p23, @p24, @p25, @p26, @p27, @p28, @p29, @p30, @p31, @p32, @p33, @p34, @p35, @p36, @p37, @p38, @p39, @p40, @p41, @p42, @p43, @p44, @p45, @p46, @p47, @p48, @p49, @p50, @p51, @p52, @p53, @p54, @p55, 0), (@p56, @p57, @p58, @p59, @p60, @p61, @p62, @p63, @p64, @p65, @p66, @p67, @p68, @p69, @p70, @p71, @p72, @p73, @p74, @p75, @p76, @p77, @p78, @p79, @p80, @p81, @p82, @p83, @p84, @p85, @p86, @p87, @p88, @p89, @p90, @p91, @p92, @p93, @p94, @p95, @p96, @p97, @p98, @p99, @p100, @p101, @p102, @p103, @p104, @p105, @p106, @p107, @p108, @p109, @p110, @p111, 1), (@p112, @p113, @p114, @p115, @p116, @p117, @p118, @p119, @p120, @p121, @p122, @p123, @p124, @p125, @p126, @p127, @p128, @p129, @p130, @p131, @p132, @p133, @p134, @p135, @p136, @p137, @p138, @p139, @p140, @p141, @p142, @p143, @p144, @p145, @p146, @p147, @p148, @p149, @p150, @p151, @p152, @p153, @p154, @p155, @p156, @p157, @p158, @p159, @p160, @p161, @p162, @p163, @p164, @p165, @p166, @p167, 2), (@p168, @p169, @p170, @p171, @p172, @p173, @p174, @p175, @p176, @p177, @p178, @p179, @p180, @p181, @p182, @p183, @p184, @p185, @p186, @p187, @p188, @p189, @p190, @p191, @p192, @p193, @p194, @p195, @p196, @p197, @p198, @p199, @p200, @p201, @p202, @p203, @p204, @p205, @p206, @p207, @p208, @p209, @p210, @p211, @p212, @p213, @p214, @p215, @p216, @p217, @p218, @p219, @p220, @p221, @p222, @p223, 3), (@p224, @p225, @p226, @p227, @p228, @p229, @p230, @p231, @p232, @p233, @p234, @p235, @p236, @p237, @p238, @p239, @p240, @p241, @p242, @p243, @p244, @p245, @p246, @p247, @p248, @p249, @p250, @p251, @p252, @p253, @p254, @p255, @p256, @p257, @p258, @p259, @p260, @p261, @p262, @p263, @p264, @p265, @p266, @p267, @p268, @p269, @p270, @p271, @p272, @p273, @p274, @p275, @p276, @p277, @p278, @p279, 4), (@p280, @p281, @p282, @p283, @p284, @p285, @p286, @p287, @p288, @p289, @p290, @p291, @p292, @p293, @p294, @p295, @p296, @p297, @p298, @p299, @p300, @p301, @p302, @p303, @p304, @p305, @p306, @p307, @p308, @p309, @p310, @p311, @p312, @p313, @p314, @p315, @p316, @p317, @p318, @p319, @p320, @p321, @p322, @p323, @p324, @p325, @p326, @p327, @p328, @p329, @p330, @p331, @p332, @p333, @p334, @p335, 5), (@p336, @p337, @p338, @p339, @p340, @p341, @p342, @p343, @p344, @p345, @p346, @p347, @p348, @p349, @p350, @p351, @p352, @p353, @p354, @p355, @p356, @p357, @p358, @p359, @p360, @p361, @p362, @p363, @p364, @p365, @p366, @p367, @p368, @p369, @p370, @p371, @p372, @p373, @p374, @p375, @p376, @p377, @p378, @p379, @p380, @p381, @p382, @p383, @p384, @p385, @p386, @p387, @p388, @p389, @p390, @p391, 6), (@p392, @p393, @p394, @p395, @p396, @p397, @p398, @p399, @p400, @p401, @p402, @p403, @p404, @p405, @p406, @p407, @p408, @p409, @p410, @p411, @p412, @p413, @p414, @p415, @p416, @p417, @p418, @p419, @p420, @p421, @p422, @p423, @p424, @p425, @p426, @p427, @p428, @p429, @p430, @p431, @p432, @p433, @p434, @p435, @p436, @p437, @p438, @p439, @p440, @p441, @p442, @p443, @p444, @p445, @p446, @p447, 7), (@p448, @p449, @p450, @p451, @p452, @p453, @p454, @p455, @p456, @p457, @p458, @p459, @p460, @p461, @p462, @p463, @p464, @p465, @p466, @p467, @p468, @p469, @p470, @p471, @p472, @p473, @p474, @p475, @p476, @p477, @p478, @p479, @p480, @p481, @p482, @p483, @p484, @p485, @p486, @p487, @p488, @p489, @p490, @p491, @p492, @p493, @p494, @p495, @p496, @p497, @p498, @p499, @p500, @p501, @p502, @p503, 8), (@p504, @p505, @p506, @p507, @p508, @p509, @p510, @p511, @p512, @p513, @p514, @p515, @p516, @p517, @p518, @p519, @p520, @p521, @p522, @p523, @p524, @p525, @p526, @p527, @p528, @p529, @p530, @p531, @p532, @p533, @p534, @p535, @p536, @p537, @p538, @p539, @p540, @p541, @p542, @p543, @p544, @p545, @p546, @p547, @p548, @p549, @p550, @p551, @p552, @p553, @p554, @p555, @p556, @p557, @p558, @p559, 9), (@p560, @p561, @p562, @p563, @p564, @p565, @p566, @p567, @p568, @p569, @p570, @p571, @p572, @p573, @p574, @p575, @p576, @p577, @p578, @p579, @p580, @p581, @p582, @p583, @p584, @p585, @p586, @p587, @p588, @p589, @p590, @p591, @p592, @p593, @p594, @p595, @p596, @p597, @p598, @p599, @p600, @p601, @p602, @p603, @p604, @p605, @p606, @p607, @p608, @p609, @p610, @p611, @p612, @p613, @p614, @p615, 10), (@p616, @p617, @p618, @p619, @p620, @p621, @p622, @p623, @p624, @p625, @p626, @p627, @p628, @p629, @p630, @p631, @p632, @p633, @p634, @p635, @p636, @p637, @p638, @p639, @p640, @p641, @p642, @p643, @p644, @p645, @p646, @p647, @p648, @p649, @p650, @p651, @p652, @p653, @p654, @p655, @p656, @p657, @p658, @p659, @p660, @p661, @p662, @p663, @p664, @p665, @p666, @p667, @p668, @p669, @p670, @p671, 11), (@p672, @p673, @p674, @p675, @p676, @p677, @p678, @p679, @p680, @p681, @p682, @p683, @p684, @p685, @p686, @p687, @p688, @p689, @p690, @p691, @p692, @p693, @p694, @p695, @p696, @p697, @p698, @p699, @p700, @p701, @p702, @p703, @p704, @p705, @p706, @p707, @p708, @p709, @p710, @p711, @p712, @p713, @p714, @p715, @p716, @p717, @p718, @p719, @p720, @p721, @p722, @p723, @p724, @p725, @p726, @p727, 12), (@p728, @p729, @p730, @p731, @p732, @p733, @p734, @p735, @p736, @p737, @p738, @p739, @p740, @p741, @p742, @p743, @p744, @p745, @p746, @p747, @p748, @p749, @p750, @p751, @p752, @p753, @p754, @p755, @p756, @p757, @p758, @p759, @p760, @p761, @p762, @p763, @p764, @p765, @p766, @p767, @p768, @p769, @p770, @p771, @p772, @p773, @p774, @p775, @p776, @p777, @p778, @p779, @p780, @p781, @p782, @p783, 13), (@p784, @p785, @p786, @p787, @p788, @p789, @p790, @p791, @p792, @p793, @p794, @p795, @p796, @p797, @p798, @p799, @p800, @p801, @p802, @p803, @p804, @p805, @p806, @p807, @p808, @p809, @p810, @p811, @p812, @p813, @p814, @p815, @p816, @p817, @p818, @p819, @p820, @p821, @p822, @p823, @p824, @p825, @p826, @p827, @p828, @p829, @p830, @p831, @p832, @p833, @p834, @p835, @p836, @p837, @p838, @p839, 14), (@p840, @p841, @p842, @p843, @p844, @p845, @p846, @p847, @p848, @p849, @p850, @p851, @p852, @p853, @p854, @p855, @p856, @p857, @p858, @p859, @p860, @p861, @p862, @p863, @p864, @p865, @p866, @p867, @p868, @p869, @p870, @p871, @p872, @p873, @p874, @p875, @p876, @p877, @p878, @p879, @p880, @p881, @p882, @p883, @p884, @p885, @p886, @p887, @p888, @p889, @p890, @p891, @p892, @p893, @p894, @p895, 15), (@p896, @p897, @p898, @p899, @p900, @p901, @p902, @p903, @p904, @p905, @p906, @p907, @p908, @p909, @p910, @p911, @p912, @p913, @p914, @p915, @p916, @p917, @p918, @p919, @p920, @p921, @p922, @p923, @p924, @p925, @p926, @p927, @p928, @p929, @p930, @p931, @p932, @p933, @p934, @p935, @p936, @p937, @p938, @p939, @p940, @p941, @p942, @p943, @p944, @p945, @p946, @p947, @p948, @p949, @p950, @p951, 16), (@p952, @p953, @p954, @p955, @p956, @p957, @p958, @p959, @p960, @p961, @p962, @p963, @p964, @p965, @p966, @p967, @p968, @p969, @p970, @p971, @p972, @p973, @p974, @p975, @p976, @p977, @p978, @p979, @p980, @p981, @p982, @p983, @p984, @p985, @p986, @p987, @p988, @p989, @p990, @p991, @p992, @p993, @p994, @p995, @p996, @p997, @p998, @p999, @p1000, @p1001, @p1002, @p1003, @p1004, @p1005, @p1006, @p1007, 17), (@p1008, @p1009, @p1010, @p1011, @p1012, @p1013, @p1014, @p1015, @p1016, @p1017, @p1018, @p1019, @p1020, @p1021, @p1022, @p1023, @p1024, @p1025, @p1026, @p1027, @p1028, @p1029, @p1030, @p1031, @p1032, @p1033, @p1034, @p1035, @p1036, @p1037, @p1038, @p1039, @p1040, @p1041, @p1042, @p1043, @p1044, @p1045, @p1046, @p1047, @p1048, @p1049, @p1050, @p1051, @p1052, @p1053, @p1054, @p1055, @p1056, @p1057, @p1058, @p1059, @p1060, @p1061, @p1062, @p1063, 18), (@p1064, @p1065, @p1066, @p1067, @p1068, @p1069, @p1070, @p1071, @p1072, @p1073, @p1074, @p1075, @p1076, @p1077, @p1078, @p1079, @p1080, @p1081, @p1082, @p1083, @p1084, @p1085, @p1086, @p1087, @p1088, @p1089, @p1090, @p1091, @p1092, @p1093, @p1094, @p1095, @p1096, @p1097, @p1098, @p1099, @p1100, @p1101, @p1102, @p1103, @p1104, @p1105, @p1106, @p1107, @p1108, @p1109, @p1110, @p1111, @p1112, @p1113, @p1114, @p1115, @p1116, @p1117, @p1118, @p1119, 19), (@p1120, @p1121, @p1122, @p1123, @p1124, @p1125, @p1126, @p1127, @p1128, @p1129, @p1130, @p1131, @p1132, @p1133, @p1134, @p1135, @p1136, @p1137, @p1138, @p1139, @p1140, @p1141, @p1142, @p1143, @p1144, @p1145, @p1146, @p1147, @p1148, @p1149, @p1150, @p1151, @p1152, @p1153, @p1154, @p1155, @p1156, @p1157, @p1158, @p1159, @p1160, @p1161, @p1162, @p1163, @p1164, @p1165, @p1166, @p1167, @p1168, @p1169, @p1170, @p1171, @p1172, @p1173, @p1174, @p1175, 20), (@p1176, @p1177, @p1178, @p1179, @p1180, @p1181, @p1182, @p1183, @p1184, @p1185, @p1186, @p1187, @p1188, @p1189, @p1190, @p1191, @p1192, @p1193, @p1194, @p1195, @p1196, @p1197, @p1198, @p1199, @p1200, @p1201, @p1202, @p1203, @p1204, @p1205, @p1206, @p1207, @p1208, @p1209, @p1210, @p1211, @p1212, @p1213, @p1214, @p1215, @p1216, @p1217, @p1218, @p1219, @p1220, @p1221, @p1222, @p1223, @p1224, @p1225, @p1226, @p1227, @p1228, @p1229, @p1230, @p1231, 21), (@p1232, @p1233, @p1234, @p1235, @p1236, @p1237, @p1238, @p1239, @p1240, @p1241, @p1242, @p1243, @p1244, @p1245, @p1246, @p1247, @p1248, @p1249, @p1250, @p1251, @p1252, @p1253, @p1254, @p1255, @p1256, @p1257, @p1258, @p1259, @p1260, @p1261, @p1262, @p1263, @p1264, @p1265, @p1266, @p1267, @p1268, @p1269, @p1270, @p1271, @p1272, @p1273, @p1274, @p1275, @p1276, @p1277, @p1278, @p1279, @p1280, @p1281, @p1282, @p1283, @p1284, @p1285, @p1286, @p1287, 22), (@p1288, @p1289, @p1290, @p1291, @p1292, @p1293, @p1294, @p1295, @p1296, @p1297, @p1298, @p1299, @p1300, @p1301, @p1302, @p1303, @p1304, @p1305, @p1306, @p1307, @p1308, @p1309, @p1310, @p1311, @p1312, @p1313, @p1314, @p1315, @p1316, @p1317, @p1318, @p1319, @p1320, @p1321, @p1322, @p1323, @p1324, @p1325, @p1326, @p1327, @p1328, @p1329, @p1330, @p1331, @p1332, @p1333, @p1334, @p1335, @p1336, @p1337, @p1338, @p1339, @p1340, @p1341, @p1342, @p1343, 23), (@p1344, @p1345, @p1346, @p1347, @p1348, @p1349, @p1350, @p1351, @p1352, @p1353, @p1354, @p1355, @p1356, @p1357, @p1358, @p1359, @p1360, @p1361, @p1362, @p1363, @p1364, @p1365, @p1366, @p1367, @p1368, @p1369, @p1370, @p1371, @p1372, @p1373, @p1374, @p1375, @p1376, @p1377, @p1378, @p1379, @p1380, @p1381, @p1382, @p1383, @p1384, @p1385, @p1386, @p1387, @p1388, @p1389, @p1390, @p1391, @p1392, @p1393, @p1394, @p1395, @p1396, @p1397, @p1398, @p1399, 24), (@p1400, @p1401, @p1402, @p1403, @p1404, @p1405, @p1406, @p1407, @p1408, @p1409, @p1410, @p1411, @p1412, @p1413, @p1414, @p1415, @p1416, @p1417, @p1418, @p1419, @p1420, @p1421, @p1422, @p1423, @p1424, @p1425, @p1426, @p1427, @p1428, @p1429, @p1430, @p1431, @p1432, @p1433, @p1434, @p1435, @p1436, @p1437, @p1438, @p1439, @p1440, @p1441, @p1442, @p1443, @p1444, @p1445, @p1446, @p1447, @p1448, @p1449, @p1450, @p1451, @p1452, @p1453, @p1454, @p1455, 25), (@p1456, @p1457, @p1458, @p1459, @p1460, @p1461, @p1462, @p1463, @p1464, @p1465, @p1466, @p1467, @p1468, @p1469, @p1470, @p1471, @p1472, @p1473, @p1474, @p1475, @p1476, @p1477, @p1478, @p1479, @p1480, @p1481, @p1482, @p1483, @p1484, @p1485, @p1486, @p1487, @p1488, @p1489, @p1490, @p1491, @p1492, @p1493, @p1494, @p1495, @p1496, @p1497, @p1498, @p1499, @p1500, @p1501, @p1502, @p1503, @p1504, @p1505, @p1506, @p1507, @p1508, @p1509, @p1510, @p1511, 26), (@p1512, @p1513, @p1514, @p1515, @p1516, @p1517, @p1518, @p1519, @p1520, @p1521, @p1522, @p1523, @p1524, @p1525, @p1526, @p1527, @p1528, @p1529, @p1530, @p1531, @p1532, @p1533, @p1534, @p1535, @p1536, @p1537, @p1538, @p1539, @p1540, @p1541, @p1542, @p1543, @p1544, @p1545, @p1546, @p1547, @p1548, @p1549, @p1550, @p1551, @p1552, @p1553, @p1554, @p1555, @p1556, @p1557, @p1558, @p1559, @p1560, @p1561, @p1562, @p1563, @p1564, @p1565, @p1566, @p1567, 27), (@p1568, @p1569, @p1570, @p1571, @p1572, @p1573, @p1574, @p1575, @p1576, @p1577, @p1578, @p1579, @p1580, @p1581, @p1582, @p1583, @p1584, @p1585, @p1586, @p1587, @p1588, @p1589, @p1590, @p1591, @p1592, @p1593, @p1594, @p1595, @p1596, @p1597, @p1598, @p1599, @p1600, @p1601, @p1602, @p1603, @p1604, @p1605, @p1606, @p1607, @p1608, @p1609, @p1610, @p1611, @p1612, @p1613, @p1614, @p1615, @p1616, @p1617, @p1618, @p1619, @p1620, @p1621, @p1622, @p1623, 28), (@p1624, @p1625, @p1626, @p1627, @p1628, @p1629, @p1630, @p1631, @p1632, @p1633, @p1634, @p1635, @p1636, @p1637, @p1638, @p1639, @p1640, @p1641, @p1642, @p1643, @p1644, @p1645, @p1646, @p1647, @p1648, @p1649, @p1650, @p1651, @p1652, @p1653, @p1654, @p1655, @p1656, @p1657, @p1658, @p1659, @p1660, @p1661, @p1662, @p1663, @p1664, @p1665, @p1666, @p1667, @p1668, @p1669, @p1670, @p1671, @p1672, @p1673, @p1674, @p1675, @p1676, @p1677, @p1678, @p1679, 29), (@p1680, @p1681, @p1682, @p1683, @p1684, @p1685, @p1686, @p1687, @p1688, @p1689, @p1690, @p1691, @p1692, @p1693, @p1694, @p1695, @p1696, @p1697, @p1698, @p1699, @p1700, @p1701, @p1702, @p1703, @p1704, @p1705, @p1706, @p1707, @p1708, @p1709, @p1710, @p1711, @p1712, @p1713, @p1714, @p1715, @p1716, @p1717, @p1718, @p1719, @p1720, @p1721, @p1722, @p1723, @p1724, @p1725, @p1726, @p1727, @p1728, @p1729, @p1730, @p1731, @p1732, @p1733, @p1734, @p1735, 30), (@p1736, @p1737, @p1738, @p1739, @p1740, @p1741, @p1742, @p1743, @p1744, @p1745, @p1746, @p1747, @p1748, @p1749, @p1750, @p1751, @p1752, @p1753, @p1754, @p1755, @p1756, @p1757, @p1758, @p1759, @p1760, @p1761, @p1762, @p1763, @p1764, @p1765, @p1766, @p1767, @p1768, @p1769, @p1770, @p1771, @p1772, @p1773, @p1774, @p1775, @p1776, @p1777, @p1778, @p1779, @p1780, @p1781, @p1782, @p1783, @p1784, @p1785, @p1786, @p1787, @p1788, @p1789, @p1790, @p1791, 31), (@p1792, @p1793, @p1794, @p1795, @p1796, @p1797, @p1798, @p1799, @p1800, @p1801, @p1802, @p1803, @p1804, @p1805, @p1806, @p1807, @p1808, @p1809, @p1810, @p1811, @p1812, @p1813, @p1814, @p1815, @p1816, @p1817, @p1818, @p1819, @p1820, @p1821, @p1822, @p1823, @p1824, @p1825, @p1826, @p1827, @p1828, @p1829, @p1830, @p1831, @p1832, @p1833, @p1834, @p1835, @p1836, @p1837, @p1838, @p1839, @p1840, @p1841, @p1842, @p1843, @p1844, @p1845, @p1846, @p1847, 32), (@p1848, @p1849, @p1850, @p1851, @p1852, @p1853, @p1854, @p1855, @p1856, @p1857, @p1858, @p1859, @p1860, @p1861, @p1862, @p1863, @p1864, @p1865, @p1866, @p1867, @p1868, @p1869, @p1870, @p1871, @p1872, @p1873, @p1874, @p1875, @p1876, @p1877, @p1878, @p1879, @p1880, @p1881, @p1882, @p1883, @p1884, @p1885, @p1886, @p1887, @p1888, @p1889, @p1890, @p1891, @p1892, @p1893, @p1894, @p1895, @p1896, @p1897, @p1898, @p1899, @p1900, @p1901, @p1902, @p1903, 33), (@p1904, @p1905, @p1906, @p1907, @p1908, @p1909, @p1910, @p1911, @p1912, @p1913, @p1914, @p1915, @p1916, @p1917, @p1918, @p1919, @p1920, @p1921, @p1922, @p1923, @p1924, @p1925, @p1926, @p1927, @p1928, @p1929, @p1930, @p1931, @p1932, @p1933, @p1934, @p1935, @p1936, @p1937, @p1938, @p1939, @p1940, @p1941, @p1942, @p1943, @p1944, @p1945, @p1946, @p1947, @p1948, @p1949, @p1950, @p1951, @p1952, @p1953, @p1954, @p1955, @p1956, @p1957, @p1958, @p1959, 34), (@p1960, @p1961, @p1962, @p1963, @p1964, @p1965, @p1966, @p1967, @p1968, @p1969, @p1970, @p1971, @p1972, @p1973, @p1974, @p1975, @p1976, @p1977, @p1978, @p1979, @p1980, @p1981, @p1982, @p1983, @p1984, @p1985, @p1986, @p1987, @p1988, @p1989, @p1990, @p1991, @p1992, @p1993, @p1994, @p1995, @p1996, @p1997, @p1998, @p1999, @p2000, @p2001, @p2002, @p2003, @p2004, @p2005, @p2006, @p2007, @p2008, @p2009, @p2010, @p2011, @p2012, @p2013, @p2014, @p2015, 35), (@p2016, @p2017, @p2018, @p2019, @p2020, @p2021, @p2022, @p2023, @p2024, @p2025, @p2026, @p2027, @p2028, @p2029, @p2030, @p2031, @p2032, @p2033, @p2034, @p2035, @p2036, @p2037, @p2038, @p2039, @p2040, @p2041, @p2042, @p2043, @p2044, @p2045, @p2046, @p2047, @p2048, @p2049, @p2050, @p2051, @p2052, @p2053, @p2054, @p2055, @p2056, @p2057, @p2058, @p2059, @p2060, @p2061, @p2062, @p2063, @p2064, @p2065, @p2066, @p2067, @p2068, @p2069, @p2070, @p2071, 36)) AS i ([addressee_cntry_cd], [addressee_city], [addressee_district], [addressee_email], [addressee_full_address], [addressee_home_address], [addressee_name], [addressee_postcode], [addressee_province], [addressee_subdistrict], [addressee_tel], [create_table], [delivery_code], [delivery_recipient_name], [delivery_relation_id], [delivery_status_id], [dest_outlet_id], [dest_outlet_port], [document_number], [item_barcode], [item_cod], [item_gross_weight], [item_height], [item_length], [item_price], [item_width], [lat], [log_id], [long], [outlet_id], [outlet_port], [podUrl], [remark], [scan_cntry_cd], [scan_cntry_postcode], [sender_cntry_cd], [sender_district], [sender_email], [sender_full_address], [sender_home_address], [member_id], [sender_name], [sender_postcode], [sender_province], [sender_subdistrict], [sender_tel], [server_id], [signatureUrl], [state], [status_code], [status_dtm], [timestamp], [transmit_dtm], [user_id], [wckt_id], [wkstn_no], _Position) ON 1=0 WHEN NOT MATCHED THEN INSERT ([addressee_cntry_cd], [addressee_city], [addressee_district], [addressee_email], [addressee_full_address], [addressee_home_address], [addressee_name], [addressee_postcode], [addressee_province], [addressee_subdistrict], [addressee_tel], [create_table], [delivery_code], [delivery_recipient_name], [delivery_relation_id], [delivery_status_id], [dest_outlet_id], [dest_outlet_port], [document_number], [item_barcode], [item_cod], [item_gross_weight], [item_height], [item_length], [item_price], [item_width], [lat], [log_id], [long], [outlet_id], [outlet_port], [podUrl], [remark], [scan_cntry_cd], [scan_cntry_postcode], [sender_cntry_cd], [sender_district], [sender_email], [sender_full_address], [sender_home_address], [member_id], [sender_name], [sender_postcode], [sender_province], [sender_subdistrict], [sender_tel], [server_id], [signatureUrl], [state], [status_code], [status_dtm], [timestamp], [transmit_dtm], [user_id], [wckt_id], [wkstn_no]) VALUES (i.[addressee_cntry_cd], i.[addressee_city], i.[addressee_district], i.[addressee_email], i.[addressee_full_address], i.[addressee_home_address], i.[addressee_name], i.[addressee_postcode], i.[addressee_province], i.[addressee_subdistrict], i.[addressee_tel], i.[create_table], i.[delivery_code], i.[delivery_recipient_name], i.[delivery_relation_id], i.[delivery_status_id], i.[dest_outlet_id], i.[dest_outlet_port], i.[document_number], i.[item_barcode], i.[item_cod], i.[item_gross_weight], i.[item_height], i.[item_length], i.[item_price], i.[item_width], i.[lat], i.[log_id], i.[long], i.[outlet_id], i.[outlet_port], i.[podUrl], i.[remark], i.[scan_cntry_cd], i.[scan_cntry_postcode], i.[sender_cntry_cd], i.[sender_district], i.[sender_email], i.[sender_full_address], i.[sender_home_address], i.[member_id], i.[sender_name], i.[sender_postcode], i.[sender_province], i.[sender_subdistrict], i.[sender_tel], i.[server_id], i.[signatureUrl], i.[state], i.[status_code], i.[status_dtm], i.[timestamp], i.[transmit_dtm], i.[user_id], i.[wckt_id], i.[wkstn_no]) OUTPUT INSERTED.[item_id], i._Position INTO @inserted0;  SELECT [t].[item_id] FROM [raw_data] t INNER JOIN @inserted0 i ON ([t].[item_id] = [i].[item_id]) ORDER BY [i].[_Position];  ",4,4,0,440,10,4
"(@p0 nvarchar(4000),@p1 nvarchar(4000),@p2 nvarchar(4000),@p3 nvarchar(4000),@p4 nvarchar(4000),@p5 nvarchar(4000),@p6 nvarchar(4000),@p7 nvarchar(4000),@p8 nvarchar(4000),@p9 nvarchar(4000),@p10 nvarchar(4000),@p11 datetime2(7),@p12 nvarchar(4000),@p13 nvarchar(4000),@p14 int,@p15 int,@p16 int,@p17 nvarchar(4000),@p18 nvarchar(4000),@p19 nvarchar(4000),@p20 nvarchar(4000),@p21 decimal(18,2),@p22 nvarchar(4000),@p23 nvarchar(4000),@p24 decimal(18,2),@p25 nvarchar(4000),@p26 nvarchar(4000),@p27 nvarchar(4000),@p28 nvarchar(4000),@p29 int,@p30 nvarchar(4000),@p31 nvarchar(4000),@p32 nvarchar(4000),@p33 nvarchar(4000),@p34 nvarchar(4000),@p35 nvarchar(4000),@p36 nvarchar(4000),@p37 nvarchar(4000),@p38 nvarchar(4000),@p39 nvarchar(4000),@p40 int,@p41 nvarchar(4000),@p42 nvarchar(4000),@p43 nvarchar(4000),@p44 nvarchar(4000),@p45 nvarchar(4000),@p46 int,@p47 nvarchar(4000),@p48 int,@p49 int,@p50 datetime2(7),@p51 datetime2(7),@p52 datetime2(7),@p53 nvarchar(4000),@p54 nvarchar(4000),@p55 nvarchar(4000),@p56 nvarchar(4000),@p57 nvarchar(4000),@p58 nvarchar(4000),@p59 nvarchar(4000),@p60 nvarchar(4000),@p61 nvarchar(4000),@p62 nvarchar(4000),@p63 nvarchar(4000),@p64 nvarchar(4000),@p65 nvarchar(4000),@p66 nvarchar(4000),@p67 datetime2(7),@p68 nvarchar(4000),@p69 nvarchar(4000),@p70 int,@p71 int,@p72 int,@p73 nvarchar(4000),@p74 nvarchar(4000),@p75 nvarchar(4000),@p76 nvarchar(4000),@p77 decimal(18,2),@p78 nvarchar(4000),@p79 nvarchar(4000),@p80 decimal(18,2),@p81 nvarchar(4000),@p82 nvarchar(4000),@p83 nvarchar(4000),@p84 nvarchar(4000),@p85 int,@p86 nvarchar(4000),@p87 nvarchar(4000),@p88 nvarchar(4000),@p89 nvarchar(4000),@p90 nvarchar(4000),@p91 nvarchar(4000),@p92 nvarchar(4000),@p93 nvarchar(4000),@p94 nvarchar(4000),@p95 nvarchar(4000),@p96 int,@p97 nvarchar(4000),@p98 nvarchar(4000),@p99 nvarchar(4000),@p100 nvarchar(4000),@p101 nvarchar(4000),@p102 int,@p103 nvarchar(4000),@p104 int,@p105 int,@p106 datetime2(7),@p107 datetime2(7),@p108 datetime2(7),@p109 nvarchar(4000),@p110 nvarchar(4000),@p111 nvarchar(4000),@p112 nvarchar(4000),@p113 nvarchar(4000),@p114 nvarchar(4000),@p115 nvarchar(4000),@p116 nvarchar(4000),@p117 nvarchar(4000),@p118 nvarchar(4000),@p119 nvarchar(4000),@p120 nvarchar(4000),@p121 nvarchar(4000),@p122 nvarchar(4000),@p123 datetime2(7),@p124 nvarchar(4000),@p125 nvarchar(4000),@p126 int,@p127 int,@p128 int,@p129 nvarchar(4000),@p130 nvarchar(4000),@p131 nvarchar(4000),@p132 nvarchar(4000),@p133 decimal(18,2),@p134 nvarchar(4000),@p135 nvarchar(4000),@p136 decimal(18,2),@p137 nvarchar(4000),@p138 nvarchar(4000),@p139 nvarchar(4000),@p140 nvarchar(4000),@p141 int,@p142 nvarchar(4000),@p143 nvarchar(4000),@p144 nvarchar(4000),@p145 nvarchar(4000),@p146 nvarchar(4000),@p147 nvarchar(4000),@p148 nvarchar(4000),@p149 nvarchar(4000),@p150 nvarchar(4000),@p151 nvarchar(4000),@p152 int,@p153 nvarchar(4000),@p154 nvarchar(4000),@p155 nvarchar(4000),@p156 nvarchar(4000),@p157 nvarchar(4000),@p158 int,@p159 nvarchar(4000),@p160 int,@p161 int,@p162 datetime2(7),@p163 datetime2(7),@p164 datetime2(7),@p165 nvarchar(4000),@p166 nvarchar(4000),@p167 nvarchar(4000),@p168 nvarchar(4000),@p169 nvarchar(4000),@p170 nvarchar(4000),@p171 nvarchar(4000),@p172 nvarchar(4000),@p173 nvarchar(4000),@p174 nvarchar(4000),@p175 nvarchar(4000),@p176 nvarchar(4000),@p177 nvarchar(4000),@p178 nvarchar(4000),@p179 datetime2(7),@p180 nvarchar(4000),@p181 nvarchar(4000),@p182 int,@p183 int,@p184 int,@p185 nvarchar(4000),@p186 nvarchar(4000),@p187 nvarchar(4000),@p188 nvarchar(4000),@p189 decimal(18,2),@p190 nvarchar(4000),@p191 nvarchar(4000),@p192 decimal(18,2),@p193 nvarchar(4000),@p194 nvarchar(4000),@p195 nvarchar(4000),@p196 nvarchar(4000),@p197 int,@p198 nvarchar(4000),@p199 nvarchar(4000),@p200 nvarchar(4000),@p201 nvarchar(4000),@p202 nvarchar(4000),@p203 nvarchar(4000),@p204 nvarchar(4000),@p205 nvarchar(4000),@p206 nvarchar(4000),@p207 nvarchar(4000),@p208 int,@p209 nvarchar(4000),@p210 nvarchar(4000),@p211 nvarchar(4000),@p212 nvarchar(4000),@p213 nvarchar(4000),@p214 int,@p215 nvarchar(4000),@p216 int,@p217 int,@p218 datetime2(7),@p219 datetime2(7),@p220 datetime2(7),@p221 nvarchar(4000),@p222 nvarchar(4000),@p223 nvarchar(4000),@p224 nvarchar(4000),@p225 nvarchar(4000),@p226 nvarchar(4000),@p227 nvarchar(4000),@p228 nvarchar(4000),@p229 nvarchar(4000),@p230 nvarchar(4000),@p231 nvarchar(4000),@p232 nvarchar(4000),@p233 nvarchar(4000),@p234 nvarchar(4000),@p235 datetime2(7),@p236 nvarchar(4000),@p237 nvarchar(4000),@p238 int,@p239 int,@p240 int,@p241 nvarchar(4000),@p242 nvarchar(4000),@p243 nvarchar(4000),@p244 nvarchar(4000),@p245 decimal(18,2),@p246 nvarchar(4000),@p247 nvarchar(4000),@p248 decimal(18,2),@p249 nvarchar(4000),@p250 nvarchar(4000),@p251 nvarchar(4000),@p252 nvarchar(4000),@p253 int,@p254 nvarchar(4000),@p255 nvarchar(4000),@p256 nvarchar(4000),@p257 nvarchar(4000),@p258 nvarchar(4000),@p259 nvarchar(4000),@p260 nvarchar(4000),@p261 nvarchar(4000),@p262 nvarchar(4000),@p263 nvarchar(4000),@p264 int,@p265 nvarchar(4000),@p266 nvarchar(4000),@p267 nvarchar(4000),@p268 nvarchar(4000),@p269 nvarchar(4000),@p270 int,@p271 nvarchar(4000),@p272 int,@p273 int,@p274 datetime2(7),@p275 datetime2(7),@p276 datetime2(7),@p277 nvarchar(4000),@p278 nvarchar(4000),@p279 nvarchar(4000),@p280 nvarchar(4000),@p281 nvarchar(4000),@p282 nvarchar(4000),@p283 nvarchar(4000),@p284 nvarchar(4000),@p285 nvarchar(4000),@p286 nvarchar(4000),@p287 nvarchar(4000),@p288 nvarchar(4000),@p289 nvarchar(4000),@p290 nvarchar(4000),@p291 datetime2(7),@p292 nvarchar(4000),@p293 nvarchar(4000),@p294 int,@p295 int,@p296 int,@p297 nvarchar(4000),@p298 nvarchar(4000),@p299 nvarchar(4000),@p300 nvarchar(4000),@p301 decimal(18,2),@p302 nvarchar(4000),@p303 nvarchar(4000),@p304 decimal(18,2),@p305 nvarchar(4000),@p306 nvarchar(4000),@p307 nvarchar(4000),@p308 nvarchar(4000),@p309 int,@p310 nvarchar(4000),@p311 nvarchar(4000),@p312 nvarchar(4000),@p313 nvarchar(4000),@p314 nvarchar(4000),@p315 nvarchar(4000),@p316 nvarchar(4000),@p317 nvarchar(4000),@p318 nvarchar(4000),@p319 nvarchar(4000),@p320 int,@p321 nvarchar(4000),@p322 nvarchar(4000),@p323 nvarchar(4000),@p324 nvarchar(4000),@p325 nvarchar(4000),@p326 int,@p327 nvarchar(4000),@p328 int,@p329 int,@p330 datetime2(7),@p331 datetime2(7),@p332 datetime2(7),@p333 nvarchar(4000),@p334 nvarchar(4000),@p335 nvarchar(4000),@p336 nvarchar(4000),@p337 nvarchar(4000),@p338 nvarchar(4000),@p339 nvarchar(4000),@p340 nvarchar(4000),@p341 nvarchar(4000),@p342 nvarchar(4000),@p343 nvarchar(4000),@p344 nvarchar(4000),@p345 nvarchar(4000),@p346 nvarchar(4000),@p347 datetime2(7),@p348 nvarchar(4000),@p349 nvarchar(4000),@p350 int,@p351 int,@p352 int,@p353 nvarchar(4000),@p354 nvarchar(4000),@p355 nvarchar(4000),@p356 nvarchar(4000),@p357 decimal(18,2),@p358 nvarchar(4000),@p359 nvarchar(4000),@p360 decimal(18,2),@p361 nvarchar(4000),@p362 nvarchar(4000),@p363 nvarchar(4000),@p364 nvarchar(4000),@p365 int,@p366 nvarchar(4000),@p367 nvarchar(4000),@p368 nvarchar(4000),@p369 nvarchar(4000),@p370 nvarchar(4000),@p371 nvarchar(4000),@p372 nvarchar(4000),@p373 nvarchar(4000),@p374 nvarchar(4000),@p375 nvarchar(4000),@p376 int,@p377 nvarchar(4000),@p378 nvarchar(4000),@p379 nvarchar(4000),@p380 nvarchar(4000),@p381 nvarchar(4000),@p382 int,@p383 nvarchar(4000),@p384 int,@p385 int,@p386 datetime2(7),@p387 datetime2(7),@p388 datetime2(7),@p389 nvarchar(4000),@p390 nvarchar(4000),@p391 nvarchar(4000),@p392 nvarchar(4000),@p393 nvarchar(4000),@p394 nvarchar(4000),@p395 nvarchar(4000),@p396 nvarchar(4000),@p397 nvarchar(4000),@p398 nvarchar(4000),@p399 nvarchar(4000),@p400 nvarchar(4000),@p401 nvarchar(4000),@p402 nvarchar(4000),@p403 datetime2(7),@p404 nvarchar(4000),@p405 nvarchar(4000),@p406 int,@p407 int,@p408 int,@p409 nvarchar(4000),@p410 nvarchar(4000),@p411 nvarchar(4000),@p412 nvarchar(4000),@p413 decimal(18,2),@p414 nvarchar(4000),@p415 nvarchar(4000),@p416 decimal(18,2),@p417 nvarchar(4000),@p418 nvarchar(4000),@p419 nvarchar(4000),@p420 nvarchar(4000),@p421 int,@p422 nvarchar(4000),@p423 nvarchar(4000),@p424 nvarchar(4000),@p425 nvarchar(4000),@p426 nvarchar(4000),@p427 nvarchar(4000),@p428 nvarchar(4000),@p429 nvarchar(4000),@p430 nvarchar(4000),@p431 nvarchar(4000),@p432 int,@p433 nvarchar(4000),@p434 nvarchar(4000),@p435 nvarchar(4000),@p436 nvarchar(4000),@p437 nvarchar(4000),@p438 int,@p439 nvarchar(4000),@p440 int,@p441 int,@p442 datetime2(7),@p443 datetime2(7),@p444 datetime2(7),@p445 nvarchar(4000),@p446 nvarchar(4000),@p447 nvarchar(4000),@p448 nvarchar(4000),@p449 nvarchar(4000),@p450 nvarchar(4000),@p451 nvarchar(4000),@p452 nvarchar(4000),@p453 nvarchar(4000),@p454 nvarchar(4000),@p455 nvarchar(4000),@p456 nvarchar(4000),@p457 nvarchar(4000),@p458 nvarchar(4000),@p459 datetime2(7),@p460 nvarchar(4000),@p461 nvarchar(4000),@p462 int,@p463 int,@p464 int,@p465 nvarchar(4000),@p466 nvarchar(4000),@p467 nvarchar(4000),@p468 nvarchar(4000),@p469 decimal(18,2),@p470 nvarchar(4000),@p471 nvarchar(4000),@p472 decimal(18,2),@p473 nvarchar(4000),@p474 nvarchar(4000),@p475 nvarchar(4000),@p476 nvarchar(4000),@p477 int,@p478 nvarchar(4000),@p479 nvarchar(4000),@p480 nvarchar(4000),@p481 nvarchar(4000),@p482 nvarchar(4000),@p483 nvarchar(4000),@p484 nvarchar(4000),@p485 nvarchar(4000),@p486 nvarchar(4000),@p487 nvarchar(4000),@p488 int,@p489 nvarchar(4000),@p490 nvarchar(4000),@p491 nvarchar(4000),@p492 nvarchar(4000),@p493 nvarchar(4000),@p494 int,@p495 nvarchar(4000),@p496 int,@p497 int,@p498 datetime2(7),@p499 datetime2(7),@p500 datetime2(7),@p501 nvarchar(4000),@p502 nvarchar(4000),@p503 nvarchar(4000),@p504 nvarchar(4000),@p505 nvarchar(4000),@p506 nvarchar(4000),@p507 nvarchar(4000),@p508 nvarchar(4000),@p509 nvarchar(4000),@p510 nvarchar(4000),@p511 nvarchar(4000),@p512 nvarchar(4000),@p513 nvarchar(4000),@p514 nvarchar(4000),@p515 datetime2(7),@p516 nvarchar(4000),@p517 nvarchar(4000),@p518 int,@p519 int,@p520 int,@p521 nvarchar(4000),@p522 nvarchar(4000),@p523 nvarchar(4000),@p524 nvarchar(4000),@p525 decimal(18,2),@p526 nvarchar(4000),@p527 nvarchar(4000),@p528 decimal(18,2),@p529 nvarchar(4000),@p530 nvarchar(4000),@p531 nvarchar(4000),@p532 nvarchar(4000),@p533 int,@p534 nvarchar(4000),@p535 nvarchar(4000),@p536 nvarchar(4000),@p537 nvarchar(4000),@p538 nvarchar(4000),@p539 nvarchar(4000),@p540 nvarchar(4000),@p541 nvarchar(4000),@p542 nvarchar(4000),@p543 nvarchar(4000),@p544 int,@p545 nvarchar(4000),@p546 nvarchar(4000),@p547 nvarchar(4000),@p548 nvarchar(4000),@p549 nvarchar(4000),@p550 int,@p551 nvarchar(4000),@p552 int,@p553 int,@p554 datetime2(7),@p555 datetime2(7),@p556 datetime2(7),@p557 nvarchar(4000),@p558 nvarchar(4000),@p559 nvarchar(4000),@p560 nvarchar(4000),@p561 nvarchar(4000),@p562 nvarchar(4000),@p563 nvarchar(4000),@p564 nvarchar(4000),@p565 nvarchar(4000),@p566 nvarchar(4000),@p567 nvarchar(4000),@p568 nvarchar(4000),@p569 nvarchar(4000),@p570 nvarchar(4000),@p571 datetime2(7),@p572 nvarchar(4000),@p573 nvarchar(4000),@p574 int,@p575 int,@p576 int,@p577 nvarchar(4000),@p578 nvarchar(4000),@p579 nvarchar(4000),@p580 nvarchar(4000),@p581 decimal(18,2),@p582 nvarchar(4000),@p583 nvarchar(4000),@p584 decimal(18,2),@p585 nvarchar(4000),@p586 nvarchar(4000),@p587 nvarchar(4000),@p588 nvarchar(4000),@p589 int,@p590 nvarchar(4000),@p591 nvarchar(4000),@p592 nvarchar(4000),@p593 nvarchar(4000),@p594 nvarchar(4000),@p595 nvarchar(4000),@p596 nvarchar(4000),@p597 nvarchar(4000),@p598 nvarchar(4000),@p599 nvarchar(4000),@p600 int,@p601 nvarchar(4000),@p602 nvarchar(4000),@p603 nvarchar(4000),@p604 nvarchar(4000),@p605 nvarchar(4000),@p606 int,@p607 nvarchar(4000),@p608 int,@p609 int,@p610 datetime2(7),@p611 datetime2(7),@p612 datetime2(7),@p613 nvarchar(4000),@p614 nvarchar(4000),@p615 nvarchar(4000),@p616 nvarchar(4000),@p617 nvarchar(4000),@p618 nvarchar(4000),@p619 nvarchar(4000),@p620 nvarchar(4000),@p621 nvarchar(4000),@p622 nvarchar(4000),@p623 nvarchar(4000),@p624 nvarchar(4000),@p625 nvarchar(4000),@p626 nvarchar(4000),@p627 datetime2(7),@p628 nvarchar(4000),@p629 nvarchar(4000),@p630 int,@p631 int,@p632 int,@p633 nvarchar(4000),@p634 nvarchar(4000),@p635 nvarchar(4000),@p636 nvarchar(4000),@p637 decimal(18,2),@p638 nvarchar(4000),@p639 nvarchar(4000),@p640 decimal(18,2),@p641 nvarchar(4000),@p642 nvarchar(4000),@p643 nvarchar(4000),@p644 nvarchar(4000),@p645 int,@p646 nvarchar(4000),@p647 nvarchar(4000),@p648 nvarchar(4000),@p649 nvarchar(4000),@p650 nvarchar(4000),@p651 nvarchar(4000),@p652 nvarchar(4000),@p653 nvarchar(4000),@p654 nvarchar(4000),@p655 nvarchar(4000),@p656 int,@p657 nvarchar(4000),@p658 nvarchar(4000),@p659 nvarchar(4000),@p660 nvarchar(4000),@p661 nvarchar(4000),@p662 int,@p663 nvarchar(4000),@p664 int,@p665 int,@p666 datetime2(7),@p667 datetime2(7),@p668 datetime2(7),@p669 nvarchar(4000),@p670 nvarchar(4000),@p671 nvarchar(4000),@p672 nvarchar(4000),@p673 nvarchar(4000),@p674 nvarchar(4000),@p675 nvarchar(4000),@p676 nvarchar(4000),@p677 nvarchar(4000),@p678 nvarchar(4000),@p679 nvarchar(4000),@p680 nvarchar(4000),@p681 nvarchar(4000),@p682 nvarchar(4000),@p683 datetime2(7),@p684 nvarchar(4000),@p685 nvarchar(4000),@p686 int,@p687 int,@p688 int,@p689 nvarchar(4000),@p690 nvarchar(4000),@p691 nvarchar(4000),@p692 nvarchar(4000),@p693 decimal(18,2),@p694 nvarchar(4000),@p695 nvarchar(4000),@p696 decimal(18,2),@p697 nvarchar(4000),@p698 nvarchar(4000),@p699 nvarchar(4000),@p700 nvarchar(4000),@p701 int,@p702 nvarchar(4000),@p703 nvarchar(4000),@p704 nvarchar(4000),@p705 nvarchar(4000),@p706 nvarchar(4000),@p707 nvarchar(4000),@p708 nvarchar(4000),@p709 nvarchar(4000),@p710 nvarchar(4000),@p711 nvarchar(4000),@p712 int,@p713 nvarchar(4000),@p714 nvarchar(4000),@p715 nvarchar(4000),@p716 nvarchar(4000),@p717 nvarchar(4000),@p718 int,@p719 nvarchar(4000),@p720 int,@p721 int,@p722 datetime2(7),@p723 datetime2(7),@p724 datetime2(7),@p725 nvarchar(4000),@p726 nvarchar(4000),@p727 nvarchar(4000),@p728 nvarchar(4000),@p729 nvarchar(4000),@p730 nvarchar(4000),@p731 nvarchar(4000),@p732 nvarchar(4000),@p733 nvarchar(4000),@p734 nvarchar(4000),@p735 nvarchar(4000),@p736 nvarchar(4000),@p737 nvarchar(4000),@p738 nvarchar(4000),@p739 datetime2(7),@p740 nvarchar(4000),@p741 nvarchar(4000),@p742 int,@p743 int,@p744 int,@p745 nvarchar(4000),@p746 nvarchar(4000),@p747 nvarchar(4000),@p748 nvarchar(4000),@p749 decimal(18,2),@p750 nvarchar(4000),@p751 nvarchar(4000),@p752 decimal(18,2),@p753 nvarchar(4000),@p754 nvarchar(4000),@p755 nvarchar(4000),@p756 nvarchar(4000),@p757 int,@p758 nvarchar(4000),@p759 nvarchar(4000),@p760 nvarchar(4000),@p761 nvarchar(4000),@p762 nvarchar(4000),@p763 nvarchar(4000),@p764 nvarchar(4000),@p765 nvarchar(4000),@p766 nvarchar(4000),@p767 nvarchar(4000),@p768 int,@p769 nvarchar(4000),@p770 nvarchar(4000),@p771 nvarchar(4000),@p772 nvarchar(4000),@p773 nvarchar(4000),@p774 int,@p775 nvarchar(4000),@p776 int,@p777 int,@p778 datetime2(7),@p779 datetime2(7),@p780 datetime2(7),@p781 nvarchar(4000),@p782 nvarchar(4000),@p783 nvarchar(4000),@p784 nvarchar(4000),@p785 nvarchar(4000),@p786 nvarchar(4000),@p787 nvarchar(4000),@p788 nvarchar(4000),@p789 nvarchar(4000),@p790 nvarchar(4000),@p791 nvarchar(4000),@p792 nvarchar(4000),@p793 nvarchar(4000),@p794 nvarchar(4000),@p795 datetime2(7),@p796 nvarchar(4000),@p797 nvarchar(4000),@p798 int,@p799 int,@p800 int,@p801 nvarchar(4000),@p802 nvarchar(4000),@p803 nvarchar(4000),@p804 nvarchar(4000),@p805 decimal(18,2),@p806 nvarchar(4000),@p807 nvarchar(4000),@p808 decimal(18,2),@p809 nvarchar(4000),@p810 nvarchar(4000),@p811 nvarchar(4000),@p812 nvarchar(4000),@p813 int,@p814 nvarchar(4000),@p815 nvarchar(4000),@p816 nvarchar(4000),@p817 nvarchar(4000),@p818 nvarchar(4000),@p819 nvarchar(4000),@p820 nvarchar(4000),@p821 nvarchar(4000),@p822 nvarchar(4000),@p823 nvarchar(4000),@p824 int,@p825 nvarchar(4000),@p826 nvarchar(4000),@p827 nvarchar(4000),@p828 nvarchar(4000),@p829 nvarchar(4000),@p830 int,@p831 nvarchar(4000),@p832 int,@p833 int,@p834 datetime2(7),@p835 datetime2(7),@p836 datetime2(7),@p837 nvarchar(4000),@p838 nvarchar(4000),@p839 nvarchar(4000),@p840 nvarchar(4000),@p841 nvarchar(4000),@p842 nvarchar(4000),@p843 nvarchar(4000),@p844 nvarchar(4000),@p845 nvarchar(4000),@p846 nvarchar(4000),@p847 nvarchar(4000),@p848 nvarchar(4000),@p849 nvarchar(4000),@p850 nvarchar(4000),@p851 datetime2(7),@p852 nvarchar(4000),@p853 nvarchar(4000),@p854 int,@p855 int,@p856 int,@p857 nvarchar(4000),@p858 nvarchar(4000),@p859 nvarchar(4000),@p860 nvarchar(4000),@p861 decimal(18,2),@p862 nvarchar(4000),@p863 nvarchar(4000),@p864 decimal(18,2),@p865 nvarchar(4000),@p866 nvarchar(4000),@p867 nvarchar(4000),@p868 nvarchar(4000),@p869 int,@p870 nvarchar(4000),@p871 nvarchar(4000),@p872 nvarchar(4000),@p873 nvarchar(4000),@p874 nvarchar(4000),@p875 nvarchar(4000),@p876 nvarchar(4000),@p877 nvarchar(4000),@p878 nvarchar(4000),@p879 nvarchar(4000),@p880 int,@p881 nvarchar(4000),@p882 nvarchar(4000),@p883 nvarchar(4000),@p884 nvarchar(4000),@p885 nvarchar(4000),@p886 int,@p887 nvarchar(4000),@p888 int,@p889 int,@p890 datetime2(7),@p891 datetime2(7),@p892 datetime2(7),@p893 nvarchar(4000),@p894 nvarchar(4000),@p895 nvarchar(4000),@p896 nvarchar(4000),@p897 nvarchar(4000),@p898 nvarchar(4000),@p899 nvarchar(4000),@p900 nvarchar(4000),@p901 nvarchar(4000),@p902 nvarchar(4000),@p903 nvarchar(4000),@p904 nvarchar(4000),@p905 nvarchar(4000),@p906 nvarchar(4000),@p907 datetime2(7),@p908 nvarchar(4000),@p909 nvarchar(4000),@p910 int,@p911 int,@p912 int,@p913 nvarchar(4000),@p914 nvarchar(4000),@p915 nvarchar(4000),@p916 nvarchar(4000),@p917 decimal(18,2),@p918 nvarchar(4000),@p919 nvarchar(4000),@p920 decimal(18,2),@p921 nvarchar(4000),@p922 nvarchar(4000),@p923 nvarchar(4000),@p924 nvarchar(4000),@p925 int,@p926 nvarchar(4000),@p927 nvarchar(4000),@p928 nvarchar(4000),@p929 nvarchar(4000),@p930 nvarchar(4000),@p931 nvarchar(4000),@p932 nvarchar(4000),@p933 nvarchar(4000),@p934 nvarchar(4000),@p935 nvarchar(4000),@p936 int,@p937 nvarchar(4000),@p938 nvarchar(4000),@p939 nvarchar(4000),@p940 nvarchar(4000),@p941 nvarchar(4000),@p942 int,@p943 nvarchar(4000),@p944 int,@p945 int,@p946 datetime2(7),@p947 datetime2(7),@p948 datetime2(7),@p949 nvarchar(4000),@p950 nvarchar(4000),@p951 nvarchar(4000),@p952 nvarchar(4000),@p953 nvarchar(4000),@p954 nvarchar(4000),@p955 nvarchar(4000),@p956 nvarchar(4000),@p957 nvarchar(4000),@p958 nvarchar(4000),@p959 nvarchar(4000),@p960 nvarchar(4000),@p961 nvarchar(4000),@p962 nvarchar(4000),@p963 datetime2(7),@p964 nvarchar(4000),@p965 nvarchar(4000),@p966 int,@p967 int,@p968 int,@p969 nvarchar(4000),@p970 nvarchar(4000),@p971 nvarchar(4000),@p972 nvarchar(4000),@p973 decimal(18,2),@p974 nvarchar(4000),@p975 nvarchar(4000),@p976 decimal(18,2),@p977 nvarchar(4000),@p978 nvarchar(4000),@p979 nvarchar(4000),@p980 nvarchar(4000),@p981 int,@p982 nvarchar(4000),@p983 nvarchar(4000),@p984 nvarchar(4000),@p985 nvarchar(4000),@p986 nvarchar(4000),@p987 nvarchar(4000),@p988 nvarchar(4000),@p989 nvarchar(4000),@p990 nvarchar(4000),@p991 nvarchar(4000),@p992 int,@p993 nvarchar(4000),@p994 nvarchar(4000),@p995 nvarchar(4000),@p996 nvarchar(4000),@p997 nvarchar(4000),@p998 int,@p999 nvarchar(4000),@p1000 int,@p1001 int,@p1002 datetime2(7),@p1003 datetime2(7),@p1004 datetime2(7),@p1005 nvarchar(4000),@p1006 nvarchar(4000),@p1007 nvarchar(4000),@p1008 nvarchar(4000),@p1009 nvarchar(4000),@p1010 nvarchar(4000),@p1011 nvarchar(4000),@p1012 nvarchar(4000),@p1013 nvarchar(4000),@p1014 nvarchar(4000),@p1015 nvarchar(4000),@p1016 nvarchar(4000),@p1017 nvarchar(4000),@p1018 nvarchar(4000),@p1019 datetime2(7),@p1020 nvarchar(4000),@p1021 nvarchar(4000),@p1022 int,@p1023 int,@p1024 int,@p1025 nvarchar(4000),@p1026 nvarchar(4000),@p1027 nvarchar(4000),@p1028 nvarchar(4000),@p1029 decimal(18,2),@p1030 nvarchar(4000),@p1031 nvarchar(4000),@p1032 decimal(18,2),@p1033 nvarchar(4000),@p1034 nvarchar(4000),@p1035 nvarchar(4000),@p1036 nvarchar(4000),@p1037 int,@p1038 nvarchar(4000),@p1039 nvarchar(4000),@p1040 nvarchar(4000),@p1041 nvarchar(4000),@p1042 nvarchar(4000),@p1043 nvarchar(4000),@p1044 nvarchar(4000),@p1045 nvarchar(4000),@p1046 nvarchar(4000),@p1047 nvarchar(4000),@p1048 int,@p1049 nvarchar(4000),@p1050 nvarchar(4000),@p1051 nvarchar(4000),@p1052 nvarchar(4000),@p1053 nvarchar(4000),@p1054 int,@p1055 nvarchar(4000),@p1056 int,@p1057 int,@p1058 datetime2(7),@p1059 datetime2(7),@p1060 datetime2(7),@p1061 nvarchar(4000),@p1062 nvarchar(4000),@p1063 nvarchar(4000),@p1064 nvarchar(4000),@p1065 nvarchar(4000),@p1066 nvarchar(4000),@p1067 nvarchar(4000),@p1068 nvarchar(4000),@p1069 nvarchar(4000),@p1070 nvarchar(4000),@p1071 nvarchar(4000),@p1072 nvarchar(4000),@p1073 nvarchar(4000),@p1074 nvarchar(4000),@p1075 datetime2(7),@p1076 nvarchar(4000),@p1077 nvarchar(4000),@p1078 int,@p1079 int,@p1080 int,@p1081 nvarchar(4000),@p1082 nvarchar(4000),@p1083 nvarchar(4000),@p1084 nvarchar(4000),@p1085 decimal(18,2),@p1086 nvarchar(4000),@p1087 nvarchar(4000),@p1088 decimal(18,2),@p1089 nvarchar(4000),@p1090 nvarchar(4000),@p1091 nvarchar(4000),@p1092 nvarchar(4000),@p1093 int,@p1094 nvarchar(4000),@p1095 nvarchar(4000),@p1096 nvarchar(4000),@p1097 nvarchar(4000),@p1098 nvarchar(4000),@p1099 nvarchar(4000),@p1100 nvarchar(4000),@p1101 nvarchar(4000),@p1102 nvarchar(4000),@p1103 nvarchar(4000),@p1104 int,@p1105 nvarchar(4000),@p1106 nvarchar(4000),@p1107 nvarchar(4000),@p1108 nvarchar(4000),@p1109 nvarchar(4000),@p1110 int,@p1111 nvarchar(4000),@p1112 int,@p1113 int,@p1114 datetime2(7),@p1115 datetime2(7),@p1116 datetime2(7),@p1117 nvarchar(4000),@p1118 nvarchar(4000),@p1119 nvarchar(4000),@p1120 nvarchar(4000),@p1121 nvarchar(4000),@p1122 nvarchar(4000),@p1123 nvarchar(4000),@p1124 nvarchar(4000),@p1125 nvarchar(4000),@p1126 nvarchar(4000),@p1127 nvarchar(4000),@p1128 nvarchar(4000),@p1129 nvarchar(4000),@p1130 nvarchar(4000),@p1131 datetime2(7),@p1132 nvarchar(4000),@p1133 nvarchar(4000),@p1134 int,@p1135 int,@p1136 int,@p1137 nvarchar(4000),@p1138 nvarchar(4000),@p1139 nvarchar(4000),@p1140 nvarchar(4000),@p1141 decimal(18,2),@p1142 nvarchar(4000),@p1143 nvarchar(4000),@p1144 decimal(18,2),@p1145 nvarchar(4000),@p1146 nvarchar(4000),@p1147 nvarchar(4000),@p1148 nvarchar(4000),@p1149 int,@p1150 nvarchar(4000),@p1151 nvarchar(4000),@p1152 nvarchar(4000),@p1153 nvarchar(4000),@p1154 nvarchar(4000),@p1155 nvarchar(4000),@p1156 nvarchar(4000),@p1157 nvarchar(4000),@p1158 nvarchar(4000),@p1159 nvarchar(4000),@p1160 int,@p1161 nvarchar(4000),@p1162 nvarchar(4000),@p1163 nvarchar(4000),@p1164 nvarchar(4000),@p1165 nvarchar(4000),@p1166 int,@p1167 nvarchar(4000),@p1168 int,@p1169 int,@p1170 datetime2(7),@p1171 datetime2(7),@p1172 datetime2(7),@p1173 nvarchar(4000),@p1174 nvarchar(4000),@p1175 nvarchar(4000),@p1176 nvarchar(4000),@p1177 nvarchar(4000),@p1178 nvarchar(4000),@p1179 nvarchar(4000),@p1180 nvarchar(4000),@p1181 nvarchar(4000),@p1182 nvarchar(4000),@p1183 nvarchar(4000),@p1184 nvarchar(4000),@p1185 nvarchar(4000),@p1186 nvarchar(4000),@p1187 datetime2(7),@p1188 nvarchar(4000),@p1189 nvarchar(4000),@p1190 int,@p1191 int,@p1192 int,@p1193 nvarchar(4000),@p1194 nvarchar(4000),@p1195 nvarchar(4000),@p1196 nvarchar(4000),@p1197 decimal(18,2),@p1198 nvarchar(4000),@p1199 nvarchar(4000),@p1200 decimal(18,2),@p1201 nvarchar(4000),@p1202 nvarchar(4000),@p1203 nvarchar(4000),@p1204 nvarchar(4000),@p1205 int,@p1206 nvarchar(4000),@p1207 nvarchar(4000),@p1208 nvarchar(4000),@p1209 nvarchar(4000),@p1210 nvarchar(4000),@p1211 nvarchar(4000),@p1212 nvarchar(4000),@p1213 nvarchar(4000),@p1214 nvarchar(4000),@p1215 nvarchar(4000),@p1216 int,@p1217 nvarchar(4000),@p1218 nvarchar(4000),@p1219 nvarchar(4000),@p1220 nvarchar(4000),@p1221 nvarchar(4000),@p1222 int,@p1223 nvarchar(4000),@p1224 int,@p1225 int,@p1226 datetime2(7),@p1227 datetime2(7),@p1228 datetime2(7),@p1229 nvarchar(4000),@p1230 nvarchar(4000),@p1231 nvarchar(4000),@p1232 nvarchar(4000),@p1233 nvarchar(4000),@p1234 nvarchar(4000),@p1235 nvarchar(4000),@p1236 nvarchar(4000),@p1237 nvarchar(4000),@p1238 nvarchar(4000),@p1239 nvarchar(4000),@p1240 nvarchar(4000),@p1241 nvarchar(4000),@p1242 nvarchar(4000),@p1243 datetime2(7),@p1244 nvarchar(4000),@p1245 nvarchar(4000),@p1246 int,@p1247 int,@p1248 int,@p1249 nvarchar(4000),@p1250 nvarchar(4000),@p1251 nvarchar(4000),@p1252 nvarchar(4000),@p1253 decimal(18,2),@p1254 nvarchar(4000),@p1255 nvarchar(4000),@p1256 decimal(18,2),@p1257 nvarchar(4000),@p1258 nvarchar(4000),@p1259 nvarchar(4000),@p1260 nvarchar(4000),@p1261 int,@p1262 nvarchar(4000),@p1263 nvarchar(4000),@p1264 nvarchar(4000),@p1265 nvarchar(4000),@p1266 nvarchar(4000),@p1267 nvarchar(4000),@p1268 nvarchar(4000),@p1269 nvarchar(4000),@p1270 nvarchar(4000),@p1271 nvarchar(4000),@p1272 int,@p1273 nvarchar(4000),@p1274 nvarchar(4000),@p1275 nvarchar(4000),@p1276 nvarchar(4000),@p1277 nvarchar(4000),@p1278 int,@p1279 nvarchar(4000),@p1280 int,@p1281 int,@p1282 datetime2(7),@p1283 datetime2(7),@p1284 datetime2(7),@p1285 nvarchar(4000),@p1286 nvarchar(4000),@p1287 nvarchar(4000),@p1288 nvarchar(4000),@p1289 nvarchar(4000),@p1290 nvarchar(4000),@p1291 nvarchar(4000),@p1292 nvarchar(4000),@p1293 nvarchar(4000),@p1294 nvarchar(4000),@p1295 nvarchar(4000),@p1296 nvarchar(4000),@p1297 nvarchar(4000),@p1298 nvarchar(4000),@p1299 datetime2(7),@p1300 nvarchar(4000),@p1301 nvarchar(4000),@p1302 int,@p1303 int,@p1304 int,@p1305 nvarchar(4000),@p1306 nvarchar(4000),@p1307 nvarchar(4000),@p1308 nvarchar(4000),@p1309 decimal(18,2),@p1310 nvarchar(4000),@p1311 nvarchar(4000),@p1312 decimal(18,2),@p1313 nvarchar(4000),@p1314 nvarchar(4000),@p1315 nvarchar(4000),@p1316 nvarchar(4000),@p1317 int,@p1318 nvarchar(4000),@p1319 nvarchar(4000),@p1320 nvarchar(4000),@p1321 nvarchar(4000),@p1322 nvarchar(4000),@p1323 nvarchar(4000),@p1324 nvarchar(4000),@p1325 nvarchar(4000),@p1326 nvarchar(4000),@p1327 nvarchar(4000),@p1328 int,@p1329 nvarchar(4000),@p1330 nvarchar(4000),@p1331 nvarchar(4000),@p1332 nvarchar(4000),@p1333 nvarchar(4000),@p1334 int,@p1335 nvarchar(4000),@p1336 int,@p1337 int,@p1338 datetime2(7),@p1339 datetime2(7),@p1340 datetime2(7),@p1341 nvarchar(4000),@p1342 nvarchar(4000),@p1343 nvarchar(4000),@p1344 nvarchar(4000),@p1345 nvarchar(4000),@p1346 nvarchar(4000),@p1347 nvarchar(4000),@p1348 nvarchar(4000),@p1349 nvarchar(4000),@p1350 nvarchar(4000),@p1351 nvarchar(4000),@p1352 nvarchar(4000),@p1353 nvarchar(4000),@p1354 nvarchar(4000),@p1355 datetime2(7),@p1356 nvarchar(4000),@p1357 nvarchar(4000),@p1358 int,@p1359 int,@p1360 int,@p1361 nvarchar(4000),@p1362 nvarchar(4000),@p1363 nvarchar(4000),@p1364 nvarchar(4000),@p1365 decimal(18,2),@p1366 nvarchar(4000),@p1367 nvarchar(4000),@p1368 decimal(18,2),@p1369 nvarchar(4000),@p1370 nvarchar(4000),@p1371 nvarchar(4000),@p1372 nvarchar(4000),@p1373 int,@p1374 nvarchar(4000),@p1375 nvarchar(4000),@p1376 nvarchar(4000),@p1377 nvarchar(4000),@p1378 nvarchar(4000),@p1379 nvarchar(4000),@p1380 nvarchar(4000),@p1381 nvarchar(4000),@p1382 nvarchar(4000),@p1383 nvarchar(4000),@p1384 int,@p1385 nvarchar(4000),@p1386 nvarchar(4000),@p1387 nvarchar(4000),@p1388 nvarchar(4000),@p1389 nvarchar(4000),@p1390 int,@p1391 nvarchar(4000),@p1392 int,@p1393 int,@p1394 datetime2(7),@p1395 datetime2(7),@p1396 datetime2(7),@p1397 nvarchar(4000),@p1398 nvarchar(4000),@p1399 nvarchar(4000),@p1400 nvarchar(4000),@p1401 nvarchar(4000),@p1402 nvarchar(4000),@p1403 nvarchar(4000),@p1404 nvarchar(4000),@p1405 nvarchar(4000),@p1406 nvarchar(4000),@p1407 nvarchar(4000),@p1408 nvarchar(4000),@p1409 nvarchar(4000),@p1410 nvarchar(4000),@p1411 datetime2(7),@p1412 nvarchar(4000),@p1413 nvarchar(4000),@p1414 int,@p1415 int,@p1416 int,@p1417 nvarchar(4000),@p1418 nvarchar(4000),@p1419 nvarchar(4000),@p1420 nvarchar(4000),@p1421 decimal(18,2),@p1422 nvarchar(4000),@p1423 nvarchar(4000),@p1424 decimal(18,2),@p1425 nvarchar(4000),@p1426 nvarchar(4000),@p1427 nvarchar(4000),@p1428 nvarchar(4000),@p1429 int,@p1430 nvarchar(4000),@p1431 nvarchar(4000),@p1432 nvarchar(4000),@p1433 nvarchar(4000),@p1434 nvarchar(4000),@p1435 nvarchar(4000),@p1436 nvarchar(4000),@p1437 nvarchar(4000),@p1438 nvarchar(4000),@p1439 nvarchar(4000),@p1440 int,@p1441 nvarchar(4000),@p1442 nvarchar(4000),@p1443 nvarchar(4000),@p1444 nvarchar(4000),@p1445 nvarchar(4000),@p1446 int,@p1447 nvarchar(4000),@p1448 int,@p1449 int,@p1450 datetime2(7),@p1451 datetime2(7),@p1452 datetime2(7),@p1453 nvarchar(4000),@p1454 nvarchar(4000),@p1455 nvarchar(4000),@p1456 nvarchar(4000),@p1457 nvarchar(4000),@p1458 nvarchar(4000),@p1459 nvarchar(4000),@p1460 nvarchar(4000),@p1461 nvarchar(4000),@p1462 nvarchar(4000),@p1463 nvarchar(4000),@p1464 nvarchar(4000),@p1465 nvarchar(4000),@p1466 nvarchar(4000),@p1467 datetime2(7),@p1468 nvarchar(4000),@p1469 nvarchar(4000),@p1470 int,@p1471 int,@p1472 int,@p1473 nvarchar(4000),@p1474 nvarchar(4000),@p1475 nvarchar(4000),@p1476 nvarchar(4000),@p1477 decimal(18,2),@p1478 nvarchar(4000),@p1479 nvarchar(4000),@p1480 decimal(18,2),@p1481 nvarchar(4000),@p1482 nvarchar(4000),@p1483 nvarchar(4000),@p1484 nvarchar(4000),@p1485 int,@p1486 nvarchar(4000),@p1487 nvarchar(4000),@p1488 nvarchar(4000),@p1489 nvarchar(4000),@p1490 nvarchar(4000),@p1491 nvarchar(4000),@p1492 nvarchar(4000),@p1493 nvarchar(4000),@p1494 nvarchar(4000),@p1495 nvarchar(4000),@p1496 int,@p1497 nvarchar(4000),@p1498 nvarchar(4000),@p1499 nvarchar(4000),@p1500 nvarchar(4000),@p1501 nvarchar(4000),@p1502 int,@p1503 nvarchar(4000),@p1504 int,@p1505 int,@p1506 datetime2(7),@p1507 datetime2(7),@p1508 datetime2(7),@p1509 nvarchar(4000),@p1510 nvarchar(4000),@p1511 nvarchar(4000),@p1512 nvarchar(4000),@p1513 nvarchar(4000),@p1514 nvarchar(4000),@p1515 nvarchar(4000),@p1516 nvarchar(4000),@p1517 nvarchar(4000),@p1518 nvarchar(4000),@p1519 nvarchar(4000),@p1520 nvarchar(4000),@p1521 nvarchar(4000),@p1522 nvarchar(4000),@p1523 datetime2(7),@p1524 nvarchar(4000),@p1525 nvarchar(4000),@p1526 int,@p1527 int,@p1528 int,@p1529 nvarchar(4000),@p1530 nvarchar(4000),@p1531 nvarchar(4000),@p1532 nvarchar(4000),@p1533 decimal(18,2),@p1534 nvarchar(4000),@p1535 nvarchar(4000),@p1536 decimal(18,2),@p1537 nvarchar(4000),@p1538 nvarchar(4000),@p1539 nvarchar(4000),@p1540 nvarchar(4000),@p1541 int,@p1542 nvarchar(4000),@p1543 nvarchar(4000),@p1544 nvarchar(4000),@p1545 nvarchar(4000),@p1546 nvarchar(4000),@p1547 nvarchar(4000),@p1548 nvarchar(4000),@p1549 nvarchar(4000),@p1550 nvarchar(4000),@p1551 nvarchar(4000),@p1552 int,@p1553 nvarchar(4000),@p1554 nvarchar(4000),@p1555 nvarchar(4000),@p1556 nvarchar(4000),@p1557 nvarchar(4000),@p1558 int,@p1559 nvarchar(4000),@p1560 int,@p1561 int,@p1562 datetime2(7),@p1563 datetime2(7),@p1564 datetime2(7),@p1565 nvarchar(4000),@p1566 nvarchar(4000),@p1567 nvarchar(4000),@p1568 nvarchar(4000),@p1569 nvarchar(4000),@p1570 nvarchar(4000),@p1571 nvarchar(4000),@p1572 nvarchar(4000),@p1573 nvarchar(4000),@p1574 nvarchar(4000),@p1575 nvarchar(4000),@p1576 nvarchar(4000),@p1577 nvarchar(4000),@p1578 nvarchar(4000),@p1579 datetime2(7),@p1580 nvarchar(4000),@p1581 nvarchar(4000),@p1582 int,@p1583 int,@p1584 int,@p1585 nvarchar(4000),@p1586 nvarchar(4000),@p1587 nvarchar(4000),@p1588 decimal(18,2),@p1589 decimal(18,2),@p1590 nvarchar(4000),@p1591 nvarchar(4000),@p1592 decimal(18,2),@p1593 nvarchar(4000),@p1594 nvarchar(4000),@p1595 nvarchar(4000),@p1596 nvarchar(4000),@p1597 int,@p1598 nvarchar(4000),@p1599 nvarchar(4000),@p1600 nvarchar(4000),@p1601 nvarchar(4000),@p1602 nvarchar(4000),@p1603 nvarchar(4000),@p1604 nvarchar(4000),@p1605 nvarchar(4000),@p1606 nvarchar(4000),@p1607 nvarchar(4000),@p1608 int,@p1609 nvarchar(4000),@p1610 nvarchar(4000),@p1611 nvarchar(4000),@p1612 nvarchar(4000),@p1613 nvarchar(4000),@p1614 int,@p1615 nvarchar(4000),@p1616 int,@p1617 int,@p1618 datetime2(7),@p1619 datetime2(7),@p1620 datetime2(7),@p1621 nvarchar(4000),@p1622 nvarchar(4000),@p1623 nvarchar(4000),@p1624 nvarchar(4000),@p1625 nvarchar(4000),@p1626 nvarchar(4000),@p1627 nvarchar(4000),@p1628 nvarchar(4000),@p1629 nvarchar(4000),@p1630 nvarchar(4000),@p1631 nvarchar(4000),@p1632 nvarchar(4000),@p1633 nvarchar(4000),@p1634 nvarchar(4000),@p1635 datetime2(7),@p1636 nvarchar(4000),@p1637 nvarchar(4000),@p1638 int,@p1639 int,@p1640 int,@p1641 nvarchar(4000),@p1642 nvarchar(4000),@p1643 nvarchar(4000),@p1644 decimal(18,2),@p1645 decimal(18,2),@p1646 nvarchar(4000),@p1647 nvarchar(4000),@p1648 decimal(18,2),@p1649 nvarchar(4000),@p1650 nvarchar(4000),@p1651 nvarchar(4000),@p1652 nvarchar(4000),@p1653 int,@p1654 nvarchar(4000),@p1655 nvarchar(4000),@p1656 nvarchar(4000),@p1657 nvarchar(4000),@p1658 nvarchar(4000),@p1659 nvarchar(4000),@p1660 nvarchar(4000),@p1661 nvarchar(4000),@p1662 nvarchar(4000),@p1663 nvarchar(4000),@p1664 int,@p1665 nvarchar(4000),@p1666 nvarchar(4000),@p1667 nvarchar(4000),@p1668 nvarchar(4000),@p1669 nvarchar(4000),@p1670 int,@p1671 nvarchar(4000),@p1672 int,@p1673 int,@p1674 datetime2(7),@p1675 datetime2(7),@p1676 datetime2(7),@p1677 nvarchar(4000),@p1678 nvarchar(4000),@p1679 nvarchar(4000),@p1680 nvarchar(4000),@p1681 nvarchar(4000),@p1682 nvarchar(4000),@p1683 nvarchar(4000),@p1684 nvarchar(4000),@p1685 nvarchar(4000),@p1686 nvarchar(4000),@p1687 nvarchar(4000),@p1688 nvarchar(4000),@p1689 nvarchar(4000),@p1690 nvarchar(4000),@p1691 datetime2(7),@p1692 nvarchar(4000),@p1693 nvarchar(4000),@p1694 int,@p1695 int,@p1696 int,@p1697 nvarchar(4000),@p1698 nvarchar(4000),@p1699 nvarchar(4000),@p1700 decimal(18,2),@p1701 decimal(18,2),@p1702 nvarchar(4000),@p1703 nvarchar(4000),@p1704 decimal(18,2),@p1705 nvarchar(4000),@p1706 nvarchar(4000),@p1707 nvarchar(4000),@p1708 nvarchar(4000),@p1709 int,@p1710 nvarchar(4000),@p1711 nvarchar(4000),@p1712 nvarchar(4000),@p1713 nvarchar(4000),@p1714 nvarchar(4000),@p1715 nvarchar(4000),@p1716 nvarchar(4000),@p1717 nvarchar(4000),@p1718 nvarchar(4000),@p1719 nvarchar(4000),@p1720 int,@p1721 nvarchar(4000),@p1722 nvarchar(4000),@p1723 nvarchar(4000),@p1724 nvarchar(4000),@p1725 nvarchar(4000),@p1726 int,@p1727 nvarchar(4000),@p1728 int,@p1729 int,@p1730 datetime2(7),@p1731 datetime2(7),@p1732 datetime2(7),@p1733 nvarchar(4000),@p1734 nvarchar(4000),@p1735 nvarchar(4000),@p1736 nvarchar(4000),@p1737 nvarchar(4000),@p1738 nvarchar(4000),@p1739 nvarchar(4000),@p1740 nvarchar(4000),@p1741 nvarchar(4000),@p1742 nvarchar(4000),@p1743 nvarchar(4000),@p1744 nvarchar(4000),@p1745 nvarchar(4000),@p1746 nvarchar(4000),@p1747 datetime2(7),@p1748 nvarchar(4000),@p1749 nvarchar(4000),@p1750 int,@p1751 int,@p1752 int,@p1753 nvarchar(4000),@p1754 nvarchar(4000),@p1755 nvarchar(4000),@p1756 decimal(18,2),@p1757 decimal(18,2),@p1758 nvarchar(4000),@p1759 nvarchar(4000),@p1760 decimal(18,2),@p1761 nvarchar(4000),@p1762 nvarchar(4000),@p1763 nvarchar(4000),@p1764 nvarchar(4000),@p1765 int,@p1766 nvarchar(4000),@p1767 nvarchar(4000),@p1768 nvarchar(4000),@p1769 nvarchar(4000),@p1770 nvarchar(4000),@p1771 nvarchar(4000),@p1772 nvarchar(4000),@p1773 nvarchar(4000),@p1774 nvarchar(4000),@p1775 nvarchar(4000),@p1776 int,@p1777 nvarchar(4000),@p1778 nvarchar(4000),@p1779 nvarchar(4000),@p1780 nvarchar(4000),@p1781 nvarchar(4000),@p1782 int,@p1783 nvarchar(4000),@p1784 int,@p1785 int,@p1786 datetime2(7),@p1787 datetime2(7),@p1788 datetime2(7),@p1789 nvarchar(4000),@p1790 nvarchar(4000),@p1791 nvarchar(4000),@p1792 nvarchar(4000),@p1793 nvarchar(4000),@p1794 nvarchar(4000),@p1795 nvarchar(4000),@p1796 nvarchar(4000),@p1797 nvarchar(4000),@p1798 nvarchar(4000),@p1799 nvarchar(4000),@p1800 nvarchar(4000),@p1801 nvarchar(4000),@p1802 nvarchar(4000),@p1803 datetime2(7),@p1804 nvarchar(4000),@p1805 nvarchar(4000),@p1806 int,@p1807 int,@p1808 int,@p1809 nvarchar(4000),@p1810 nvarchar(4000),@p1811 nvarchar(4000),@p1812 decimal(18,2),@p1813 decimal(18,2),@p1814 nvarchar(4000),@p1815 nvarchar(4000),@p1816 decimal(18,2),@p1817 nvarchar(4000),@p1818 nvarchar(4000),@p1819 nvarchar(4000),@p1820 nvarchar(4000),@p1821 int,@p1822 nvarchar(4000),@p1823 nvarchar(4000),@p1824 nvarchar(4000),@p1825 nvarchar(4000),@p1826 nvarchar(4000),@p1827 nvarchar(4000),@p1828 nvarchar(4000),@p1829 nvarchar(4000),@p1830 nvarchar(4000),@p1831 nvarchar(4000),@p1832 int,@p1833 nvarchar(4000),@p1834 nvarchar(4000),@p1835 nvarchar(4000),@p1836 nvarchar(4000),@p1837 nvarchar(4000),@p1838 int,@p1839 nvarchar(4000),@p1840 int,@p1841 int,@p1842 datetime2(7),@p1843 datetime2(7),@p1844 datetime2(7),@p1845 nvarchar(4000),@p1846 nvarchar(4000),@p1847 nvarchar(4000),@p1848 nvarchar(4000),@p1849 nvarchar(4000),@p1850 nvarchar(4000),@p1851 nvarchar(4000),@p1852 nvarchar(4000),@p1853 nvarchar(4000),@p1854 nvarchar(4000),@p1855 nvarchar(4000),@p1856 nvarchar(4000),@p1857 nvarchar(4000),@p1858 nvarchar(4000),@p1859 datetime2(7),@p1860 nvarchar(4000),@p1861 nvarchar(4000),@p1862 int,@p1863 int,@p1864 int,@p1865 nvarchar(4000),@p1866 nvarchar(4000),@p1867 nvarchar(4000),@p1868 decimal(18,2),@p1869 decimal(18,2),@p1870 nvarchar(4000),@p1871 nvarchar(4000),@p1872 decimal(18,2),@p1873 nvarchar(4000),@p1874 nvarchar(4000),@p1875 nvarchar(4000),@p1876 nvarchar(4000),@p1877 int,@p1878 nvarchar(4000),@p1879 nvarchar(4000),@p1880 nvarchar(4000),@p1881 nvarchar(4000),@p1882 nvarchar(4000),@p1883 nvarchar(4000),@p1884 nvarchar(4000),@p1885 nvarchar(4000),@p1886 nvarchar(4000),@p1887 nvarchar(4000),@p1888 int,@p1889 nvarchar(4000),@p1890 nvarchar(4000),@p1891 nvarchar(4000),@p1892 nvarchar(4000),@p1893 nvarchar(4000),@p1894 int,@p1895 nvarchar(4000),@p1896 int,@p1897 int,@p1898 datetime2(7),@p1899 datetime2(7),@p1900 datetime2(7),@p1901 nvarchar(4000),@p1902 nvarchar(4000),@p1903 nvarchar(4000),@p1904 nvarchar(4000),@p1905 nvarchar(4000),@p1906 nvarchar(4000),@p1907 nvarchar(4000),@p1908 nvarchar(4000),@p1909 nvarchar(4000),@p1910 nvarchar(4000),@p1911 nvarchar(4000),@p1912 nvarchar(4000),@p1913 nvarchar(4000),@p1914 nvarchar(4000),@p1915 datetime2(7),@p1916 nvarchar(4000),@p1917 nvarchar(4000),@p1918 int,@p1919 int,@p1920 int,@p1921 nvarchar(4000),@p1922 nvarchar(4000),@p1923 nvarchar(4000),@p1924 decimal(18,2),@p1925 decimal(18,2),@p1926 nvarchar(4000),@p1927 nvarchar(4000),@p1928 decimal(18,2),@p1929 nvarchar(4000),@p1930 nvarchar(4000),@p1931 nvarchar(4000),@p1932 nvarchar(4000),@p1933 int,@p1934 nvarchar(4000),@p1935 nvarchar(4000),@p1936 nvarchar(4000),@p1937 nvarchar(4000),@p1938 nvarchar(4000),@p1939 nvarchar(4000),@p1940 nvarchar(4000),@p1941 nvarchar(4000),@p1942 nvarchar(4000),@p1943 nvarchar(4000),@p1944 int,@p1945 nvarchar(4000),@p1946 nvarchar(4000),@p1947 nvarchar(4000),@p1948 nvarchar(4000),@p1949 nvarchar(4000),@p1950 int,@p1951 nvarchar(4000),@p1952 int,@p1953 int,@p1954 datetime2(7),@p1955 datetime2(7),@p1956 datetime2(7),@p1957 nvarchar(4000),@p1958 nvarchar(4000),@p1959 nvarchar(4000),@p1960 nvarchar(4000),@p1961 nvarchar(4000),@p1962 nvarchar(4000),@p1963 nvarchar(4000),@p1964 nvarchar(4000),@p1965 nvarchar(4000),@p1966 nvarchar(4000),@p1967 nvarchar(4000),@p1968 nvarchar(4000),@p1969 nvarchar(4000),@p1970 nvarchar(4000),@p1971 datetime2(7),@p1972 nvarchar(4000),@p1973 nvarchar(4000),@p1974 int,@p1975 int,@p1976 int,@p1977 nvarchar(4000),@p1978 nvarchar(4000),@p1979 nvarchar(4000),@p1980 decimal(18,2),@p1981 decimal(18,2),@p1982 nvarchar(4000),@p1983 nvarchar(4000),@p1984 decimal(18,2),@p1985 nvarchar(4000),@p1986 nvarchar(4000),@p1987 nvarchar(4000),@p1988 nvarchar(4000),@p1989 int,@p1990 nvarchar(4000),@p1991 nvarchar(4000),@p1992 nvarchar(4000),@p1993 nvarchar(4000),@p1994 nvarchar(4000),@p1995 nvarchar(4000),@p1996 nvarchar(4000),@p1997 nvarchar(4000),@p1998 nvarchar(4000),@p1999 nvarchar(4000),@p2000 int,@p2001 nvarchar(4000),@p2002 nvarchar(4000),@p2003 nvarchar(4000),@p2004 nvarchar(4000),@p2005 nvarchar(4000),@p2006 int,@p2007 nvarchar(4000),@p2008 int,@p2009 int,@p2010 datetime2(7),@p2011 datetime2(7),@p2012 datetime2(7),@p2013 nvarchar(4000),@p2014 nvarchar(4000),@p2015 nvarchar(4000),@p2016 nvarchar(4000),@p2017 nvarchar(4000),@p2018 nvarchar(4000),@p2019 nvarchar(4000),@p2020 nvarchar(4000),@p2021 nvarchar(4000),@p2022 nvarchar(4000),@p2023 nvarchar(4000),@p2024 nvarchar(4000),@p2025 nvarchar(4000),@p2026 nvarchar(4000),@p2027 datetime2(7),@p2028 nvarchar(4000),@p2029 nvarchar(4000),@p2030 int,@p2031 int,@p2032 int,@p2033 nvarchar(4000),@p2034 nvarchar(4000),@p2035 nvarchar(4000),@p2036 nvarchar(4000),@p2037 decimal(18,2),@p2038 nvarchar(4000),@p2039 nvarchar(4000),@p2040 decimal(18,2),@p2041 nvarchar(4000),@p2042 nvarchar(4000),@p2043 nvarchar(4000),@p2044 nvarchar(4000),@p2045 int,@p2046 nvarchar(4000),@p2047 nvarchar(4000),@p2048 nvarchar(4000),@p2049 nvarchar(4000),@p2050 nvarchar(4000),@p2051 nvarchar(4000),@p2052 nvarchar(4000),@p2053 nvarchar(4000),@p2054 nvarchar(4000),@p2055 nvarchar(4000),@p2056 int,@p2057 nvarchar(4000),@p2058 nvarchar(4000),@p2059 nvarchar(4000),@p2060 nvarchar(4000),@p2061 nvarchar(4000),@p2062 int,@p2063 nvarchar(4000),@p2064 int,@p2065 int,@p2066 datetime2(7),@p2067 datetime2(7),@p2068 datetime2(7),@p2069 nvarchar(4000),@p2070 nvarchar(4000),@p2071 nvarchar(4000))SET NOCOUNT ON; DECLARE @inserted0 TABLE ([item_id] int, [_Position] [int]); MERGE [raw_data] USING ( VALUES (@p0, @p1, @p2, @p3, @p4, @p5, @p6, @p7, @p8, @p9, @p10, @p11, @p12, @p13, @p14, @p15, @p16, @p17, @p18, @p19, @p20, @p21, @p22, @p23, @p24, @p25, @p26, @p27, @p28, @p29, @p30, @p31, @p32, @p33, @p34, @p35, @p36, @p37, @p38, @p39, @p40, @p41, @p42, @p43, @p44, @p45, @p46, @p47, @p48, @p49, @p50, @p51, @p52, @p53, @p54, @p55, 0), (@p56, @p57, @p58, @p59, @p60, @p61, @p62, @p63, @p64, @p65, @p66, @p67, @p68, @p69, @p70, @p71, @p72, @p73, @p74, @p75, @p76, @p77, @p78, @p79, @p80, @p81, @p82, @p83, @p84, @p85, @p86, @p87, @p88, @p89, @p90, @p91, @p92, @p93, @p94, @p95, @p96, @p97, @p98, @p99, @p100, @p101, @p102, @p103, @p104, @p105, @p106, @p107, @p108, @p109, @p110, @p111, 1), (@p112, @p113, @p114, @p115, @p116, @p117, @p118, @p119, @p120, @p121, @p122, @p123, @p124, @p125, @p126, @p127, @p128, @p129, @p130, @p131, @p132, @p133, @p134, @p135, @p136, @p137, @p138, @p139, @p140, @p141, @p142, @p143, @p144, @p145, @p146, @p147, @p148, @p149, @p150, @p151, @p152, @p153, @p154, @p155, @p156, @p157, @p158, @p159, @p160, @p161, @p162, @p163, @p164, @p165, @p166, @p167, 2), (@p168, @p169, @p170, @p171, @p172, @p173, @p174, @p175, @p176, @p177, @p178, @p179, @p180, @p181, @p182, @p183, @p184, @p185, @p186, @p187, @p188, @p189, @p190, @p191, @p192, @p193, @p194, @p195, @p196, @p197, @p198, @p199, @p200, @p201, @p202, @p203, @p204, @p205, @p206, @p207, @p208, @p209, @p210, @p211, @p212, @p213, @p214, @p215, @p216, @p217, @p218, @p219, @p220, @p221, @p222, @p223, 3), (@p224, @p225, @p226, @p227, @p228, @p229, @p230, @p231, @p232, @p233, @p234, @p235, @p236, @p237, @p238, @p239, @p240, @p241, @p242, @p243, @p244, @p245, @p246, @p247, @p248, @p249, @p250, @p251, @p252, @p253, @p254, @p255, @p256, @p257, @p258, @p259, @p260, @p261, @p262, @p263, @p264, @p265, @p266, @p267, @p268, @p269, @p270, @p271, @p272, @p273, @p274, @p275, @p276, @p277, @p278, @p279, 4), (@p280, @p281, @p282, @p283, @p284, @p285, @p286, @p287, @p288, @p289, @p290, @p291, @p292, @p293, @p294, @p295, @p296, @p297, @p298, @p299, @p300, @p301, @p302, @p303, @p304, @p305, @p306, @p307, @p308, @p309, @p310, @p311, @p312, @p313, @p314, @p315, @p316, @p317, @p318, @p319, @p320, @p321, @p322, @p323, @p324, @p325, @p326, @p327, @p328, @p329, @p330, @p331, @p332, @p333, @p334, @p335, 5), (@p336, @p337, @p338, @p339, @p340, @p341, @p342, @p343, @p344, @p345, @p346, @p347, @p348, @p349, @p350, @p351, @p352, @p353, @p354, @p355, @p356, @p357, @p358, @p359, @p360, @p361, @p362, @p363, @p364, @p365, @p366, @p367, @p368, @p369, @p370, @p371, @p372, @p373, @p374, @p375, @p376, @p377, @p378, @p379, @p380, @p381, @p382, @p383, @p384, @p385, @p386, @p387, @p388, @p389, @p390, @p391, 6), (@p392, @p393, @p394, @p395, @p396, @p397, @p398, @p399, @p400, @p401, @p402, @p403, @p404, @p405, @p406, @p407, @p408, @p409, @p410, @p411, @p412, @p413, @p414, @p415, @p416, @p417, @p418, @p419, @p420, @p421, @p422, @p423, @p424, @p425, @p426, @p427, @p428, @p429, @p430, @p431, @p432, @p433, @p434, @p435, @p436, @p437, @p438, @p439, @p440, @p441, @p442, @p443, @p444, @p445, @p446, @p447, 7), (@p448, @p449, @p450, @p451, @p452, @p453, @p454, @p455, @p456, @p457, @p458, @p459, @p460, @p461, @p462, @p463, @p464, @p465, @p466, @p467, @p468, @p469, @p470, @p471, @p472, @p473, @p474, @p475, @p476, @p477, @p478, @p479, @p480, @p481, @p482, @p483, @p484, @p485, @p486, @p487, @p488, @p489, @p490, @p491, @p492, @p493, @p494, @p495, @p496, @p497, @p498, @p499, @p500, @p501, @p502, @p503, 8), (@p504, @p505, @p506, @p507, @p508, @p509, @p510, @p511, @p512, @p513, @p514, @p515, @p516, @p517, @p518, @p519, @p520, @p521, @p522, @p523, @p524, @p525, @p526, @p527, @p528, @p529, @p530, @p531, @p532, @p533, @p534, @p535, @p536, @p537, @p538, @p539, @p540, @p541, @p542, @p543, @p544, @p545, @p546, @p547, @p548, @p549, @p550, @p551, @p552, @p553, @p554, @p555, @p556, @p557, @p558, @p559, 9), (@p560, @p561, @p562, @p563, @p564, @p565, @p566, @p567, @p568, @p569, @p570, @p571, @p572, @p573, @p574, @p575, @p576, @p577, @p578, @p579, @p580, @p581, @p582, @p583, @p584, @p585, @p586, @p587, @p588, @p589, @p590, @p591, @p592, @p593, @p594, @p595, @p596, @p597, @p598, @p599, @p600, @p601, @p602, @p603, @p604, @p605, @p606, @p607, @p608, @p609, @p610, @p611, @p612, @p613, @p614, @p615, 10), (@p616, @p617, @p618, @p619, @p620, @p621, @p622, @p623, @p624, @p625, @p626, @p627, @p628, @p629, @p630, @p631, @p632, @p633, @p634, @p635, @p636, @p637, @p638, @p639, @p640, @p641, @p642, @p643, @p644, @p645, @p646, @p647, @p648, @p649, @p650, @p651, @p652, @p653, @p654, @p655, @p656, @p657, @p658, @p659, @p660, @p661, @p662, @p663, @p664, @p665, @p666, @p667, @p668, @p669, @p670, @p671, 11), (@p672, @p673, @p674, @p675, @p676, @p677, @p678, @p679, @p680, @p681, @p682, @p683, @p684, @p685, @p686, @p687, @p688, @p689, @p690, @p691, @p692, @p693, @p694, @p695, @p696, @p697, @p698, @p699, @p700, @p701, @p702, @p703, @p704, @p705, @p706, @p707, @p708, @p709, @p710, @p711, @p712, @p713, @p714, @p715, @p716, @p717, @p718, @p719, @p720, @p721, @p722, @p723, @p724, @p725, @p726, @p727, 12), (@p728, @p729, @p730, @p731, @p732, @p733, @p734, @p735, @p736, @p737, @p738, @p739, @p740, @p741, @p742, @p743, @p744, @p745, @p746, @p747, @p748, @p749, @p750, @p751, @p752, @p753, @p754, @p755, @p756, @p757, @p758, @p759, @p760, @p761, @p762, @p763, @p764, @p765, @p766, @p767, @p768, @p769, @p770, @p771, @p772, @p773, @p774, @p775, @p776, @p777, @p778, @p779, @p780, @p781, @p782, @p783, 13), (@p784, @p785, @p786, @p787, @p788, @p789, @p790, @p791, @p792, @p793, @p794, @p795, @p796, @p797, @p798, @p799, @p800, @p801, @p802, @p803, @p804, @p805, @p806, @p807, @p808, @p809, @p810, @p811, @p812, @p813, @p814, @p815, @p816, @p817, @p818, @p819, @p820, @p821, @p822, @p823, @p824, @p825, @p826, @p827, @p828, @p829, @p830, @p831, @p832, @p833, @p834, @p835, @p836, @p837, @p838, @p839, 14), (@p840, @p841, @p842, @p843, @p844, @p845, @p846, @p847, @p848, @p849, @p850, @p851, @p852, @p853, @p854, @p855, @p856, @p857, @p858, @p859, @p860, @p861, @p862, @p863, @p864, @p865, @p866, @p867, @p868, @p869, @p870, @p871, @p872, @p873, @p874, @p875, @p876, @p877, @p878, @p879, @p880, @p881, @p882, @p883, @p884, @p885, @p886, @p887, @p888, @p889, @p890, @p891, @p892, @p893, @p894, @p895, 15), (@p896, @p897, @p898, @p899, @p900, @p901, @p902, @p903, @p904, @p905, @p906, @p907, @p908, @p909, @p910, @p911, @p912, @p913, @p914, @p915, @p916, @p917, @p918, @p919, @p920, @p921, @p922, @p923, @p924, @p925, @p926, @p927, @p928, @p929, @p930, @p931, @p932, @p933, @p934, @p935, @p936, @p937, @p938, @p939, @p940, @p941, @p942, @p943, @p944, @p945, @p946, @p947, @p948, @p949, @p950, @p951, 16), (@p952, @p953, @p954, @p955, @p956, @p957, @p958, @p959, @p960, @p961, @p962, @p963, @p964, @p965, @p966, @p967, @p968, @p969, @p970, @p971, @p972, @p973, @p974, @p975, @p976, @p977, @p978, @p979, @p980, @p981, @p982, @p983, @p984, @p985, @p986, @p987, @p988, @p989, @p990, @p991, @p992, @p993, @p994, @p995, @p996, @p997, @p998, @p999, @p1000, @p1001, @p1002, @p1003, @p1004, @p1005, @p1006, @p1007, 17), (@p1008, @p1009, @p1010, @p1011, @p1012, @p1013, @p1014, @p1015, @p1016, @p1017, @p1018, @p1019, @p1020, @p1021, @p1022, @p1023, @p1024, @p1025, @p1026, @p1027, @p1028, @p1029, @p1030, @p1031, @p1032, @p1033, @p1034, @p1035, @p1036, @p1037, @p1038, @p1039, @p1040, @p1041, @p1042, @p1043, @p1044, @p1045, @p1046, @p1047, @p1048, @p1049, @p1050, @p1051, @p1052, @p1053, @p1054, @p1055, @p1056, @p1057, @p1058, @p1059, @p1060, @p1061, @p1062, @p1063, 18), (@p1064, @p1065, @p1066, @p1067, @p1068, @p1069, @p1070, @p1071, @p1072, @p1073, @p1074, @p1075, @p1076, @p1077, @p1078, @p1079, @p1080, @p1081, @p1082, @p1083, @p1084, @p1085, @p1086, @p1087, @p1088, @p1089, @p1090, @p1091, @p1092, @p1093, @p1094, @p1095, @p1096, @p1097, @p1098, @p1099, @p1100, @p1101, @p1102, @p1103, @p1104, @p1105, @p1106, @p1107, @p1108, @p1109, @p1110, @p1111, @p1112, @p1113, @p1114, @p1115, @p1116, @p1117, @p1118, @p1119, 19), (@p1120, @p1121, @p1122, @p1123, @p1124, @p1125, @p1126, @p1127, @p1128, @p1129, @p1130, @p1131, @p1132, @p1133, @p1134, @p1135, @p1136, @p1137, @p1138, @p1139, @p1140, @p1141, @p1142, @p1143, @p1144, @p1145, @p1146, @p1147, @p1148, @p1149, @p1150, @p1151, @p1152, @p1153, @p1154, @p1155, @p1156, @p1157, @p1158, @p1159, @p1160, @p1161, @p1162, @p1163, @p1164, @p1165, @p1166, @p1167, @p1168, @p1169, @p1170, @p1171, @p1172, @p1173, @p1174, @p1175, 20), (@p1176, @p1177, @p1178, @p1179, @p1180, @p1181, @p1182, @p1183, @p1184, @p1185, @p1186, @p1187, @p1188, @p1189, @p1190, @p1191, @p1192, @p1193, @p1194, @p1195, @p1196, @p1197, @p1198, @p1199, @p1200, @p1201, @p1202, @p1203, @p1204, @p1205, @p1206, @p1207, @p1208, @p1209, @p1210, @p1211, @p1212, @p1213, @p1214, @p1215, @p1216, @p1217, @p1218, @p1219, @p1220, @p1221, @p1222, @p1223, @p1224, @p1225, @p1226, @p1227, @p1228, @p1229, @p1230, @p1231, 21), (@p1232, @p1233, @p1234, @p1235, @p1236, @p1237, @p1238, @p1239, @p1240, @p1241, @p1242, @p1243, @p1244, @p1245, @p1246, @p1247, @p1248, @p1249, @p1250, @p1251, @p1252, @p1253, @p1254, @p1255, @p1256, @p1257, @p1258, @p1259, @p1260, @p1261, @p1262, @p1263, @p1264, @p1265, @p1266, @p1267, @p1268, @p1269, @p1270, @p1271, @p1272, @p1273, @p1274, @p1275, @p1276, @p1277, @p1278, @p1279, @p1280, @p1281, @p1282, @p1283, @p1284, @p1285, @p1286, @p1287, 22), (@p1288, @p1289, @p1290, @p1291, @p1292, @p1293, @p1294, @p1295, @p1296, @p1297, @p1298, @p1299, @p1300, @p1301, @p1302, @p1303, @p1304, @p1305, @p1306, @p1307, @p1308, @p1309, @p1310, @p1311, @p1312, @p1313, @p1314, @p1315, @p1316, @p1317, @p1318, @p1319, @p1320, @p1321, @p1322, @p1323, @p1324, @p1325, @p1326, @p1327, @p1328, @p1329, @p1330, @p1331, @p1332, @p1333, @p1334, @p1335, @p1336, @p1337, @p1338, @p1339, @p1340, @p1341, @p1342, @p1343, 23), (@p1344, @p1345, @p1346, @p1347, @p1348, @p1349, @p1350, @p1351, @p1352, @p1353, @p1354, @p1355, @p1356, @p1357, @p1358, @p1359, @p1360, @p1361, @p1362, @p1363, @p1364, @p1365, @p1366, @p1367, @p1368, @p1369, @p1370, @p1371, @p1372, @p1373, @p1374, @p1375, @p1376, @p1377, @p1378, @p1379, @p1380, @p1381, @p1382, @p1383, @p1384, @p1385, @p1386, @p1387, @p1388, @p1389, @p1390, @p1391, @p1392, @p1393, @p1394, @p1395, @p1396, @p1397, @p1398, @p1399, 24), (@p1400, @p1401, @p1402, @p1403, @p1404, @p1405, @p1406, @p1407, @p1408, @p1409, @p1410, @p1411, @p1412, @p1413, @p1414, @p1415, @p1416, @p1417, @p1418, @p1419, @p1420, @p1421, @p1422, @p1423, @p1424, @p1425, @p1426, @p1427, @p1428, @p1429, @p1430, @p1431, @p1432, @p1433, @p1434, @p1435, @p1436, @p1437, @p1438, @p1439, @p1440, @p1441, @p1442, @p1443, @p1444, @p1445, @p1446, @p1447, @p1448, @p1449, @p1450, @p1451, @p1452, @p1453, @p1454, @p1455, 25), (@p1456, @p1457, @p1458, @p1459, @p1460, @p1461, @p1462, @p1463, @p1464, @p1465, @p1466, @p1467, @p1468, @p1469, @p1470, @p1471, @p1472, @p1473, @p1474, @p1475, @p1476, @p1477, @p1478, @p1479, @p1480, @p1481, @p1482, @p1483, @p1484, @p1485, @p1486, @p1487, @p1488, @p1489, @p1490, @p1491, @p1492, @p1493, @p1494, @p1495, @p1496, @p1497, @p1498, @p1499, @p1500, @p1501, @p1502, @p1503, @p1504, @p1505, @p1506, @p1507, @p1508, @p1509, @p1510, @p1511, 26), (@p1512, @p1513, @p1514, @p1515, @p1516, @p1517, @p1518, @p1519, @p1520, @p1521, @p1522, @p1523, @p1524, @p1525, @p1526, @p1527, @p1528, @p1529, @p1530, @p1531, @p1532, @p1533, @p1534, @p1535, @p1536, @p1537, @p1538, @p1539, @p1540, @p1541, @p1542, @p1543, @p1544, @p1545, @p1546, @p1547, @p1548, @p1549, @p1550, @p1551, @p1552, @p1553, @p1554, @p1555, @p1556, @p1557, @p1558, @p1559, @p1560, @p1561, @p1562, @p1563, @p1564, @p1565, @p1566, @p1567, 27), (@p1568, @p1569, @p1570, @p1571, @p1572, @p1573, @p1574, @p1575, @p1576, @p1577, @p1578, @p1579, @p1580, @p1581, @p1582, @p1583, @p1584, @p1585, @p1586, @p1587, @p1588, @p1589, @p1590, @p1591, @p1592, @p1593, @p1594, @p1595, @p1596, @p1597, @p1598, @p1599, @p1600, @p1601, @p1602, @p1603, @p1604, @p1605, @p1606, @p1607, @p1608, @p1609, @p1610, @p1611, @p1612, @p1613, @p1614, @p1615, @p1616, @p1617, @p1618, @p1619, @p1620, @p1621, @p1622, @p1623, 28), (@p1624, @p1625, @p1626, @p1627, @p1628, @p1629, @p1630, @p1631, @p1632, @p1633, @p1634, @p1635, @p1636, @p1637, @p1638, @p1639, @p1640, @p1641, @p1642, @p1643, @p1644, @p1645, @p1646, @p1647, @p1648, @p1649, @p1650, @p1651, @p1652, @p1653, @p1654, @p1655, @p1656, @p1657, @p1658, @p1659, @p1660, @p1661, @p1662, @p1663, @p1664, @p1665, @p1666, @p1667, @p1668, @p1669, @p1670, @p1671, @p1672, @p1673, @p1674, @p1675, @p1676, @p1677, @p1678, @p1679, 29), (@p1680, @p1681, @p1682, @p1683, @p1684, @p1685, @p1686, @p1687, @p1688, @p1689, @p1690, @p1691, @p1692, @p1693, @p1694, @p1695, @p1696, @p1697, @p1698, @p1699, @p1700, @p1701, @p1702, @p1703, @p1704, @p1705, @p1706, @p1707, @p1708, @p1709, @p1710, @p1711, @p1712, @p1713, @p1714, @p1715, @p1716, @p1717, @p1718, @p1719, @p1720, @p1721, @p1722, @p1723, @p1724, @p1725, @p1726, @p1727, @p1728, @p1729, @p1730, @p1731, @p1732, @p1733, @p1734, @p1735, 30), (@p1736, @p1737, @p1738, @p1739, @p1740, @p1741, @p1742, @p1743, @p1744, @p1745, @p1746, @p1747, @p1748, @p1749, @p1750, @p1751, @p1752, @p1753, @p1754, @p1755, @p1756, @p1757, @p1758, @p1759, @p1760, @p1761, @p1762, @p1763, @p1764, @p1765, @p1766, @p1767, @p1768, @p1769, @p1770, @p1771, @p1772, @p1773, @p1774, @p1775, @p1776, @p1777, @p1778, @p1779, @p1780, @p1781, @p1782, @p1783, @p1784, @p1785, @p1786, @p1787, @p1788, @p1789, @p1790, @p1791, 31), (@p1792, @p1793, @p1794, @p1795, @p1796, @p1797, @p1798, @p1799, @p1800, @p1801, @p1802, @p1803, @p1804, @p1805, @p1806, @p1807, @p1808, @p1809, @p1810, @p1811, @p1812, @p1813, @p1814, @p1815, @p1816, @p1817, @p1818, @p1819, @p1820, @p1821, @p1822, @p1823, @p1824, @p1825, @p1826, @p1827, @p1828, @p1829, @p1830, @p1831, @p1832, @p1833, @p1834, @p1835, @p1836, @p1837, @p1838, @p1839, @p1840, @p1841, @p1842, @p1843, @p1844, @p1845, @p1846, @p1847, 32), (@p1848, @p1849, @p1850, @p1851, @p1852, @p1853, @p1854, @p1855, @p1856, @p1857, @p1858, @p1859, @p1860, @p1861, @p1862, @p1863, @p1864, @p1865, @p1866, @p1867, @p1868, @p1869, @p1870, @p1871, @p1872, @p1873, @p1874, @p1875, @p1876, @p1877, @p1878, @p1879, @p1880, @p1881, @p1882, @p1883, @p1884, @p1885, @p1886, @p1887, @p1888, @p1889, @p1890, @p1891, @p1892, @p1893, @p1894, @p1895, @p1896, @p1897, @p1898, @p1899, @p1900, @p1901, @p1902, @p1903, 33), (@p1904, @p1905, @p1906, @p1907, @p1908, @p1909, @p1910, @p1911, @p1912, @p1913, @p1914, @p1915, @p1916, @p1917, @p1918, @p1919, @p1920, @p1921, @p1922, @p1923, @p1924, @p1925, @p1926, @p1927, @p1928, @p1929, @p1930, @p1931, @p1932, @p1933, @p1934, @p1935, @p1936, @p1937, @p1938, @p1939, @p1940, @p1941, @p1942, @p1943, @p1944, @p1945, @p1946, @p1947, @p1948, @p1949, @p1950, @p1951, @p1952, @p1953, @p1954, @p1955, @p1956, @p1957, @p1958, @p1959, 34), (@p1960, @p1961, @p1962, @p1963, @p1964, @p1965, @p1966, @p1967, @p1968, @p1969, @p1970, @p1971, @p1972, @p1973, @p1974, @p1975, @p1976, @p1977, @p1978, @p1979, @p1980, @p1981, @p1982, @p1983, @p1984, @p1985, @p1986, @p1987, @p1988, @p1989, @p1990, @p1991, @p1992, @p1993, @p1994, @p1995, @p1996, @p1997, @p1998, @p1999, @p2000, @p2001, @p2002, @p2003, @p2004, @p2005, @p2006, @p2007, @p2008, @p2009, @p2010, @p2011, @p2012, @p2013, @p2014, @p2015, 35), (@p2016, @p2017, @p2018, @p2019, @p2020, @p2021, @p2022, @p2023, @p2024, @p2025, @p2026, @p2027, @p2028, @p2029, @p2030, @p2031, @p2032, @p2033, @p2034, @p2035, @p2036, @p2037, @p2038, @p2039, @p2040, @p2041, @p2042, @p2043, @p2044, @p2045, @p2046, @p2047, @p2048, @p2049, @p2050, @p2051, @p2052, @p2053, @p2054, @p2055, @p2056, @p2057, @p2058, @p2059, @p2060, @p2061, @p2062, @p2063, @p2064, @p2065, @p2066, @p2067, @p2068, @p2069, @p2070, @p2071, 36)) AS i ([addressee_cntry_cd], [addressee_city], [addressee_district], [addressee_email], [addressee_full_address], [addressee_home_address], [addressee_name], [addressee_postcode], [addressee_province], [addressee_subdistrict], [addressee_tel], [create_table], [delivery_code], [delivery_recipient_name], [delivery_relation_id], [delivery_status_id], [dest_outlet_id], [dest_outlet_port], [document_number], [item_barcode], [item_cod], [item_gross_weight], [item_height], [item_length], [item_price], [item_width], [lat], [log_id], [long], [outlet_id], [outlet_port], [podUrl], [remark], [scan_cntry_cd], [scan_cntry_postcode], [sender_cntry_cd], [sender_district], [sender_email], [sender_full_address], [sender_home_address], [member_id], [sender_name], [sender_postcode], [sender_province], [sender_subdistrict], [sender_tel], [server_id], [signatureUrl], [state], [status_code], [status_dtm], [timestamp], [transmit_dtm], [user_id], [wckt_id], [wkstn_no], _Position) ON 1=0 WHEN NOT MATCHED THEN INSERT ([addressee_cntry_cd], [addressee_city], [addressee_district], [addressee_email], [addressee_full_address], [addressee_home_address], [addressee_name], [addressee_postcode], [addressee_province], [addressee_subdistrict], [addressee_tel], [create_table], [delivery_code], [delivery_recipient_name], [delivery_relation_id], [delivery_status_id], [dest_outlet_id], [dest_outlet_port], [document_number], [item_barcode], [item_cod], [item_gross_weight], [item_height], [item_length], [item_price], [item_width], [lat], [log_id], [long], [outlet_id], [outlet_port], [podUrl], [remark], [scan_cntry_cd], [scan_cntry_postcode], [sender_cntry_cd], [sender_district], [sender_email], [sender_full_address], [sender_home_address], [member_id], [sender_name], [sender_postcode], [sender_province], [sender_subdistrict], [sender_tel], [server_id], [signatureUrl], [state], [status_code], [status_dtm], [timestamp], [transmit_dtm], [user_id], [wckt_id], [wkstn_no]) VALUES (i.[addressee_cntry_cd], i.[addressee_city], i.[addressee_district], i.[addressee_email], i.[addressee_full_address], i.[addressee_home_address], i.[addressee_name], i.[addressee_postcode], i.[addressee_province], i.[addressee_subdistrict], i.[addressee_tel], i.[create_table], i.[delivery_code], i.[delivery_recipient_name], i.[delivery_relation_id], i.[delivery_status_id], i.[dest_outlet_id], i.[dest_outlet_port], i.[document_number], i.[item_barcode], i.[item_cod], i.[item_gross_weight], i.[item_height], i.[item_length], i.[item_price], i.[item_width], i.[lat], i.[log_id], i.[long], i.[outlet_id], i.[outlet_port], i.[podUrl], i.[remark], i.[scan_cntry_cd], i.[scan_cntry_postcode], i.[sender_cntry_cd], i.[sender_district], i.[sender_email], i.[sender_full_address], i.[sender_home_address], i.[member_id], i.[sender_name], i.[sender_postcode], i.[sender_province], i.[sender_subdistrict], i.[sender_tel], i.[server_id], i.[signatureUrl], i.[state], i.[status_code], i.[status_dtm], i.[timestamp], i.[transmit_dtm], i.[user_id], i.[wckt_id], i.[wkstn_no]) OUTPUT INSERTED.[item_id], i._Position INTO @inserted0;  SELECT [t].[item_id] FROM [raw_data] t INNER JOIN @inserted0 i ON ([t].[item_id] = [i].[item_id]) ORDER BY [i].[_Position];  ",4,4,0,446,9,4
"SELECT log.name AS [Name], log.principal_id AS [ID], ISNULL(ak.name,N'') AS [AsymmetricKey], ISNULL(cert.name,N'') AS [Certificate], ISNULL(c.name,N'') AS [Credential], CASE WHEN N'U' = log.type THEN 0 WHEN N'G' = log.type THEN 1 WHEN N'S' = log.type THEN 2 WHEN N'C' = log.type THEN 3 WHEN N'K' = log.type THEN 4  WHEN N'E' = log.type THEN 5 WHEN N'X' = log.type THEN 6 END AS [LoginType] FROM sys.server_principals AS log LEFT OUTER JOIN master.sys.asymmetric_keys AS ak ON ak.sid = log.sid LEFT OUTER JOIN master.sys.certificates AS cert ON cert.sid = log.sid LEFT OUTER JOIN sys.credentials AS c ON c.credential_id = log.credential_id WHERE (log.type in ('U', 'G', 'S', 'C', 'K', 'E', 'X') AND log.principal_id not between 101 and 255 AND log.name <> N'##MS_AgentSigningCertificate##') ORDER BY [Name] ASC",4,4,0,313,0,4
"(@p0 nvarchar(4000),@p1 nvarchar(4000),@p2 nvarchar(4000),@p3 nvarchar(4000),@p4 nvarchar(4000),@p5 nvarchar(4000),@p6 nvarchar(4000),@p7 nvarchar(4000),@p8 nvarchar(4000),@p9 nvarchar(4000),@p10 nvarchar(4000),@p11 datetime2(7),@p12 nvarchar(4000),@p13 nvarchar(4000),@p14 int,@p15 int,@p16 int,@p17 nvarchar(4000),@p18 nvarchar(4000),@p19 nvarchar(4000),@p20 decimal(18,2),@p21 decimal(18,2),@p22 nvarchar(4000),@p23 nvarchar(4000),@p24 decimal(18,2),@p25 nvarchar(4000),@p26 nvarchar(4000),@p27 nvarchar(4000),@p28 nvarchar(4000),@p29 int,@p30 nvarchar(4000),@p31 nvarchar(4000),@p32 nvarchar(4000),@p33 nvarchar(4000),@p34 nvarchar(4000),@p35 nvarchar(4000),@p36 nvarchar(4000),@p37 nvarchar(4000),@p38 nvarchar(4000),@p39 nvarchar(4000),@p40 int,@p41 nvarchar(4000),@p42 nvarchar(4000),@p43 nvarchar(4000),@p44 nvarchar(4000),@p45 nvarchar(4000),@p46 int,@p47 nvarchar(4000),@p48 int,@p49 int,@p50 datetime2(7),@p51 datetime2(7),@p52 datetime2(7),@p53 nvarchar(4000),@p54 nvarchar(4000),@p55 nvarchar(4000),@p56 nvarchar(4000),@p57 nvarchar(4000),@p58 nvarchar(4000),@p59 nvarchar(4000),@p60 nvarchar(4000),@p61 nvarchar(4000),@p62 nvarchar(4000),@p63 nvarchar(4000),@p64 nvarchar(4000),@p65 nvarchar(4000),@p66 nvarchar(4000),@p67 datetime2(7),@p68 nvarchar(4000),@p69 nvarchar(4000),@p70 int,@p71 int,@p72 int,@p73 nvarchar(4000),@p74 nvarchar(4000),@p75 nvarchar(4000),@p76 decimal(18,2),@p77 decimal(18,2),@p78 nvarchar(4000),@p79 nvarchar(4000),@p80 decimal(18,2),@p81 nvarchar(4000),@p82 nvarchar(4000),@p83 nvarchar(4000),@p84 nvarchar(4000),@p85 int,@p86 nvarchar(4000),@p87 nvarchar(4000),@p88 nvarchar(4000),@p89 nvarchar(4000),@p90 nvarchar(4000),@p91 nvarchar(4000),@p92 nvarchar(4000),@p93 nvarchar(4000),@p94 nvarchar(4000),@p95 nvarchar(4000),@p96 int,@p97 nvarchar(4000),@p98 nvarchar(4000),@p99 nvarchar(4000),@p100 nvarchar(4000),@p101 nvarchar(4000),@p102 int,@p103 nvarchar(4000),@p104 int,@p105 int,@p106 datetime2(7),@p107 datetime2(7),@p108 datetime2(7),@p109 nvarchar(4000),@p110 nvarchar(4000),@p111 nvarchar(4000),@p112 nvarchar(4000),@p113 nvarchar(4000),@p114 nvarchar(4000),@p115 nvarchar(4000),@p116 nvarchar(4000),@p117 nvarchar(4000),@p118 nvarchar(4000),@p119 nvarchar(4000),@p120 nvarchar(4000),@p121 nvarchar(4000),@p122 nvarchar(4000),@p123 datetime2(7),@p124 nvarchar(4000),@p125 nvarchar(4000),@p126 int,@p127 int,@p128 int,@p129 nvarchar(4000),@p130 nvarchar(4000),@p131 nvarchar(4000),@p132 decimal(18,2),@p133 decimal(18,2),@p134 nvarchar(4000),@p135 nvarchar(4000),@p136 decimal(18,2),@p137 nvarchar(4000),@p138 nvarchar(4000),@p139 nvarchar(4000),@p140 nvarchar(4000),@p141 int,@p142 nvarchar(4000),@p143 nvarchar(4000),@p144 nvarchar(4000),@p145 nvarchar(4000),@p146 nvarchar(4000),@p147 nvarchar(4000),@p148 nvarchar(4000),@p149 nvarchar(4000),@p150 nvarchar(4000),@p151 nvarchar(4000),@p152 int,@p153 nvarchar(4000),@p154 nvarchar(4000),@p155 nvarchar(4000),@p156 nvarchar(4000),@p157 nvarchar(4000),@p158 int,@p159 nvarchar(4000),@p160 int,@p161 int,@p162 datetime2(7),@p163 datetime2(7),@p164 datetime2(7),@p165 nvarchar(4000),@p166 nvarchar(4000),@p167 nvarchar(4000),@p168 nvarchar(4000),@p169 nvarchar(4000),@p170 nvarchar(4000),@p171 nvarchar(4000),@p172 nvarchar(4000),@p173 nvarchar(4000),@p174 nvarchar(4000),@p175 nvarchar(4000),@p176 nvarchar(4000),@p177 nvarchar(4000),@p178 nvarchar(4000),@p179 datetime2(7),@p180 nvarchar(4000),@p181 nvarchar(4000),@p182 int,@p183 int,@p184 int,@p185 nvarchar(4000),@p186 nvarchar(4000),@p187 nvarchar(4000),@p188 nvarchar(4000),@p189 decimal(18,2),@p190 nvarchar(4000),@p191 nvarchar(4000),@p192 decimal(18,2),@p193 nvarchar(4000),@p194 nvarchar(4000),@p195 nvarchar(4000),@p196 nvarchar(4000),@p197 int,@p198 nvarchar(4000),@p199 nvarchar(4000),@p200 nvarchar(4000),@p201 nvarchar(4000),@p202 nvarchar(4000),@p203 nvarchar(4000),@p204 nvarchar(4000),@p205 nvarchar(4000),@p206 nvarchar(4000),@p207 nvarchar(4000),@p208 int,@p209 nvarchar(4000),@p210 nvarchar(4000),@p211 nvarchar(4000),@p212 nvarchar(4000),@p213 nvarchar(4000),@p214 int,@p215 nvarchar(4000),@p216 int,@p217 int,@p218 datetime2(7),@p219 datetime2(7),@p220 datetime2(7),@p221 nvarchar(4000),@p222 nvarchar(4000),@p223 nvarchar(4000),@p224 nvarchar(4000),@p225 nvarchar(4000),@p226 nvarchar(4000),@p227 nvarchar(4000),@p228 nvarchar(4000),@p229 nvarchar(4000),@p230 nvarchar(4000),@p231 nvarchar(4000),@p232 nvarchar(4000),@p233 nvarchar(4000),@p234 nvarchar(4000),@p235 datetime2(7),@p236 nvarchar(4000),@p237 nvarchar(4000),@p238 int,@p239 int,@p240 int,@p241 nvarchar(4000),@p242 nvarchar(4000),@p243 nvarchar(4000),@p244 nvarchar(4000),@p245 decimal(18,2),@p246 nvarchar(4000),@p247 nvarchar(4000),@p248 decimal(18,2),@p249 nvarchar(4000),@p250 nvarchar(4000),@p251 nvarchar(4000),@p252 nvarchar(4000),@p253 int,@p254 nvarchar(4000),@p255 nvarchar(4000),@p256 nvarchar(4000),@p257 nvarchar(4000),@p258 nvarchar(4000),@p259 nvarchar(4000),@p260 nvarchar(4000),@p261 nvarchar(4000),@p262 nvarchar(4000),@p263 nvarchar(4000),@p264 int,@p265 nvarchar(4000),@p266 nvarchar(4000),@p267 nvarchar(4000),@p268 nvarchar(4000),@p269 nvarchar(4000),@p270 int,@p271 nvarchar(4000),@p272 int,@p273 int,@p274 datetime2(7),@p275 datetime2(7),@p276 datetime2(7),@p277 nvarchar(4000),@p278 nvarchar(4000),@p279 nvarchar(4000),@p280 nvarchar(4000),@p281 nvarchar(4000),@p282 nvarchar(4000),@p283 nvarchar(4000),@p284 nvarchar(4000),@p285 nvarchar(4000),@p286 nvarchar(4000),@p287 nvarchar(4000),@p288 nvarchar(4000),@p289 nvarchar(4000),@p290 nvarchar(4000),@p291 datetime2(7),@p292 nvarchar(4000),@p293 nvarchar(4000),@p294 int,@p295 int,@p296 int,@p297 nvarchar(4000),@p298 nvarchar(4000),@p299 nvarchar(4000),@p300 nvarchar(4000),@p301 decimal(18,2),@p302 nvarchar(4000),@p303 nvarchar(4000),@p304 decimal(18,2),@p305 nvarchar(4000),@p306 nvarchar(4000),@p307 nvarchar(4000),@p308 nvarchar(4000),@p309 int,@p310 nvarchar(4000),@p311 nvarchar(4000),@p312 nvarchar(4000),@p313 nvarchar(4000),@p314 nvarchar(4000),@p315 nvarchar(4000),@p316 nvarchar(4000),@p317 nvarchar(4000),@p318 nvarchar(4000),@p319 nvarchar(4000),@p320 int,@p321 nvarchar(4000),@p322 nvarchar(4000),@p323 nvarchar(4000),@p324 nvarchar(4000),@p325 nvarchar(4000),@p326 int,@p327 nvarchar(4000),@p328 int,@p329 int,@p330 datetime2(7),@p331 datetime2(7),@p332 datetime2(7),@p333 nvarchar(4000),@p334 nvarchar(4000),@p335 nvarchar(4000),@p336 nvarchar(4000),@p337 nvarchar(4000),@p338 nvarchar(4000),@p339 nvarchar(4000),@p340 nvarchar(4000),@p341 nvarchar(4000),@p342 nvarchar(4000),@p343 nvarchar(4000),@p344 nvarchar(4000),@p345 nvarchar(4000),@p346 nvarchar(4000),@p347 datetime2(7),@p348 nvarchar(4000),@p349 nvarchar(4000),@p350 int,@p351 int,@p352 int,@p353 nvarchar(4000),@p354 nvarchar(4000),@p355 nvarchar(4000),@p356 nvarchar(4000),@p357 decimal(18,2),@p358 nvarchar(4000),@p359 nvarchar(4000),@p360 decimal(18,2),@p361 nvarchar(4000),@p362 nvarchar(4000),@p363 nvarchar(4000),@p364 nvarchar(4000),@p365 int,@p366 nvarchar(4000),@p367 nvarchar(4000),@p368 nvarchar(4000),@p369 nvarchar(4000),@p370 nvarchar(4000),@p371 nvarchar(4000),@p372 nvarchar(4000),@p373 nvarchar(4000),@p374 nvarchar(4000),@p375 nvarchar(4000),@p376 int,@p377 nvarchar(4000),@p378 nvarchar(4000),@p379 nvarchar(4000),@p380 nvarchar(4000),@p381 nvarchar(4000),@p382 int,@p383 nvarchar(4000),@p384 int,@p385 int,@p386 datetime2(7),@p387 datetime2(7),@p388 datetime2(7),@p389 nvarchar(4000),@p390 nvarchar(4000),@p391 nvarchar(4000),@p392 nvarchar(4000),@p393 nvarchar(4000),@p394 nvarchar(4000),@p395 nvarchar(4000),@p396 nvarchar(4000),@p397 nvarchar(4000),@p398 nvarchar(4000),@p399 nvarchar(4000),@p400 nvarchar(4000),@p401 nvarchar(4000),@p402 nvarchar(4000),@p403 datetime2(7),@p404 nvarchar(4000),@p405 nvarchar(4000),@p406 int,@p407 int,@p408 int,@p409 nvarchar(4000),@p410 nvarchar(4000),@p411 nvarchar(4000),@p412 decimal(18,2),@p413 decimal(18,2),@p414 nvarchar(4000),@p415 nvarchar(4000),@p416 decimal(18,2),@p417 nvarchar(4000),@p418 nvarchar(4000),@p419 nvarchar(4000),@p420 nvarchar(4000),@p421 int,@p422 nvarchar(4000),@p423 nvarchar(4000),@p424 nvarchar(4000),@p425 nvarchar(4000),@p426 nvarchar(4000),@p427 nvarchar(4000),@p428 nvarchar(4000),@p429 nvarchar(4000),@p430 nvarchar(4000),@p431 nvarchar(4000),@p432 int,@p433 nvarchar(4000),@p434 nvarchar(4000),@p435 nvarchar(4000),@p436 nvarchar(4000),@p437 nvarchar(4000),@p438 int,@p439 nvarchar(4000),@p440 int,@p441 int,@p442 datetime2(7),@p443 datetime2(7),@p444 datetime2(7),@p445 nvarchar(4000),@p446 nvarchar(4000),@p447 nvarchar(4000),@p448 nvarchar(4000),@p449 nvarchar(4000),@p450 nvarchar(4000),@p451 nvarchar(4000),@p452 nvarchar(4000),@p453 nvarchar(4000),@p454 nvarchar(4000),@p455 nvarchar(4000),@p456 nvarchar(4000),@p457 nvarchar(4000),@p458 nvarchar(4000),@p459 datetime2(7),@p460 nvarchar(4000),@p461 nvarchar(4000),@p462 int,@p463 int,@p464 int,@p465 nvarchar(4000),@p466 nvarchar(4000),@p467 nvarchar(4000),@p468 decimal(18,2),@p469 decimal(18,2),@p470 nvarchar(4000),@p471 nvarchar(4000),@p472 decimal(18,2),@p473 nvarchar(4000),@p474 nvarchar(4000),@p475 nvarchar(4000),@p476 nvarchar(4000),@p477 int,@p478 nvarchar(4000),@p479 nvarchar(4000),@p480 nvarchar(4000),@p481 nvarchar(4000),@p482 nvarchar(4000),@p483 nvarchar(4000),@p484 nvarchar(4000),@p485 nvarchar(4000),@p486 nvarchar(4000),@p487 nvarchar(4000),@p488 int,@p489 nvarchar(4000),@p490 nvarchar(4000),@p491 nvarchar(4000),@p492 nvarchar(4000),@p493 nvarchar(4000),@p494 int,@p495 nvarchar(4000),@p496 int,@p497 int,@p498 datetime2(7),@p499 datetime2(7),@p500 datetime2(7),@p501 nvarchar(4000),@p502 nvarchar(4000),@p503 nvarchar(4000),@p504 nvarchar(4000),@p505 nvarchar(4000),@p506 nvarchar(4000),@p507 nvarchar(4000),@p508 nvarchar(4000),@p509 nvarchar(4000),@p510 nvarchar(4000),@p511 nvarchar(4000),@p512 nvarchar(4000),@p513 nvarchar(4000),@p514 nvarchar(4000),@p515 datetime2(7),@p516 nvarchar(4000),@p517 nvarchar(4000),@p518 int,@p519 int,@p520 int,@p521 nvarchar(4000),@p522 nvarchar(4000),@p523 nvarchar(4000),@p524 decimal(18,2),@p525 decimal(18,2),@p526 nvarchar(4000),@p527 nvarchar(4000),@p528 decimal(18,2),@p529 nvarchar(4000),@p530 nvarchar(4000),@p531 nvarchar(4000),@p532 nvarchar(4000),@p533 int,@p534 nvarchar(4000),@p535 nvarchar(4000),@p536 nvarchar(4000),@p537 nvarchar(4000),@p538 nvarchar(4000),@p539 nvarchar(4000),@p540 nvarchar(4000),@p541 nvarchar(4000),@p542 nvarchar(4000),@p543 nvarchar(4000),@p544 int,@p545 nvarchar(4000),@p546 nvarchar(4000),@p547 nvarchar(4000),@p548 nvarchar(4000),@p549 nvarchar(4000),@p550 int,@p551 nvarchar(4000),@p552 int,@p553 int,@p554 datetime2(7),@p555 datetime2(7),@p556 datetime2(7),@p557 nvarchar(4000),@p558 nvarchar(4000),@p559 nvarchar(4000),@p560 nvarchar(4000),@p561 nvarchar(4000),@p562 nvarchar(4000),@p563 nvarchar(4000),@p564 nvarchar(4000),@p565 nvarchar(4000),@p566 nvarchar(4000),@p567 nvarchar(4000),@p568 nvarchar(4000),@p569 nvarchar(4000),@p570 nvarchar(4000),@p571 datetime2(7),@p572 nvarchar(4000),@p573 nvarchar(4000),@p574 int,@p575 int,@p576 int,@p577 nvarchar(4000),@p578 nvarchar(4000),@p579 nvarchar(4000),@p580 decimal(18,2),@p581 decimal(18,2),@p582 nvarchar(4000),@p583 nvarchar(4000),@p584 decimal(18,2),@p585 nvarchar(4000),@p586 nvarchar(4000),@p587 nvarchar(4000),@p588 nvarchar(4000),@p589 int,@p590 nvarchar(4000),@p591 nvarchar(4000),@p592 nvarchar(4000),@p593 nvarchar(4000),@p594 nvarchar(4000),@p595 nvarchar(4000),@p596 nvarchar(4000),@p597 nvarchar(4000),@p598 nvarchar(4000),@p599 nvarchar(4000),@p600 int,@p601 nvarchar(4000),@p602 nvarchar(4000),@p603 nvarchar(4000),@p604 nvarchar(4000),@p605 nvarchar(4000),@p606 int,@p607 nvarchar(4000),@p608 int,@p609 int,@p610 datetime2(7),@p611 datetime2(7),@p612 datetime2(7),@p613 nvarchar(4000),@p614 nvarchar(4000),@p615 nvarchar(4000),@p616 nvarchar(4000),@p617 nvarchar(4000),@p618 nvarchar(4000),@p619 nvarchar(4000),@p620 nvarchar(4000),@p621 nvarchar(4000),@p622 nvarchar(4000),@p623 nvarchar(4000),@p624 nvarchar(4000),@p625 nvarchar(4000),@p626 nvarchar(4000),@p627 datetime2(7),@p628 nvarchar(4000),@p629 nvarchar(4000),@p630 int,@p631 int,@p632 int,@p633 nvarchar(4000),@p634 nvarchar(4000),@p635 nvarchar(4000),@p636 nvarchar(4000),@p637 decimal(18,2),@p638 nvarchar(4000),@p639 nvarchar(4000),@p640 decimal(18,2),@p641 nvarchar(4000),@p642 nvarchar(4000),@p643 nvarchar(4000),@p644 nvarchar(4000),@p645 int,@p646 nvarchar(4000),@p647 nvarchar(4000),@p648 nvarchar(4000),@p649 nvarchar(4000),@p650 nvarchar(4000),@p651 nvarchar(4000),@p652 nvarchar(4000),@p653 nvarchar(4000),@p654 nvarchar(4000),@p655 nvarchar(4000),@p656 int,@p657 nvarchar(4000),@p658 nvarchar(4000),@p659 nvarchar(4000),@p660 nvarchar(4000),@p661 nvarchar(4000),@p662 int,@p663 nvarchar(4000),@p664 int,@p665 int,@p666 datetime2(7),@p667 datetime2(7),@p668 datetime2(7),@p669 nvarchar(4000),@p670 nvarchar(4000),@p671 nvarchar(4000),@p672 nvarchar(4000),@p673 nvarchar(4000),@p674 nvarchar(4000),@p675 nvarchar(4000),@p676 nvarchar(4000),@p677 nvarchar(4000),@p678 nvarchar(4000),@p679 nvarchar(4000),@p680 nvarchar(4000),@p681 nvarchar(4000),@p682 nvarchar(4000),@p683 datetime2(7),@p684 nvarchar(4000),@p685 nvarchar(4000),@p686 int,@p687 int,@p688 int,@p689 nvarchar(4000),@p690 nvarchar(4000),@p691 nvarchar(4000),@p692 nvarchar(4000),@p693 decimal(18,2),@p694 nvarchar(4000),@p695 nvarchar(4000),@p696 decimal(18,2),@p697 nvarchar(4000),@p698 nvarchar(4000),@p699 nvarchar(4000),@p700 nvarchar(4000),@p701 int,@p702 nvarchar(4000),@p703 nvarchar(4000),@p704 nvarchar(4000),@p705 nvarchar(4000),@p706 nvarchar(4000),@p707 nvarchar(4000),@p708 nvarchar(4000),@p709 nvarchar(4000),@p710 nvarchar(4000),@p711 nvarchar(4000),@p712 int,@p713 nvarchar(4000),@p714 nvarchar(4000),@p715 nvarchar(4000),@p716 nvarchar(4000),@p717 nvarchar(4000),@p718 int,@p719 nvarchar(4000),@p720 int,@p721 int,@p722 datetime2(7),@p723 datetime2(7),@p724 datetime2(7),@p725 nvarchar(4000),@p726 nvarchar(4000),@p727 nvarchar(4000),@p728 nvarchar(4000),@p729 nvarchar(4000),@p730 nvarchar(4000),@p731 nvarchar(4000),@p732 nvarchar(4000),@p733 nvarchar(4000),@p734 nvarchar(4000),@p735 nvarchar(4000),@p736 nvarchar(4000),@p737 nvarchar(4000),@p738 nvarchar(4000),@p739 datetime2(7),@p740 nvarchar(4000),@p741 nvarchar(4000),@p742 int,@p743 int,@p744 int,@p745 nvarchar(4000),@p746 nvarchar(4000),@p747 nvarchar(4000),@p748 nvarchar(4000),@p749 decimal(18,2),@p750 nvarchar(4000),@p751 nvarchar(4000),@p752 decimal(18,2),@p753 nvarchar(4000),@p754 nvarchar(4000),@p755 nvarchar(4000),@p756 nvarchar(4000),@p757 int,@p758 nvarchar(4000),@p759 nvarchar(4000),@p760 nvarchar(4000),@p761 nvarchar(4000),@p762 nvarchar(4000),@p763 nvarchar(4000),@p764 nvarchar(4000),@p765 nvarchar(4000),@p766 nvarchar(4000),@p767 nvarchar(4000),@p768 int,@p769 nvarchar(4000),@p770 nvarchar(4000),@p771 nvarchar(4000),@p772 nvarchar(4000),@p773 nvarchar(4000),@p774 int,@p775 nvarchar(4000),@p776 int,@p777 int,@p778 datetime2(7),@p779 datetime2(7),@p780 datetime2(7),@p781 nvarchar(4000),@p782 nvarchar(4000),@p783 nvarchar(4000),@p784 nvarchar(4000),@p785 nvarchar(4000),@p786 nvarchar(4000),@p787 nvarchar(4000),@p788 nvarchar(4000),@p789 nvarchar(4000),@p790 nvarchar(4000),@p791 nvarchar(4000),@p792 nvarchar(4000),@p793 nvarchar(4000),@p794 nvarchar(4000),@p795 datetime2(7),@p796 nvarchar(4000),@p797 nvarchar(4000),@p798 int,@p799 int,@p800 int,@p801 nvarchar(4000),@p802 nvarchar(4000),@p803 nvarchar(4000),@p804 nvarchar(4000),@p805 decimal(18,2),@p806 nvarchar(4000),@p807 nvarchar(4000),@p808 decimal(18,2),@p809 nvarchar(4000),@p810 nvarchar(4000),@p811 nvarchar(4000),@p812 nvarchar(4000),@p813 int,@p814 nvarchar(4000),@p815 nvarchar(4000),@p816 nvarchar(4000),@p817 nvarchar(4000),@p818 nvarchar(4000),@p819 nvarchar(4000),@p820 nvarchar(4000),@p821 nvarchar(4000),@p822 nvarchar(4000),@p823 nvarchar(4000),@p824 int,@p825 nvarchar(4000),@p826 nvarchar(4000),@p827 nvarchar(4000),@p828 nvarchar(4000),@p829 nvarchar(4000),@p830 int,@p831 nvarchar(4000),@p832 int,@p833 int,@p834 datetime2(7),@p835 datetime2(7),@p836 datetime2(7),@p837 nvarchar(4000),@p838 nvarchar(4000),@p839 nvarchar(4000),@p840 nvarchar(4000),@p841 nvarchar(4000),@p842 nvarchar(4000),@p843 nvarchar(4000),@p844 nvarchar(4000),@p845 nvarchar(4000),@p846 nvarchar(4000),@p847 nvarchar(4000),@p848 nvarchar(4000),@p849 nvarchar(4000),@p850 nvarchar(4000),@p851 datetime2(7),@p852 nvarchar(4000),@p853 nvarchar(4000),@p854 int,@p855 int,@p856 int,@p857 nvarchar(4000),@p858 nvarchar(4000),@p859 nvarchar(4000),@p860 nvarchar(4000),@p861 decimal(18,2),@p862 nvarchar(4000),@p863 nvarchar(4000),@p864 decimal(18,2),@p865 nvarchar(4000),@p866 nvarchar(4000),@p867 nvarchar(4000),@p868 nvarchar(4000),@p869 int,@p870 nvarchar(4000),@p871 nvarchar(4000),@p872 nvarchar(4000),@p873 nvarchar(4000),@p874 nvarchar(4000),@p875 nvarchar(4000),@p876 nvarchar(4000),@p877 nvarchar(4000),@p878 nvarchar(4000),@p879 nvarchar(4000),@p880 int,@p881 nvarchar(4000),@p882 nvarchar(4000),@p883 nvarchar(4000),@p884 nvarchar(4000),@p885 nvarchar(4000),@p886 int,@p887 nvarchar(4000),@p888 int,@p889 int,@p890 datetime2(7),@p891 datetime2(7),@p892 datetime2(7),@p893 nvarchar(4000),@p894 nvarchar(4000),@p895 nvarchar(4000),@p896 nvarchar(4000),@p897 nvarchar(4000),@p898 nvarchar(4000),@p899 nvarchar(4000),@p900 nvarchar(4000),@p901 nvarchar(4000),@p902 nvarchar(4000),@p903 nvarchar(4000),@p904 nvarchar(4000),@p905 nvarchar(4000),@p906 nvarchar(4000),@p907 datetime2(7),@p908 nvarchar(4000),@p909 nvarchar(4000),@p910 int,@p911 int,@p912 int,@p913 nvarchar(4000),@p914 nvarchar(4000),@p915 nvarchar(4000),@p916 nvarchar(4000),@p917 decimal(18,2),@p918 nvarchar(4000),@p919 nvarchar(4000),@p920 decimal(18,2),@p921 nvarchar(4000),@p922 nvarchar(4000),@p923 nvarchar(4000),@p924 nvarchar(4000),@p925 int,@p926 nvarchar(4000),@p927 nvarchar(4000),@p928 nvarchar(4000),@p929 nvarchar(4000),@p930 nvarchar(4000),@p931 nvarchar(4000),@p932 nvarchar(4000),@p933 nvarchar(4000),@p934 nvarchar(4000),@p935 nvarchar(4000),@p936 int,@p937 nvarchar(4000),@p938 nvarchar(4000),@p939 nvarchar(4000),@p940 nvarchar(4000),@p941 nvarchar(4000),@p942 int,@p943 nvarchar(4000),@p944 int,@p945 int,@p946 datetime2(7),@p947 datetime2(7),@p948 datetime2(7),@p949 nvarchar(4000),@p950 nvarchar(4000),@p951 nvarchar(4000),@p952 nvarchar(4000),@p953 nvarchar(4000),@p954 nvarchar(4000),@p955 nvarchar(4000),@p956 nvarchar(4000),@p957 nvarchar(4000),@p958 nvarchar(4000),@p959 nvarchar(4000),@p960 nvarchar(4000),@p961 nvarchar(4000),@p962 nvarchar(4000),@p963 datetime2(7),@p964 nvarchar(4000),@p965 nvarchar(4000),@p966 int,@p967 int,@p968 int,@p969 nvarchar(4000),@p970 nvarchar(4000),@p971 nvarchar(4000),@p972 nvarchar(4000),@p973 decimal(18,2),@p974 nvarchar(4000),@p975 nvarchar(4000),@p976 decimal(18,2),@p977 nvarchar(4000),@p978 nvarchar(4000),@p979 nvarchar(4000),@p980 nvarchar(4000),@p981 int,@p982 nvarchar(4000),@p983 nvarchar(4000),@p984 nvarchar(4000),@p985 nvarchar(4000),@p986 nvarchar(4000),@p987 nvarchar(4000),@p988 nvarchar(4000),@p989 nvarchar(4000),@p990 nvarchar(4000),@p991 nvarchar(4000),@p992 int,@p993 nvarchar(4000),@p994 nvarchar(4000),@p995 nvarchar(4000),@p996 nvarchar(4000),@p997 nvarchar(4000),@p998 int,@p999 nvarchar(4000),@p1000 int,@p1001 int,@p1002 datetime2(7),@p1003 datetime2(7),@p1004 datetime2(7),@p1005 nvarchar(4000),@p1006 nvarchar(4000),@p1007 nvarchar(4000),@p1008 nvarchar(4000),@p1009 nvarchar(4000),@p1010 nvarchar(4000),@p1011 nvarchar(4000),@p1012 nvarchar(4000),@p1013 nvarchar(4000),@p1014 nvarchar(4000),@p1015 nvarchar(4000),@p1016 nvarchar(4000),@p1017 nvarchar(4000),@p1018 nvarchar(4000),@p1019 datetime2(7),@p1020 nvarchar(4000),@p1021 nvarchar(4000),@p1022 int,@p1023 int,@p1024 int,@p1025 nvarchar(4000),@p1026 nvarchar(4000),@p1027 nvarchar(4000),@p1028 nvarchar(4000),@p1029 decimal(18,2),@p1030 nvarchar(4000),@p1031 nvarchar(4000),@p1032 decimal(18,2),@p1033 nvarchar(4000),@p1034 nvarchar(4000),@p1035 nvarchar(4000),@p1036 nvarchar(4000),@p1037 int,@p1038 nvarchar(4000),@p1039 nvarchar(4000),@p1040 nvarchar(4000),@p1041 nvarchar(4000),@p1042 nvarchar(4000),@p1043 nvarchar(4000),@p1044 nvarchar(4000),@p1045 nvarchar(4000),@p1046 nvarchar(4000),@p1047 nvarchar(4000),@p1048 int,@p1049 nvarchar(4000),@p1050 nvarchar(4000),@p1051 nvarchar(4000),@p1052 nvarchar(4000),@p1053 nvarchar(4000),@p1054 int,@p1055 nvarchar(4000),@p1056 int,@p1057 int,@p1058 datetime2(7),@p1059 datetime2(7),@p1060 datetime2(7),@p1061 nvarchar(4000),@p1062 nvarchar(4000),@p1063 nvarchar(4000),@p1064 nvarchar(4000),@p1065 nvarchar(4000),@p1066 nvarchar(4000),@p1067 nvarchar(4000),@p1068 nvarchar(4000),@p1069 nvarchar(4000),@p1070 nvarchar(4000),@p1071 nvarchar(4000),@p1072 nvarchar(4000),@p1073 nvarchar(4000),@p1074 nvarchar(4000),@p1075 datetime2(7),@p1076 nvarchar(4000),@p1077 nvarchar(4000),@p1078 int,@p1079 int,@p1080 int,@p1081 nvarchar(4000),@p1082 nvarchar(4000),@p1083 nvarchar(4000),@p1084 nvarchar(4000),@p1085 decimal(18,2),@p1086 nvarchar(4000),@p1087 nvarchar(4000),@p1088 decimal(18,2),@p1089 nvarchar(4000),@p1090 nvarchar(4000),@p1091 nvarchar(4000),@p1092 nvarchar(4000),@p1093 int,@p1094 nvarchar(4000),@p1095 nvarchar(4000),@p1096 nvarchar(4000),@p1097 nvarchar(4000),@p1098 nvarchar(4000),@p1099 nvarchar(4000),@p1100 nvarchar(4000),@p1101 nvarchar(4000),@p1102 nvarchar(4000),@p1103 nvarchar(4000),@p1104 int,@p1105 nvarchar(4000),@p1106 nvarchar(4000),@p1107 nvarchar(4000),@p1108 nvarchar(4000),@p1109 nvarchar(4000),@p1110 int,@p1111 nvarchar(4000),@p1112 int,@p1113 int,@p1114 datetime2(7),@p1115 datetime2(7),@p1116 datetime2(7),@p1117 nvarchar(4000),@p1118 nvarchar(4000),@p1119 nvarchar(4000),@p1120 nvarchar(4000),@p1121 nvarchar(4000),@p1122 nvarchar(4000),@p1123 nvarchar(4000),@p1124 nvarchar(4000),@p1125 nvarchar(4000),@p1126 nvarchar(4000),@p1127 nvarchar(4000),@p1128 nvarchar(4000),@p1129 nvarchar(4000),@p1130 nvarchar(4000),@p1131 datetime2(7),@p1132 nvarchar(4000),@p1133 nvarchar(4000),@p1134 int,@p1135 int,@p1136 int,@p1137 nvarchar(4000),@p1138 nvarchar(4000),@p1139 nvarchar(4000),@p1140 nvarchar(4000),@p1141 decimal(18,2),@p1142 nvarchar(4000),@p1143 nvarchar(4000),@p1144 decimal(18,2),@p1145 nvarchar(4000),@p1146 nvarchar(4000),@p1147 nvarchar(4000),@p1148 nvarchar(4000),@p1149 int,@p1150 nvarchar(4000),@p1151 nvarchar(4000),@p1152 nvarchar(4000),@p1153 nvarchar(4000),@p1154 nvarchar(4000),@p1155 nvarchar(4000),@p1156 nvarchar(4000),@p1157 nvarchar(4000),@p1158 nvarchar(4000),@p1159 nvarchar(4000),@p1160 int,@p1161 nvarchar(4000),@p1162 nvarchar(4000),@p1163 nvarchar(4000),@p1164 nvarchar(4000),@p1165 nvarchar(4000),@p1166 int,@p1167 nvarchar(4000),@p1168 int,@p1169 int,@p1170 datetime2(7),@p1171 datetime2(7),@p1172 datetime2(7),@p1173 nvarchar(4000),@p1174 nvarchar(4000),@p1175 nvarchar(4000),@p1176 nvarchar(4000),@p1177 nvarchar(4000),@p1178 nvarchar(4000),@p1179 nvarchar(4000),@p1180 nvarchar(4000),@p1181 nvarchar(4000),@p1182 nvarchar(4000),@p1183 nvarchar(4000),@p1184 nvarchar(4000),@p1185 nvarchar(4000),@p1186 nvarchar(4000),@p1187 datetime2(7),@p1188 nvarchar(4000),@p1189 nvarchar(4000),@p1190 int,@p1191 int,@p1192 int,@p1193 nvarchar(4000),@p1194 nvarchar(4000),@p1195 nvarchar(4000),@p1196 nvarchar(4000),@p1197 decimal(18,2),@p1198 nvarchar(4000),@p1199 nvarchar(4000),@p1200 decimal(18,2),@p1201 nvarchar(4000),@p1202 nvarchar(4000),@p1203 nvarchar(4000),@p1204 nvarchar(4000),@p1205 int,@p1206 nvarchar(4000),@p1207 nvarchar(4000),@p1208 nvarchar(4000),@p1209 nvarchar(4000),@p1210 nvarchar(4000),@p1211 nvarchar(4000),@p1212 nvarchar(4000),@p1213 nvarchar(4000),@p1214 nvarchar(4000),@p1215 nvarchar(4000),@p1216 int,@p1217 nvarchar(4000),@p1218 nvarchar(4000),@p1219 nvarchar(4000),@p1220 nvarchar(4000),@p1221 nvarchar(4000),@p1222 int,@p1223 nvarchar(4000),@p1224 int,@p1225 int,@p1226 datetime2(7),@p1227 datetime2(7),@p1228 datetime2(7),@p1229 nvarchar(4000),@p1230 nvarchar(4000),@p1231 nvarchar(4000),@p1232 nvarchar(4000),@p1233 nvarchar(4000),@p1234 nvarchar(4000),@p1235 nvarchar(4000),@p1236 nvarchar(4000),@p1237 nvarchar(4000),@p1238 nvarchar(4000),@p1239 nvarchar(4000),@p1240 nvarchar(4000),@p1241 nvarchar(4000),@p1242 nvarchar(4000),@p1243 datetime2(7),@p1244 nvarchar(4000),@p1245 nvarchar(4000),@p1246 int,@p1247 int,@p1248 int,@p1249 nvarchar(4000),@p1250 nvarchar(4000),@p1251 nvarchar(4000),@p1252 nvarchar(4000),@p1253 decimal(18,2),@p1254 nvarchar(4000),@p1255 nvarchar(4000),@p1256 decimal(18,2),@p1257 nvarchar(4000),@p1258 nvarchar(4000),@p1259 nvarchar(4000),@p1260 nvarchar(4000),@p1261 int,@p1262 nvarchar(4000),@p1263 nvarchar(4000),@p1264 nvarchar(4000),@p1265 nvarchar(4000),@p1266 nvarchar(4000),@p1267 nvarchar(4000),@p1268 nvarchar(4000),@p1269 nvarchar(4000),@p1270 nvarchar(4000),@p1271 nvarchar(4000),@p1272 int,@p1273 nvarchar(4000),@p1274 nvarchar(4000),@p1275 nvarchar(4000),@p1276 nvarchar(4000),@p1277 nvarchar(4000),@p1278 int,@p1279 nvarchar(4000),@p1280 int,@p1281 int,@p1282 datetime2(7),@p1283 datetime2(7),@p1284 datetime2(7),@p1285 nvarchar(4000),@p1286 nvarchar(4000),@p1287 nvarchar(4000),@p1288 nvarchar(4000),@p1289 nvarchar(4000),@p1290 nvarchar(4000),@p1291 nvarchar(4000),@p1292 nvarchar(4000),@p1293 nvarchar(4000),@p1294 nvarchar(4000),@p1295 nvarchar(4000),@p1296 nvarchar(4000),@p1297 nvarchar(4000),@p1298 nvarchar(4000),@p1299 datetime2(7),@p1300 nvarchar(4000),@p1301 nvarchar(4000),@p1302 int,@p1303 int,@p1304 int,@p1305 nvarchar(4000),@p1306 nvarchar(4000),@p1307 nvarchar(4000),@p1308 nvarchar(4000),@p1309 decimal(18,2),@p1310 nvarchar(4000),@p1311 nvarchar(4000),@p1312 decimal(18,2),@p1313 nvarchar(4000),@p1314 nvarchar(4000),@p1315 nvarchar(4000),@p1316 nvarchar(4000),@p1317 int,@p1318 nvarchar(4000),@p1319 nvarchar(4000),@p1320 nvarchar(4000),@p1321 nvarchar(4000),@p1322 nvarchar(4000),@p1323 nvarchar(4000),@p1324 nvarchar(4000),@p1325 nvarchar(4000),@p1326 nvarchar(4000),@p1327 nvarchar(4000),@p1328 int,@p1329 nvarchar(4000),@p1330 nvarchar(4000),@p1331 nvarchar(4000),@p1332 nvarchar(4000),@p1333 nvarchar(4000),@p1334 int,@p1335 nvarchar(4000),@p1336 int,@p1337 int,@p1338 datetime2(7),@p1339 datetime2(7),@p1340 datetime2(7),@p1341 nvarchar(4000),@p1342 nvarchar(4000),@p1343 nvarchar(4000),@p1344 nvarchar(4000),@p1345 nvarchar(4000),@p1346 nvarchar(4000),@p1347 nvarchar(4000),@p1348 nvarchar(4000),@p1349 nvarchar(4000),@p1350 nvarchar(4000),@p1351 nvarchar(4000),@p1352 nvarchar(4000),@p1353 nvarchar(4000),@p1354 nvarchar(4000),@p1355 datetime2(7),@p1356 nvarchar(4000),@p1357 nvarchar(4000),@p1358 int,@p1359 int,@p1360 int,@p1361 nvarchar(4000),@p1362 nvarchar(4000),@p1363 nvarchar(4000),@p1364 nvarchar(4000),@p1365 decimal(18,2),@p1366 nvarchar(4000),@p1367 nvarchar(4000),@p1368 decimal(18,2),@p1369 nvarchar(4000),@p1370 nvarchar(4000),@p1371 nvarchar(4000),@p1372 nvarchar(4000),@p1373 int,@p1374 nvarchar(4000),@p1375 nvarchar(4000),@p1376 nvarchar(4000),@p1377 nvarchar(4000),@p1378 nvarchar(4000),@p1379 nvarchar(4000),@p1380 nvarchar(4000),@p1381 nvarchar(4000),@p1382 nvarchar(4000),@p1383 nvarchar(4000),@p1384 int,@p1385 nvarchar(4000),@p1386 nvarchar(4000),@p1387 nvarchar(4000),@p1388 nvarchar(4000),@p1389 nvarchar(4000),@p1390 int,@p1391 nvarchar(4000),@p1392 int,@p1393 int,@p1394 datetime2(7),@p1395 datetime2(7),@p1396 datetime2(7),@p1397 nvarchar(4000),@p1398 nvarchar(4000),@p1399 nvarchar(4000),@p1400 nvarchar(4000),@p1401 nvarchar(4000),@p1402 nvarchar(4000),@p1403 nvarchar(4000),@p1404 nvarchar(4000),@p1405 nvarchar(4000),@p1406 nvarchar(4000),@p1407 nvarchar(4000),@p1408 nvarchar(4000),@p1409 nvarchar(4000),@p1410 nvarchar(4000),@p1411 datetime2(7),@p1412 nvarchar(4000),@p1413 nvarchar(4000),@p1414 int,@p1415 int,@p1416 int,@p1417 nvarchar(4000),@p1418 nvarchar(4000),@p1419 nvarchar(4000),@p1420 nvarchar(4000),@p1421 decimal(18,2),@p1422 nvarchar(4000),@p1423 nvarchar(4000),@p1424 decimal(18,2),@p1425 nvarchar(4000),@p1426 nvarchar(4000),@p1427 nvarchar(4000),@p1428 nvarchar(4000),@p1429 int,@p1430 nvarchar(4000),@p1431 nvarchar(4000),@p1432 nvarchar(4000),@p1433 nvarchar(4000),@p1434 nvarchar(4000),@p1435 nvarchar(4000),@p1436 nvarchar(4000),@p1437 nvarchar(4000),@p1438 nvarchar(4000),@p1439 nvarchar(4000),@p1440 int,@p1441 nvarchar(4000),@p1442 nvarchar(4000),@p1443 nvarchar(4000),@p1444 nvarchar(4000),@p1445 nvarchar(4000),@p1446 int,@p1447 nvarchar(4000),@p1448 int,@p1449 int,@p1450 datetime2(7),@p1451 datetime2(7),@p1452 datetime2(7),@p1453 nvarchar(4000),@p1454 nvarchar(4000),@p1455 nvarchar(4000),@p1456 nvarchar(4000),@p1457 nvarchar(4000),@p1458 nvarchar(4000),@p1459 nvarchar(4000),@p1460 nvarchar(4000),@p1461 nvarchar(4000),@p1462 nvarchar(4000),@p1463 nvarchar(4000),@p1464 nvarchar(4000),@p1465 nvarchar(4000),@p1466 nvarchar(4000),@p1467 datetime2(7),@p1468 nvarchar(4000),@p1469 nvarchar(4000),@p1470 int,@p1471 int,@p1472 int,@p1473 nvarchar(4000),@p1474 nvarchar(4000),@p1475 nvarchar(4000),@p1476 nvarchar(4000),@p1477 decimal(18,2),@p1478 nvarchar(4000),@p1479 nvarchar(4000),@p1480 decimal(18,2),@p1481 nvarchar(4000),@p1482 nvarchar(4000),@p1483 nvarchar(4000),@p1484 nvarchar(4000),@p1485 int,@p1486 nvarchar(4000),@p1487 nvarchar(4000),@p1488 nvarchar(4000),@p1489 nvarchar(4000),@p1490 nvarchar(4000),@p1491 nvarchar(4000),@p1492 nvarchar(4000),@p1493 nvarchar(4000),@p1494 nvarchar(4000),@p1495 nvarchar(4000),@p1496 int,@p1497 nvarchar(4000),@p1498 nvarchar(4000),@p1499 nvarchar(4000),@p1500 nvarchar(4000),@p1501 nvarchar(4000),@p1502 int,@p1503 nvarchar(4000),@p1504 int,@p1505 int,@p1506 datetime2(7),@p1507 datetime2(7),@p1508 datetime2(7),@p1509 nvarchar(4000),@p1510 nvarchar(4000),@p1511 nvarchar(4000),@p1512 nvarchar(4000),@p1513 nvarchar(4000),@p1514 nvarchar(4000),@p1515 nvarchar(4000),@p1516 nvarchar(4000),@p1517 nvarchar(4000),@p1518 nvarchar(4000),@p1519 nvarchar(4000),@p1520 nvarchar(4000),@p1521 nvarchar(4000),@p1522 nvarchar(4000),@p1523 datetime2(7),@p1524 nvarchar(4000),@p1525 nvarchar(4000),@p1526 int,@p1527 int,@p1528 int,@p1529 nvarchar(4000),@p1530 nvarchar(4000),@p1531 nvarchar(4000),@p1532 nvarchar(4000),@p1533 decimal(18,2),@p1534 nvarchar(4000),@p1535 nvarchar(4000),@p1536 decimal(18,2),@p1537 nvarchar(4000),@p1538 nvarchar(4000),@p1539 nvarchar(4000),@p1540 nvarchar(4000),@p1541 int,@p1542 nvarchar(4000),@p1543 nvarchar(4000),@p1544 nvarchar(4000),@p1545 nvarchar(4000),@p1546 nvarchar(4000),@p1547 nvarchar(4000),@p1548 nvarchar(4000),@p1549 nvarchar(4000),@p1550 nvarchar(4000),@p1551 nvarchar(4000),@p1552 int,@p1553 nvarchar(4000),@p1554 nvarchar(4000),@p1555 nvarchar(4000),@p1556 nvarchar(4000),@p1557 nvarchar(4000),@p1558 int,@p1559 nvarchar(4000),@p1560 int,@p1561 int,@p1562 datetime2(7),@p1563 datetime2(7),@p1564 datetime2(7),@p1565 nvarchar(4000),@p1566 nvarchar(4000),@p1567 nvarchar(4000),@p1568 nvarchar(4000),@p1569 nvarchar(4000),@p1570 nvarchar(4000),@p1571 nvarchar(4000),@p1572 nvarchar(4000),@p1573 nvarchar(4000),@p1574 nvarchar(4000),@p1575 nvarchar(4000),@p1576 nvarchar(4000),@p1577 nvarchar(4000),@p1578 nvarchar(4000),@p1579 datetime2(7),@p1580 nvarchar(4000),@p1581 nvarchar(4000),@p1582 int,@p1583 int,@p1584 int,@p1585 nvarchar(4000),@p1586 nvarchar(4000),@p1587 nvarchar(4000),@p1588 nvarchar(4000),@p1589 decimal(18,2),@p1590 nvarchar(4000),@p1591 nvarchar(4000),@p1592 decimal(18,2),@p1593 nvarchar(4000),@p1594 nvarchar(4000),@p1595 nvarchar(4000),@p1596 nvarchar(4000),@p1597 int,@p1598 nvarchar(4000),@p1599 nvarchar(4000),@p1600 nvarchar(4000),@p1601 nvarchar(4000),@p1602 nvarchar(4000),@p1603 nvarchar(4000),@p1604 nvarchar(4000),@p1605 nvarchar(4000),@p1606 nvarchar(4000),@p1607 nvarchar(4000),@p1608 int,@p1609 nvarchar(4000),@p1610 nvarchar(4000),@p1611 nvarchar(4000),@p1612 nvarchar(4000),@p1613 nvarchar(4000),@p1614 int,@p1615 nvarchar(4000),@p1616 int,@p1617 int,@p1618 datetime2(7),@p1619 datetime2(7),@p1620 datetime2(7),@p1621 nvarchar(4000),@p1622 nvarchar(4000),@p1623 nvarchar(4000),@p1624 nvarchar(4000),@p1625 nvarchar(4000),@p1626 nvarchar(4000),@p1627 nvarchar(4000),@p1628 nvarchar(4000),@p1629 nvarchar(4000),@p1630 nvarchar(4000),@p1631 nvarchar(4000),@p1632 nvarchar(4000),@p1633 nvarchar(4000),@p1634 nvarchar(4000),@p1635 datetime2(7),@p1636 nvarchar(4000),@p1637 nvarchar(4000),@p1638 int,@p1639 int,@p1640 int,@p1641 nvarchar(4000),@p1642 nvarchar(4000),@p1643 nvarchar(4000),@p1644 nvarchar(4000),@p1645 decimal(18,2),@p1646 nvarchar(4000),@p1647 nvarchar(4000),@p1648 decimal(18,2),@p1649 nvarchar(4000),@p1650 nvarchar(4000),@p1651 nvarchar(4000),@p1652 nvarchar(4000),@p1653 int,@p1654 nvarchar(4000),@p1655 nvarchar(4000),@p1656 nvarchar(4000),@p1657 nvarchar(4000),@p1658 nvarchar(4000),@p1659 nvarchar(4000),@p1660 nvarchar(4000),@p1661 nvarchar(4000),@p1662 nvarchar(4000),@p1663 nvarchar(4000),@p1664 int,@p1665 nvarchar(4000),@p1666 nvarchar(4000),@p1667 nvarchar(4000),@p1668 nvarchar(4000),@p1669 nvarchar(4000),@p1670 int,@p1671 nvarchar(4000),@p1672 int,@p1673 int,@p1674 datetime2(7),@p1675 datetime2(7),@p1676 datetime2(7),@p1677 nvarchar(4000),@p1678 nvarchar(4000),@p1679 nvarchar(4000),@p1680 nvarchar(4000),@p1681 nvarchar(4000),@p1682 nvarchar(4000),@p1683 nvarchar(4000),@p1684 nvarchar(4000),@p1685 nvarchar(4000),@p1686 nvarchar(4000),@p1687 nvarchar(4000),@p1688 nvarchar(4000),@p1689 nvarchar(4000),@p1690 nvarchar(4000),@p1691 datetime2(7),@p1692 nvarchar(4000),@p1693 nvarchar(4000),@p1694 int,@p1695 int,@p1696 int,@p1697 nvarchar(4000),@p1698 nvarchar(4000),@p1699 nvarchar(4000),@p1700 nvarchar(4000),@p1701 decimal(18,2),@p1702 nvarchar(4000),@p1703 nvarchar(4000),@p1704 decimal(18,2),@p1705 nvarchar(4000),@p1706 nvarchar(4000),@p1707 nvarchar(4000),@p1708 nvarchar(4000),@p1709 int,@p1710 nvarchar(4000),@p1711 nvarchar(4000),@p1712 nvarchar(4000),@p1713 nvarchar(4000),@p1714 nvarchar(4000),@p1715 nvarchar(4000),@p1716 nvarchar(4000),@p1717 nvarchar(4000),@p1718 nvarchar(4000),@p1719 nvarchar(4000),@p1720 int,@p1721 nvarchar(4000),@p1722 nvarchar(4000),@p1723 nvarchar(4000),@p1724 nvarchar(4000),@p1725 nvarchar(4000),@p1726 int,@p1727 nvarchar(4000),@p1728 int,@p1729 int,@p1730 datetime2(7),@p1731 datetime2(7),@p1732 datetime2(7),@p1733 nvarchar(4000),@p1734 nvarchar(4000),@p1735 nvarchar(4000),@p1736 nvarchar(4000),@p1737 nvarchar(4000),@p1738 nvarchar(4000),@p1739 nvarchar(4000),@p1740 nvarchar(4000),@p1741 nvarchar(4000),@p1742 nvarchar(4000),@p1743 nvarchar(4000),@p1744 nvarchar(4000),@p1745 nvarchar(4000),@p1746 nvarchar(4000),@p1747 datetime2(7),@p1748 nvarchar(4000),@p1749 nvarchar(4000),@p1750 int,@p1751 int,@p1752 int,@p1753 nvarchar(4000),@p1754 nvarchar(4000),@p1755 nvarchar(4000),@p1756 nvarchar(4000),@p1757 decimal(18,2),@p1758 nvarchar(4000),@p1759 nvarchar(4000),@p1760 decimal(18,2),@p1761 nvarchar(4000),@p1762 nvarchar(4000),@p1763 nvarchar(4000),@p1764 nvarchar(4000),@p1765 int,@p1766 nvarchar(4000),@p1767 nvarchar(4000),@p1768 nvarchar(4000),@p1769 nvarchar(4000),@p1770 nvarchar(4000),@p1771 nvarchar(4000),@p1772 nvarchar(4000),@p1773 nvarchar(4000),@p1774 nvarchar(4000),@p1775 nvarchar(4000),@p1776 int,@p1777 nvarchar(4000),@p1778 nvarchar(4000),@p1779 nvarchar(4000),@p1780 nvarchar(4000),@p1781 nvarchar(4000),@p1782 int,@p1783 nvarchar(4000),@p1784 int,@p1785 int,@p1786 datetime2(7),@p1787 datetime2(7),@p1788 datetime2(7),@p1789 nvarchar(4000),@p1790 nvarchar(4000),@p1791 nvarchar(4000),@p1792 nvarchar(4000),@p1793 nvarchar(4000),@p1794 nvarchar(4000),@p1795 nvarchar(4000),@p1796 nvarchar(4000),@p1797 nvarchar(4000),@p1798 nvarchar(4000),@p1799 nvarchar(4000),@p1800 nvarchar(4000),@p1801 nvarchar(4000),@p1802 nvarchar(4000),@p1803 datetime2(7),@p1804 nvarchar(4000),@p1805 nvarchar(4000),@p1806 int,@p1807 int,@p1808 int,@p1809 nvarchar(4000),@p1810 nvarchar(4000),@p1811 nvarchar(4000),@p1812 nvarchar(4000),@p1813 decimal(18,2),@p1814 nvarchar(4000),@p1815 nvarchar(4000),@p1816 decimal(18,2),@p1817 nvarchar(4000),@p1818 nvarchar(4000),@p1819 nvarchar(4000),@p1820 nvarchar(4000),@p1821 int,@p1822 nvarchar(4000),@p1823 nvarchar(4000),@p1824 nvarchar(4000),@p1825 nvarchar(4000),@p1826 nvarchar(4000),@p1827 nvarchar(4000),@p1828 nvarchar(4000),@p1829 nvarchar(4000),@p1830 nvarchar(4000),@p1831 nvarchar(4000),@p1832 int,@p1833 nvarchar(4000),@p1834 nvarchar(4000),@p1835 nvarchar(4000),@p1836 nvarchar(4000),@p1837 nvarchar(4000),@p1838 int,@p1839 nvarchar(4000),@p1840 int,@p1841 int,@p1842 datetime2(7),@p1843 datetime2(7),@p1844 datetime2(7),@p1845 nvarchar(4000),@p1846 nvarchar(4000),@p1847 nvarchar(4000),@p1848 nvarchar(4000),@p1849 nvarchar(4000),@p1850 nvarchar(4000),@p1851 nvarchar(4000),@p1852 nvarchar(4000),@p1853 nvarchar(4000),@p1854 nvarchar(4000),@p1855 nvarchar(4000),@p1856 nvarchar(4000),@p1857 nvarchar(4000),@p1858 nvarchar(4000),@p1859 datetime2(7),@p1860 nvarchar(4000),@p1861 nvarchar(4000),@p1862 int,@p1863 int,@p1864 int,@p1865 nvarchar(4000),@p1866 nvarchar(4000),@p1867 nvarchar(4000),@p1868 nvarchar(4000),@p1869 decimal(18,2),@p1870 nvarchar(4000),@p1871 nvarchar(4000),@p1872 decimal(18,2),@p1873 nvarchar(4000),@p1874 nvarchar(4000),@p1875 nvarchar(4000),@p1876 nvarchar(4000),@p1877 int,@p1878 nvarchar(4000),@p1879 nvarchar(4000),@p1880 nvarchar(4000),@p1881 nvarchar(4000),@p1882 nvarchar(4000),@p1883 nvarchar(4000),@p1884 nvarchar(4000),@p1885 nvarchar(4000),@p1886 nvarchar(4000),@p1887 nvarchar(4000),@p1888 int,@p1889 nvarchar(4000),@p1890 nvarchar(4000),@p1891 nvarchar(4000),@p1892 nvarchar(4000),@p1893 nvarchar(4000),@p1894 int,@p1895 nvarchar(4000),@p1896 int,@p1897 int,@p1898 datetime2(7),@p1899 datetime2(7),@p1900 datetime2(7),@p1901 nvarchar(4000),@p1902 nvarchar(4000),@p1903 nvarchar(4000),@p1904 nvarchar(4000),@p1905 nvarchar(4000),@p1906 nvarchar(4000),@p1907 nvarchar(4000),@p1908 nvarchar(4000),@p1909 nvarchar(4000),@p1910 nvarchar(4000),@p1911 nvarchar(4000),@p1912 nvarchar(4000),@p1913 nvarchar(4000),@p1914 nvarchar(4000),@p1915 datetime2(7),@p1916 nvarchar(4000),@p1917 nvarchar(4000),@p1918 int,@p1919 int,@p1920 int,@p1921 nvarchar(4000),@p1922 nvarchar(4000),@p1923 nvarchar(4000),@p1924 nvarchar(4000),@p1925 decimal(18,2),@p1926 nvarchar(4000),@p1927 nvarchar(4000),@p1928 decimal(18,2),@p1929 nvarchar(4000),@p1930 nvarchar(4000),@p1931 nvarchar(4000),@p1932 nvarchar(4000),@p1933 int,@p1934 nvarchar(4000),@p1935 nvarchar(4000),@p1936 nvarchar(4000),@p1937 nvarchar(4000),@p1938 nvarchar(4000),@p1939 nvarchar(4000),@p1940 nvarchar(4000),@p1941 nvarchar(4000),@p1942 nvarchar(4000),@p1943 nvarchar(4000),@p1944 int,@p1945 nvarchar(4000),@p1946 nvarchar(4000),@p1947 nvarchar(4000),@p1948 nvarchar(4000),@p1949 nvarchar(4000),@p1950 int,@p1951 nvarchar(4000),@p1952 int,@p1953 int,@p1954 datetime2(7),@p1955 datetime2(7),@p1956 datetime2(7),@p1957 nvarchar(4000),@p1958 nvarchar(4000),@p1959 nvarchar(4000),@p1960 nvarchar(4000),@p1961 nvarchar(4000),@p1962 nvarchar(4000),@p1963 nvarchar(4000),@p1964 nvarchar(4000),@p1965 nvarchar(4000),@p1966 nvarchar(4000),@p1967 nvarchar(4000),@p1968 nvarchar(4000),@p1969 nvarchar(4000),@p1970 nvarchar(4000),@p1971 datetime2(7),@p1972 nvarchar(4000),@p1973 nvarchar(4000),@p1974 int,@p1975 int,@p1976 int,@p1977 nvarchar(4000),@p1978 nvarchar(4000),@p1979 nvarchar(4000),@p1980 nvarchar(4000),@p1981 decimal(18,2),@p1982 nvarchar(4000),@p1983 nvarchar(4000),@p1984 decimal(18,2),@p1985 nvarchar(4000),@p1986 nvarchar(4000),@p1987 nvarchar(4000),@p1988 nvarchar(4000),@p1989 int,@p1990 nvarchar(4000),@p1991 nvarchar(4000),@p1992 nvarchar(4000),@p1993 nvarchar(4000),@p1994 nvarchar(4000),@p1995 nvarchar(4000),@p1996 nvarchar(4000),@p1997 nvarchar(4000),@p1998 nvarchar(4000),@p1999 nvarchar(4000),@p2000 int,@p2001 nvarchar(4000),@p2002 nvarchar(4000),@p2003 nvarchar(4000),@p2004 nvarchar(4000),@p2005 nvarchar(4000),@p2006 int,@p2007 nvarchar(4000),@p2008 int,@p2009 int,@p2010 datetime2(7),@p2011 datetime2(7),@p2012 datetime2(7),@p2013 nvarchar(4000),@p2014 nvarchar(4000),@p2015 nvarchar(4000),@p2016 nvarchar(4000),@p2017 nvarchar(4000),@p2018 nvarchar(4000),@p2019 nvarchar(4000),@p2020 nvarchar(4000),@p2021 nvarchar(4000),@p2022 nvarchar(4000),@p2023 nvarchar(4000),@p2024 nvarchar(4000),@p2025 nvarchar(4000),@p2026 nvarchar(4000),@p2027 datetime2(7),@p2028 nvarchar(4000),@p2029 nvarchar(4000),@p2030 int,@p2031 int,@p2032 int,@p2033 nvarchar(4000),@p2034 nvarchar(4000),@p2035 nvarchar(4000),@p2036 nvarchar(4000),@p2037 decimal(18,2),@p2038 nvarchar(4000),@p2039 nvarchar(4000),@p2040 decimal(18,2),@p2041 nvarchar(4000),@p2042 nvarchar(4000),@p2043 nvarchar(4000),@p2044 nvarchar(4000),@p2045 int,@p2046 nvarchar(4000),@p2047 nvarchar(4000),@p2048 nvarchar(4000),@p2049 nvarchar(4000),@p2050 nvarchar(4000),@p2051 nvarchar(4000),@p2052 nvarchar(4000),@p2053 nvarchar(4000),@p2054 nvarchar(4000),@p2055 nvarchar(4000),@p2056 int,@p2057 nvarchar(4000),@p2058 nvarchar(4000),@p2059 nvarchar(4000),@p2060 nvarchar(4000),@p2061 nvarchar(4000),@p2062 int,@p2063 nvarchar(4000),@p2064 int,@p2065 int,@p2066 datetime2(7),@p2067 datetime2(7),@p2068 datetime2(7),@p2069 nvarchar(4000),@p2070 nvarchar(4000),@p2071 nvarchar(4000))SET NOCOUNT ON; DECLARE @inserted0 TABLE ([item_id] int, [_Position] [int]); MERGE [raw_data] USING ( VALUES (@p0, @p1, @p2, @p3, @p4, @p5, @p6, @p7, @p8, @p9, @p10, @p11, @p12, @p13, @p14, @p15, @p16, @p17, @p18, @p19, @p20, @p21, @p22, @p23, @p24, @p25, @p26, @p27, @p28, @p29, @p30, @p31, @p32, @p33, @p34, @p35, @p36, @p37, @p38, @p39, @p40, @p41, @p42, @p43, @p44, @p45, @p46, @p47, @p48, @p49, @p50, @p51, @p52, @p53, @p54, @p55, 0), (@p56, @p57, @p58, @p59, @p60, @p61, @p62, @p63, @p64, @p65, @p66, @p67, @p68, @p69, @p70, @p71, @p72, @p73, @p74, @p75, @p76, @p77, @p78, @p79, @p80, @p81, @p82, @p83, @p84, @p85, @p86, @p87, @p88, @p89, @p90, @p91, @p92, @p93, @p94, @p95, @p96, @p97, @p98, @p99, @p100, @p101, @p102, @p103, @p104, @p105, @p106, @p107, @p108, @p109, @p110, @p111, 1), (@p112, @p113, @p114, @p115, @p116, @p117, @p118, @p119, @p120, @p121, @p122, @p123, @p124, @p125, @p126, @p127, @p128, @p129, @p130, @p131, @p132, @p133, @p134, @p135, @p136, @p137, @p138, @p139, @p140, @p141, @p142, @p143, @p144, @p145, @p146, @p147, @p148, @p149, @p150, @p151, @p152, @p153, @p154, @p155, @p156, @p157, @p158, @p159, @p160, @p161, @p162, @p163, @p164, @p165, @p166, @p167, 2), (@p168, @p169, @p170, @p171, @p172, @p173, @p174, @p175, @p176, @p177, @p178, @p179, @p180, @p181, @p182, @p183, @p184, @p185, @p186, @p187, @p188, @p189, @p190, @p191, @p192, @p193, @p194, @p195, @p196, @p197, @p198, @p199, @p200, @p201, @p202, @p203, @p204, @p205, @p206, @p207, @p208, @p209, @p210, @p211, @p212, @p213, @p214, @p215, @p216, @p217, @p218, @p219, @p220, @p221, @p222, @p223, 3), (@p224, @p225, @p226, @p227, @p228, @p229, @p230, @p231, @p232, @p233, @p234, @p235, @p236, @p237, @p238, @p239, @p240, @p241, @p242, @p243, @p244, @p245, @p246, @p247, @p248, @p249, @p250, @p251, @p252, @p253, @p254, @p255, @p256, @p257, @p258, @p259, @p260, @p261, @p262, @p263, @p264, @p265, @p266, @p267, @p268, @p269, @p270, @p271, @p272, @p273, @p274, @p275, @p276, @p277, @p278, @p279, 4), (@p280, @p281, @p282, @p283, @p284, @p285, @p286, @p287, @p288, @p289, @p290, @p291, @p292, @p293, @p294, @p295, @p296, @p297, @p298, @p299, @p300, @p301, @p302, @p303, @p304, @p305, @p306, @p307, @p308, @p309, @p310, @p311, @p312, @p313, @p314, @p315, @p316, @p317, @p318, @p319, @p320, @p321, @p322, @p323, @p324, @p325, @p326, @p327, @p328, @p329, @p330, @p331, @p332, @p333, @p334, @p335, 5), (@p336, @p337, @p338, @p339, @p340, @p341, @p342, @p343, @p344, @p345, @p346, @p347, @p348, @p349, @p350, @p351, @p352, @p353, @p354, @p355, @p356, @p357, @p358, @p359, @p360, @p361, @p362, @p363, @p364, @p365, @p366, @p367, @p368, @p369, @p370, @p371, @p372, @p373, @p374, @p375, @p376, @p377, @p378, @p379, @p380, @p381, @p382, @p383, @p384, @p385, @p386, @p387, @p388, @p389, @p390, @p391, 6), (@p392, @p393, @p394, @p395, @p396, @p397, @p398, @p399, @p400, @p401, @p402, @p403, @p404, @p405, @p406, @p407, @p408, @p409, @p410, @p411, @p412, @p413, @p414, @p415, @p416, @p417, @p418, @p419, @p420, @p421, @p422, @p423, @p424, @p425, @p426, @p427, @p428, @p429, @p430, @p431, @p432, @p433, @p434, @p435, @p436, @p437, @p438, @p439, @p440, @p441, @p442, @p443, @p444, @p445, @p446, @p447, 7), (@p448, @p449, @p450, @p451, @p452, @p453, @p454, @p455, @p456, @p457, @p458, @p459, @p460, @p461, @p462, @p463, @p464, @p465, @p466, @p467, @p468, @p469, @p470, @p471, @p472, @p473, @p474, @p475, @p476, @p477, @p478, @p479, @p480, @p481, @p482, @p483, @p484, @p485, @p486, @p487, @p488, @p489, @p490, @p491, @p492, @p493, @p494, @p495, @p496, @p497, @p498, @p499, @p500, @p501, @p502, @p503, 8), (@p504, @p505, @p506, @p507, @p508, @p509, @p510, @p511, @p512, @p513, @p514, @p515, @p516, @p517, @p518, @p519, @p520, @p521, @p522, @p523, @p524, @p525, @p526, @p527, @p528, @p529, @p530, @p531, @p532, @p533, @p534, @p535, @p536, @p537, @p538, @p539, @p540, @p541, @p542, @p543, @p544, @p545, @p546, @p547, @p548, @p549, @p550, @p551, @p552, @p553, @p554, @p555, @p556, @p557, @p558, @p559, 9), (@p560, @p561, @p562, @p563, @p564, @p565, @p566, @p567, @p568, @p569, @p570, @p571, @p572, @p573, @p574, @p575, @p576, @p577, @p578, @p579, @p580, @p581, @p582, @p583, @p584, @p585, @p586, @p587, @p588, @p589, @p590, @p591, @p592, @p593, @p594, @p595, @p596, @p597, @p598, @p599, @p600, @p601, @p602, @p603, @p604, @p605, @p606, @p607, @p608, @p609, @p610, @p611, @p612, @p613, @p614, @p615, 10), (@p616, @p617, @p618, @p619, @p620, @p621, @p622, @p623, @p624, @p625, @p626, @p627, @p628, @p629, @p630, @p631, @p632, @p633, @p634, @p635, @p636, @p637, @p638, @p639, @p640, @p641, @p642, @p643, @p644, @p645, @p646, @p647, @p648, @p649, @p650, @p651, @p652, @p653, @p654, @p655, @p656, @p657, @p658, @p659, @p660, @p661, @p662, @p663, @p664, @p665, @p666, @p667, @p668, @p669, @p670, @p671, 11), (@p672, @p673, @p674, @p675, @p676, @p677, @p678, @p679, @p680, @p681, @p682, @p683, @p684, @p685, @p686, @p687, @p688, @p689, @p690, @p691, @p692, @p693, @p694, @p695, @p696, @p697, @p698, @p699, @p700, @p701, @p702, @p703, @p704, @p705, @p706, @p707, @p708, @p709, @p710, @p711, @p712, @p713, @p714, @p715, @p716, @p717, @p718, @p719, @p720, @p721, @p722, @p723, @p724, @p725, @p726, @p727, 12), (@p728, @p729, @p730, @p731, @p732, @p733, @p734, @p735, @p736, @p737, @p738, @p739, @p740, @p741, @p742, @p743, @p744, @p745, @p746, @p747, @p748, @p749, @p750, @p751, @p752, @p753, @p754, @p755, @p756, @p757, @p758, @p759, @p760, @p761, @p762, @p763, @p764, @p765, @p766, @p767, @p768, @p769, @p770, @p771, @p772, @p773, @p774, @p775, @p776, @p777, @p778, @p779, @p780, @p781, @p782, @p783, 13), (@p784, @p785, @p786, @p787, @p788, @p789, @p790, @p791, @p792, @p793, @p794, @p795, @p796, @p797, @p798, @p799, @p800, @p801, @p802, @p803, @p804, @p805, @p806, @p807, @p808, @p809, @p810, @p811, @p812, @p813, @p814, @p815, @p816, @p817, @p818, @p819, @p820, @p821, @p822, @p823, @p824, @p825, @p826, @p827, @p828, @p829, @p830, @p831, @p832, @p833, @p834, @p835, @p836, @p837, @p838, @p839, 14), (@p840, @p841, @p842, @p843, @p844, @p845, @p846, @p847, @p848, @p849, @p850, @p851, @p852, @p853, @p854, @p855, @p856, @p857, @p858, @p859, @p860, @p861, @p862, @p863, @p864, @p865, @p866, @p867, @p868, @p869, @p870, @p871, @p872, @p873, @p874, @p875, @p876, @p877, @p878, @p879, @p880, @p881, @p882, @p883, @p884, @p885, @p886, @p887, @p888, @p889, @p890, @p891, @p892, @p893, @p894, @p895, 15), (@p896, @p897, @p898, @p899, @p900, @p901, @p902, @p903, @p904, @p905, @p906, @p907, @p908, @p909, @p910, @p911, @p912, @p913, @p914, @p915, @p916, @p917, @p918, @p919, @p920, @p921, @p922, @p923, @p924, @p925, @p926, @p927, @p928, @p929, @p930, @p931, @p932, @p933, @p934, @p935, @p936, @p937, @p938, @p939, @p940, @p941, @p942, @p943, @p944, @p945, @p946, @p947, @p948, @p949, @p950, @p951, 16), (@p952, @p953, @p954, @p955, @p956, @p957, @p958, @p959, @p960, @p961, @p962, @p963, @p964, @p965, @p966, @p967, @p968, @p969, @p970, @p971, @p972, @p973, @p974, @p975, @p976, @p977, @p978, @p979, @p980, @p981, @p982, @p983, @p984, @p985, @p986, @p987, @p988, @p989, @p990, @p991, @p992, @p993, @p994, @p995, @p996, @p997, @p998, @p999, @p1000, @p1001, @p1002, @p1003, @p1004, @p1005, @p1006, @p1007, 17), (@p1008, @p1009, @p1010, @p1011, @p1012, @p1013, @p1014, @p1015, @p1016, @p1017, @p1018, @p1019, @p1020, @p1021, @p1022, @p1023, @p1024, @p1025, @p1026, @p1027, @p1028, @p1029, @p1030, @p1031, @p1032, @p1033, @p1034, @p1035, @p1036, @p1037, @p1038, @p1039, @p1040, @p1041, @p1042, @p1043, @p1044, @p1045, @p1046, @p1047, @p1048, @p1049, @p1050, @p1051, @p1052, @p1053, @p1054, @p1055, @p1056, @p1057, @p1058, @p1059, @p1060, @p1061, @p1062, @p1063, 18), (@p1064, @p1065, @p1066, @p1067, @p1068, @p1069, @p1070, @p1071, @p1072, @p1073, @p1074, @p1075, @p1076, @p1077, @p1078, @p1079, @p1080, @p1081, @p1082, @p1083, @p1084, @p1085, @p1086, @p1087, @p1088, @p1089, @p1090, @p1091, @p1092, @p1093, @p1094, @p1095, @p1096, @p1097, @p1098, @p1099, @p1100, @p1101, @p1102, @p1103, @p1104, @p1105, @p1106, @p1107, @p1108, @p1109, @p1110, @p1111, @p1112, @p1113, @p1114, @p1115, @p1116, @p1117, @p1118, @p1119, 19), (@p1120, @p1121, @p1122, @p1123, @p1124, @p1125, @p1126, @p1127, @p1128, @p1129, @p1130, @p1131, @p1132, @p1133, @p1134, @p1135, @p1136, @p1137, @p1138, @p1139, @p1140, @p1141, @p1142, @p1143, @p1144, @p1145, @p1146, @p1147, @p1148, @p1149, @p1150, @p1151, @p1152, @p1153, @p1154, @p1155, @p1156, @p1157, @p1158, @p1159, @p1160, @p1161, @p1162, @p1163, @p1164, @p1165, @p1166, @p1167, @p1168, @p1169, @p1170, @p1171, @p1172, @p1173, @p1174, @p1175, 20), (@p1176, @p1177, @p1178, @p1179, @p1180, @p1181, @p1182, @p1183, @p1184, @p1185, @p1186, @p1187, @p1188, @p1189, @p1190, @p1191, @p1192, @p1193, @p1194, @p1195, @p1196, @p1197, @p1198, @p1199, @p1200, @p1201, @p1202, @p1203, @p1204, @p1205, @p1206, @p1207, @p1208, @p1209, @p1210, @p1211, @p1212, @p1213, @p1214, @p1215, @p1216, @p1217, @p1218, @p1219, @p1220, @p1221, @p1222, @p1223, @p1224, @p1225, @p1226, @p1227, @p1228, @p1229, @p1230, @p1231, 21), (@p1232, @p1233, @p1234, @p1235, @p1236, @p1237, @p1238, @p1239, @p1240, @p1241, @p1242, @p1243, @p1244, @p1245, @p1246, @p1247, @p1248, @p1249, @p1250, @p1251, @p1252, @p1253, @p1254, @p1255, @p1256, @p1257, @p1258, @p1259, @p1260, @p1261, @p1262, @p1263, @p1264, @p1265, @p1266, @p1267, @p1268, @p1269, @p1270, @p1271, @p1272, @p1273, @p1274, @p1275, @p1276, @p1277, @p1278, @p1279, @p1280, @p1281, @p1282, @p1283, @p1284, @p1285, @p1286, @p1287, 22), (@p1288, @p1289, @p1290, @p1291, @p1292, @p1293, @p1294, @p1295, @p1296, @p1297, @p1298, @p1299, @p1300, @p1301, @p1302, @p1303, @p1304, @p1305, @p1306, @p1307, @p1308, @p1309, @p1310, @p1311, @p1312, @p1313, @p1314, @p1315, @p1316, @p1317, @p1318, @p1319, @p1320, @p1321, @p1322, @p1323, @p1324, @p1325, @p1326, @p1327, @p1328, @p1329, @p1330, @p1331, @p1332, @p1333, @p1334, @p1335, @p1336, @p1337, @p1338, @p1339, @p1340, @p1341, @p1342, @p1343, 23), (@p1344, @p1345, @p1346, @p1347, @p1348, @p1349, @p1350, @p1351, @p1352, @p1353, @p1354, @p1355, @p1356, @p1357, @p1358, @p1359, @p1360, @p1361, @p1362, @p1363, @p1364, @p1365, @p1366, @p1367, @p1368, @p1369, @p1370, @p1371, @p1372, @p1373, @p1374, @p1375, @p1376, @p1377, @p1378, @p1379, @p1380, @p1381, @p1382, @p1383, @p1384, @p1385, @p1386, @p1387, @p1388, @p1389, @p1390, @p1391, @p1392, @p1393, @p1394, @p1395, @p1396, @p1397, @p1398, @p1399, 24), (@p1400, @p1401, @p1402, @p1403, @p1404, @p1405, @p1406, @p1407, @p1408, @p1409, @p1410, @p1411, @p1412, @p1413, @p1414, @p1415, @p1416, @p1417, @p1418, @p1419, @p1420, @p1421, @p1422, @p1423, @p1424, @p1425, @p1426, @p1427, @p1428, @p1429, @p1430, @p1431, @p1432, @p1433, @p1434, @p1435, @p1436, @p1437, @p1438, @p1439, @p1440, @p1441, @p1442, @p1443, @p1444, @p1445, @p1446, @p1447, @p1448, @p1449, @p1450, @p1451, @p1452, @p1453, @p1454, @p1455, 25), (@p1456, @p1457, @p1458, @p1459, @p1460, @p1461, @p1462, @p1463, @p1464, @p1465, @p1466, @p1467, @p1468, @p1469, @p1470, @p1471, @p1472, @p1473, @p1474, @p1475, @p1476, @p1477, @p1478, @p1479, @p1480, @p1481, @p1482, @p1483, @p1484, @p1485, @p1486, @p1487, @p1488, @p1489, @p1490, @p1491, @p1492, @p1493, @p1494, @p1495, @p1496, @p1497, @p1498, @p1499, @p1500, @p1501, @p1502, @p1503, @p1504, @p1505, @p1506, @p1507, @p1508, @p1509, @p1510, @p1511, 26), (@p1512, @p1513, @p1514, @p1515, @p1516, @p1517, @p1518, @p1519, @p1520, @p1521, @p1522, @p1523, @p1524, @p1525, @p1526, @p1527, @p1528, @p1529, @p1530, @p1531, @p1532, @p1533, @p1534, @p1535, @p1536, @p1537, @p1538, @p1539, @p1540, @p1541, @p1542, @p1543, @p1544, @p1545, @p1546, @p1547, @p1548, @p1549, @p1550, @p1551, @p1552, @p1553, @p1554, @p1555, @p1556, @p1557, @p1558, @p1559, @p1560, @p1561, @p1562, @p1563, @p1564, @p1565, @p1566, @p1567, 27), (@p1568, @p1569, @p1570, @p1571, @p1572, @p1573, @p1574, @p1575, @p1576, @p1577, @p1578, @p1579, @p1580, @p1581, @p1582, @p1583, @p1584, @p1585, @p1586, @p1587, @p1588, @p1589, @p1590, @p1591, @p1592, @p1593, @p1594, @p1595, @p1596, @p1597, @p1598, @p1599, @p1600, @p1601, @p1602, @p1603, @p1604, @p1605, @p1606, @p1607, @p1608, @p1609, @p1610, @p1611, @p1612, @p1613, @p1614, @p1615, @p1616, @p1617, @p1618, @p1619, @p1620, @p1621, @p1622, @p1623, 28), (@p1624, @p1625, @p1626, @p1627, @p1628, @p1629, @p1630, @p1631, @p1632, @p1633, @p1634, @p1635, @p1636, @p1637, @p1638, @p1639, @p1640, @p1641, @p1642, @p1643, @p1644, @p1645, @p1646, @p1647, @p1648, @p1649, @p1650, @p1651, @p1652, @p1653, @p1654, @p1655, @p1656, @p1657, @p1658, @p1659, @p1660, @p1661, @p1662, @p1663, @p1664, @p1665, @p1666, @p1667, @p1668, @p1669, @p1670, @p1671, @p1672, @p1673, @p1674, @p1675, @p1676, @p1677, @p1678, @p1679, 29), (@p1680, @p1681, @p1682, @p1683, @p1684, @p1685, @p1686, @p1687, @p1688, @p1689, @p1690, @p1691, @p1692, @p1693, @p1694, @p1695, @p1696, @p1697, @p1698, @p1699, @p1700, @p1701, @p1702, @p1703, @p1704, @p1705, @p1706, @p1707, @p1708, @p1709, @p1710, @p1711, @p1712, @p1713, @p1714, @p1715, @p1716, @p1717, @p1718, @p1719, @p1720, @p1721, @p1722, @p1723, @p1724, @p1725, @p1726, @p1727, @p1728, @p1729, @p1730, @p1731, @p1732, @p1733, @p1734, @p1735, 30), (@p1736, @p1737, @p1738, @p1739, @p1740, @p1741, @p1742, @p1743, @p1744, @p1745, @p1746, @p1747, @p1748, @p1749, @p1750, @p1751, @p1752, @p1753, @p1754, @p1755, @p1756, @p1757, @p1758, @p1759, @p1760, @p1761, @p1762, @p1763, @p1764, @p1765, @p1766, @p1767, @p1768, @p1769, @p1770, @p1771, @p1772, @p1773, @p1774, @p1775, @p1776, @p1777, @p1778, @p1779, @p1780, @p1781, @p1782, @p1783, @p1784, @p1785, @p1786, @p1787, @p1788, @p1789, @p1790, @p1791, 31), (@p1792, @p1793, @p1794, @p1795, @p1796, @p1797, @p1798, @p1799, @p1800, @p1801, @p1802, @p1803, @p1804, @p1805, @p1806, @p1807, @p1808, @p1809, @p1810, @p1811, @p1812, @p1813, @p1814, @p1815, @p1816, @p1817, @p1818, @p1819, @p1820, @p1821, @p1822, @p1823, @p1824, @p1825, @p1826, @p1827, @p1828, @p1829, @p1830, @p1831, @p1832, @p1833, @p1834, @p1835, @p1836, @p1837, @p1838, @p1839, @p1840, @p1841, @p1842, @p1843, @p1844, @p1845, @p1846, @p1847, 32), (@p1848, @p1849, @p1850, @p1851, @p1852, @p1853, @p1854, @p1855, @p1856, @p1857, @p1858, @p1859, @p1860, @p1861, @p1862, @p1863, @p1864, @p1865, @p1866, @p1867, @p1868, @p1869, @p1870, @p1871, @p1872, @p1873, @p1874, @p1875, @p1876, @p1877, @p1878, @p1879, @p1880, @p1881, @p1882, @p1883, @p1884, @p1885, @p1886, @p1887, @p1888, @p1889, @p1890, @p1891, @p1892, @p1893, @p1894, @p1895, @p1896, @p1897, @p1898, @p1899, @p1900, @p1901, @p1902, @p1903, 33), (@p1904, @p1905, @p1906, @p1907, @p1908, @p1909, @p1910, @p1911, @p1912, @p1913, @p1914, @p1915, @p1916, @p1917, @p1918, @p1919, @p1920, @p1921, @p1922, @p1923, @p1924, @p1925, @p1926, @p1927, @p1928, @p1929, @p1930, @p1931, @p1932, @p1933, @p1934, @p1935, @p1936, @p1937, @p1938, @p1939, @p1940, @p1941, @p1942, @p1943, @p1944, @p1945, @p1946, @p1947, @p1948, @p1949, @p1950, @p1951, @p1952, @p1953, @p1954, @p1955, @p1956, @p1957, @p1958, @p1959, 34), (@p1960, @p1961, @p1962, @p1963, @p1964, @p1965, @p1966, @p1967, @p1968, @p1969, @p1970, @p1971, @p1972, @p1973, @p1974, @p1975, @p1976, @p1977, @p1978, @p1979, @p1980, @p1981, @p1982, @p1983, @p1984, @p1985, @p1986, @p1987, @p1988, @p1989, @p1990, @p1991, @p1992, @p1993, @p1994, @p1995, @p1996, @p1997, @p1998, @p1999, @p2000, @p2001, @p2002, @p2003, @p2004, @p2005, @p2006, @p2007, @p2008, @p2009, @p2010, @p2011, @p2012, @p2013, @p2014, @p2015, 35), (@p2016, @p2017, @p2018, @p2019, @p2020, @p2021, @p2022, @p2023, @p2024, @p2025, @p2026, @p2027, @p2028, @p2029, @p2030, @p2031, @p2032, @p2033, @p2034, @p2035, @p2036, @p2037, @p2038, @p2039, @p2040, @p2041, @p2042, @p2043, @p2044, @p2045, @p2046, @p2047, @p2048, @p2049, @p2050, @p2051, @p2052, @p2053, @p2054, @p2055, @p2056, @p2057, @p2058, @p2059, @p2060, @p2061, @p2062, @p2063, @p2064, @p2065, @p2066, @p2067, @p2068, @p2069, @p2070, @p2071, 36)) AS i ([addressee_cntry_cd], [addressee_city], [addressee_district], [addressee_email], [addressee_full_address], [addressee_home_address], [addressee_name], [addressee_postcode], [addressee_province], [addressee_subdistrict], [addressee_tel], [create_table], [delivery_code], [delivery_recipient_name], [delivery_relation_id], [delivery_status_id], [dest_outlet_id], [dest_outlet_port], [document_number], [item_barcode], [item_cod], [item_gross_weight], [item_height], [item_length], [item_price], [item_width], [lat], [log_id], [long], [outlet_id], [outlet_port], [podUrl], [remark], [scan_cntry_cd], [scan_cntry_postcode], [sender_cntry_cd], [sender_district], [sender_email], [sender_full_address], [sender_home_address], [member_id], [sender_name], [sender_postcode], [sender_province], [sender_subdistrict], [sender_tel], [server_id], [signatureUrl], [state], [status_code], [status_dtm], [timestamp], [transmit_dtm], [user_id], [wckt_id], [wkstn_no], _Position) ON 1=0 WHEN NOT MATCHED THEN INSERT ([addressee_cntry_cd], [addressee_city], [addressee_district], [addressee_email], [addressee_full_address], [addressee_home_address], [addressee_name], [addressee_postcode], [addressee_province], [addressee_subdistrict], [addressee_tel], [create_table], [delivery_code], [delivery_recipient_name], [delivery_relation_id], [delivery_status_id], [dest_outlet_id], [dest_outlet_port], [document_number], [item_barcode], [item_cod], [item_gross_weight], [item_height], [item_length], [item_price], [item_width], [lat], [log_id], [long], [outlet_id], [outlet_port], [podUrl], [remark], [scan_cntry_cd], [scan_cntry_postcode], [sender_cntry_cd], [sender_district], [sender_email], [sender_full_address], [sender_home_address], [member_id], [sender_name], [sender_postcode], [sender_province], [sender_subdistrict], [sender_tel], [server_id], [signatureUrl], [state], [status_code], [status_dtm], [timestamp], [transmit_dtm], [user_id], [wckt_id], [wkstn_no]) VALUES (i.[addressee_cntry_cd], i.[addressee_city], i.[addressee_district], i.[addressee_email], i.[addressee_full_address], i.[addressee_home_address], i.[addressee_name], i.[addressee_postcode], i.[addressee_province], i.[addressee_subdistrict], i.[addressee_tel], i.[create_table], i.[delivery_code], i.[delivery_recipient_name], i.[delivery_relation_id], i.[delivery_status_id], i.[dest_outlet_id], i.[dest_outlet_port], i.[document_number], i.[item_barcode], i.[item_cod], i.[item_gross_weight], i.[item_height], i.[item_length], i.[item_price], i.[item_width], i.[lat], i.[log_id], i.[long], i.[outlet_id], i.[outlet_port], i.[podUrl], i.[remark], i.[scan_cntry_cd], i.[scan_cntry_postcode], i.[sender_cntry_cd], i.[sender_district], i.[sender_email], i.[sender_full_address], i.[sender_home_address], i.[member_id], i.[sender_name], i.[sender_postcode], i.[sender_province], i.[sender_subdistrict], i.[sender_tel], i.[server_id], i.[signatureUrl], i.[state], i.[status_code], i.[status_dtm], i.[timestamp], i.[transmit_dtm], i.[user_id], i.[wckt_id], i.[wkstn_no]) OUTPUT INSERTED.[item_id], i._Position INTO @inserted0;  SELECT [t].[item_id] FROM [raw_data] t INNER JOIN @inserted0 i ON ([t].[item_id] = [i].[item_id]) ORDER BY [i].[_Position];  ",4,4,0,430,1,4
"(@p0 nvarchar(4000),@p1 nvarchar(4000),@p2 nvarchar(4000),@p3 nvarchar(4000),@p4 nvarchar(4000),@p5 nvarchar(4000),@p6 nvarchar(4000),@p7 nvarchar(4000),@p8 nvarchar(4000),@p9 nvarchar(4000),@p10 nvarchar(4000),@p11 datetime2(7),@p12 nvarchar(4000),@p13 nvarchar(4000),@p14 int,@p15 int,@p16 int,@p17 nvarchar(4000),@p18 nvarchar(4000),@p19 nvarchar(4000),@p20 decimal(18,2),@p21 decimal(18,2),@p22 nvarchar(4000),@p23 nvarchar(4000),@p24 decimal(18,2),@p25 nvarchar(4000),@p26 nvarchar(4000),@p27 nvarchar(4000),@p28 nvarchar(4000),@p29 int,@p30 nvarchar(4000),@p31 nvarchar(4000),@p32 nvarchar(4000),@p33 nvarchar(4000),@p34 nvarchar(4000),@p35 nvarchar(4000),@p36 nvarchar(4000),@p37 nvarchar(4000),@p38 nvarchar(4000),@p39 nvarchar(4000),@p40 int,@p41 nvarchar(4000),@p42 nvarchar(4000),@p43 nvarchar(4000),@p44 nvarchar(4000),@p45 nvarchar(4000),@p46 int,@p47 nvarchar(4000),@p48 int,@p49 int,@p50 datetime2(7),@p51 datetime2(7),@p52 datetime2(7),@p53 nvarchar(4000),@p54 nvarchar(4000),@p55 nvarchar(4000),@p56 nvarchar(4000),@p57 nvarchar(4000),@p58 nvarchar(4000),@p59 nvarchar(4000),@p60 nvarchar(4000),@p61 nvarchar(4000),@p62 nvarchar(4000),@p63 nvarchar(4000),@p64 nvarchar(4000),@p65 nvarchar(4000),@p66 nvarchar(4000),@p67 datetime2(7),@p68 nvarchar(4000),@p69 nvarchar(4000),@p70 int,@p71 int,@p72 int,@p73 nvarchar(4000),@p74 nvarchar(4000),@p75 nvarchar(4000),@p76 nvarchar(4000),@p77 decimal(18,2),@p78 nvarchar(4000),@p79 nvarchar(4000),@p80 decimal(18,2),@p81 nvarchar(4000),@p82 nvarchar(4000),@p83 nvarchar(4000),@p84 nvarchar(4000),@p85 int,@p86 nvarchar(4000),@p87 nvarchar(4000),@p88 nvarchar(4000),@p89 nvarchar(4000),@p90 nvarchar(4000),@p91 nvarchar(4000),@p92 nvarchar(4000),@p93 nvarchar(4000),@p94 nvarchar(4000),@p95 nvarchar(4000),@p96 int,@p97 nvarchar(4000),@p98 nvarchar(4000),@p99 nvarchar(4000),@p100 nvarchar(4000),@p101 nvarchar(4000),@p102 int,@p103 nvarchar(4000),@p104 int,@p105 int,@p106 datetime2(7),@p107 datetime2(7),@p108 datetime2(7),@p109 nvarchar(4000),@p110 nvarchar(4000),@p111 nvarchar(4000),@p112 nvarchar(4000),@p113 nvarchar(4000),@p114 nvarchar(4000),@p115 nvarchar(4000),@p116 nvarchar(4000),@p117 nvarchar(4000),@p118 nvarchar(4000),@p119 nvarchar(4000),@p120 nvarchar(4000),@p121 nvarchar(4000),@p122 nvarchar(4000),@p123 datetime2(7),@p124 nvarchar(4000),@p125 nvarchar(4000),@p126 int,@p127 int,@p128 int,@p129 nvarchar(4000),@p130 nvarchar(4000),@p131 nvarchar(4000),@p132 nvarchar(4000),@p133 decimal(18,2),@p134 nvarchar(4000),@p135 nvarchar(4000),@p136 decimal(18,2),@p137 nvarchar(4000),@p138 nvarchar(4000),@p139 nvarchar(4000),@p140 nvarchar(4000),@p141 int,@p142 nvarchar(4000),@p143 nvarchar(4000),@p144 nvarchar(4000),@p145 nvarchar(4000),@p146 nvarchar(4000),@p147 nvarchar(4000),@p148 nvarchar(4000),@p149 nvarchar(4000),@p150 nvarchar(4000),@p151 nvarchar(4000),@p152 int,@p153 nvarchar(4000),@p154 nvarchar(4000),@p155 nvarchar(4000),@p156 nvarchar(4000),@p157 nvarchar(4000),@p158 int,@p159 nvarchar(4000),@p160 int,@p161 int,@p162 datetime2(7),@p163 datetime2(7),@p164 datetime2(7),@p165 nvarchar(4000),@p166 nvarchar(4000),@p167 nvarchar(4000),@p168 nvarchar(4000),@p169 nvarchar(4000),@p170 nvarchar(4000),@p171 nvarchar(4000),@p172 nvarchar(4000),@p173 nvarchar(4000),@p174 nvarchar(4000),@p175 nvarchar(4000),@p176 nvarchar(4000),@p177 nvarchar(4000),@p178 nvarchar(4000),@p179 datetime2(7),@p180 nvarchar(4000),@p181 nvarchar(4000),@p182 int,@p183 int,@p184 int,@p185 nvarchar(4000),@p186 nvarchar(4000),@p187 nvarchar(4000),@p188 decimal(18,2),@p189 decimal(18,2),@p190 nvarchar(4000),@p191 nvarchar(4000),@p192 decimal(18,2),@p193 nvarchar(4000),@p194 nvarchar(4000),@p195 nvarchar(4000),@p196 nvarchar(4000),@p197 int,@p198 nvarchar(4000),@p199 nvarchar(4000),@p200 nvarchar(4000),@p201 nvarchar(4000),@p202 nvarchar(4000),@p203 nvarchar(4000),@p204 nvarchar(4000),@p205 nvarchar(4000),@p206 nvarchar(4000),@p207 nvarchar(4000),@p208 int,@p209 nvarchar(4000),@p210 nvarchar(4000),@p211 nvarchar(4000),@p212 nvarchar(4000),@p213 nvarchar(4000),@p214 int,@p215 nvarchar(4000),@p216 int,@p217 int,@p218 datetime2(7),@p219 datetime2(7),@p220 datetime2(7),@p221 nvarchar(4000),@p222 nvarchar(4000),@p223 nvarchar(4000),@p224 nvarchar(4000),@p225 nvarchar(4000),@p226 nvarchar(4000),@p227 nvarchar(4000),@p228 nvarchar(4000),@p229 nvarchar(4000),@p230 nvarchar(4000),@p231 nvarchar(4000),@p232 nvarchar(4000),@p233 nvarchar(4000),@p234 nvarchar(4000),@p235 datetime2(7),@p236 nvarchar(4000),@p237 nvarchar(4000),@p238 int,@p239 int,@p240 int,@p241 nvarchar(4000),@p242 nvarchar(4000),@p243 nvarchar(4000),@p244 nvarchar(4000),@p245 decimal(18,2),@p246 nvarchar(4000),@p247 nvarchar(4000),@p248 decimal(18,2),@p249 nvarchar(4000),@p250 nvarchar(4000),@p251 nvarchar(4000),@p252 nvarchar(4000),@p253 int,@p254 nvarchar(4000),@p255 nvarchar(4000),@p256 nvarchar(4000),@p257 nvarchar(4000),@p258 nvarchar(4000),@p259 nvarchar(4000),@p260 nvarchar(4000),@p261 nvarchar(4000),@p262 nvarchar(4000),@p263 nvarchar(4000),@p264 int,@p265 nvarchar(4000),@p266 nvarchar(4000),@p267 nvarchar(4000),@p268 nvarchar(4000),@p269 nvarchar(4000),@p270 int,@p271 nvarchar(4000),@p272 int,@p273 int,@p274 datetime2(7),@p275 datetime2(7),@p276 datetime2(7),@p277 nvarchar(4000),@p278 nvarchar(4000),@p279 nvarchar(4000),@p280 nvarchar(4000),@p281 nvarchar(4000),@p282 nvarchar(4000),@p283 nvarchar(4000),@p284 nvarchar(4000),@p285 nvarchar(4000),@p286 nvarchar(4000),@p287 nvarchar(4000),@p288 nvarchar(4000),@p289 nvarchar(4000),@p290 nvarchar(4000),@p291 datetime2(7),@p292 nvarchar(4000),@p293 nvarchar(4000),@p294 int,@p295 int,@p296 int,@p297 nvarchar(4000),@p298 nvarchar(4000),@p299 nvarchar(4000),@p300 decimal(18,2),@p301 decimal(18,2),@p302 nvarchar(4000),@p303 nvarchar(4000),@p304 decimal(18,2),@p305 nvarchar(4000),@p306 nvarchar(4000),@p307 nvarchar(4000),@p308 nvarchar(4000),@p309 int,@p310 nvarchar(4000),@p311 nvarchar(4000),@p312 nvarchar(4000),@p313 nvarchar(4000),@p314 nvarchar(4000),@p315 nvarchar(4000),@p316 nvarchar(4000),@p317 nvarchar(4000),@p318 nvarchar(4000),@p319 nvarchar(4000),@p320 int,@p321 nvarchar(4000),@p322 nvarchar(4000),@p323 nvarchar(4000),@p324 nvarchar(4000),@p325 nvarchar(4000),@p326 int,@p327 nvarchar(4000),@p328 int,@p329 int,@p330 datetime2(7),@p331 datetime2(7),@p332 datetime2(7),@p333 nvarchar(4000),@p334 nvarchar(4000),@p335 nvarchar(4000),@p336 nvarchar(4000),@p337 nvarchar(4000),@p338 nvarchar(4000),@p339 nvarchar(4000),@p340 nvarchar(4000),@p341 nvarchar(4000),@p342 nvarchar(4000),@p343 nvarchar(4000),@p344 nvarchar(4000),@p345 nvarchar(4000),@p346 nvarchar(4000),@p347 datetime2(7),@p348 nvarchar(4000),@p349 nvarchar(4000),@p350 int,@p351 int,@p352 int,@p353 nvarchar(4000),@p354 nvarchar(4000),@p355 nvarchar(4000),@p356 decimal(18,2),@p357 decimal(18,2),@p358 nvarchar(4000),@p359 nvarchar(4000),@p360 decimal(18,2),@p361 nvarchar(4000),@p362 nvarchar(4000),@p363 nvarchar(4000),@p364 nvarchar(4000),@p365 int,@p366 nvarchar(4000),@p367 nvarchar(4000),@p368 nvarchar(4000),@p369 nvarchar(4000),@p370 nvarchar(4000),@p371 nvarchar(4000),@p372 nvarchar(4000),@p373 nvarchar(4000),@p374 nvarchar(4000),@p375 nvarchar(4000),@p376 int,@p377 nvarchar(4000),@p378 nvarchar(4000),@p379 nvarchar(4000),@p380 nvarchar(4000),@p381 nvarchar(4000),@p382 int,@p383 nvarchar(4000),@p384 int,@p385 int,@p386 datetime2(7),@p387 datetime2(7),@p388 datetime2(7),@p389 nvarchar(4000),@p390 nvarchar(4000),@p391 nvarchar(4000),@p392 nvarchar(4000),@p393 nvarchar(4000),@p394 nvarchar(4000),@p395 nvarchar(4000),@p396 nvarchar(4000),@p397 nvarchar(4000),@p398 nvarchar(4000),@p399 nvarchar(4000),@p400 nvarchar(4000),@p401 nvarchar(4000),@p402 nvarchar(4000),@p403 datetime2(7),@p404 nvarchar(4000),@p405 nvarchar(4000),@p406 int,@p407 int,@p408 int,@p409 nvarchar(4000),@p410 nvarchar(4000),@p411 nvarchar(4000),@p412 nvarchar(4000),@p413 decimal(18,2),@p414 nvarchar(4000),@p415 nvarchar(4000),@p416 decimal(18,2),@p417 nvarchar(4000),@p418 nvarchar(4000),@p419 nvarchar(4000),@p420 nvarchar(4000),@p421 int,@p422 nvarchar(4000),@p423 nvarchar(4000),@p424 nvarchar(4000),@p425 nvarchar(4000),@p426 nvarchar(4000),@p427 nvarchar(4000),@p428 nvarchar(4000),@p429 nvarchar(4000),@p430 nvarchar(4000),@p431 nvarchar(4000),@p432 int,@p433 nvarchar(4000),@p434 nvarchar(4000),@p435 nvarchar(4000),@p436 nvarchar(4000),@p437 nvarchar(4000),@p438 int,@p439 nvarchar(4000),@p440 int,@p441 int,@p442 datetime2(7),@p443 datetime2(7),@p444 datetime2(7),@p445 nvarchar(4000),@p446 nvarchar(4000),@p447 nvarchar(4000),@p448 nvarchar(4000),@p449 nvarchar(4000),@p450 nvarchar(4000),@p451 nvarchar(4000),@p452 nvarchar(4000),@p453 nvarchar(4000),@p454 nvarchar(4000),@p455 nvarchar(4000),@p456 nvarchar(4000),@p457 nvarchar(4000),@p458 nvarchar(4000),@p459 datetime2(7),@p460 nvarchar(4000),@p461 nvarchar(4000),@p462 int,@p463 int,@p464 int,@p465 nvarchar(4000),@p466 nvarchar(4000),@p467 nvarchar(4000),@p468 decimal(18,2),@p469 decimal(18,2),@p470 nvarchar(4000),@p471 nvarchar(4000),@p472 decimal(18,2),@p473 nvarchar(4000),@p474 nvarchar(4000),@p475 nvarchar(4000),@p476 nvarchar(4000),@p477 int,@p478 nvarchar(4000),@p479 nvarchar(4000),@p480 nvarchar(4000),@p481 nvarchar(4000),@p482 nvarchar(4000),@p483 nvarchar(4000),@p484 nvarchar(4000),@p485 nvarchar(4000),@p486 nvarchar(4000),@p487 nvarchar(4000),@p488 int,@p489 nvarchar(4000),@p490 nvarchar(4000),@p491 nvarchar(4000),@p492 nvarchar(4000),@p493 nvarchar(4000),@p494 int,@p495 nvarchar(4000),@p496 int,@p497 int,@p498 datetime2(7),@p499 datetime2(7),@p500 datetime2(7),@p501 nvarchar(4000),@p502 nvarchar(4000),@p503 nvarchar(4000),@p504 nvarchar(4000),@p505 nvarchar(4000),@p506 nvarchar(4000),@p507 nvarchar(4000),@p508 nvarchar(4000),@p509 nvarchar(4000),@p510 nvarchar(4000),@p511 nvarchar(4000),@p512 nvarchar(4000),@p513 nvarchar(4000),@p514 nvarchar(4000),@p515 datetime2(7),@p516 nvarchar(4000),@p517 nvarchar(4000),@p518 int,@p519 int,@p520 int,@p521 nvarchar(4000),@p522 nvarchar(4000),@p523 nvarchar(4000),@p524 decimal(18,2),@p525 decimal(18,2),@p526 nvarchar(4000),@p527 nvarchar(4000),@p528 decimal(18,2),@p529 nvarchar(4000),@p530 nvarchar(4000),@p531 nvarchar(4000),@p532 nvarchar(4000),@p533 int,@p534 nvarchar(4000),@p535 nvarchar(4000),@p536 nvarchar(4000),@p537 nvarchar(4000),@p538 nvarchar(4000),@p539 nvarchar(4000),@p540 nvarchar(4000),@p541 nvarchar(4000),@p542 nvarchar(4000),@p543 nvarchar(4000),@p544 int,@p545 nvarchar(4000),@p546 nvarchar(4000),@p547 nvarchar(4000),@p548 nvarchar(4000),@p549 nvarchar(4000),@p550 int,@p551 nvarchar(4000),@p552 int,@p553 int,@p554 datetime2(7),@p555 datetime2(7),@p556 datetime2(7),@p557 nvarchar(4000),@p558 nvarchar(4000),@p559 nvarchar(4000),@p560 nvarchar(4000),@p561 nvarchar(4000),@p562 nvarchar(4000),@p563 nvarchar(4000),@p564 nvarchar(4000),@p565 nvarchar(4000),@p566 nvarchar(4000),@p567 nvarchar(4000),@p568 nvarchar(4000),@p569 nvarchar(4000),@p570 nvarchar(4000),@p571 datetime2(7),@p572 nvarchar(4000),@p573 nvarchar(4000),@p574 int,@p575 int,@p576 int,@p577 nvarchar(4000),@p578 nvarchar(4000),@p579 nvarchar(4000),@p580 decimal(18,2),@p581 decimal(18,2),@p582 nvarchar(4000),@p583 nvarchar(4000),@p584 decimal(18,2),@p585 nvarchar(4000),@p586 nvarchar(4000),@p587 nvarchar(4000),@p588 nvarchar(4000),@p589 int,@p590 nvarchar(4000),@p591 nvarchar(4000),@p592 nvarchar(4000),@p593 nvarchar(4000),@p594 nvarchar(4000),@p595 nvarchar(4000),@p596 nvarchar(4000),@p597 nvarchar(4000),@p598 nvarchar(4000),@p599 nvarchar(4000),@p600 int,@p601 nvarchar(4000),@p602 nvarchar(4000),@p603 nvarchar(4000),@p604 nvarchar(4000),@p605 nvarchar(4000),@p606 int,@p607 nvarchar(4000),@p608 int,@p609 int,@p610 datetime2(7),@p611 datetime2(7),@p612 datetime2(7),@p613 nvarchar(4000),@p614 nvarchar(4000),@p615 nvarchar(4000),@p616 nvarchar(4000),@p617 nvarchar(4000),@p618 nvarchar(4000),@p619 nvarchar(4000),@p620 nvarchar(4000),@p621 nvarchar(4000),@p622 nvarchar(4000),@p623 nvarchar(4000),@p624 nvarchar(4000),@p625 nvarchar(4000),@p626 nvarchar(4000),@p627 datetime2(7),@p628 nvarchar(4000),@p629 nvarchar(4000),@p630 int,@p631 int,@p632 int,@p633 nvarchar(4000),@p634 nvarchar(4000),@p635 nvarchar(4000),@p636 decimal(18,2),@p637 decimal(18,2),@p638 nvarchar(4000),@p639 nvarchar(4000),@p640 decimal(18,2),@p641 nvarchar(4000),@p642 nvarchar(4000),@p643 nvarchar(4000),@p644 nvarchar(4000),@p645 int,@p646 nvarchar(4000),@p647 nvarchar(4000),@p648 nvarchar(4000),@p649 nvarchar(4000),@p650 nvarchar(4000),@p651 nvarchar(4000),@p652 nvarchar(4000),@p653 nvarchar(4000),@p654 nvarchar(4000),@p655 nvarchar(4000),@p656 int,@p657 nvarchar(4000),@p658 nvarchar(4000),@p659 nvarchar(4000),@p660 nvarchar(4000),@p661 nvarchar(4000),@p662 int,@p663 nvarchar(4000),@p664 int,@p665 int,@p666 datetime2(7),@p667 datetime2(7),@p668 datetime2(7),@p669 nvarchar(4000),@p670 nvarchar(4000),@p671 nvarchar(4000),@p672 nvarchar(4000),@p673 nvarchar(4000),@p674 nvarchar(4000),@p675 nvarchar(4000),@p676 nvarchar(4000),@p677 nvarchar(4000),@p678 nvarchar(4000),@p679 nvarchar(4000),@p680 nvarchar(4000),@p681 nvarchar(4000),@p682 nvarchar(4000),@p683 datetime2(7),@p684 nvarchar(4000),@p685 nvarchar(4000),@p686 int,@p687 int,@p688 int,@p689 nvarchar(4000),@p690 nvarchar(4000),@p691 nvarchar(4000),@p692 nvarchar(4000),@p693 decimal(18,2),@p694 nvarchar(4000),@p695 nvarchar(4000),@p696 decimal(18,2),@p697 nvarchar(4000),@p698 nvarchar(4000),@p699 nvarchar(4000),@p700 nvarchar(4000),@p701 int,@p702 nvarchar(4000),@p703 nvarchar(4000),@p704 nvarchar(4000),@p705 nvarchar(4000),@p706 nvarchar(4000),@p707 nvarchar(4000),@p708 nvarchar(4000),@p709 nvarchar(4000),@p710 nvarchar(4000),@p711 nvarchar(4000),@p712 int,@p713 nvarchar(4000),@p714 nvarchar(4000),@p715 nvarchar(4000),@p716 nvarchar(4000),@p717 nvarchar(4000),@p718 int,@p719 nvarchar(4000),@p720 int,@p721 int,@p722 datetime2(7),@p723 datetime2(7),@p724 datetime2(7),@p725 nvarchar(4000),@p726 nvarchar(4000),@p727 nvarchar(4000),@p728 nvarchar(4000),@p729 nvarchar(4000),@p730 nvarchar(4000),@p731 nvarchar(4000),@p732 nvarchar(4000),@p733 nvarchar(4000),@p734 nvarchar(4000),@p735 nvarchar(4000),@p736 nvarchar(4000),@p737 nvarchar(4000),@p738 nvarchar(4000),@p739 datetime2(7),@p740 nvarchar(4000),@p741 nvarchar(4000),@p742 int,@p743 int,@p744 int,@p745 nvarchar(4000),@p746 nvarchar(4000),@p747 nvarchar(4000),@p748 nvarchar(4000),@p749 decimal(18,2),@p750 nvarchar(4000),@p751 nvarchar(4000),@p752 decimal(18,2),@p753 nvarchar(4000),@p754 nvarchar(4000),@p755 nvarchar(4000),@p756 nvarchar(4000),@p757 int,@p758 nvarchar(4000),@p759 nvarchar(4000),@p760 nvarchar(4000),@p761 nvarchar(4000),@p762 nvarchar(4000),@p763 nvarchar(4000),@p764 nvarchar(4000),@p765 nvarchar(4000),@p766 nvarchar(4000),@p767 nvarchar(4000),@p768 int,@p769 nvarchar(4000),@p770 nvarchar(4000),@p771 nvarchar(4000),@p772 nvarchar(4000),@p773 nvarchar(4000),@p774 int,@p775 nvarchar(4000),@p776 int,@p777 int,@p778 datetime2(7),@p779 datetime2(7),@p780 datetime2(7),@p781 nvarchar(4000),@p782 nvarchar(4000),@p783 nvarchar(4000),@p784 nvarchar(4000),@p785 nvarchar(4000),@p786 nvarchar(4000),@p787 nvarchar(4000),@p788 nvarchar(4000),@p789 nvarchar(4000),@p790 nvarchar(4000),@p791 nvarchar(4000),@p792 nvarchar(4000),@p793 nvarchar(4000),@p794 nvarchar(4000),@p795 datetime2(7),@p796 nvarchar(4000),@p797 nvarchar(4000),@p798 int,@p799 int,@p800 int,@p801 nvarchar(4000),@p802 nvarchar(4000),@p803 nvarchar(4000),@p804 nvarchar(4000),@p805 decimal(18,2),@p806 nvarchar(4000),@p807 nvarchar(4000),@p808 decimal(18,2),@p809 nvarchar(4000),@p810 nvarchar(4000),@p811 nvarchar(4000),@p812 nvarchar(4000),@p813 int,@p814 nvarchar(4000),@p815 nvarchar(4000),@p816 nvarchar(4000),@p817 nvarchar(4000),@p818 nvarchar(4000),@p819 nvarchar(4000),@p820 nvarchar(4000),@p821 nvarchar(4000),@p822 nvarchar(4000),@p823 nvarchar(4000),@p824 int,@p825 nvarchar(4000),@p826 nvarchar(4000),@p827 nvarchar(4000),@p828 nvarchar(4000),@p829 nvarchar(4000),@p830 int,@p831 nvarchar(4000),@p832 int,@p833 int,@p834 datetime2(7),@p835 datetime2(7),@p836 datetime2(7),@p837 nvarchar(4000),@p838 nvarchar(4000),@p839 nvarchar(4000),@p840 nvarchar(4000),@p841 nvarchar(4000),@p842 nvarchar(4000),@p843 nvarchar(4000),@p844 nvarchar(4000),@p845 nvarchar(4000),@p846 nvarchar(4000),@p847 nvarchar(4000),@p848 nvarchar(4000),@p849 nvarchar(4000),@p850 nvarchar(4000),@p851 datetime2(7),@p852 nvarchar(4000),@p853 nvarchar(4000),@p854 int,@p855 int,@p856 int,@p857 nvarchar(4000),@p858 nvarchar(4000),@p859 nvarchar(4000),@p860 decimal(18,2),@p861 decimal(18,2),@p862 nvarchar(4000),@p863 nvarchar(4000),@p864 decimal(18,2),@p865 nvarchar(4000),@p866 nvarchar(4000),@p867 nvarchar(4000),@p868 nvarchar(4000),@p869 int,@p870 nvarchar(4000),@p871 nvarchar(4000),@p872 nvarchar(4000),@p873 nvarchar(4000),@p874 nvarchar(4000),@p875 nvarchar(4000),@p876 nvarchar(4000),@p877 nvarchar(4000),@p878 nvarchar(4000),@p879 nvarchar(4000),@p880 int,@p881 nvarchar(4000),@p882 nvarchar(4000),@p883 nvarchar(4000),@p884 nvarchar(4000),@p885 nvarchar(4000),@p886 int,@p887 nvarchar(4000),@p888 int,@p889 int,@p890 datetime2(7),@p891 datetime2(7),@p892 datetime2(7),@p893 nvarchar(4000),@p894 nvarchar(4000),@p895 nvarchar(4000),@p896 nvarchar(4000),@p897 nvarchar(4000),@p898 nvarchar(4000),@p899 nvarchar(4000),@p900 nvarchar(4000),@p901 nvarchar(4000),@p902 nvarchar(4000),@p903 nvarchar(4000),@p904 nvarchar(4000),@p905 nvarchar(4000),@p906 nvarchar(4000),@p907 datetime2(7),@p908 nvarchar(4000),@p909 nvarchar(4000),@p910 int,@p911 int,@p912 int,@p913 nvarchar(4000),@p914 nvarchar(4000),@p915 nvarchar(4000),@p916 decimal(18,2),@p917 decimal(18,2),@p918 nvarchar(4000),@p919 nvarchar(4000),@p920 decimal(18,2),@p921 nvarchar(4000),@p922 nvarchar(4000),@p923 nvarchar(4000),@p924 nvarchar(4000),@p925 int,@p926 nvarchar(4000),@p927 nvarchar(4000),@p928 nvarchar(4000),@p929 nvarchar(4000),@p930 nvarchar(4000),@p931 nvarchar(4000),@p932 nvarchar(4000),@p933 nvarchar(4000),@p934 nvarchar(4000),@p935 nvarchar(4000),@p936 int,@p937 nvarchar(4000),@p938 nvarchar(4000),@p939 nvarchar(4000),@p940 nvarchar(4000),@p941 nvarchar(4000),@p942 int,@p943 nvarchar(4000),@p944 int,@p945 int,@p946 datetime2(7),@p947 datetime2(7),@p948 datetime2(7),@p949 nvarchar(4000),@p950 nvarchar(4000),@p951 nvarchar(4000),@p952 nvarchar(4000),@p953 nvarchar(4000),@p954 nvarchar(4000),@p955 nvarchar(4000),@p956 nvarchar(4000),@p957 nvarchar(4000),@p958 nvarchar(4000),@p959 nvarchar(4000),@p960 nvarchar(4000),@p961 nvarchar(4000),@p962 nvarchar(4000),@p963 datetime2(7),@p964 nvarchar(4000),@p965 nvarchar(4000),@p966 int,@p967 int,@p968 int,@p969 nvarchar(4000),@p970 nvarchar(4000),@p971 nvarchar(4000),@p972 decimal(18,2),@p973 decimal(18,2),@p974 nvarchar(4000),@p975 nvarchar(4000),@p976 decimal(18,2),@p977 nvarchar(4000),@p978 nvarchar(4000),@p979 nvarchar(4000),@p980 nvarchar(4000),@p981 int,@p982 nvarchar(4000),@p983 nvarchar(4000),@p984 nvarchar(4000),@p985 nvarchar(4000),@p986 nvarchar(4000),@p987 nvarchar(4000),@p988 nvarchar(4000),@p989 nvarchar(4000),@p990 nvarchar(4000),@p991 nvarchar(4000),@p992 int,@p993 nvarchar(4000),@p994 nvarchar(4000),@p995 nvarchar(4000),@p996 nvarchar(4000),@p997 nvarchar(4000),@p998 int,@p999 nvarchar(4000),@p1000 int,@p1001 int,@p1002 datetime2(7),@p1003 datetime2(7),@p1004 datetime2(7),@p1005 nvarchar(4000),@p1006 nvarchar(4000),@p1007 nvarchar(4000),@p1008 nvarchar(4000),@p1009 nvarchar(4000),@p1010 nvarchar(4000),@p1011 nvarchar(4000),@p1012 nvarchar(4000),@p1013 nvarchar(4000),@p1014 nvarchar(4000),@p1015 nvarchar(4000),@p1016 nvarchar(4000),@p1017 nvarchar(4000),@p1018 nvarchar(4000),@p1019 datetime2(7),@p1020 nvarchar(4000),@p1021 nvarchar(4000),@p1022 int,@p1023 int,@p1024 int,@p1025 nvarchar(4000),@p1026 nvarchar(4000),@p1027 nvarchar(4000),@p1028 decimal(18,2),@p1029 decimal(18,2),@p1030 nvarchar(4000),@p1031 nvarchar(4000),@p1032 decimal(18,2),@p1033 nvarchar(4000),@p1034 nvarchar(4000),@p1035 nvarchar(4000),@p1036 nvarchar(4000),@p1037 int,@p1038 nvarchar(4000),@p1039 nvarchar(4000),@p1040 nvarchar(4000),@p1041 nvarchar(4000),@p1042 nvarchar(4000),@p1043 nvarchar(4000),@p1044 nvarchar(4000),@p1045 nvarchar(4000),@p1046 nvarchar(4000),@p1047 nvarchar(4000),@p1048 int,@p1049 nvarchar(4000),@p1050 nvarchar(4000),@p1051 nvarchar(4000),@p1052 nvarchar(4000),@p1053 nvarchar(4000),@p1054 int,@p1055 nvarchar(4000),@p1056 int,@p1057 int,@p1058 datetime2(7),@p1059 datetime2(7),@p1060 datetime2(7),@p1061 nvarchar(4000),@p1062 nvarchar(4000),@p1063 nvarchar(4000),@p1064 nvarchar(4000),@p1065 nvarchar(4000),@p1066 nvarchar(4000),@p1067 nvarchar(4000),@p1068 nvarchar(4000),@p1069 nvarchar(4000),@p1070 nvarchar(4000),@p1071 nvarchar(4000),@p1072 nvarchar(4000),@p1073 nvarchar(4000),@p1074 nvarchar(4000),@p1075 datetime2(7),@p1076 nvarchar(4000),@p1077 nvarchar(4000),@p1078 int,@p1079 int,@p1080 int,@p1081 nvarchar(4000),@p1082 nvarchar(4000),@p1083 nvarchar(4000),@p1084 decimal(18,2),@p1085 decimal(18,2),@p1086 nvarchar(4000),@p1087 nvarchar(4000),@p1088 decimal(18,2),@p1089 nvarchar(4000),@p1090 nvarchar(4000),@p1091 nvarchar(4000),@p1092 nvarchar(4000),@p1093 int,@p1094 nvarchar(4000),@p1095 nvarchar(4000),@p1096 nvarchar(4000),@p1097 nvarchar(4000),@p1098 nvarchar(4000),@p1099 nvarchar(4000),@p1100 nvarchar(4000),@p1101 nvarchar(4000),@p1102 nvarchar(4000),@p1103 nvarchar(4000),@p1104 int,@p1105 nvarchar(4000),@p1106 nvarchar(4000),@p1107 nvarchar(4000),@p1108 nvarchar(4000),@p1109 nvarchar(4000),@p1110 int,@p1111 nvarchar(4000),@p1112 int,@p1113 int,@p1114 datetime2(7),@p1115 datetime2(7),@p1116 datetime2(7),@p1117 nvarchar(4000),@p1118 nvarchar(4000),@p1119 nvarchar(4000),@p1120 nvarchar(4000),@p1121 nvarchar(4000),@p1122 nvarchar(4000),@p1123 nvarchar(4000),@p1124 nvarchar(4000),@p1125 nvarchar(4000),@p1126 nvarchar(4000),@p1127 nvarchar(4000),@p1128 nvarchar(4000),@p1129 nvarchar(4000),@p1130 nvarchar(4000),@p1131 datetime2(7),@p1132 nvarchar(4000),@p1133 nvarchar(4000),@p1134 int,@p1135 int,@p1136 int,@p1137 nvarchar(4000),@p1138 nvarchar(4000),@p1139 nvarchar(4000),@p1140 nvarchar(4000),@p1141 decimal(18,2),@p1142 nvarchar(4000),@p1143 nvarchar(4000),@p1144 decimal(18,2),@p1145 nvarchar(4000),@p1146 nvarchar(4000),@p1147 nvarchar(4000),@p1148 nvarchar(4000),@p1149 int,@p1150 nvarchar(4000),@p1151 nvarchar(4000),@p1152 nvarchar(4000),@p1153 nvarchar(4000),@p1154 nvarchar(4000),@p1155 nvarchar(4000),@p1156 nvarchar(4000),@p1157 nvarchar(4000),@p1158 nvarchar(4000),@p1159 nvarchar(4000),@p1160 int,@p1161 nvarchar(4000),@p1162 nvarchar(4000),@p1163 nvarchar(4000),@p1164 nvarchar(4000),@p1165 nvarchar(4000),@p1166 int,@p1167 nvarchar(4000),@p1168 int,@p1169 int,@p1170 datetime2(7),@p1171 datetime2(7),@p1172 datetime2(7),@p1173 nvarchar(4000),@p1174 nvarchar(4000),@p1175 nvarchar(4000),@p1176 nvarchar(4000),@p1177 nvarchar(4000),@p1178 nvarchar(4000),@p1179 nvarchar(4000),@p1180 nvarchar(4000),@p1181 nvarchar(4000),@p1182 nvarchar(4000),@p1183 nvarchar(4000),@p1184 nvarchar(4000),@p1185 nvarchar(4000),@p1186 nvarchar(4000),@p1187 datetime2(7),@p1188 nvarchar(4000),@p1189 nvarchar(4000),@p1190 int,@p1191 int,@p1192 int,@p1193 nvarchar(4000),@p1194 nvarchar(4000),@p1195 nvarchar(4000),@p1196 decimal(18,2),@p1197 decimal(18,2),@p1198 nvarchar(4000),@p1199 nvarchar(4000),@p1200 decimal(18,2),@p1201 nvarchar(4000),@p1202 nvarchar(4000),@p1203 nvarchar(4000),@p1204 nvarchar(4000),@p1205 int,@p1206 nvarchar(4000),@p1207 nvarchar(4000),@p1208 nvarchar(4000),@p1209 nvarchar(4000),@p1210 nvarchar(4000),@p1211 nvarchar(4000),@p1212 nvarchar(4000),@p1213 nvarchar(4000),@p1214 nvarchar(4000),@p1215 nvarchar(4000),@p1216 int,@p1217 nvarchar(4000),@p1218 nvarchar(4000),@p1219 nvarchar(4000),@p1220 nvarchar(4000),@p1221 nvarchar(4000),@p1222 int,@p1223 nvarchar(4000),@p1224 int,@p1225 int,@p1226 datetime2(7),@p1227 datetime2(7),@p1228 datetime2(7),@p1229 nvarchar(4000),@p1230 nvarchar(4000),@p1231 nvarchar(4000),@p1232 nvarchar(4000),@p1233 nvarchar(4000),@p1234 nvarchar(4000),@p1235 nvarchar(4000),@p1236 nvarchar(4000),@p1237 nvarchar(4000),@p1238 nvarchar(4000),@p1239 nvarchar(4000),@p1240 nvarchar(4000),@p1241 nvarchar(4000),@p1242 nvarchar(4000),@p1243 datetime2(7),@p1244 nvarchar(4000),@p1245 nvarchar(4000),@p1246 int,@p1247 int,@p1248 int,@p1249 nvarchar(4000),@p1250 nvarchar(4000),@p1251 nvarchar(4000),@p1252 decimal(18,2),@p1253 decimal(18,2),@p1254 nvarchar(4000),@p1255 nvarchar(4000),@p1256 decimal(18,2),@p1257 nvarchar(4000),@p1258 nvarchar(4000),@p1259 nvarchar(4000),@p1260 nvarchar(4000),@p1261 int,@p1262 nvarchar(4000),@p1263 nvarchar(4000),@p1264 nvarchar(4000),@p1265 nvarchar(4000),@p1266 nvarchar(4000),@p1267 nvarchar(4000),@p1268 nvarchar(4000),@p1269 nvarchar(4000),@p1270 nvarchar(4000),@p1271 nvarchar(4000),@p1272 int,@p1273 nvarchar(4000),@p1274 nvarchar(4000),@p1275 nvarchar(4000),@p1276 nvarchar(4000),@p1277 nvarchar(4000),@p1278 int,@p1279 nvarchar(4000),@p1280 int,@p1281 int,@p1282 datetime2(7),@p1283 datetime2(7),@p1284 datetime2(7),@p1285 nvarchar(4000),@p1286 nvarchar(4000),@p1287 nvarchar(4000),@p1288 nvarchar(4000),@p1289 nvarchar(4000),@p1290 nvarchar(4000),@p1291 nvarchar(4000),@p1292 nvarchar(4000),@p1293 nvarchar(4000),@p1294 nvarchar(4000),@p1295 nvarchar(4000),@p1296 nvarchar(4000),@p1297 nvarchar(4000),@p1298 nvarchar(4000),@p1299 datetime2(7),@p1300 nvarchar(4000),@p1301 nvarchar(4000),@p1302 int,@p1303 int,@p1304 int,@p1305 nvarchar(4000),@p1306 nvarchar(4000),@p1307 nvarchar(4000),@p1308 decimal(18,2),@p1309 decimal(18,2),@p1310 nvarchar(4000),@p1311 nvarchar(4000),@p1312 decimal(18,2),@p1313 nvarchar(4000),@p1314 nvarchar(4000),@p1315 nvarchar(4000),@p1316 nvarchar(4000),@p1317 int,@p1318 nvarchar(4000),@p1319 nvarchar(4000),@p1320 nvarchar(4000),@p1321 nvarchar(4000),@p1322 nvarchar(4000),@p1323 nvarchar(4000),@p1324 nvarchar(4000),@p1325 nvarchar(4000),@p1326 nvarchar(4000),@p1327 nvarchar(4000),@p1328 int,@p1329 nvarchar(4000),@p1330 nvarchar(4000),@p1331 nvarchar(4000),@p1332 nvarchar(4000),@p1333 nvarchar(4000),@p1334 int,@p1335 nvarchar(4000),@p1336 int,@p1337 int,@p1338 datetime2(7),@p1339 datetime2(7),@p1340 datetime2(7),@p1341 nvarchar(4000),@p1342 nvarchar(4000),@p1343 nvarchar(4000),@p1344 nvarchar(4000),@p1345 nvarchar(4000),@p1346 nvarchar(4000),@p1347 nvarchar(4000),@p1348 nvarchar(4000),@p1349 nvarchar(4000),@p1350 nvarchar(4000),@p1351 nvarchar(4000),@p1352 nvarchar(4000),@p1353 nvarchar(4000),@p1354 nvarchar(4000),@p1355 datetime2(7),@p1356 nvarchar(4000),@p1357 nvarchar(4000),@p1358 int,@p1359 int,@p1360 int,@p1361 nvarchar(4000),@p1362 nvarchar(4000),@p1363 nvarchar(4000),@p1364 nvarchar(4000),@p1365 decimal(18,2),@p1366 nvarchar(4000),@p1367 nvarchar(4000),@p1368 decimal(18,2),@p1369 nvarchar(4000),@p1370 nvarchar(4000),@p1371 nvarchar(4000),@p1372 nvarchar(4000),@p1373 int,@p1374 nvarchar(4000),@p1375 nvarchar(4000),@p1376 nvarchar(4000),@p1377 nvarchar(4000),@p1378 nvarchar(4000),@p1379 nvarchar(4000),@p1380 nvarchar(4000),@p1381 nvarchar(4000),@p1382 nvarchar(4000),@p1383 nvarchar(4000),@p1384 int,@p1385 nvarchar(4000),@p1386 nvarchar(4000),@p1387 nvarchar(4000),@p1388 nvarchar(4000),@p1389 nvarchar(4000),@p1390 int,@p1391 nvarchar(4000),@p1392 int,@p1393 int,@p1394 datetime2(7),@p1395 datetime2(7),@p1396 datetime2(7),@p1397 nvarchar(4000),@p1398 nvarchar(4000),@p1399 nvarchar(4000),@p1400 nvarchar(4000),@p1401 nvarchar(4000),@p1402 nvarchar(4000),@p1403 nvarchar(4000),@p1404 nvarchar(4000),@p1405 nvarchar(4000),@p1406 nvarchar(4000),@p1407 nvarchar(4000),@p1408 nvarchar(4000),@p1409 nvarchar(4000),@p1410 nvarchar(4000),@p1411 datetime2(7),@p1412 nvarchar(4000),@p1413 nvarchar(4000),@p1414 int,@p1415 int,@p1416 int,@p1417 nvarchar(4000),@p1418 nvarchar(4000),@p1419 nvarchar(4000),@p1420 decimal(18,2),@p1421 decimal(18,2),@p1422 nvarchar(4000),@p1423 nvarchar(4000),@p1424 decimal(18,2),@p1425 nvarchar(4000),@p1426 nvarchar(4000),@p1427 nvarchar(4000),@p1428 nvarchar(4000),@p1429 int,@p1430 nvarchar(4000),@p1431 nvarchar(4000),@p1432 nvarchar(4000),@p1433 nvarchar(4000),@p1434 nvarchar(4000),@p1435 nvarchar(4000),@p1436 nvarchar(4000),@p1437 nvarchar(4000),@p1438 nvarchar(4000),@p1439 nvarchar(4000),@p1440 int,@p1441 nvarchar(4000),@p1442 nvarchar(4000),@p1443 nvarchar(4000),@p1444 nvarchar(4000),@p1445 nvarchar(4000),@p1446 int,@p1447 nvarchar(4000),@p1448 int,@p1449 int,@p1450 datetime2(7),@p1451 datetime2(7),@p1452 datetime2(7),@p1453 nvarchar(4000),@p1454 nvarchar(4000),@p1455 nvarchar(4000),@p1456 nvarchar(4000),@p1457 nvarchar(4000),@p1458 nvarchar(4000),@p1459 nvarchar(4000),@p1460 nvarchar(4000),@p1461 nvarchar(4000),@p1462 nvarchar(4000),@p1463 nvarchar(4000),@p1464 nvarchar(4000),@p1465 nvarchar(4000),@p1466 nvarchar(4000),@p1467 datetime2(7),@p1468 nvarchar(4000),@p1469 nvarchar(4000),@p1470 int,@p1471 int,@p1472 int,@p1473 nvarchar(4000),@p1474 nvarchar(4000),@p1475 nvarchar(4000),@p1476 decimal(18,2),@p1477 decimal(18,2),@p1478 nvarchar(4000),@p1479 nvarchar(4000),@p1480 decimal(18,2),@p1481 nvarchar(4000),@p1482 nvarchar(4000),@p1483 nvarchar(4000),@p1484 nvarchar(4000),@p1485 int,@p1486 nvarchar(4000),@p1487 nvarchar(4000),@p1488 nvarchar(4000),@p1489 nvarchar(4000),@p1490 nvarchar(4000),@p1491 nvarchar(4000),@p1492 nvarchar(4000),@p1493 nvarchar(4000),@p1494 nvarchar(4000),@p1495 nvarchar(4000),@p1496 int,@p1497 nvarchar(4000),@p1498 nvarchar(4000),@p1499 nvarchar(4000),@p1500 nvarchar(4000),@p1501 nvarchar(4000),@p1502 int,@p1503 nvarchar(4000),@p1504 int,@p1505 int,@p1506 datetime2(7),@p1507 datetime2(7),@p1508 datetime2(7),@p1509 nvarchar(4000),@p1510 nvarchar(4000),@p1511 nvarchar(4000),@p1512 nvarchar(4000),@p1513 nvarchar(4000),@p1514 nvarchar(4000),@p1515 nvarchar(4000),@p1516 nvarchar(4000),@p1517 nvarchar(4000),@p1518 nvarchar(4000),@p1519 nvarchar(4000),@p1520 nvarchar(4000),@p1521 nvarchar(4000),@p1522 nvarchar(4000),@p1523 datetime2(7),@p1524 nvarchar(4000),@p1525 nvarchar(4000),@p1526 int,@p1527 int,@p1528 int,@p1529 nvarchar(4000),@p1530 nvarchar(4000),@p1531 nvarchar(4000),@p1532 decimal(18,2),@p1533 decimal(18,2),@p1534 nvarchar(4000),@p1535 nvarchar(4000),@p1536 decimal(18,2),@p1537 nvarchar(4000),@p1538 nvarchar(4000),@p1539 nvarchar(4000),@p1540 nvarchar(4000),@p1541 int,@p1542 nvarchar(4000),@p1543 nvarchar(4000),@p1544 nvarchar(4000),@p1545 nvarchar(4000),@p1546 nvarchar(4000),@p1547 nvarchar(4000),@p1548 nvarchar(4000),@p1549 nvarchar(4000),@p1550 nvarchar(4000),@p1551 nvarchar(4000),@p1552 int,@p1553 nvarchar(4000),@p1554 nvarchar(4000),@p1555 nvarchar(4000),@p1556 nvarchar(4000),@p1557 nvarchar(4000),@p1558 int,@p1559 nvarchar(4000),@p1560 int,@p1561 int,@p1562 datetime2(7),@p1563 datetime2(7),@p1564 datetime2(7),@p1565 nvarchar(4000),@p1566 nvarchar(4000),@p1567 nvarchar(4000),@p1568 nvarchar(4000),@p1569 nvarchar(4000),@p1570 nvarchar(4000),@p1571 nvarchar(4000),@p1572 nvarchar(4000),@p1573 nvarchar(4000),@p1574 nvarchar(4000),@p1575 nvarchar(4000),@p1576 nvarchar(4000),@p1577 nvarchar(4000),@p1578 nvarchar(4000),@p1579 datetime2(7),@p1580 nvarchar(4000),@p1581 nvarchar(4000),@p1582 int,@p1583 int,@p1584 int,@p1585 nvarchar(4000),@p1586 nvarchar(4000),@p1587 nvarchar(4000),@p1588 decimal(18,2),@p1589 decimal(18,2),@p1590 nvarchar(4000),@p1591 nvarchar(4000),@p1592 decimal(18,2),@p1593 nvarchar(4000),@p1594 nvarchar(4000),@p1595 nvarchar(4000),@p1596 nvarchar(4000),@p1597 int,@p1598 nvarchar(4000),@p1599 nvarchar(4000),@p1600 nvarchar(4000),@p1601 nvarchar(4000),@p1602 nvarchar(4000),@p1603 nvarchar(4000),@p1604 nvarchar(4000),@p1605 nvarchar(4000),@p1606 nvarchar(4000),@p1607 nvarchar(4000),@p1608 int,@p1609 nvarchar(4000),@p1610 nvarchar(4000),@p1611 nvarchar(4000),@p1612 nvarchar(4000),@p1613 nvarchar(4000),@p1614 int,@p1615 nvarchar(4000),@p1616 int,@p1617 int,@p1618 datetime2(7),@p1619 datetime2(7),@p1620 datetime2(7),@p1621 nvarchar(4000),@p1622 nvarchar(4000),@p1623 nvarchar(4000),@p1624 nvarchar(4000),@p1625 nvarchar(4000),@p1626 nvarchar(4000),@p1627 nvarchar(4000),@p1628 nvarchar(4000),@p1629 nvarchar(4000),@p1630 nvarchar(4000),@p1631 nvarchar(4000),@p1632 nvarchar(4000),@p1633 nvarchar(4000),@p1634 nvarchar(4000),@p1635 datetime2(7),@p1636 nvarchar(4000),@p1637 nvarchar(4000),@p1638 int,@p1639 int,@p1640 int,@p1641 nvarchar(4000),@p1642 nvarchar(4000),@p1643 nvarchar(4000),@p1644 nvarchar(4000),@p1645 decimal(18,2),@p1646 nvarchar(4000),@p1647 nvarchar(4000),@p1648 decimal(18,2),@p1649 nvarchar(4000),@p1650 nvarchar(4000),@p1651 nvarchar(4000),@p1652 nvarchar(4000),@p1653 int,@p1654 nvarchar(4000),@p1655 nvarchar(4000),@p1656 nvarchar(4000),@p1657 nvarchar(4000),@p1658 nvarchar(4000),@p1659 nvarchar(4000),@p1660 nvarchar(4000),@p1661 nvarchar(4000),@p1662 nvarchar(4000),@p1663 nvarchar(4000),@p1664 int,@p1665 nvarchar(4000),@p1666 nvarchar(4000),@p1667 nvarchar(4000),@p1668 nvarchar(4000),@p1669 nvarchar(4000),@p1670 int,@p1671 nvarchar(4000),@p1672 int,@p1673 int,@p1674 datetime2(7),@p1675 datetime2(7),@p1676 datetime2(7),@p1677 nvarchar(4000),@p1678 nvarchar(4000),@p1679 nvarchar(4000),@p1680 nvarchar(4000),@p1681 nvarchar(4000),@p1682 nvarchar(4000),@p1683 nvarchar(4000),@p1684 nvarchar(4000),@p1685 nvarchar(4000),@p1686 nvarchar(4000),@p1687 nvarchar(4000),@p1688 nvarchar(4000),@p1689 nvarchar(4000),@p1690 nvarchar(4000),@p1691 datetime2(7),@p1692 nvarchar(4000),@p1693 nvarchar(4000),@p1694 int,@p1695 int,@p1696 int,@p1697 nvarchar(4000),@p1698 nvarchar(4000),@p1699 nvarchar(4000),@p1700 decimal(18,2),@p1701 decimal(18,2),@p1702 nvarchar(4000),@p1703 nvarchar(4000),@p1704 decimal(18,2),@p1705 nvarchar(4000),@p1706 nvarchar(4000),@p1707 nvarchar(4000),@p1708 nvarchar(4000),@p1709 int,@p1710 nvarchar(4000),@p1711 nvarchar(4000),@p1712 nvarchar(4000),@p1713 nvarchar(4000),@p1714 nvarchar(4000),@p1715 nvarchar(4000),@p1716 nvarchar(4000),@p1717 nvarchar(4000),@p1718 nvarchar(4000),@p1719 nvarchar(4000),@p1720 int,@p1721 nvarchar(4000),@p1722 nvarchar(4000),@p1723 nvarchar(4000),@p1724 nvarchar(4000),@p1725 nvarchar(4000),@p1726 int,@p1727 nvarchar(4000),@p1728 int,@p1729 int,@p1730 datetime2(7),@p1731 datetime2(7),@p1732 datetime2(7),@p1733 nvarchar(4000),@p1734 nvarchar(4000),@p1735 nvarchar(4000),@p1736 nvarchar(4000),@p1737 nvarchar(4000),@p1738 nvarchar(4000),@p1739 nvarchar(4000),@p1740 nvarchar(4000),@p1741 nvarchar(4000),@p1742 nvarchar(4000),@p1743 nvarchar(4000),@p1744 nvarchar(4000),@p1745 nvarchar(4000),@p1746 nvarchar(4000),@p1747 datetime2(7),@p1748 nvarchar(4000),@p1749 nvarchar(4000),@p1750 int,@p1751 int,@p1752 int,@p1753 nvarchar(4000),@p1754 nvarchar(4000),@p1755 nvarchar(4000),@p1756 nvarchar(4000),@p1757 decimal(18,2),@p1758 nvarchar(4000),@p1759 nvarchar(4000),@p1760 decimal(18,2),@p1761 nvarchar(4000),@p1762 nvarchar(4000),@p1763 nvarchar(4000),@p1764 nvarchar(4000),@p1765 int,@p1766 nvarchar(4000),@p1767 nvarchar(4000),@p1768 nvarchar(4000),@p1769 nvarchar(4000),@p1770 nvarchar(4000),@p1771 nvarchar(4000),@p1772 nvarchar(4000),@p1773 nvarchar(4000),@p1774 nvarchar(4000),@p1775 nvarchar(4000),@p1776 int,@p1777 nvarchar(4000),@p1778 nvarchar(4000),@p1779 nvarchar(4000),@p1780 nvarchar(4000),@p1781 nvarchar(4000),@p1782 int,@p1783 nvarchar(4000),@p1784 int,@p1785 int,@p1786 datetime2(7),@p1787 datetime2(7),@p1788 datetime2(7),@p1789 nvarchar(4000),@p1790 nvarchar(4000),@p1791 nvarchar(4000),@p1792 nvarchar(4000),@p1793 nvarchar(4000),@p1794 nvarchar(4000),@p1795 nvarchar(4000),@p1796 nvarchar(4000),@p1797 nvarchar(4000),@p1798 nvarchar(4000),@p1799 nvarchar(4000),@p1800 nvarchar(4000),@p1801 nvarchar(4000),@p1802 nvarchar(4000),@p1803 datetime2(7),@p1804 nvarchar(4000),@p1805 nvarchar(4000),@p1806 int,@p1807 int,@p1808 int,@p1809 nvarchar(4000),@p1810 nvarchar(4000),@p1811 nvarchar(4000),@p1812 decimal(18,2),@p1813 decimal(18,2),@p1814 nvarchar(4000),@p1815 nvarchar(4000),@p1816 decimal(18,2),@p1817 nvarchar(4000),@p1818 nvarchar(4000),@p1819 nvarchar(4000),@p1820 nvarchar(4000),@p1821 int,@p1822 nvarchar(4000),@p1823 nvarchar(4000),@p1824 nvarchar(4000),@p1825 nvarchar(4000),@p1826 nvarchar(4000),@p1827 nvarchar(4000),@p1828 nvarchar(4000),@p1829 nvarchar(4000),@p1830 nvarchar(4000),@p1831 nvarchar(4000),@p1832 int,@p1833 nvarchar(4000),@p1834 nvarchar(4000),@p1835 nvarchar(4000),@p1836 nvarchar(4000),@p1837 nvarchar(4000),@p1838 int,@p1839 nvarchar(4000),@p1840 int,@p1841 int,@p1842 datetime2(7),@p1843 datetime2(7),@p1844 datetime2(7),@p1845 nvarchar(4000),@p1846 nvarchar(4000),@p1847 nvarchar(4000),@p1848 nvarchar(4000),@p1849 nvarchar(4000),@p1850 nvarchar(4000),@p1851 nvarchar(4000),@p1852 nvarchar(4000),@p1853 nvarchar(4000),@p1854 nvarchar(4000),@p1855 nvarchar(4000),@p1856 nvarchar(4000),@p1857 nvarchar(4000),@p1858 nvarchar(4000),@p1859 datetime2(7),@p1860 nvarchar(4000),@p1861 nvarchar(4000),@p1862 int,@p1863 int,@p1864 int,@p1865 nvarchar(4000),@p1866 nvarchar(4000),@p1867 nvarchar(4000),@p1868 nvarchar(4000),@p1869 decimal(18,2),@p1870 nvarchar(4000),@p1871 nvarchar(4000),@p1872 decimal(18,2),@p1873 nvarchar(4000),@p1874 nvarchar(4000),@p1875 nvarchar(4000),@p1876 nvarchar(4000),@p1877 int,@p1878 nvarchar(4000),@p1879 nvarchar(4000),@p1880 nvarchar(4000),@p1881 nvarchar(4000),@p1882 nvarchar(4000),@p1883 nvarchar(4000),@p1884 nvarchar(4000),@p1885 nvarchar(4000),@p1886 nvarchar(4000),@p1887 nvarchar(4000),@p1888 int,@p1889 nvarchar(4000),@p1890 nvarchar(4000),@p1891 nvarchar(4000),@p1892 nvarchar(4000),@p1893 nvarchar(4000),@p1894 int,@p1895 nvarchar(4000),@p1896 int,@p1897 int,@p1898 datetime2(7),@p1899 datetime2(7),@p1900 datetime2(7),@p1901 nvarchar(4000),@p1902 nvarchar(4000),@p1903 nvarchar(4000),@p1904 nvarchar(4000),@p1905 nvarchar(4000),@p1906 nvarchar(4000),@p1907 nvarchar(4000),@p1908 nvarchar(4000),@p1909 nvarchar(4000),@p1910 nvarchar(4000),@p1911 nvarchar(4000),@p1912 nvarchar(4000),@p1913 nvarchar(4000),@p1914 nvarchar(4000),@p1915 datetime2(7),@p1916 nvarchar(4000),@p1917 nvarchar(4000),@p1918 int,@p1919 int,@p1920 int,@p1921 nvarchar(4000),@p1922 nvarchar(4000),@p1923 nvarchar(4000),@p1924 decimal(18,2),@p1925 decimal(18,2),@p1926 nvarchar(4000),@p1927 nvarchar(4000),@p1928 decimal(18,2),@p1929 nvarchar(4000),@p1930 nvarchar(4000),@p1931 nvarchar(4000),@p1932 nvarchar(4000),@p1933 int,@p1934 nvarchar(4000),@p1935 nvarchar(4000),@p1936 nvarchar(4000),@p1937 nvarchar(4000),@p1938 nvarchar(4000),@p1939 nvarchar(4000),@p1940 nvarchar(4000),@p1941 nvarchar(4000),@p1942 nvarchar(4000),@p1943 nvarchar(4000),@p1944 int,@p1945 nvarchar(4000),@p1946 nvarchar(4000),@p1947 nvarchar(4000),@p1948 nvarchar(4000),@p1949 nvarchar(4000),@p1950 int,@p1951 nvarchar(4000),@p1952 int,@p1953 int,@p1954 datetime2(7),@p1955 datetime2(7),@p1956 datetime2(7),@p1957 nvarchar(4000),@p1958 nvarchar(4000),@p1959 nvarchar(4000),@p1960 nvarchar(4000),@p1961 nvarchar(4000),@p1962 nvarchar(4000),@p1963 nvarchar(4000),@p1964 nvarchar(4000),@p1965 nvarchar(4000),@p1966 nvarchar(4000),@p1967 nvarchar(4000),@p1968 nvarchar(4000),@p1969 nvarchar(4000),@p1970 nvarchar(4000),@p1971 datetime2(7),@p1972 nvarchar(4000),@p1973 nvarchar(4000),@p1974 int,@p1975 int,@p1976 int,@p1977 nvarchar(4000),@p1978 nvarchar(4000),@p1979 nvarchar(4000),@p1980 decimal(18,2),@p1981 decimal(18,2),@p1982 nvarchar(4000),@p1983 nvarchar(4000),@p1984 decimal(18,2),@p1985 nvarchar(4000),@p1986 nvarchar(4000),@p1987 nvarchar(4000),@p1988 nvarchar(4000),@p1989 int,@p1990 nvarchar(4000),@p1991 nvarchar(4000),@p1992 nvarchar(4000),@p1993 nvarchar(4000),@p1994 nvarchar(4000),@p1995 nvarchar(4000),@p1996 nvarchar(4000),@p1997 nvarchar(4000),@p1998 nvarchar(4000),@p1999 nvarchar(4000),@p2000 int,@p2001 nvarchar(4000),@p2002 nvarchar(4000),@p2003 nvarchar(4000),@p2004 nvarchar(4000),@p2005 nvarchar(4000),@p2006 int,@p2007 nvarchar(4000),@p2008 int,@p2009 int,@p2010 datetime2(7),@p2011 datetime2(7),@p2012 datetime2(7),@p2013 nvarchar(4000),@p2014 nvarchar(4000),@p2015 nvarchar(4000),@p2016 nvarchar(4000),@p2017 nvarchar(4000),@p2018 nvarchar(4000),@p2019 nvarchar(4000),@p2020 nvarchar(4000),@p2021 nvarchar(4000),@p2022 nvarchar(4000),@p2023 nvarchar(4000),@p2024 nvarchar(4000),@p2025 nvarchar(4000),@p2026 nvarchar(4000),@p2027 datetime2(7),@p2028 nvarchar(4000),@p2029 nvarchar(4000),@p2030 int,@p2031 int,@p2032 int,@p2033 nvarchar(4000),@p2034 nvarchar(4000),@p2035 nvarchar(4000),@p2036 decimal(18,2),@p2037 decimal(18,2),@p2038 nvarchar(4000),@p2039 nvarchar(4000),@p2040 decimal(18,2),@p2041 nvarchar(4000),@p2042 nvarchar(4000),@p2043 nvarchar(4000),@p2044 nvarchar(4000),@p2045 int,@p2046 nvarchar(4000),@p2047 nvarchar(4000),@p2048 nvarchar(4000),@p2049 nvarchar(4000),@p2050 nvarchar(4000),@p2051 nvarchar(4000),@p2052 nvarchar(4000),@p2053 nvarchar(4000),@p2054 nvarchar(4000),@p2055 nvarchar(4000),@p2056 int,@p2057 nvarchar(4000),@p2058 nvarchar(4000),@p2059 nvarchar(4000),@p2060 nvarchar(4000),@p2061 nvarchar(4000),@p2062 int,@p2063 nvarchar(4000),@p2064 int,@p2065 int,@p2066 datetime2(7),@p2067 datetime2(7),@p2068 datetime2(7),@p2069 nvarchar(4000),@p2070 nvarchar(4000),@p2071 nvarchar(4000))SET NOCOUNT ON; DECLARE @inserted0 TABLE ([item_id] int, [_Position] [int]); MERGE [raw_data] USING ( VALUES (@p0, @p1, @p2, @p3, @p4, @p5, @p6, @p7, @p8, @p9, @p10, @p11, @p12, @p13, @p14, @p15, @p16, @p17, @p18, @p19, @p20, @p21, @p22, @p23, @p24, @p25, @p26, @p27, @p28, @p29, @p30, @p31, @p32, @p33, @p34, @p35, @p36, @p37, @p38, @p39, @p40, @p41, @p42, @p43, @p44, @p45, @p46, @p47, @p48, @p49, @p50, @p51, @p52, @p53, @p54, @p55, 0), (@p56, @p57, @p58, @p59, @p60, @p61, @p62, @p63, @p64, @p65, @p66, @p67, @p68, @p69, @p70, @p71, @p72, @p73, @p74, @p75, @p76, @p77, @p78, @p79, @p80, @p81, @p82, @p83, @p84, @p85, @p86, @p87, @p88, @p89, @p90, @p91, @p92, @p93, @p94, @p95, @p96, @p97, @p98, @p99, @p100, @p101, @p102, @p103, @p104, @p105, @p106, @p107, @p108, @p109, @p110, @p111, 1), (@p112, @p113, @p114, @p115, @p116, @p117, @p118, @p119, @p120, @p121, @p122, @p123, @p124, @p125, @p126, @p127, @p128, @p129, @p130, @p131, @p132, @p133, @p134, @p135, @p136, @p137, @p138, @p139, @p140, @p141, @p142, @p143, @p144, @p145, @p146, @p147, @p148, @p149, @p150, @p151, @p152, @p153, @p154, @p155, @p156, @p157, @p158, @p159, @p160, @p161, @p162, @p163, @p164, @p165, @p166, @p167, 2), (@p168, @p169, @p170, @p171, @p172, @p173, @p174, @p175, @p176, @p177, @p178, @p179, @p180, @p181, @p182, @p183, @p184, @p185, @p186, @p187, @p188, @p189, @p190, @p191, @p192, @p193, @p194, @p195, @p196, @p197, @p198, @p199, @p200, @p201, @p202, @p203, @p204, @p205, @p206, @p207, @p208, @p209, @p210, @p211, @p212, @p213, @p214, @p215, @p216, @p217, @p218, @p219, @p220, @p221, @p222, @p223, 3), (@p224, @p225, @p226, @p227, @p228, @p229, @p230, @p231, @p232, @p233, @p234, @p235, @p236, @p237, @p238, @p239, @p240, @p241, @p242, @p243, @p244, @p245, @p246, @p247, @p248, @p249, @p250, @p251, @p252, @p253, @p254, @p255, @p256, @p257, @p258, @p259, @p260, @p261, @p262, @p263, @p264, @p265, @p266, @p267, @p268, @p269, @p270, @p271, @p272, @p273, @p274, @p275, @p276, @p277, @p278, @p279, 4), (@p280, @p281, @p282, @p283, @p284, @p285, @p286, @p287, @p288, @p289, @p290, @p291, @p292, @p293, @p294, @p295, @p296, @p297, @p298, @p299, @p300, @p301, @p302, @p303, @p304, @p305, @p306, @p307, @p308, @p309, @p310, @p311, @p312, @p313, @p314, @p315, @p316, @p317, @p318, @p319, @p320, @p321, @p322, @p323, @p324, @p325, @p326, @p327, @p328, @p329, @p330, @p331, @p332, @p333, @p334, @p335, 5), (@p336, @p337, @p338, @p339, @p340, @p341, @p342, @p343, @p344, @p345, @p346, @p347, @p348, @p349, @p350, @p351, @p352, @p353, @p354, @p355, @p356, @p357, @p358, @p359, @p360, @p361, @p362, @p363, @p364, @p365, @p366, @p367, @p368, @p369, @p370, @p371, @p372, @p373, @p374, @p375, @p376, @p377, @p378, @p379, @p380, @p381, @p382, @p383, @p384, @p385, @p386, @p387, @p388, @p389, @p390, @p391, 6), (@p392, @p393, @p394, @p395, @p396, @p397, @p398, @p399, @p400, @p401, @p402, @p403, @p404, @p405, @p406, @p407, @p408, @p409, @p410, @p411, @p412, @p413, @p414, @p415, @p416, @p417, @p418, @p419, @p420, @p421, @p422, @p423, @p424, @p425, @p426, @p427, @p428, @p429, @p430, @p431, @p432, @p433, @p434, @p435, @p436, @p437, @p438, @p439, @p440, @p441, @p442, @p443, @p444, @p445, @p446, @p447, 7), (@p448, @p449, @p450, @p451, @p452, @p453, @p454, @p455, @p456, @p457, @p458, @p459, @p460, @p461, @p462, @p463, @p464, @p465, @p466, @p467, @p468, @p469, @p470, @p471, @p472, @p473, @p474, @p475, @p476, @p477, @p478, @p479, @p480, @p481, @p482, @p483, @p484, @p485, @p486, @p487, @p488, @p489, @p490, @p491, @p492, @p493, @p494, @p495, @p496, @p497, @p498, @p499, @p500, @p501, @p502, @p503, 8), (@p504, @p505, @p506, @p507, @p508, @p509, @p510, @p511, @p512, @p513, @p514, @p515, @p516, @p517, @p518, @p519, @p520, @p521, @p522, @p523, @p524, @p525, @p526, @p527, @p528, @p529, @p530, @p531, @p532, @p533, @p534, @p535, @p536, @p537, @p538, @p539, @p540, @p541, @p542, @p543, @p544, @p545, @p546, @p547, @p548, @p549, @p550, @p551, @p552, @p553, @p554, @p555, @p556, @p557, @p558, @p559, 9), (@p560, @p561, @p562, @p563, @p564, @p565, @p566, @p567, @p568, @p569, @p570, @p571, @p572, @p573, @p574, @p575, @p576, @p577, @p578, @p579, @p580, @p581, @p582, @p583, @p584, @p585, @p586, @p587, @p588, @p589, @p590, @p591, @p592, @p593, @p594, @p595, @p596, @p597, @p598, @p599, @p600, @p601, @p602, @p603, @p604, @p605, @p606, @p607, @p608, @p609, @p610, @p611, @p612, @p613, @p614, @p615, 10), (@p616, @p617, @p618, @p619, @p620, @p621, @p622, @p623, @p624, @p625, @p626, @p627, @p628, @p629, @p630, @p631, @p632, @p633, @p634, @p635, @p636, @p637, @p638, @p639, @p640, @p641, @p642, @p643, @p644, @p645, @p646, @p647, @p648, @p649, @p650, @p651, @p652, @p653, @p654, @p655, @p656, @p657, @p658, @p659, @p660, @p661, @p662, @p663, @p664, @p665, @p666, @p667, @p668, @p669, @p670, @p671, 11), (@p672, @p673, @p674, @p675, @p676, @p677, @p678, @p679, @p680, @p681, @p682, @p683, @p684, @p685, @p686, @p687, @p688, @p689, @p690, @p691, @p692, @p693, @p694, @p695, @p696, @p697, @p698, @p699, @p700, @p701, @p702, @p703, @p704, @p705, @p706, @p707, @p708, @p709, @p710, @p711, @p712, @p713, @p714, @p715, @p716, @p717, @p718, @p719, @p720, @p721, @p722, @p723, @p724, @p725, @p726, @p727, 12), (@p728, @p729, @p730, @p731, @p732, @p733, @p734, @p735, @p736, @p737, @p738, @p739, @p740, @p741, @p742, @p743, @p744, @p745, @p746, @p747, @p748, @p749, @p750, @p751, @p752, @p753, @p754, @p755, @p756, @p757, @p758, @p759, @p760, @p761, @p762, @p763, @p764, @p765, @p766, @p767, @p768, @p769, @p770, @p771, @p772, @p773, @p774, @p775, @p776, @p777, @p778, @p779, @p780, @p781, @p782, @p783, 13), (@p784, @p785, @p786, @p787, @p788, @p789, @p790, @p791, @p792, @p793, @p794, @p795, @p796, @p797, @p798, @p799, @p800, @p801, @p802, @p803, @p804, @p805, @p806, @p807, @p808, @p809, @p810, @p811, @p812, @p813, @p814, @p815, @p816, @p817, @p818, @p819, @p820, @p821, @p822, @p823, @p824, @p825, @p826, @p827, @p828, @p829, @p830, @p831, @p832, @p833, @p834, @p835, @p836, @p837, @p838, @p839, 14), (@p840, @p841, @p842, @p843, @p844, @p845, @p846, @p847, @p848, @p849, @p850, @p851, @p852, @p853, @p854, @p855, @p856, @p857, @p858, @p859, @p860, @p861, @p862, @p863, @p864, @p865, @p866, @p867, @p868, @p869, @p870, @p871, @p872, @p873, @p874, @p875, @p876, @p877, @p878, @p879, @p880, @p881, @p882, @p883, @p884, @p885, @p886, @p887, @p888, @p889, @p890, @p891, @p892, @p893, @p894, @p895, 15), (@p896, @p897, @p898, @p899, @p900, @p901, @p902, @p903, @p904, @p905, @p906, @p907, @p908, @p909, @p910, @p911, @p912, @p913, @p914, @p915, @p916, @p917, @p918, @p919, @p920, @p921, @p922, @p923, @p924, @p925, @p926, @p927, @p928, @p929, @p930, @p931, @p932, @p933, @p934, @p935, @p936, @p937, @p938, @p939, @p940, @p941, @p942, @p943, @p944, @p945, @p946, @p947, @p948, @p949, @p950, @p951, 16), (@p952, @p953, @p954, @p955, @p956, @p957, @p958, @p959, @p960, @p961, @p962, @p963, @p964, @p965, @p966, @p967, @p968, @p969, @p970, @p971, @p972, @p973, @p974, @p975, @p976, @p977, @p978, @p979, @p980, @p981, @p982, @p983, @p984, @p985, @p986, @p987, @p988, @p989, @p990, @p991, @p992, @p993, @p994, @p995, @p996, @p997, @p998, @p999, @p1000, @p1001, @p1002, @p1003, @p1004, @p1005, @p1006, @p1007, 17), (@p1008, @p1009, @p1010, @p1011, @p1012, @p1013, @p1014, @p1015, @p1016, @p1017, @p1018, @p1019, @p1020, @p1021, @p1022, @p1023, @p1024, @p1025, @p1026, @p1027, @p1028, @p1029, @p1030, @p1031, @p1032, @p1033, @p1034, @p1035, @p1036, @p1037, @p1038, @p1039, @p1040, @p1041, @p1042, @p1043, @p1044, @p1045, @p1046, @p1047, @p1048, @p1049, @p1050, @p1051, @p1052, @p1053, @p1054, @p1055, @p1056, @p1057, @p1058, @p1059, @p1060, @p1061, @p1062, @p1063, 18), (@p1064, @p1065, @p1066, @p1067, @p1068, @p1069, @p1070, @p1071, @p1072, @p1073, @p1074, @p1075, @p1076, @p1077, @p1078, @p1079, @p1080, @p1081, @p1082, @p1083, @p1084, @p1085, @p1086, @p1087, @p1088, @p1089, @p1090, @p1091, @p1092, @p1093, @p1094, @p1095, @p1096, @p1097, @p1098, @p1099, @p1100, @p1101, @p1102, @p1103, @p1104, @p1105, @p1106, @p1107, @p1108, @p1109, @p1110, @p1111, @p1112, @p1113, @p1114, @p1115, @p1116, @p1117, @p1118, @p1119, 19), (@p1120, @p1121, @p1122, @p1123, @p1124, @p1125, @p1126, @p1127, @p1128, @p1129, @p1130, @p1131, @p1132, @p1133, @p1134, @p1135, @p1136, @p1137, @p1138, @p1139, @p1140, @p1141, @p1142, @p1143, @p1144, @p1145, @p1146, @p1147, @p1148, @p1149, @p1150, @p1151, @p1152, @p1153, @p1154, @p1155, @p1156, @p1157, @p1158, @p1159, @p1160, @p1161, @p1162, @p1163, @p1164, @p1165, @p1166, @p1167, @p1168, @p1169, @p1170, @p1171, @p1172, @p1173, @p1174, @p1175, 20), (@p1176, @p1177, @p1178, @p1179, @p1180, @p1181, @p1182, @p1183, @p1184, @p1185, @p1186, @p1187, @p1188, @p1189, @p1190, @p1191, @p1192, @p1193, @p1194, @p1195, @p1196, @p1197, @p1198, @p1199, @p1200, @p1201, @p1202, @p1203, @p1204, @p1205, @p1206, @p1207, @p1208, @p1209, @p1210, @p1211, @p1212, @p1213, @p1214, @p1215, @p1216, @p1217, @p1218, @p1219, @p1220, @p1221, @p1222, @p1223, @p1224, @p1225, @p1226, @p1227, @p1228, @p1229, @p1230, @p1231, 21), (@p1232, @p1233, @p1234, @p1235, @p1236, @p1237, @p1238, @p1239, @p1240, @p1241, @p1242, @p1243, @p1244, @p1245, @p1246, @p1247, @p1248, @p1249, @p1250, @p1251, @p1252, @p1253, @p1254, @p1255, @p1256, @p1257, @p1258, @p1259, @p1260, @p1261, @p1262, @p1263, @p1264, @p1265, @p1266, @p1267, @p1268, @p1269, @p1270, @p1271, @p1272, @p1273, @p1274, @p1275, @p1276, @p1277, @p1278, @p1279, @p1280, @p1281, @p1282, @p1283, @p1284, @p1285, @p1286, @p1287, 22), (@p1288, @p1289, @p1290, @p1291, @p1292, @p1293, @p1294, @p1295, @p1296, @p1297, @p1298, @p1299, @p1300, @p1301, @p1302, @p1303, @p1304, @p1305, @p1306, @p1307, @p1308, @p1309, @p1310, @p1311, @p1312, @p1313, @p1314, @p1315, @p1316, @p1317, @p1318, @p1319, @p1320, @p1321, @p1322, @p1323, @p1324, @p1325, @p1326, @p1327, @p1328, @p1329, @p1330, @p1331, @p1332, @p1333, @p1334, @p1335, @p1336, @p1337, @p1338, @p1339, @p1340, @p1341, @p1342, @p1343, 23), (@p1344, @p1345, @p1346, @p1347, @p1348, @p1349, @p1350, @p1351, @p1352, @p1353, @p1354, @p1355, @p1356, @p1357, @p1358, @p1359, @p1360, @p1361, @p1362, @p1363, @p1364, @p1365, @p1366, @p1367, @p1368, @p1369, @p1370, @p1371, @p1372, @p1373, @p1374, @p1375, @p1376, @p1377, @p1378, @p1379, @p1380, @p1381, @p1382, @p1383, @p1384, @p1385, @p1386, @p1387, @p1388, @p1389, @p1390, @p1391, @p1392, @p1393, @p1394, @p1395, @p1396, @p1397, @p1398, @p1399, 24), (@p1400, @p1401, @p1402, @p1403, @p1404, @p1405, @p1406, @p1407, @p1408, @p1409, @p1410, @p1411, @p1412, @p1413, @p1414, @p1415, @p1416, @p1417, @p1418, @p1419, @p1420, @p1421, @p1422, @p1423, @p1424, @p1425, @p1426, @p1427, @p1428, @p1429, @p1430, @p1431, @p1432, @p1433, @p1434, @p1435, @p1436, @p1437, @p1438, @p1439, @p1440, @p1441, @p1442, @p1443, @p1444, @p1445, @p1446, @p1447, @p1448, @p1449, @p1450, @p1451, @p1452, @p1453, @p1454, @p1455, 25), (@p1456, @p1457, @p1458, @p1459, @p1460, @p1461, @p1462, @p1463, @p1464, @p1465, @p1466, @p1467, @p1468, @p1469, @p1470, @p1471, @p1472, @p1473, @p1474, @p1475, @p1476, @p1477, @p1478, @p1479, @p1480, @p1481, @p1482, @p1483, @p1484, @p1485, @p1486, @p1487, @p1488, @p1489, @p1490, @p1491, @p1492, @p1493, @p1494, @p1495, @p1496, @p1497, @p1498, @p1499, @p1500, @p1501, @p1502, @p1503, @p1504, @p1505, @p1506, @p1507, @p1508, @p1509, @p1510, @p1511, 26), (@p1512, @p1513, @p1514, @p1515, @p1516, @p1517, @p1518, @p1519, @p1520, @p1521, @p1522, @p1523, @p1524, @p1525, @p1526, @p1527, @p1528, @p1529, @p1530, @p1531, @p1532, @p1533, @p1534, @p1535, @p1536, @p1537, @p1538, @p1539, @p1540, @p1541, @p1542, @p1543, @p1544, @p1545, @p1546, @p1547, @p1548, @p1549, @p1550, @p1551, @p1552, @p1553, @p1554, @p1555, @p1556, @p1557, @p1558, @p1559, @p1560, @p1561, @p1562, @p1563, @p1564, @p1565, @p1566, @p1567, 27), (@p1568, @p1569, @p1570, @p1571, @p1572, @p1573, @p1574, @p1575, @p1576, @p1577, @p1578, @p1579, @p1580, @p1581, @p1582, @p1583, @p1584, @p1585, @p1586, @p1587, @p1588, @p1589, @p1590, @p1591, @p1592, @p1593, @p1594, @p1595, @p1596, @p1597, @p1598, @p1599, @p1600, @p1601, @p1602, @p1603, @p1604, @p1605, @p1606, @p1607, @p1608, @p1609, @p1610, @p1611, @p1612, @p1613, @p1614, @p1615, @p1616, @p1617, @p1618, @p1619, @p1620, @p1621, @p1622, @p1623, 28), (@p1624, @p1625, @p1626, @p1627, @p1628, @p1629, @p1630, @p1631, @p1632, @p1633, @p1634, @p1635, @p1636, @p1637, @p1638, @p1639, @p1640, @p1641, @p1642, @p1643, @p1644, @p1645, @p1646, @p1647, @p1648, @p1649, @p1650, @p1651, @p1652, @p1653, @p1654, @p1655, @p1656, @p1657, @p1658, @p1659, @p1660, @p1661, @p1662, @p1663, @p1664, @p1665, @p1666, @p1667, @p1668, @p1669, @p1670, @p1671, @p1672, @p1673, @p1674, @p1675, @p1676, @p1677, @p1678, @p1679, 29), (@p1680, @p1681, @p1682, @p1683, @p1684, @p1685, @p1686, @p1687, @p1688, @p1689, @p1690, @p1691, @p1692, @p1693, @p1694, @p1695, @p1696, @p1697, @p1698, @p1699, @p1700, @p1701, @p1702, @p1703, @p1704, @p1705, @p1706, @p1707, @p1708, @p1709, @p1710, @p1711, @p1712, @p1713, @p1714, @p1715, @p1716, @p1717, @p1718, @p1719, @p1720, @p1721, @p1722, @p1723, @p1724, @p1725, @p1726, @p1727, @p1728, @p1729, @p1730, @p1731, @p1732, @p1733, @p1734, @p1735, 30), (@p1736, @p1737, @p1738, @p1739, @p1740, @p1741, @p1742, @p1743, @p1744, @p1745, @p1746, @p1747, @p1748, @p1749, @p1750, @p1751, @p1752, @p1753, @p1754, @p1755, @p1756, @p1757, @p1758, @p1759, @p1760, @p1761, @p1762, @p1763, @p1764, @p1765, @p1766, @p1767, @p1768, @p1769, @p1770, @p1771, @p1772, @p1773, @p1774, @p1775, @p1776, @p1777, @p1778, @p1779, @p1780, @p1781, @p1782, @p1783, @p1784, @p1785, @p1786, @p1787, @p1788, @p1789, @p1790, @p1791, 31), (@p1792, @p1793, @p1794, @p1795, @p1796, @p1797, @p1798, @p1799, @p1800, @p1801, @p1802, @p1803, @p1804, @p1805, @p1806, @p1807, @p1808, @p1809, @p1810, @p1811, @p1812, @p1813, @p1814, @p1815, @p1816, @p1817, @p1818, @p1819, @p1820, @p1821, @p1822, @p1823, @p1824, @p1825, @p1826, @p1827, @p1828, @p1829, @p1830, @p1831, @p1832, @p1833, @p1834, @p1835, @p1836, @p1837, @p1838, @p1839, @p1840, @p1841, @p1842, @p1843, @p1844, @p1845, @p1846, @p1847, 32), (@p1848, @p1849, @p1850, @p1851, @p1852, @p1853, @p1854, @p1855, @p1856, @p1857, @p1858, @p1859, @p1860, @p1861, @p1862, @p1863, @p1864, @p1865, @p1866, @p1867, @p1868, @p1869, @p1870, @p1871, @p1872, @p1873, @p1874, @p1875, @p1876, @p1877, @p1878, @p1879, @p1880, @p1881, @p1882, @p1883, @p1884, @p1885, @p1886, @p1887, @p1888, @p1889, @p1890, @p1891, @p1892, @p1893, @p1894, @p1895, @p1896, @p1897, @p1898, @p1899, @p1900, @p1901, @p1902, @p1903, 33), (@p1904, @p1905, @p1906, @p1907, @p1908, @p1909, @p1910, @p1911, @p1912, @p1913, @p1914, @p1915, @p1916, @p1917, @p1918, @p1919, @p1920, @p1921, @p1922, @p1923, @p1924, @p1925, @p1926, @p1927, @p1928, @p1929, @p1930, @p1931, @p1932, @p1933, @p1934, @p1935, @p1936, @p1937, @p1938, @p1939, @p1940, @p1941, @p1942, @p1943, @p1944, @p1945, @p1946, @p1947, @p1948, @p1949, @p1950, @p1951, @p1952, @p1953, @p1954, @p1955, @p1956, @p1957, @p1958, @p1959, 34), (@p1960, @p1961, @p1962, @p1963, @p1964, @p1965, @p1966, @p1967, @p1968, @p1969, @p1970, @p1971, @p1972, @p1973, @p1974, @p1975, @p1976, @p1977, @p1978, @p1979, @p1980, @p1981, @p1982, @p1983, @p1984, @p1985, @p1986, @p1987, @p1988, @p1989, @p1990, @p1991, @p1992, @p1993, @p1994, @p1995, @p1996, @p1997, @p1998, @p1999, @p2000, @p2001, @p2002, @p2003, @p2004, @p2005, @p2006, @p2007, @p2008, @p2009, @p2010, @p2011, @p2012, @p2013, @p2014, @p2015, 35), (@p2016, @p2017, @p2018, @p2019, @p2020, @p2021, @p2022, @p2023, @p2024, @p2025, @p2026, @p2027, @p2028, @p2029, @p2030, @p2031, @p2032, @p2033, @p2034, @p2035, @p2036, @p2037, @p2038, @p2039, @p2040, @p2041, @p2042, @p2043, @p2044, @p2045, @p2046, @p2047, @p2048, @p2049, @p2050, @p2051, @p2052, @p2053, @p2054, @p2055, @p2056, @p2057, @p2058, @p2059, @p2060, @p2061, @p2062, @p2063, @p2064, @p2065, @p2066, @p2067, @p2068, @p2069, @p2070, @p2071, 36)) AS i ([addressee_cntry_cd], [addressee_city], [addressee_district], [addressee_email], [addressee_full_address], [addressee_home_address], [addressee_name], [addressee_postcode], [addressee_province], [addressee_subdistrict], [addressee_tel], [create_table], [delivery_code], [delivery_recipient_name], [delivery_relation_id], [delivery_status_id], [dest_outlet_id], [dest_outlet_port], [document_number], [item_barcode], [item_cod], [item_gross_weight], [item_height], [item_length], [item_price], [item_width], [lat], [log_id], [long], [outlet_id], [outlet_port], [podUrl], [remark], [scan_cntry_cd], [scan_cntry_postcode], [sender_cntry_cd], [sender_district], [sender_email], [sender_full_address], [sender_home_address], [member_id], [sender_name], [sender_postcode], [sender_province], [sender_subdistrict], [sender_tel], [server_id], [signatureUrl], [state], [status_code], [status_dtm], [timestamp], [transmit_dtm], [user_id], [wckt_id], [wkstn_no], _Position) ON 1=0 WHEN NOT MATCHED THEN INSERT ([addressee_cntry_cd], [addressee_city], [addressee_district], [addressee_email], [addressee_full_address], [addressee_home_address], [addressee_name], [addressee_postcode], [addressee_province], [addressee_subdistrict], [addressee_tel], [create_table], [delivery_code], [delivery_recipient_name], [delivery_relation_id], [delivery_status_id], [dest_outlet_id], [dest_outlet_port], [document_number], [item_barcode], [item_cod], [item_gross_weight], [item_height], [item_length], [item_price], [item_width], [lat], [log_id], [long], [outlet_id], [outlet_port], [podUrl], [remark], [scan_cntry_cd], [scan_cntry_postcode], [sender_cntry_cd], [sender_district], [sender_email], [sender_full_address], [sender_home_address], [member_id], [sender_name], [sender_postcode], [sender_province], [sender_subdistrict], [sender_tel], [server_id], [signatureUrl], [state], [status_code], [status_dtm], [timestamp], [transmit_dtm], [user_id], [wckt_id], [wkstn_no]) VALUES (i.[addressee_cntry_cd], i.[addressee_city], i.[addressee_district], i.[addressee_email], i.[addressee_full_address], i.[addressee_home_address], i.[addressee_name], i.[addressee_postcode], i.[addressee_province], i.[addressee_subdistrict], i.[addressee_tel], i.[create_table], i.[delivery_code], i.[delivery_recipient_name], i.[delivery_relation_id], i.[delivery_status_id], i.[dest_outlet_id], i.[dest_outlet_port], i.[document_number], i.[item_barcode], i.[item_cod], i.[item_gross_weight], i.[item_height], i.[item_length], i.[item_price], i.[item_width], i.[lat], i.[log_id], i.[long], i.[outlet_id], i.[outlet_port], i.[podUrl], i.[remark], i.[scan_cntry_cd], i.[scan_cntry_postcode], i.[sender_cntry_cd], i.[sender_district], i.[sender_email], i.[sender_full_address], i.[sender_home_address], i.[member_id], i.[sender_name], i.[sender_postcode], i.[sender_province], i.[sender_subdistrict], i.[sender_tel], i.[server_id], i.[signatureUrl], i.[state], i.[status_code], i.[status_dtm], i.[timestamp], i.[transmit_dtm], i.[user_id], i.[wckt_id], i.[wkstn_no]) OUTPUT INSERTED.[item_id], i._Position INTO @inserted0;  SELECT [t].[item_id] FROM [raw_data] t INNER JOIN @inserted0 i ON ([t].[item_id] = [i].[item_id]) ORDER BY [i].[_Position];  ",4,4,0,449,18,4
"(@p0 nvarchar(4000),@p1 nvarchar(4000),@p2 nvarchar(4000),@p3 nvarchar(4000),@p4 nvarchar(4000),@p5 nvarchar(4000),@p6 nvarchar(4000),@p7 nvarchar(4000),@p8 nvarchar(4000),@p9 nvarchar(4000),@p10 nvarchar(4000),@p11 datetime2(7),@p12 nvarchar(4000),@p13 nvarchar(4000),@p14 int,@p15 int,@p16 int,@p17 nvarchar(4000),@p18 nvarchar(4000),@p19 nvarchar(4000),@p20 decimal(18,2),@p21 decimal(18,2),@p22 nvarchar(4000),@p23 nvarchar(4000),@p24 decimal(18,2),@p25 nvarchar(4000),@p26 nvarchar(4000),@p27 nvarchar(4000),@p28 nvarchar(4000),@p29 int,@p30 nvarchar(4000),@p31 nvarchar(4000),@p32 nvarchar(4000),@p33 nvarchar(4000),@p34 nvarchar(4000),@p35 nvarchar(4000),@p36 nvarchar(4000),@p37 nvarchar(4000),@p38 nvarchar(4000),@p39 nvarchar(4000),@p40 int,@p41 nvarchar(4000),@p42 nvarchar(4000),@p43 nvarchar(4000),@p44 nvarchar(4000),@p45 nvarchar(4000),@p46 int,@p47 nvarchar(4000),@p48 int,@p49 int,@p50 datetime2(7),@p51 datetime2(7),@p52 datetime2(7),@p53 nvarchar(4000),@p54 nvarchar(4000),@p55 nvarchar(4000),@p56 nvarchar(4000),@p57 nvarchar(4000),@p58 nvarchar(4000),@p59 nvarchar(4000),@p60 nvarchar(4000),@p61 nvarchar(4000),@p62 nvarchar(4000),@p63 nvarchar(4000),@p64 nvarchar(4000),@p65 nvarchar(4000),@p66 nvarchar(4000),@p67 datetime2(7),@p68 nvarchar(4000),@p69 nvarchar(4000),@p70 int,@p71 int,@p72 int,@p73 nvarchar(4000),@p74 nvarchar(4000),@p75 nvarchar(4000),@p76 decimal(18,2),@p77 decimal(18,2),@p78 nvarchar(4000),@p79 nvarchar(4000),@p80 decimal(18,2),@p81 nvarchar(4000),@p82 nvarchar(4000),@p83 nvarchar(4000),@p84 nvarchar(4000),@p85 int,@p86 nvarchar(4000),@p87 nvarchar(4000),@p88 nvarchar(4000),@p89 nvarchar(4000),@p90 nvarchar(4000),@p91 nvarchar(4000),@p92 nvarchar(4000),@p93 nvarchar(4000),@p94 nvarchar(4000),@p95 nvarchar(4000),@p96 int,@p97 nvarchar(4000),@p98 nvarchar(4000),@p99 nvarchar(4000),@p100 nvarchar(4000),@p101 nvarchar(4000),@p102 int,@p103 nvarchar(4000),@p104 int,@p105 int,@p106 datetime2(7),@p107 datetime2(7),@p108 datetime2(7),@p109 nvarchar(4000),@p110 nvarchar(4000),@p111 nvarchar(4000),@p112 nvarchar(4000),@p113 nvarchar(4000),@p114 nvarchar(4000),@p115 nvarchar(4000),@p116 nvarchar(4000),@p117 nvarchar(4000),@p118 nvarchar(4000),@p119 nvarchar(4000),@p120 nvarchar(4000),@p121 nvarchar(4000),@p122 nvarchar(4000),@p123 datetime2(7),@p124 nvarchar(4000),@p125 nvarchar(4000),@p126 int,@p127 int,@p128 int,@p129 nvarchar(4000),@p130 nvarchar(4000),@p131 nvarchar(4000),@p132 decimal(18,2),@p133 decimal(18,2),@p134 nvarchar(4000),@p135 nvarchar(4000),@p136 decimal(18,2),@p137 nvarchar(4000),@p138 nvarchar(4000),@p139 nvarchar(4000),@p140 nvarchar(4000),@p141 int,@p142 nvarchar(4000),@p143 nvarchar(4000),@p144 nvarchar(4000),@p145 nvarchar(4000),@p146 nvarchar(4000),@p147 nvarchar(4000),@p148 nvarchar(4000),@p149 nvarchar(4000),@p150 nvarchar(4000),@p151 nvarchar(4000),@p152 int,@p153 nvarchar(4000),@p154 nvarchar(4000),@p155 nvarchar(4000),@p156 nvarchar(4000),@p157 nvarchar(4000),@p158 int,@p159 nvarchar(4000),@p160 int,@p161 int,@p162 datetime2(7),@p163 datetime2(7),@p164 datetime2(7),@p165 nvarchar(4000),@p166 nvarchar(4000),@p167 nvarchar(4000),@p168 nvarchar(4000),@p169 nvarchar(4000),@p170 nvarchar(4000),@p171 nvarchar(4000),@p172 nvarchar(4000),@p173 nvarchar(4000),@p174 nvarchar(4000),@p175 nvarchar(4000),@p176 nvarchar(4000),@p177 nvarchar(4000),@p178 nvarchar(4000),@p179 datetime2(7),@p180 nvarchar(4000),@p181 nvarchar(4000),@p182 int,@p183 int,@p184 int,@p185 nvarchar(4000),@p186 nvarchar(4000),@p187 nvarchar(4000),@p188 decimal(18,2),@p189 decimal(18,2),@p190 nvarchar(4000),@p191 nvarchar(4000),@p192 decimal(18,2),@p193 nvarchar(4000),@p194 nvarchar(4000),@p195 nvarchar(4000),@p196 nvarchar(4000),@p197 int,@p198 nvarchar(4000),@p199 nvarchar(4000),@p200 nvarchar(4000),@p201 nvarchar(4000),@p202 nvarchar(4000),@p203 nvarchar(4000),@p204 nvarchar(4000),@p205 nvarchar(4000),@p206 nvarchar(4000),@p207 nvarchar(4000),@p208 int,@p209 nvarchar(4000),@p210 nvarchar(4000),@p211 nvarchar(4000),@p212 nvarchar(4000),@p213 nvarchar(4000),@p214 int,@p215 nvarchar(4000),@p216 int,@p217 int,@p218 datetime2(7),@p219 datetime2(7),@p220 datetime2(7),@p221 nvarchar(4000),@p222 nvarchar(4000),@p223 nvarchar(4000),@p224 nvarchar(4000),@p225 nvarchar(4000),@p226 nvarchar(4000),@p227 nvarchar(4000),@p228 nvarchar(4000),@p229 nvarchar(4000),@p230 nvarchar(4000),@p231 nvarchar(4000),@p232 nvarchar(4000),@p233 nvarchar(4000),@p234 nvarchar(4000),@p235 datetime2(7),@p236 nvarchar(4000),@p237 nvarchar(4000),@p238 int,@p239 int,@p240 int,@p241 nvarchar(4000),@p242 nvarchar(4000),@p243 nvarchar(4000),@p244 decimal(18,2),@p245 decimal(18,2),@p246 nvarchar(4000),@p247 nvarchar(4000),@p248 decimal(18,2),@p249 nvarchar(4000),@p250 nvarchar(4000),@p251 nvarchar(4000),@p252 nvarchar(4000),@p253 int,@p254 nvarchar(4000),@p255 nvarchar(4000),@p256 nvarchar(4000),@p257 nvarchar(4000),@p258 nvarchar(4000),@p259 nvarchar(4000),@p260 nvarchar(4000),@p261 nvarchar(4000),@p262 nvarchar(4000),@p263 nvarchar(4000),@p264 int,@p265 nvarchar(4000),@p266 nvarchar(4000),@p267 nvarchar(4000),@p268 nvarchar(4000),@p269 nvarchar(4000),@p270 int,@p271 nvarchar(4000),@p272 int,@p273 int,@p274 datetime2(7),@p275 datetime2(7),@p276 datetime2(7),@p277 nvarchar(4000),@p278 nvarchar(4000),@p279 nvarchar(4000),@p280 nvarchar(4000),@p281 nvarchar(4000),@p282 nvarchar(4000),@p283 nvarchar(4000),@p284 nvarchar(4000),@p285 nvarchar(4000),@p286 nvarchar(4000),@p287 nvarchar(4000),@p288 nvarchar(4000),@p289 nvarchar(4000),@p290 nvarchar(4000),@p291 datetime2(7),@p292 nvarchar(4000),@p293 nvarchar(4000),@p294 int,@p295 int,@p296 int,@p297 nvarchar(4000),@p298 nvarchar(4000),@p299 nvarchar(4000),@p300 decimal(18,2),@p301 decimal(18,2),@p302 nvarchar(4000),@p303 nvarchar(4000),@p304 decimal(18,2),@p305 nvarchar(4000),@p306 nvarchar(4000),@p307 nvarchar(4000),@p308 nvarchar(4000),@p309 int,@p310 nvarchar(4000),@p311 nvarchar(4000),@p312 nvarchar(4000),@p313 nvarchar(4000),@p314 nvarchar(4000),@p315 nvarchar(4000),@p316 nvarchar(4000),@p317 nvarchar(4000),@p318 nvarchar(4000),@p319 nvarchar(4000),@p320 int,@p321 nvarchar(4000),@p322 nvarchar(4000),@p323 nvarchar(4000),@p324 nvarchar(4000),@p325 nvarchar(4000),@p326 int,@p327 nvarchar(4000),@p328 int,@p329 int,@p330 datetime2(7),@p331 datetime2(7),@p332 datetime2(7),@p333 nvarchar(4000),@p334 nvarchar(4000),@p335 nvarchar(4000),@p336 nvarchar(4000),@p337 nvarchar(4000),@p338 nvarchar(4000),@p339 nvarchar(4000),@p340 nvarchar(4000),@p341 nvarchar(4000),@p342 nvarchar(4000),@p343 nvarchar(4000),@p344 nvarchar(4000),@p345 nvarchar(4000),@p346 nvarchar(4000),@p347 datetime2(7),@p348 nvarchar(4000),@p349 nvarchar(4000),@p350 int,@p351 int,@p352 int,@p353 nvarchar(4000),@p354 nvarchar(4000),@p355 nvarchar(4000),@p356 decimal(18,2),@p357 decimal(18,2),@p358 nvarchar(4000),@p359 nvarchar(4000),@p360 decimal(18,2),@p361 nvarchar(4000),@p362 nvarchar(4000),@p363 nvarchar(4000),@p364 nvarchar(4000),@p365 int,@p366 nvarchar(4000),@p367 nvarchar(4000),@p368 nvarchar(4000),@p369 nvarchar(4000),@p370 nvarchar(4000),@p371 nvarchar(4000),@p372 nvarchar(4000),@p373 nvarchar(4000),@p374 nvarchar(4000),@p375 nvarchar(4000),@p376 int,@p377 nvarchar(4000),@p378 nvarchar(4000),@p379 nvarchar(4000),@p380 nvarchar(4000),@p381 nvarchar(4000),@p382 int,@p383 nvarchar(4000),@p384 int,@p385 int,@p386 datetime2(7),@p387 datetime2(7),@p388 datetime2(7),@p389 nvarchar(4000),@p390 nvarchar(4000),@p391 nvarchar(4000),@p392 nvarchar(4000),@p393 nvarchar(4000),@p394 nvarchar(4000),@p395 nvarchar(4000),@p396 nvarchar(4000),@p397 nvarchar(4000),@p398 nvarchar(4000),@p399 nvarchar(4000),@p400 nvarchar(4000),@p401 nvarchar(4000),@p402 nvarchar(4000),@p403 datetime2(7),@p404 nvarchar(4000),@p405 nvarchar(4000),@p406 int,@p407 int,@p408 int,@p409 nvarchar(4000),@p410 nvarchar(4000),@p411 nvarchar(4000),@p412 decimal(18,2),@p413 decimal(18,2),@p414 nvarchar(4000),@p415 nvarchar(4000),@p416 decimal(18,2),@p417 nvarchar(4000),@p418 nvarchar(4000),@p419 nvarchar(4000),@p420 nvarchar(4000),@p421 int,@p422 nvarchar(4000),@p423 nvarchar(4000),@p424 nvarchar(4000),@p425 nvarchar(4000),@p426 nvarchar(4000),@p427 nvarchar(4000),@p428 nvarchar(4000),@p429 nvarchar(4000),@p430 nvarchar(4000),@p431 nvarchar(4000),@p432 int,@p433 nvarchar(4000),@p434 nvarchar(4000),@p435 nvarchar(4000),@p436 nvarchar(4000),@p437 nvarchar(4000),@p438 int,@p439 nvarchar(4000),@p440 int,@p441 int,@p442 datetime2(7),@p443 datetime2(7),@p444 datetime2(7),@p445 nvarchar(4000),@p446 nvarchar(4000),@p447 nvarchar(4000),@p448 nvarchar(4000),@p449 nvarchar(4000),@p450 nvarchar(4000),@p451 nvarchar(4000),@p452 nvarchar(4000),@p453 nvarchar(4000),@p454 nvarchar(4000),@p455 nvarchar(4000),@p456 nvarchar(4000),@p457 nvarchar(4000),@p458 nvarchar(4000),@p459 datetime2(7),@p460 nvarchar(4000),@p461 nvarchar(4000),@p462 int,@p463 int,@p464 int,@p465 nvarchar(4000),@p466 nvarchar(4000),@p467 nvarchar(4000),@p468 decimal(18,2),@p469 decimal(18,2),@p470 nvarchar(4000),@p471 nvarchar(4000),@p472 decimal(18,2),@p473 nvarchar(4000),@p474 nvarchar(4000),@p475 nvarchar(4000),@p476 nvarchar(4000),@p477 int,@p478 nvarchar(4000),@p479 nvarchar(4000),@p480 nvarchar(4000),@p481 nvarchar(4000),@p482 nvarchar(4000),@p483 nvarchar(4000),@p484 nvarchar(4000),@p485 nvarchar(4000),@p486 nvarchar(4000),@p487 nvarchar(4000),@p488 int,@p489 nvarchar(4000),@p490 nvarchar(4000),@p491 nvarchar(4000),@p492 nvarchar(4000),@p493 nvarchar(4000),@p494 int,@p495 nvarchar(4000),@p496 int,@p497 int,@p498 datetime2(7),@p499 datetime2(7),@p500 datetime2(7),@p501 nvarchar(4000),@p502 nvarchar(4000),@p503 nvarchar(4000),@p504 nvarchar(4000),@p505 nvarchar(4000),@p506 nvarchar(4000),@p507 nvarchar(4000),@p508 nvarchar(4000),@p509 nvarchar(4000),@p510 nvarchar(4000),@p511 nvarchar(4000),@p512 nvarchar(4000),@p513 nvarchar(4000),@p514 nvarchar(4000),@p515 datetime2(7),@p516 nvarchar(4000),@p517 nvarchar(4000),@p518 int,@p519 int,@p520 int,@p521 nvarchar(4000),@p522 nvarchar(4000),@p523 nvarchar(4000),@p524 decimal(18,2),@p525 decimal(18,2),@p526 nvarchar(4000),@p527 nvarchar(4000),@p528 decimal(18,2),@p529 nvarchar(4000),@p530 nvarchar(4000),@p531 nvarchar(4000),@p532 nvarchar(4000),@p533 int,@p534 nvarchar(4000),@p535 nvarchar(4000),@p536 nvarchar(4000),@p537 nvarchar(4000),@p538 nvarchar(4000),@p539 nvarchar(4000),@p540 nvarchar(4000),@p541 nvarchar(4000),@p542 nvarchar(4000),@p543 nvarchar(4000),@p544 int,@p545 nvarchar(4000),@p546 nvarchar(4000),@p547 nvarchar(4000),@p548 nvarchar(4000),@p549 nvarchar(4000),@p550 int,@p551 nvarchar(4000),@p552 int,@p553 int,@p554 datetime2(7),@p555 datetime2(7),@p556 datetime2(7),@p557 nvarchar(4000),@p558 nvarchar(4000),@p559 nvarchar(4000),@p560 nvarchar(4000),@p561 nvarchar(4000),@p562 nvarchar(4000),@p563 nvarchar(4000),@p564 nvarchar(4000),@p565 nvarchar(4000),@p566 nvarchar(4000),@p567 nvarchar(4000),@p568 nvarchar(4000),@p569 nvarchar(4000),@p570 nvarchar(4000),@p571 datetime2(7),@p572 nvarchar(4000),@p573 nvarchar(4000),@p574 int,@p575 int,@p576 int,@p577 nvarchar(4000),@p578 nvarchar(4000),@p579 nvarchar(4000),@p580 decimal(18,2),@p581 decimal(18,2),@p582 nvarchar(4000),@p583 nvarchar(4000),@p584 decimal(18,2),@p585 nvarchar(4000),@p586 nvarchar(4000),@p587 nvarchar(4000),@p588 nvarchar(4000),@p589 int,@p590 nvarchar(4000),@p591 nvarchar(4000),@p592 nvarchar(4000),@p593 nvarchar(4000),@p594 nvarchar(4000),@p595 nvarchar(4000),@p596 nvarchar(4000),@p597 nvarchar(4000),@p598 nvarchar(4000),@p599 nvarchar(4000),@p600 int,@p601 nvarchar(4000),@p602 nvarchar(4000),@p603 nvarchar(4000),@p604 nvarchar(4000),@p605 nvarchar(4000),@p606 int,@p607 nvarchar(4000),@p608 int,@p609 int,@p610 datetime2(7),@p611 datetime2(7),@p612 datetime2(7),@p613 nvarchar(4000),@p614 nvarchar(4000),@p615 nvarchar(4000),@p616 nvarchar(4000),@p617 nvarchar(4000),@p618 nvarchar(4000),@p619 nvarchar(4000),@p620 nvarchar(4000),@p621 nvarchar(4000),@p622 nvarchar(4000),@p623 nvarchar(4000),@p624 nvarchar(4000),@p625 nvarchar(4000),@p626 nvarchar(4000),@p627 datetime2(7),@p628 nvarchar(4000),@p629 nvarchar(4000),@p630 int,@p631 int,@p632 int,@p633 nvarchar(4000),@p634 nvarchar(4000),@p635 nvarchar(4000),@p636 decimal(18,2),@p637 decimal(18,2),@p638 nvarchar(4000),@p639 nvarchar(4000),@p640 decimal(18,2),@p641 nvarchar(4000),@p642 nvarchar(4000),@p643 nvarchar(4000),@p644 nvarchar(4000),@p645 int,@p646 nvarchar(4000),@p647 nvarchar(4000),@p648 nvarchar(4000),@p649 nvarchar(4000),@p650 nvarchar(4000),@p651 nvarchar(4000),@p652 nvarchar(4000),@p653 nvarchar(4000),@p654 nvarchar(4000),@p655 nvarchar(4000),@p656 int,@p657 nvarchar(4000),@p658 nvarchar(4000),@p659 nvarchar(4000),@p660 nvarchar(4000),@p661 nvarchar(4000),@p662 int,@p663 nvarchar(4000),@p664 int,@p665 int,@p666 datetime2(7),@p667 datetime2(7),@p668 datetime2(7),@p669 nvarchar(4000),@p670 nvarchar(4000),@p671 nvarchar(4000),@p672 nvarchar(4000),@p673 nvarchar(4000),@p674 nvarchar(4000),@p675 nvarchar(4000),@p676 nvarchar(4000),@p677 nvarchar(4000),@p678 nvarchar(4000),@p679 nvarchar(4000),@p680 nvarchar(4000),@p681 nvarchar(4000),@p682 nvarchar(4000),@p683 datetime2(7),@p684 nvarchar(4000),@p685 nvarchar(4000),@p686 int,@p687 int,@p688 int,@p689 nvarchar(4000),@p690 nvarchar(4000),@p691 nvarchar(4000),@p692 decimal(18,2),@p693 decimal(18,2),@p694 nvarchar(4000),@p695 nvarchar(4000),@p696 decimal(18,2),@p697 nvarchar(4000),@p698 nvarchar(4000),@p699 nvarchar(4000),@p700 nvarchar(4000),@p701 int,@p702 nvarchar(4000),@p703 nvarchar(4000),@p704 nvarchar(4000),@p705 nvarchar(4000),@p706 nvarchar(4000),@p707 nvarchar(4000),@p708 nvarchar(4000),@p709 nvarchar(4000),@p710 nvarchar(4000),@p711 nvarchar(4000),@p712 int,@p713 nvarchar(4000),@p714 nvarchar(4000),@p715 nvarchar(4000),@p716 nvarchar(4000),@p717 nvarchar(4000),@p718 int,@p719 nvarchar(4000),@p720 int,@p721 int,@p722 datetime2(7),@p723 datetime2(7),@p724 datetime2(7),@p725 nvarchar(4000),@p726 nvarchar(4000),@p727 nvarchar(4000),@p728 nvarchar(4000),@p729 nvarchar(4000),@p730 nvarchar(4000),@p731 nvarchar(4000),@p732 nvarchar(4000),@p733 nvarchar(4000),@p734 nvarchar(4000),@p735 nvarchar(4000),@p736 nvarchar(4000),@p737 nvarchar(4000),@p738 nvarchar(4000),@p739 datetime2(7),@p740 nvarchar(4000),@p741 nvarchar(4000),@p742 int,@p743 int,@p744 int,@p745 nvarchar(4000),@p746 nvarchar(4000),@p747 nvarchar(4000),@p748 decimal(18,2),@p749 decimal(18,2),@p750 nvarchar(4000),@p751 nvarchar(4000),@p752 decimal(18,2),@p753 nvarchar(4000),@p754 nvarchar(4000),@p755 nvarchar(4000),@p756 nvarchar(4000),@p757 int,@p758 nvarchar(4000),@p759 nvarchar(4000),@p760 nvarchar(4000),@p761 nvarchar(4000),@p762 nvarchar(4000),@p763 nvarchar(4000),@p764 nvarchar(4000),@p765 nvarchar(4000),@p766 nvarchar(4000),@p767 nvarchar(4000),@p768 int,@p769 nvarchar(4000),@p770 nvarchar(4000),@p771 nvarchar(4000),@p772 nvarchar(4000),@p773 nvarchar(4000),@p774 int,@p775 nvarchar(4000),@p776 int,@p777 int,@p778 datetime2(7),@p779 datetime2(7),@p780 datetime2(7),@p781 nvarchar(4000),@p782 nvarchar(4000),@p783 nvarchar(4000),@p784 nvarchar(4000),@p785 nvarchar(4000),@p786 nvarchar(4000),@p787 nvarchar(4000),@p788 nvarchar(4000),@p789 nvarchar(4000),@p790 nvarchar(4000),@p791 nvarchar(4000),@p792 nvarchar(4000),@p793 nvarchar(4000),@p794 nvarchar(4000),@p795 datetime2(7),@p796 nvarchar(4000),@p797 nvarchar(4000),@p798 int,@p799 int,@p800 int,@p801 nvarchar(4000),@p802 nvarchar(4000),@p803 nvarchar(4000),@p804 decimal(18,2),@p805 decimal(18,2),@p806 nvarchar(4000),@p807 nvarchar(4000),@p808 decimal(18,2),@p809 nvarchar(4000),@p810 nvarchar(4000),@p811 nvarchar(4000),@p812 nvarchar(4000),@p813 int,@p814 nvarchar(4000),@p815 nvarchar(4000),@p816 nvarchar(4000),@p817 nvarchar(4000),@p818 nvarchar(4000),@p819 nvarchar(4000),@p820 nvarchar(4000),@p821 nvarchar(4000),@p822 nvarchar(4000),@p823 nvarchar(4000),@p824 int,@p825 nvarchar(4000),@p826 nvarchar(4000),@p827 nvarchar(4000),@p828 nvarchar(4000),@p829 nvarchar(4000),@p830 int,@p831 nvarchar(4000),@p832 int,@p833 int,@p834 datetime2(7),@p835 datetime2(7),@p836 datetime2(7),@p837 nvarchar(4000),@p838 nvarchar(4000),@p839 nvarchar(4000),@p840 nvarchar(4000),@p841 nvarchar(4000),@p842 nvarchar(4000),@p843 nvarchar(4000),@p844 nvarchar(4000),@p845 nvarchar(4000),@p846 nvarchar(4000),@p847 nvarchar(4000),@p848 nvarchar(4000),@p849 nvarchar(4000),@p850 nvarchar(4000),@p851 datetime2(7),@p852 nvarchar(4000),@p853 nvarchar(4000),@p854 int,@p855 int,@p856 int,@p857 nvarchar(4000),@p858 nvarchar(4000),@p859 nvarchar(4000),@p860 decimal(18,2),@p861 decimal(18,2),@p862 nvarchar(4000),@p863 nvarchar(4000),@p864 decimal(18,2),@p865 nvarchar(4000),@p866 nvarchar(4000),@p867 nvarchar(4000),@p868 nvarchar(4000),@p869 int,@p870 nvarchar(4000),@p871 nvarchar(4000),@p872 nvarchar(4000),@p873 nvarchar(4000),@p874 nvarchar(4000),@p875 nvarchar(4000),@p876 nvarchar(4000),@p877 nvarchar(4000),@p878 nvarchar(4000),@p879 nvarchar(4000),@p880 int,@p881 nvarchar(4000),@p882 nvarchar(4000),@p883 nvarchar(4000),@p884 nvarchar(4000),@p885 nvarchar(4000),@p886 int,@p887 nvarchar(4000),@p888 int,@p889 int,@p890 datetime2(7),@p891 datetime2(7),@p892 datetime2(7),@p893 nvarchar(4000),@p894 nvarchar(4000),@p895 nvarchar(4000),@p896 nvarchar(4000),@p897 nvarchar(4000),@p898 nvarchar(4000),@p899 nvarchar(4000),@p900 nvarchar(4000),@p901 nvarchar(4000),@p902 nvarchar(4000),@p903 nvarchar(4000),@p904 nvarchar(4000),@p905 nvarchar(4000),@p906 nvarchar(4000),@p907 datetime2(7),@p908 nvarchar(4000),@p909 nvarchar(4000),@p910 int,@p911 int,@p912 int,@p913 nvarchar(4000),@p914 nvarchar(4000),@p915 nvarchar(4000),@p916 decimal(18,2),@p917 decimal(18,2),@p918 nvarchar(4000),@p919 nvarchar(4000),@p920 decimal(18,2),@p921 nvarchar(4000),@p922 nvarchar(4000),@p923 nvarchar(4000),@p924 nvarchar(4000),@p925 int,@p926 nvarchar(4000),@p927 nvarchar(4000),@p928 nvarchar(4000),@p929 nvarchar(4000),@p930 nvarchar(4000),@p931 nvarchar(4000),@p932 nvarchar(4000),@p933 nvarchar(4000),@p934 nvarchar(4000),@p935 nvarchar(4000),@p936 int,@p937 nvarchar(4000),@p938 nvarchar(4000),@p939 nvarchar(4000),@p940 nvarchar(4000),@p941 nvarchar(4000),@p942 int,@p943 nvarchar(4000),@p944 int,@p945 int,@p946 datetime2(7),@p947 datetime2(7),@p948 datetime2(7),@p949 nvarchar(4000),@p950 nvarchar(4000),@p951 nvarchar(4000),@p952 nvarchar(4000),@p953 nvarchar(4000),@p954 nvarchar(4000),@p955 nvarchar(4000),@p956 nvarchar(4000),@p957 nvarchar(4000),@p958 nvarchar(4000),@p959 nvarchar(4000),@p960 nvarchar(4000),@p961 nvarchar(4000),@p962 nvarchar(4000),@p963 datetime2(7),@p964 nvarchar(4000),@p965 nvarchar(4000),@p966 int,@p967 int,@p968 int,@p969 nvarchar(4000),@p970 nvarchar(4000),@p971 nvarchar(4000),@p972 decimal(18,2),@p973 decimal(18,2),@p974 nvarchar(4000),@p975 nvarchar(4000),@p976 decimal(18,2),@p977 nvarchar(4000),@p978 nvarchar(4000),@p979 nvarchar(4000),@p980 nvarchar(4000),@p981 int,@p982 nvarchar(4000),@p983 nvarchar(4000),@p984 nvarchar(4000),@p985 nvarchar(4000),@p986 nvarchar(4000),@p987 nvarchar(4000),@p988 nvarchar(4000),@p989 nvarchar(4000),@p990 nvarchar(4000),@p991 nvarchar(4000),@p992 int,@p993 nvarchar(4000),@p994 nvarchar(4000),@p995 nvarchar(4000),@p996 nvarchar(4000),@p997 nvarchar(4000),@p998 int,@p999 nvarchar(4000),@p1000 int,@p1001 int,@p1002 datetime2(7),@p1003 datetime2(7),@p1004 datetime2(7),@p1005 nvarchar(4000),@p1006 nvarchar(4000),@p1007 nvarchar(4000),@p1008 nvarchar(4000),@p1009 nvarchar(4000),@p1010 nvarchar(4000),@p1011 nvarchar(4000),@p1012 nvarchar(4000),@p1013 nvarchar(4000),@p1014 nvarchar(4000),@p1015 nvarchar(4000),@p1016 nvarchar(4000),@p1017 nvarchar(4000),@p1018 nvarchar(4000),@p1019 datetime2(7),@p1020 nvarchar(4000),@p1021 nvarchar(4000),@p1022 int,@p1023 int,@p1024 int,@p1025 nvarchar(4000),@p1026 nvarchar(4000),@p1027 nvarchar(4000),@p1028 decimal(18,2),@p1029 decimal(18,2),@p1030 nvarchar(4000),@p1031 nvarchar(4000),@p1032 decimal(18,2),@p1033 nvarchar(4000),@p1034 nvarchar(4000),@p1035 nvarchar(4000),@p1036 nvarchar(4000),@p1037 int,@p1038 nvarchar(4000),@p1039 nvarchar(4000),@p1040 nvarchar(4000),@p1041 nvarchar(4000),@p1042 nvarchar(4000),@p1043 nvarchar(4000),@p1044 nvarchar(4000),@p1045 nvarchar(4000),@p1046 nvarchar(4000),@p1047 nvarchar(4000),@p1048 int,@p1049 nvarchar(4000),@p1050 nvarchar(4000),@p1051 nvarchar(4000),@p1052 nvarchar(4000),@p1053 nvarchar(4000),@p1054 int,@p1055 nvarchar(4000),@p1056 int,@p1057 int,@p1058 datetime2(7),@p1059 datetime2(7),@p1060 datetime2(7),@p1061 nvarchar(4000),@p1062 nvarchar(4000),@p1063 nvarchar(4000),@p1064 nvarchar(4000),@p1065 nvarchar(4000),@p1066 nvarchar(4000),@p1067 nvarchar(4000),@p1068 nvarchar(4000),@p1069 nvarchar(4000),@p1070 nvarchar(4000),@p1071 nvarchar(4000),@p1072 nvarchar(4000),@p1073 nvarchar(4000),@p1074 nvarchar(4000),@p1075 datetime2(7),@p1076 nvarchar(4000),@p1077 nvarchar(4000),@p1078 int,@p1079 int,@p1080 int,@p1081 nvarchar(4000),@p1082 nvarchar(4000),@p1083 nvarchar(4000),@p1084 decimal(18,2),@p1085 decimal(18,2),@p1086 nvarchar(4000),@p1087 nvarchar(4000),@p1088 decimal(18,2),@p1089 nvarchar(4000),@p1090 nvarchar(4000),@p1091 nvarchar(4000),@p1092 nvarchar(4000),@p1093 int,@p1094 nvarchar(4000),@p1095 nvarchar(4000),@p1096 nvarchar(4000),@p1097 nvarchar(4000),@p1098 nvarchar(4000),@p1099 nvarchar(4000),@p1100 nvarchar(4000),@p1101 nvarchar(4000),@p1102 nvarchar(4000),@p1103 nvarchar(4000),@p1104 int,@p1105 nvarchar(4000),@p1106 nvarchar(4000),@p1107 nvarchar(4000),@p1108 nvarchar(4000),@p1109 nvarchar(4000),@p1110 int,@p1111 nvarchar(4000),@p1112 int,@p1113 int,@p1114 datetime2(7),@p1115 datetime2(7),@p1116 datetime2(7),@p1117 nvarchar(4000),@p1118 nvarchar(4000),@p1119 nvarchar(4000),@p1120 nvarchar(4000),@p1121 nvarchar(4000),@p1122 nvarchar(4000),@p1123 nvarchar(4000),@p1124 nvarchar(4000),@p1125 nvarchar(4000),@p1126 nvarchar(4000),@p1127 nvarchar(4000),@p1128 nvarchar(4000),@p1129 nvarchar(4000),@p1130 nvarchar(4000),@p1131 datetime2(7),@p1132 nvarchar(4000),@p1133 nvarchar(4000),@p1134 int,@p1135 int,@p1136 int,@p1137 nvarchar(4000),@p1138 nvarchar(4000),@p1139 nvarchar(4000),@p1140 decimal(18,2),@p1141 decimal(18,2),@p1142 nvarchar(4000),@p1143 nvarchar(4000),@p1144 decimal(18,2),@p1145 nvarchar(4000),@p1146 nvarchar(4000),@p1147 nvarchar(4000),@p1148 nvarchar(4000),@p1149 int,@p1150 nvarchar(4000),@p1151 nvarchar(4000),@p1152 nvarchar(4000),@p1153 nvarchar(4000),@p1154 nvarchar(4000),@p1155 nvarchar(4000),@p1156 nvarchar(4000),@p1157 nvarchar(4000),@p1158 nvarchar(4000),@p1159 nvarchar(4000),@p1160 int,@p1161 nvarchar(4000),@p1162 nvarchar(4000),@p1163 nvarchar(4000),@p1164 nvarchar(4000),@p1165 nvarchar(4000),@p1166 int,@p1167 nvarchar(4000),@p1168 int,@p1169 int,@p1170 datetime2(7),@p1171 datetime2(7),@p1172 datetime2(7),@p1173 nvarchar(4000),@p1174 nvarchar(4000),@p1175 nvarchar(4000),@p1176 nvarchar(4000),@p1177 nvarchar(4000),@p1178 nvarchar(4000),@p1179 nvarchar(4000),@p1180 nvarchar(4000),@p1181 nvarchar(4000),@p1182 nvarchar(4000),@p1183 nvarchar(4000),@p1184 nvarchar(4000),@p1185 nvarchar(4000),@p1186 nvarchar(4000),@p1187 datetime2(7),@p1188 nvarchar(4000),@p1189 nvarchar(4000),@p1190 int,@p1191 int,@p1192 int,@p1193 nvarchar(4000),@p1194 nvarchar(4000),@p1195 nvarchar(4000),@p1196 nvarchar(4000),@p1197 decimal(18,2),@p1198 nvarchar(4000),@p1199 nvarchar(4000),@p1200 decimal(18,2),@p1201 nvarchar(4000),@p1202 nvarchar(4000),@p1203 nvarchar(4000),@p1204 nvarchar(4000),@p1205 int,@p1206 nvarchar(4000),@p1207 nvarchar(4000),@p1208 nvarchar(4000),@p1209 nvarchar(4000),@p1210 nvarchar(4000),@p1211 nvarchar(4000),@p1212 nvarchar(4000),@p1213 nvarchar(4000),@p1214 nvarchar(4000),@p1215 nvarchar(4000),@p1216 int,@p1217 nvarchar(4000),@p1218 nvarchar(4000),@p1219 nvarchar(4000),@p1220 nvarchar(4000),@p1221 nvarchar(4000),@p1222 int,@p1223 nvarchar(4000),@p1224 int,@p1225 int,@p1226 datetime2(7),@p1227 datetime2(7),@p1228 datetime2(7),@p1229 nvarchar(4000),@p1230 nvarchar(4000),@p1231 nvarchar(4000),@p1232 nvarchar(4000),@p1233 nvarchar(4000),@p1234 nvarchar(4000),@p1235 nvarchar(4000),@p1236 nvarchar(4000),@p1237 nvarchar(4000),@p1238 nvarchar(4000),@p1239 nvarchar(4000),@p1240 nvarchar(4000),@p1241 nvarchar(4000),@p1242 nvarchar(4000),@p1243 datetime2(7),@p1244 nvarchar(4000),@p1245 nvarchar(4000),@p1246 int,@p1247 int,@p1248 int,@p1249 nvarchar(4000),@p1250 nvarchar(4000),@p1251 nvarchar(4000),@p1252 nvarchar(4000),@p1253 decimal(18,2),@p1254 nvarchar(4000),@p1255 nvarchar(4000),@p1256 decimal(18,2),@p1257 nvarchar(4000),@p1258 nvarchar(4000),@p1259 nvarchar(4000),@p1260 nvarchar(4000),@p1261 int,@p1262 nvarchar(4000),@p1263 nvarchar(4000),@p1264 nvarchar(4000),@p1265 nvarchar(4000),@p1266 nvarchar(4000),@p1267 nvarchar(4000),@p1268 nvarchar(4000),@p1269 nvarchar(4000),@p1270 nvarchar(4000),@p1271 nvarchar(4000),@p1272 int,@p1273 nvarchar(4000),@p1274 nvarchar(4000),@p1275 nvarchar(4000),@p1276 nvarchar(4000),@p1277 nvarchar(4000),@p1278 int,@p1279 nvarchar(4000),@p1280 int,@p1281 int,@p1282 datetime2(7),@p1283 datetime2(7),@p1284 datetime2(7),@p1285 nvarchar(4000),@p1286 nvarchar(4000),@p1287 nvarchar(4000),@p1288 nvarchar(4000),@p1289 nvarchar(4000),@p1290 nvarchar(4000),@p1291 nvarchar(4000),@p1292 nvarchar(4000),@p1293 nvarchar(4000),@p1294 nvarchar(4000),@p1295 nvarchar(4000),@p1296 nvarchar(4000),@p1297 nvarchar(4000),@p1298 nvarchar(4000),@p1299 datetime2(7),@p1300 nvarchar(4000),@p1301 nvarchar(4000),@p1302 int,@p1303 int,@p1304 int,@p1305 nvarchar(4000),@p1306 nvarchar(4000),@p1307 nvarchar(4000),@p1308 nvarchar(4000),@p1309 decimal(18,2),@p1310 nvarchar(4000),@p1311 nvarchar(4000),@p1312 decimal(18,2),@p1313 nvarchar(4000),@p1314 nvarchar(4000),@p1315 nvarchar(4000),@p1316 nvarchar(4000),@p1317 int,@p1318 nvarchar(4000),@p1319 nvarchar(4000),@p1320 nvarchar(4000),@p1321 nvarchar(4000),@p1322 nvarchar(4000),@p1323 nvarchar(4000),@p1324 nvarchar(4000),@p1325 nvarchar(4000),@p1326 nvarchar(4000),@p1327 nvarchar(4000),@p1328 int,@p1329 nvarchar(4000),@p1330 nvarchar(4000),@p1331 nvarchar(4000),@p1332 nvarchar(4000),@p1333 nvarchar(4000),@p1334 int,@p1335 nvarchar(4000),@p1336 int,@p1337 int,@p1338 datetime2(7),@p1339 datetime2(7),@p1340 datetime2(7),@p1341 nvarchar(4000),@p1342 nvarchar(4000),@p1343 nvarchar(4000),@p1344 nvarchar(4000),@p1345 nvarchar(4000),@p1346 nvarchar(4000),@p1347 nvarchar(4000),@p1348 nvarchar(4000),@p1349 nvarchar(4000),@p1350 nvarchar(4000),@p1351 nvarchar(4000),@p1352 nvarchar(4000),@p1353 nvarchar(4000),@p1354 nvarchar(4000),@p1355 datetime2(7),@p1356 nvarchar(4000),@p1357 nvarchar(4000),@p1358 int,@p1359 int,@p1360 int,@p1361 nvarchar(4000),@p1362 nvarchar(4000),@p1363 nvarchar(4000),@p1364 nvarchar(4000),@p1365 decimal(18,2),@p1366 nvarchar(4000),@p1367 nvarchar(4000),@p1368 decimal(18,2),@p1369 nvarchar(4000),@p1370 nvarchar(4000),@p1371 nvarchar(4000),@p1372 nvarchar(4000),@p1373 int,@p1374 nvarchar(4000),@p1375 nvarchar(4000),@p1376 nvarchar(4000),@p1377 nvarchar(4000),@p1378 nvarchar(4000),@p1379 nvarchar(4000),@p1380 nvarchar(4000),@p1381 nvarchar(4000),@p1382 nvarchar(4000),@p1383 nvarchar(4000),@p1384 int,@p1385 nvarchar(4000),@p1386 nvarchar(4000),@p1387 nvarchar(4000),@p1388 nvarchar(4000),@p1389 nvarchar(4000),@p1390 int,@p1391 nvarchar(4000),@p1392 int,@p1393 int,@p1394 datetime2(7),@p1395 datetime2(7),@p1396 datetime2(7),@p1397 nvarchar(4000),@p1398 nvarchar(4000),@p1399 nvarchar(4000),@p1400 nvarchar(4000),@p1401 nvarchar(4000),@p1402 nvarchar(4000),@p1403 nvarchar(4000),@p1404 nvarchar(4000),@p1405 nvarchar(4000),@p1406 nvarchar(4000),@p1407 nvarchar(4000),@p1408 nvarchar(4000),@p1409 nvarchar(4000),@p1410 nvarchar(4000),@p1411 datetime2(7),@p1412 nvarchar(4000),@p1413 nvarchar(4000),@p1414 int,@p1415 int,@p1416 int,@p1417 nvarchar(4000),@p1418 nvarchar(4000),@p1419 nvarchar(4000),@p1420 nvarchar(4000),@p1421 decimal(18,2),@p1422 nvarchar(4000),@p1423 nvarchar(4000),@p1424 decimal(18,2),@p1425 nvarchar(4000),@p1426 nvarchar(4000),@p1427 nvarchar(4000),@p1428 nvarchar(4000),@p1429 int,@p1430 nvarchar(4000),@p1431 nvarchar(4000),@p1432 nvarchar(4000),@p1433 nvarchar(4000),@p1434 nvarchar(4000),@p1435 nvarchar(4000),@p1436 nvarchar(4000),@p1437 nvarchar(4000),@p1438 nvarchar(4000),@p1439 nvarchar(4000),@p1440 int,@p1441 nvarchar(4000),@p1442 nvarchar(4000),@p1443 nvarchar(4000),@p1444 nvarchar(4000),@p1445 nvarchar(4000),@p1446 int,@p1447 nvarchar(4000),@p1448 int,@p1449 int,@p1450 datetime2(7),@p1451 datetime2(7),@p1452 datetime2(7),@p1453 nvarchar(4000),@p1454 nvarchar(4000),@p1455 nvarchar(4000),@p1456 nvarchar(4000),@p1457 nvarchar(4000),@p1458 nvarchar(4000),@p1459 nvarchar(4000),@p1460 nvarchar(4000),@p1461 nvarchar(4000),@p1462 nvarchar(4000),@p1463 nvarchar(4000),@p1464 nvarchar(4000),@p1465 nvarchar(4000),@p1466 nvarchar(4000),@p1467 datetime2(7),@p1468 nvarchar(4000),@p1469 nvarchar(4000),@p1470 int,@p1471 int,@p1472 int,@p1473 nvarchar(4000),@p1474 nvarchar(4000),@p1475 nvarchar(4000),@p1476 nvarchar(4000),@p1477 decimal(18,2),@p1478 nvarchar(4000),@p1479 nvarchar(4000),@p1480 decimal(18,2),@p1481 nvarchar(4000),@p1482 nvarchar(4000),@p1483 nvarchar(4000),@p1484 nvarchar(4000),@p1485 int,@p1486 nvarchar(4000),@p1487 nvarchar(4000),@p1488 nvarchar(4000),@p1489 nvarchar(4000),@p1490 nvarchar(4000),@p1491 nvarchar(4000),@p1492 nvarchar(4000),@p1493 nvarchar(4000),@p1494 nvarchar(4000),@p1495 nvarchar(4000),@p1496 int,@p1497 nvarchar(4000),@p1498 nvarchar(4000),@p1499 nvarchar(4000),@p1500 nvarchar(4000),@p1501 nvarchar(4000),@p1502 int,@p1503 nvarchar(4000),@p1504 int,@p1505 int,@p1506 datetime2(7),@p1507 datetime2(7),@p1508 datetime2(7),@p1509 nvarchar(4000),@p1510 nvarchar(4000),@p1511 nvarchar(4000),@p1512 nvarchar(4000),@p1513 nvarchar(4000),@p1514 nvarchar(4000),@p1515 nvarchar(4000),@p1516 nvarchar(4000),@p1517 nvarchar(4000),@p1518 nvarchar(4000),@p1519 nvarchar(4000),@p1520 nvarchar(4000),@p1521 nvarchar(4000),@p1522 nvarchar(4000),@p1523 datetime2(7),@p1524 nvarchar(4000),@p1525 nvarchar(4000),@p1526 int,@p1527 int,@p1528 int,@p1529 nvarchar(4000),@p1530 nvarchar(4000),@p1531 nvarchar(4000),@p1532 nvarchar(4000),@p1533 decimal(18,2),@p1534 nvarchar(4000),@p1535 nvarchar(4000),@p1536 decimal(18,2),@p1537 nvarchar(4000),@p1538 nvarchar(4000),@p1539 nvarchar(4000),@p1540 nvarchar(4000),@p1541 int,@p1542 nvarchar(4000),@p1543 nvarchar(4000),@p1544 nvarchar(4000),@p1545 nvarchar(4000),@p1546 nvarchar(4000),@p1547 nvarchar(4000),@p1548 nvarchar(4000),@p1549 nvarchar(4000),@p1550 nvarchar(4000),@p1551 nvarchar(4000),@p1552 int,@p1553 nvarchar(4000),@p1554 nvarchar(4000),@p1555 nvarchar(4000),@p1556 nvarchar(4000),@p1557 nvarchar(4000),@p1558 int,@p1559 nvarchar(4000),@p1560 int,@p1561 int,@p1562 datetime2(7),@p1563 datetime2(7),@p1564 datetime2(7),@p1565 nvarchar(4000),@p1566 nvarchar(4000),@p1567 nvarchar(4000),@p1568 nvarchar(4000),@p1569 nvarchar(4000),@p1570 nvarchar(4000),@p1571 nvarchar(4000),@p1572 nvarchar(4000),@p1573 nvarchar(4000),@p1574 nvarchar(4000),@p1575 nvarchar(4000),@p1576 nvarchar(4000),@p1577 nvarchar(4000),@p1578 nvarchar(4000),@p1579 datetime2(7),@p1580 nvarchar(4000),@p1581 nvarchar(4000),@p1582 int,@p1583 int,@p1584 int,@p1585 nvarchar(4000),@p1586 nvarchar(4000),@p1587 nvarchar(4000),@p1588 nvarchar(4000),@p1589 decimal(18,2),@p1590 nvarchar(4000),@p1591 nvarchar(4000),@p1592 decimal(18,2),@p1593 nvarchar(4000),@p1594 nvarchar(4000),@p1595 nvarchar(4000),@p1596 nvarchar(4000),@p1597 int,@p1598 nvarchar(4000),@p1599 nvarchar(4000),@p1600 nvarchar(4000),@p1601 nvarchar(4000),@p1602 nvarchar(4000),@p1603 nvarchar(4000),@p1604 nvarchar(4000),@p1605 nvarchar(4000),@p1606 nvarchar(4000),@p1607 nvarchar(4000),@p1608 int,@p1609 nvarchar(4000),@p1610 nvarchar(4000),@p1611 nvarchar(4000),@p1612 nvarchar(4000),@p1613 nvarchar(4000),@p1614 int,@p1615 nvarchar(4000),@p1616 int,@p1617 int,@p1618 datetime2(7),@p1619 datetime2(7),@p1620 datetime2(7),@p1621 nvarchar(4000),@p1622 nvarchar(4000),@p1623 nvarchar(4000),@p1624 nvarchar(4000),@p1625 nvarchar(4000),@p1626 nvarchar(4000),@p1627 nvarchar(4000),@p1628 nvarchar(4000),@p1629 nvarchar(4000),@p1630 nvarchar(4000),@p1631 nvarchar(4000),@p1632 nvarchar(4000),@p1633 nvarchar(4000),@p1634 nvarchar(4000),@p1635 datetime2(7),@p1636 nvarchar(4000),@p1637 nvarchar(4000),@p1638 int,@p1639 int,@p1640 int,@p1641 nvarchar(4000),@p1642 nvarchar(4000),@p1643 nvarchar(4000),@p1644 nvarchar(4000),@p1645 decimal(18,2),@p1646 nvarchar(4000),@p1647 nvarchar(4000),@p1648 decimal(18,2),@p1649 nvarchar(4000),@p1650 nvarchar(4000),@p1651 nvarchar(4000),@p1652 nvarchar(4000),@p1653 int,@p1654 nvarchar(4000),@p1655 nvarchar(4000),@p1656 nvarchar(4000),@p1657 nvarchar(4000),@p1658 nvarchar(4000),@p1659 nvarchar(4000),@p1660 nvarchar(4000),@p1661 nvarchar(4000),@p1662 nvarchar(4000),@p1663 nvarchar(4000),@p1664 int,@p1665 nvarchar(4000),@p1666 nvarchar(4000),@p1667 nvarchar(4000),@p1668 nvarchar(4000),@p1669 nvarchar(4000),@p1670 int,@p1671 nvarchar(4000),@p1672 int,@p1673 int,@p1674 datetime2(7),@p1675 datetime2(7),@p1676 datetime2(7),@p1677 nvarchar(4000),@p1678 nvarchar(4000),@p1679 nvarchar(4000),@p1680 nvarchar(4000),@p1681 nvarchar(4000),@p1682 nvarchar(4000),@p1683 nvarchar(4000),@p1684 nvarchar(4000),@p1685 nvarchar(4000),@p1686 nvarchar(4000),@p1687 nvarchar(4000),@p1688 nvarchar(4000),@p1689 nvarchar(4000),@p1690 nvarchar(4000),@p1691 datetime2(7),@p1692 nvarchar(4000),@p1693 nvarchar(4000),@p1694 int,@p1695 int,@p1696 int,@p1697 nvarchar(4000),@p1698 nvarchar(4000),@p1699 nvarchar(4000),@p1700 nvarchar(4000),@p1701 decimal(18,2),@p1702 nvarchar(4000),@p1703 nvarchar(4000),@p1704 decimal(18,2),@p1705 nvarchar(4000),@p1706 nvarchar(4000),@p1707 nvarchar(4000),@p1708 nvarchar(4000),@p1709 int,@p1710 nvarchar(4000),@p1711 nvarchar(4000),@p1712 nvarchar(4000),@p1713 nvarchar(4000),@p1714 nvarchar(4000),@p1715 nvarchar(4000),@p1716 nvarchar(4000),@p1717 nvarchar(4000),@p1718 nvarchar(4000),@p1719 nvarchar(4000),@p1720 int,@p1721 nvarchar(4000),@p1722 nvarchar(4000),@p1723 nvarchar(4000),@p1724 nvarchar(4000),@p1725 nvarchar(4000),@p1726 int,@p1727 nvarchar(4000),@p1728 int,@p1729 int,@p1730 datetime2(7),@p1731 datetime2(7),@p1732 datetime2(7),@p1733 nvarchar(4000),@p1734 nvarchar(4000),@p1735 nvarchar(4000),@p1736 nvarchar(4000),@p1737 nvarchar(4000),@p1738 nvarchar(4000),@p1739 nvarchar(4000),@p1740 nvarchar(4000),@p1741 nvarchar(4000),@p1742 nvarchar(4000),@p1743 nvarchar(4000),@p1744 nvarchar(4000),@p1745 nvarchar(4000),@p1746 nvarchar(4000),@p1747 datetime2(7),@p1748 nvarchar(4000),@p1749 nvarchar(4000),@p1750 int,@p1751 int,@p1752 int,@p1753 nvarchar(4000),@p1754 nvarchar(4000),@p1755 nvarchar(4000),@p1756 nvarchar(4000),@p1757 decimal(18,2),@p1758 nvarchar(4000),@p1759 nvarchar(4000),@p1760 decimal(18,2),@p1761 nvarchar(4000),@p1762 nvarchar(4000),@p1763 nvarchar(4000),@p1764 nvarchar(4000),@p1765 int,@p1766 nvarchar(4000),@p1767 nvarchar(4000),@p1768 nvarchar(4000),@p1769 nvarchar(4000),@p1770 nvarchar(4000),@p1771 nvarchar(4000),@p1772 nvarchar(4000),@p1773 nvarchar(4000),@p1774 nvarchar(4000),@p1775 nvarchar(4000),@p1776 int,@p1777 nvarchar(4000),@p1778 nvarchar(4000),@p1779 nvarchar(4000),@p1780 nvarchar(4000),@p1781 nvarchar(4000),@p1782 int,@p1783 nvarchar(4000),@p1784 int,@p1785 int,@p1786 datetime2(7),@p1787 datetime2(7),@p1788 datetime2(7),@p1789 nvarchar(4000),@p1790 nvarchar(4000),@p1791 nvarchar(4000),@p1792 nvarchar(4000),@p1793 nvarchar(4000),@p1794 nvarchar(4000),@p1795 nvarchar(4000),@p1796 nvarchar(4000),@p1797 nvarchar(4000),@p1798 nvarchar(4000),@p1799 nvarchar(4000),@p1800 nvarchar(4000),@p1801 nvarchar(4000),@p1802 nvarchar(4000),@p1803 datetime2(7),@p1804 nvarchar(4000),@p1805 nvarchar(4000),@p1806 int,@p1807 int,@p1808 int,@p1809 nvarchar(4000),@p1810 nvarchar(4000),@p1811 nvarchar(4000),@p1812 nvarchar(4000),@p1813 decimal(18,2),@p1814 nvarchar(4000),@p1815 nvarchar(4000),@p1816 decimal(18,2),@p1817 nvarchar(4000),@p1818 nvarchar(4000),@p1819 nvarchar(4000),@p1820 nvarchar(4000),@p1821 int,@p1822 nvarchar(4000),@p1823 nvarchar(4000),@p1824 nvarchar(4000),@p1825 nvarchar(4000),@p1826 nvarchar(4000),@p1827 nvarchar(4000),@p1828 nvarchar(4000),@p1829 nvarchar(4000),@p1830 nvarchar(4000),@p1831 nvarchar(4000),@p1832 int,@p1833 nvarchar(4000),@p1834 nvarchar(4000),@p1835 nvarchar(4000),@p1836 nvarchar(4000),@p1837 nvarchar(4000),@p1838 int,@p1839 nvarchar(4000),@p1840 int,@p1841 int,@p1842 datetime2(7),@p1843 datetime2(7),@p1844 datetime2(7),@p1845 nvarchar(4000),@p1846 nvarchar(4000),@p1847 nvarchar(4000),@p1848 nvarchar(4000),@p1849 nvarchar(4000),@p1850 nvarchar(4000),@p1851 nvarchar(4000),@p1852 nvarchar(4000),@p1853 nvarchar(4000),@p1854 nvarchar(4000),@p1855 nvarchar(4000),@p1856 nvarchar(4000),@p1857 nvarchar(4000),@p1858 nvarchar(4000),@p1859 datetime2(7),@p1860 nvarchar(4000),@p1861 nvarchar(4000),@p1862 int,@p1863 int,@p1864 int,@p1865 nvarchar(4000),@p1866 nvarchar(4000),@p1867 nvarchar(4000),@p1868 decimal(18,2),@p1869 decimal(18,2),@p1870 nvarchar(4000),@p1871 nvarchar(4000),@p1872 decimal(18,2),@p1873 nvarchar(4000),@p1874 nvarchar(4000),@p1875 nvarchar(4000),@p1876 nvarchar(4000),@p1877 int,@p1878 nvarchar(4000),@p1879 nvarchar(4000),@p1880 nvarchar(4000),@p1881 nvarchar(4000),@p1882 nvarchar(4000),@p1883 nvarchar(4000),@p1884 nvarchar(4000),@p1885 nvarchar(4000),@p1886 nvarchar(4000),@p1887 nvarchar(4000),@p1888 int,@p1889 nvarchar(4000),@p1890 nvarchar(4000),@p1891 nvarchar(4000),@p1892 nvarchar(4000),@p1893 nvarchar(4000),@p1894 int,@p1895 nvarchar(4000),@p1896 int,@p1897 int,@p1898 datetime2(7),@p1899 datetime2(7),@p1900 datetime2(7),@p1901 nvarchar(4000),@p1902 nvarchar(4000),@p1903 nvarchar(4000),@p1904 nvarchar(4000),@p1905 nvarchar(4000),@p1906 nvarchar(4000),@p1907 nvarchar(4000),@p1908 nvarchar(4000),@p1909 nvarchar(4000),@p1910 nvarchar(4000),@p1911 nvarchar(4000),@p1912 nvarchar(4000),@p1913 nvarchar(4000),@p1914 nvarchar(4000),@p1915 datetime2(7),@p1916 nvarchar(4000),@p1917 nvarchar(4000),@p1918 int,@p1919 int,@p1920 int,@p1921 nvarchar(4000),@p1922 nvarchar(4000),@p1923 nvarchar(4000),@p1924 decimal(18,2),@p1925 decimal(18,2),@p1926 nvarchar(4000),@p1927 nvarchar(4000),@p1928 decimal(18,2),@p1929 nvarchar(4000),@p1930 nvarchar(4000),@p1931 nvarchar(4000),@p1932 nvarchar(4000),@p1933 int,@p1934 nvarchar(4000),@p1935 nvarchar(4000),@p1936 nvarchar(4000),@p1937 nvarchar(4000),@p1938 nvarchar(4000),@p1939 nvarchar(4000),@p1940 nvarchar(4000),@p1941 nvarchar(4000),@p1942 nvarchar(4000),@p1943 nvarchar(4000),@p1944 int,@p1945 nvarchar(4000),@p1946 nvarchar(4000),@p1947 nvarchar(4000),@p1948 nvarchar(4000),@p1949 nvarchar(4000),@p1950 int,@p1951 nvarchar(4000),@p1952 int,@p1953 int,@p1954 datetime2(7),@p1955 datetime2(7),@p1956 datetime2(7),@p1957 nvarchar(4000),@p1958 nvarchar(4000),@p1959 nvarchar(4000),@p1960 nvarchar(4000),@p1961 nvarchar(4000),@p1962 nvarchar(4000),@p1963 nvarchar(4000),@p1964 nvarchar(4000),@p1965 nvarchar(4000),@p1966 nvarchar(4000),@p1967 nvarchar(4000),@p1968 nvarchar(4000),@p1969 nvarchar(4000),@p1970 nvarchar(4000),@p1971 datetime2(7),@p1972 nvarchar(4000),@p1973 nvarchar(4000),@p1974 int,@p1975 int,@p1976 int,@p1977 nvarchar(4000),@p1978 nvarchar(4000),@p1979 nvarchar(4000),@p1980 decimal(18,2),@p1981 decimal(18,2),@p1982 nvarchar(4000),@p1983 nvarchar(4000),@p1984 decimal(18,2),@p1985 nvarchar(4000),@p1986 nvarchar(4000),@p1987 nvarchar(4000),@p1988 nvarchar(4000),@p1989 int,@p1990 nvarchar(4000),@p1991 nvarchar(4000),@p1992 nvarchar(4000),@p1993 nvarchar(4000),@p1994 nvarchar(4000),@p1995 nvarchar(4000),@p1996 nvarchar(4000),@p1997 nvarchar(4000),@p1998 nvarchar(4000),@p1999 nvarchar(4000),@p2000 int,@p2001 nvarchar(4000),@p2002 nvarchar(4000),@p2003 nvarchar(4000),@p2004 nvarchar(4000),@p2005 nvarchar(4000),@p2006 int,@p2007 nvarchar(4000),@p2008 int,@p2009 int,@p2010 datetime2(7),@p2011 datetime2(7),@p2012 datetime2(7),@p2013 nvarchar(4000),@p2014 nvarchar(4000),@p2015 nvarchar(4000),@p2016 nvarchar(4000),@p2017 nvarchar(4000),@p2018 nvarchar(4000),@p2019 nvarchar(4000),@p2020 nvarchar(4000),@p2021 nvarchar(4000),@p2022 nvarchar(4000),@p2023 nvarchar(4000),@p2024 nvarchar(4000),@p2025 nvarchar(4000),@p2026 nvarchar(4000),@p2027 datetime2(7),@p2028 nvarchar(4000),@p2029 nvarchar(4000),@p2030 int,@p2031 int,@p2032 int,@p2033 nvarchar(4000),@p2034 nvarchar(4000),@p2035 nvarchar(4000),@p2036 decimal(18,2),@p2037 decimal(18,2),@p2038 nvarchar(4000),@p2039 nvarchar(4000),@p2040 decimal(18,2),@p2041 nvarchar(4000),@p2042 nvarchar(4000),@p2043 nvarchar(4000),@p2044 nvarchar(4000),@p2045 int,@p2046 nvarchar(4000),@p2047 nvarchar(4000),@p2048 nvarchar(4000),@p2049 nvarchar(4000),@p2050 nvarchar(4000),@p2051 nvarchar(4000),@p2052 nvarchar(4000),@p2053 nvarchar(4000),@p2054 nvarchar(4000),@p2055 nvarchar(4000),@p2056 int,@p2057 nvarchar(4000),@p2058 nvarchar(4000),@p2059 nvarchar(4000),@p2060 nvarchar(4000),@p2061 nvarchar(4000),@p2062 int,@p2063 nvarchar(4000),@p2064 int,@p2065 int,@p2066 datetime2(7),@p2067 datetime2(7),@p2068 datetime2(7),@p2069 nvarchar(4000),@p2070 nvarchar(4000),@p2071 nvarchar(4000))SET NOCOUNT ON; DECLARE @inserted0 TABLE ([item_id] int, [_Position] [int]); MERGE [raw_data] USING ( VALUES (@p0, @p1, @p2, @p3, @p4, @p5, @p6, @p7, @p8, @p9, @p10, @p11, @p12, @p13, @p14, @p15, @p16, @p17, @p18, @p19, @p20, @p21, @p22, @p23, @p24, @p25, @p26, @p27, @p28, @p29, @p30, @p31, @p32, @p33, @p34, @p35, @p36, @p37, @p38, @p39, @p40, @p41, @p42, @p43, @p44, @p45, @p46, @p47, @p48, @p49, @p50, @p51, @p52, @p53, @p54, @p55, 0), (@p56, @p57, @p58, @p59, @p60, @p61, @p62, @p63, @p64, @p65, @p66, @p67, @p68, @p69, @p70, @p71, @p72, @p73, @p74, @p75, @p76, @p77, @p78, @p79, @p80, @p81, @p82, @p83, @p84, @p85, @p86, @p87, @p88, @p89, @p90, @p91, @p92, @p93, @p94, @p95, @p96, @p97, @p98, @p99, @p100, @p101, @p102, @p103, @p104, @p105, @p106, @p107, @p108, @p109, @p110, @p111, 1), (@p112, @p113, @p114, @p115, @p116, @p117, @p118, @p119, @p120, @p121, @p122, @p123, @p124, @p125, @p126, @p127, @p128, @p129, @p130, @p131, @p132, @p133, @p134, @p135, @p136, @p137, @p138, @p139, @p140, @p141, @p142, @p143, @p144, @p145, @p146, @p147, @p148, @p149, @p150, @p151, @p152, @p153, @p154, @p155, @p156, @p157, @p158, @p159, @p160, @p161, @p162, @p163, @p164, @p165, @p166, @p167, 2), (@p168, @p169, @p170, @p171, @p172, @p173, @p174, @p175, @p176, @p177, @p178, @p179, @p180, @p181, @p182, @p183, @p184, @p185, @p186, @p187, @p188, @p189, @p190, @p191, @p192, @p193, @p194, @p195, @p196, @p197, @p198, @p199, @p200, @p201, @p202, @p203, @p204, @p205, @p206, @p207, @p208, @p209, @p210, @p211, @p212, @p213, @p214, @p215, @p216, @p217, @p218, @p219, @p220, @p221, @p222, @p223, 3), (@p224, @p225, @p226, @p227, @p228, @p229, @p230, @p231, @p232, @p233, @p234, @p235, @p236, @p237, @p238, @p239, @p240, @p241, @p242, @p243, @p244, @p245, @p246, @p247, @p248, @p249, @p250, @p251, @p252, @p253, @p254, @p255, @p256, @p257, @p258, @p259, @p260, @p261, @p262, @p263, @p264, @p265, @p266, @p267, @p268, @p269, @p270, @p271, @p272, @p273, @p274, @p275, @p276, @p277, @p278, @p279, 4), (@p280, @p281, @p282, @p283, @p284, @p285, @p286, @p287, @p288, @p289, @p290, @p291, @p292, @p293, @p294, @p295, @p296, @p297, @p298, @p299, @p300, @p301, @p302, @p303, @p304, @p305, @p306, @p307, @p308, @p309, @p310, @p311, @p312, @p313, @p314, @p315, @p316, @p317, @p318, @p319, @p320, @p321, @p322, @p323, @p324, @p325, @p326, @p327, @p328, @p329, @p330, @p331, @p332, @p333, @p334, @p335, 5), (@p336, @p337, @p338, @p339, @p340, @p341, @p342, @p343, @p344, @p345, @p346, @p347, @p348, @p349, @p350, @p351, @p352, @p353, @p354, @p355, @p356, @p357, @p358, @p359, @p360, @p361, @p362, @p363, @p364, @p365, @p366, @p367, @p368, @p369, @p370, @p371, @p372, @p373, @p374, @p375, @p376, @p377, @p378, @p379, @p380, @p381, @p382, @p383, @p384, @p385, @p386, @p387, @p388, @p389, @p390, @p391, 6), (@p392, @p393, @p394, @p395, @p396, @p397, @p398, @p399, @p400, @p401, @p402, @p403, @p404, @p405, @p406, @p407, @p408, @p409, @p410, @p411, @p412, @p413, @p414, @p415, @p416, @p417, @p418, @p419, @p420, @p421, @p422, @p423, @p424, @p425, @p426, @p427, @p428, @p429, @p430, @p431, @p432, @p433, @p434, @p435, @p436, @p437, @p438, @p439, @p440, @p441, @p442, @p443, @p444, @p445, @p446, @p447, 7), (@p448, @p449, @p450, @p451, @p452, @p453, @p454, @p455, @p456, @p457, @p458, @p459, @p460, @p461, @p462, @p463, @p464, @p465, @p466, @p467, @p468, @p469, @p470, @p471, @p472, @p473, @p474, @p475, @p476, @p477, @p478, @p479, @p480, @p481, @p482, @p483, @p484, @p485, @p486, @p487, @p488, @p489, @p490, @p491, @p492, @p493, @p494, @p495, @p496, @p497, @p498, @p499, @p500, @p501, @p502, @p503, 8), (@p504, @p505, @p506, @p507, @p508, @p509, @p510, @p511, @p512, @p513, @p514, @p515, @p516, @p517, @p518, @p519, @p520, @p521, @p522, @p523, @p524, @p525, @p526, @p527, @p528, @p529, @p530, @p531, @p532, @p533, @p534, @p535, @p536, @p537, @p538, @p539, @p540, @p541, @p542, @p543, @p544, @p545, @p546, @p547, @p548, @p549, @p550, @p551, @p552, @p553, @p554, @p555, @p556, @p557, @p558, @p559, 9), (@p560, @p561, @p562, @p563, @p564, @p565, @p566, @p567, @p568, @p569, @p570, @p571, @p572, @p573, @p574, @p575, @p576, @p577, @p578, @p579, @p580, @p581, @p582, @p583, @p584, @p585, @p586, @p587, @p588, @p589, @p590, @p591, @p592, @p593, @p594, @p595, @p596, @p597, @p598, @p599, @p600, @p601, @p602, @p603, @p604, @p605, @p606, @p607, @p608, @p609, @p610, @p611, @p612, @p613, @p614, @p615, 10), (@p616, @p617, @p618, @p619, @p620, @p621, @p622, @p623, @p624, @p625, @p626, @p627, @p628, @p629, @p630, @p631, @p632, @p633, @p634, @p635, @p636, @p637, @p638, @p639, @p640, @p641, @p642, @p643, @p644, @p645, @p646, @p647, @p648, @p649, @p650, @p651, @p652, @p653, @p654, @p655, @p656, @p657, @p658, @p659, @p660, @p661, @p662, @p663, @p664, @p665, @p666, @p667, @p668, @p669, @p670, @p671, 11), (@p672, @p673, @p674, @p675, @p676, @p677, @p678, @p679, @p680, @p681, @p682, @p683, @p684, @p685, @p686, @p687, @p688, @p689, @p690, @p691, @p692, @p693, @p694, @p695, @p696, @p697, @p698, @p699, @p700, @p701, @p702, @p703, @p704, @p705, @p706, @p707, @p708, @p709, @p710, @p711, @p712, @p713, @p714, @p715, @p716, @p717, @p718, @p719, @p720, @p721, @p722, @p723, @p724, @p725, @p726, @p727, 12), (@p728, @p729, @p730, @p731, @p732, @p733, @p734, @p735, @p736, @p737, @p738, @p739, @p740, @p741, @p742, @p743, @p744, @p745, @p746, @p747, @p748, @p749, @p750, @p751, @p752, @p753, @p754, @p755, @p756, @p757, @p758, @p759, @p760, @p761, @p762, @p763, @p764, @p765, @p766, @p767, @p768, @p769, @p770, @p771, @p772, @p773, @p774, @p775, @p776, @p777, @p778, @p779, @p780, @p781, @p782, @p783, 13), (@p784, @p785, @p786, @p787, @p788, @p789, @p790, @p791, @p792, @p793, @p794, @p795, @p796, @p797, @p798, @p799, @p800, @p801, @p802, @p803, @p804, @p805, @p806, @p807, @p808, @p809, @p810, @p811, @p812, @p813, @p814, @p815, @p816, @p817, @p818, @p819, @p820, @p821, @p822, @p823, @p824, @p825, @p826, @p827, @p828, @p829, @p830, @p831, @p832, @p833, @p834, @p835, @p836, @p837, @p838, @p839, 14), (@p840, @p841, @p842, @p843, @p844, @p845, @p846, @p847, @p848, @p849, @p850, @p851, @p852, @p853, @p854, @p855, @p856, @p857, @p858, @p859, @p860, @p861, @p862, @p863, @p864, @p865, @p866, @p867, @p868, @p869, @p870, @p871, @p872, @p873, @p874, @p875, @p876, @p877, @p878, @p879, @p880, @p881, @p882, @p883, @p884, @p885, @p886, @p887, @p888, @p889, @p890, @p891, @p892, @p893, @p894, @p895, 15), (@p896, @p897, @p898, @p899, @p900, @p901, @p902, @p903, @p904, @p905, @p906, @p907, @p908, @p909, @p910, @p911, @p912, @p913, @p914, @p915, @p916, @p917, @p918, @p919, @p920, @p921, @p922, @p923, @p924, @p925, @p926, @p927, @p928, @p929, @p930, @p931, @p932, @p933, @p934, @p935, @p936, @p937, @p938, @p939, @p940, @p941, @p942, @p943, @p944, @p945, @p946, @p947, @p948, @p949, @p950, @p951, 16), (@p952, @p953, @p954, @p955, @p956, @p957, @p958, @p959, @p960, @p961, @p962, @p963, @p964, @p965, @p966, @p967, @p968, @p969, @p970, @p971, @p972, @p973, @p974, @p975, @p976, @p977, @p978, @p979, @p980, @p981, @p982, @p983, @p984, @p985, @p986, @p987, @p988, @p989, @p990, @p991, @p992, @p993, @p994, @p995, @p996, @p997, @p998, @p999, @p1000, @p1001, @p1002, @p1003, @p1004, @p1005, @p1006, @p1007, 17), (@p1008, @p1009, @p1010, @p1011, @p1012, @p1013, @p1014, @p1015, @p1016, @p1017, @p1018, @p1019, @p1020, @p1021, @p1022, @p1023, @p1024, @p1025, @p1026, @p1027, @p1028, @p1029, @p1030, @p1031, @p1032, @p1033, @p1034, @p1035, @p1036, @p1037, @p1038, @p1039, @p1040, @p1041, @p1042, @p1043, @p1044, @p1045, @p1046, @p1047, @p1048, @p1049, @p1050, @p1051, @p1052, @p1053, @p1054, @p1055, @p1056, @p1057, @p1058, @p1059, @p1060, @p1061, @p1062, @p1063, 18), (@p1064, @p1065, @p1066, @p1067, @p1068, @p1069, @p1070, @p1071, @p1072, @p1073, @p1074, @p1075, @p1076, @p1077, @p1078, @p1079, @p1080, @p1081, @p1082, @p1083, @p1084, @p1085, @p1086, @p1087, @p1088, @p1089, @p1090, @p1091, @p1092, @p1093, @p1094, @p1095, @p1096, @p1097, @p1098, @p1099, @p1100, @p1101, @p1102, @p1103, @p1104, @p1105, @p1106, @p1107, @p1108, @p1109, @p1110, @p1111, @p1112, @p1113, @p1114, @p1115, @p1116, @p1117, @p1118, @p1119, 19), (@p1120, @p1121, @p1122, @p1123, @p1124, @p1125, @p1126, @p1127, @p1128, @p1129, @p1130, @p1131, @p1132, @p1133, @p1134, @p1135, @p1136, @p1137, @p1138, @p1139, @p1140, @p1141, @p1142, @p1143, @p1144, @p1145, @p1146, @p1147, @p1148, @p1149, @p1150, @p1151, @p1152, @p1153, @p1154, @p1155, @p1156, @p1157, @p1158, @p1159, @p1160, @p1161, @p1162, @p1163, @p1164, @p1165, @p1166, @p1167, @p1168, @p1169, @p1170, @p1171, @p1172, @p1173, @p1174, @p1175, 20), (@p1176, @p1177, @p1178, @p1179, @p1180, @p1181, @p1182, @p1183, @p1184, @p1185, @p1186, @p1187, @p1188, @p1189, @p1190, @p1191, @p1192, @p1193, @p1194, @p1195, @p1196, @p1197, @p1198, @p1199, @p1200, @p1201, @p1202, @p1203, @p1204, @p1205, @p1206, @p1207, @p1208, @p1209, @p1210, @p1211, @p1212, @p1213, @p1214, @p1215, @p1216, @p1217, @p1218, @p1219, @p1220, @p1221, @p1222, @p1223, @p1224, @p1225, @p1226, @p1227, @p1228, @p1229, @p1230, @p1231, 21), (@p1232, @p1233, @p1234, @p1235, @p1236, @p1237, @p1238, @p1239, @p1240, @p1241, @p1242, @p1243, @p1244, @p1245, @p1246, @p1247, @p1248, @p1249, @p1250, @p1251, @p1252, @p1253, @p1254, @p1255, @p1256, @p1257, @p1258, @p1259, @p1260, @p1261, @p1262, @p1263, @p1264, @p1265, @p1266, @p1267, @p1268, @p1269, @p1270, @p1271, @p1272, @p1273, @p1274, @p1275, @p1276, @p1277, @p1278, @p1279, @p1280, @p1281, @p1282, @p1283, @p1284, @p1285, @p1286, @p1287, 22), (@p1288, @p1289, @p1290, @p1291, @p1292, @p1293, @p1294, @p1295, @p1296, @p1297, @p1298, @p1299, @p1300, @p1301, @p1302, @p1303, @p1304, @p1305, @p1306, @p1307, @p1308, @p1309, @p1310, @p1311, @p1312, @p1313, @p1314, @p1315, @p1316, @p1317, @p1318, @p1319, @p1320, @p1321, @p1322, @p1323, @p1324, @p1325, @p1326, @p1327, @p1328, @p1329, @p1330, @p1331, @p1332, @p1333, @p1334, @p1335, @p1336, @p1337, @p1338, @p1339, @p1340, @p1341, @p1342, @p1343, 23), (@p1344, @p1345, @p1346, @p1347, @p1348, @p1349, @p1350, @p1351, @p1352, @p1353, @p1354, @p1355, @p1356, @p1357, @p1358, @p1359, @p1360, @p1361, @p1362, @p1363, @p1364, @p1365, @p1366, @p1367, @p1368, @p1369, @p1370, @p1371, @p1372, @p1373, @p1374, @p1375, @p1376, @p1377, @p1378, @p1379, @p1380, @p1381, @p1382, @p1383, @p1384, @p1385, @p1386, @p1387, @p1388, @p1389, @p1390, @p1391, @p1392, @p1393, @p1394, @p1395, @p1396, @p1397, @p1398, @p1399, 24), (@p1400, @p1401, @p1402, @p1403, @p1404, @p1405, @p1406, @p1407, @p1408, @p1409, @p1410, @p1411, @p1412, @p1413, @p1414, @p1415, @p1416, @p1417, @p1418, @p1419, @p1420, @p1421, @p1422, @p1423, @p1424, @p1425, @p1426, @p1427, @p1428, @p1429, @p1430, @p1431, @p1432, @p1433, @p1434, @p1435, @p1436, @p1437, @p1438, @p1439, @p1440, @p1441, @p1442, @p1443, @p1444, @p1445, @p1446, @p1447, @p1448, @p1449, @p1450, @p1451, @p1452, @p1453, @p1454, @p1455, 25), (@p1456, @p1457, @p1458, @p1459, @p1460, @p1461, @p1462, @p1463, @p1464, @p1465, @p1466, @p1467, @p1468, @p1469, @p1470, @p1471, @p1472, @p1473, @p1474, @p1475, @p1476, @p1477, @p1478, @p1479, @p1480, @p1481, @p1482, @p1483, @p1484, @p1485, @p1486, @p1487, @p1488, @p1489, @p1490, @p1491, @p1492, @p1493, @p1494, @p1495, @p1496, @p1497, @p1498, @p1499, @p1500, @p1501, @p1502, @p1503, @p1504, @p1505, @p1506, @p1507, @p1508, @p1509, @p1510, @p1511, 26), (@p1512, @p1513, @p1514, @p1515, @p1516, @p1517, @p1518, @p1519, @p1520, @p1521, @p1522, @p1523, @p1524, @p1525, @p1526, @p1527, @p1528, @p1529, @p1530, @p1531, @p1532, @p1533, @p1534, @p1535, @p1536, @p1537, @p1538, @p1539, @p1540, @p1541, @p1542, @p1543, @p1544, @p1545, @p1546, @p1547, @p1548, @p1549, @p1550, @p1551, @p1552, @p1553, @p1554, @p1555, @p1556, @p1557, @p1558, @p1559, @p1560, @p1561, @p1562, @p1563, @p1564, @p1565, @p1566, @p1567, 27), (@p1568, @p1569, @p1570, @p1571, @p1572, @p1573, @p1574, @p1575, @p1576, @p1577, @p1578, @p1579, @p1580, @p1581, @p1582, @p1583, @p1584, @p1585, @p1586, @p1587, @p1588, @p1589, @p1590, @p1591, @p1592, @p1593, @p1594, @p1595, @p1596, @p1597, @p1598, @p1599, @p1600, @p1601, @p1602, @p1603, @p1604, @p1605, @p1606, @p1607, @p1608, @p1609, @p1610, @p1611, @p1612, @p1613, @p1614, @p1615, @p1616, @p1617, @p1618, @p1619, @p1620, @p1621, @p1622, @p1623, 28), (@p1624, @p1625, @p1626, @p1627, @p1628, @p1629, @p1630, @p1631, @p1632, @p1633, @p1634, @p1635, @p1636, @p1637, @p1638, @p1639, @p1640, @p1641, @p1642, @p1643, @p1644, @p1645, @p1646, @p1647, @p1648, @p1649, @p1650, @p1651, @p1652, @p1653, @p1654, @p1655, @p1656, @p1657, @p1658, @p1659, @p1660, @p1661, @p1662, @p1663, @p1664, @p1665, @p1666, @p1667, @p1668, @p1669, @p1670, @p1671, @p1672, @p1673, @p1674, @p1675, @p1676, @p1677, @p1678, @p1679, 29), (@p1680, @p1681, @p1682, @p1683, @p1684, @p1685, @p1686, @p1687, @p1688, @p1689, @p1690, @p1691, @p1692, @p1693, @p1694, @p1695, @p1696, @p1697, @p1698, @p1699, @p1700, @p1701, @p1702, @p1703, @p1704, @p1705, @p1706, @p1707, @p1708, @p1709, @p1710, @p1711, @p1712, @p1713, @p1714, @p1715, @p1716, @p1717, @p1718, @p1719, @p1720, @p1721, @p1722, @p1723, @p1724, @p1725, @p1726, @p1727, @p1728, @p1729, @p1730, @p1731, @p1732, @p1733, @p1734, @p1735, 30), (@p1736, @p1737, @p1738, @p1739, @p1740, @p1741, @p1742, @p1743, @p1744, @p1745, @p1746, @p1747, @p1748, @p1749, @p1750, @p1751, @p1752, @p1753, @p1754, @p1755, @p1756, @p1757, @p1758, @p1759, @p1760, @p1761, @p1762, @p1763, @p1764, @p1765, @p1766, @p1767, @p1768, @p1769, @p1770, @p1771, @p1772, @p1773, @p1774, @p1775, @p1776, @p1777, @p1778, @p1779, @p1780, @p1781, @p1782, @p1783, @p1784, @p1785, @p1786, @p1787, @p1788, @p1789, @p1790, @p1791, 31), (@p1792, @p1793, @p1794, @p1795, @p1796, @p1797, @p1798, @p1799, @p1800, @p1801, @p1802, @p1803, @p1804, @p1805, @p1806, @p1807, @p1808, @p1809, @p1810, @p1811, @p1812, @p1813, @p1814, @p1815, @p1816, @p1817, @p1818, @p1819, @p1820, @p1821, @p1822, @p1823, @p1824, @p1825, @p1826, @p1827, @p1828, @p1829, @p1830, @p1831, @p1832, @p1833, @p1834, @p1835, @p1836, @p1837, @p1838, @p1839, @p1840, @p1841, @p1842, @p1843, @p1844, @p1845, @p1846, @p1847, 32), (@p1848, @p1849, @p1850, @p1851, @p1852, @p1853, @p1854, @p1855, @p1856, @p1857, @p1858, @p1859, @p1860, @p1861, @p1862, @p1863, @p1864, @p1865, @p1866, @p1867, @p1868, @p1869, @p1870, @p1871, @p1872, @p1873, @p1874, @p1875, @p1876, @p1877, @p1878, @p1879, @p1880, @p1881, @p1882, @p1883, @p1884, @p1885, @p1886, @p1887, @p1888, @p1889, @p1890, @p1891, @p1892, @p1893, @p1894, @p1895, @p1896, @p1897, @p1898, @p1899, @p1900, @p1901, @p1902, @p1903, 33), (@p1904, @p1905, @p1906, @p1907, @p1908, @p1909, @p1910, @p1911, @p1912, @p1913, @p1914, @p1915, @p1916, @p1917, @p1918, @p1919, @p1920, @p1921, @p1922, @p1923, @p1924, @p1925, @p1926, @p1927, @p1928, @p1929, @p1930, @p1931, @p1932, @p1933, @p1934, @p1935, @p1936, @p1937, @p1938, @p1939, @p1940, @p1941, @p1942, @p1943, @p1944, @p1945, @p1946, @p1947, @p1948, @p1949, @p1950, @p1951, @p1952, @p1953, @p1954, @p1955, @p1956, @p1957, @p1958, @p1959, 34), (@p1960, @p1961, @p1962, @p1963, @p1964, @p1965, @p1966, @p1967, @p1968, @p1969, @p1970, @p1971, @p1972, @p1973, @p1974, @p1975, @p1976, @p1977, @p1978, @p1979, @p1980, @p1981, @p1982, @p1983, @p1984, @p1985, @p1986, @p1987, @p1988, @p1989, @p1990, @p1991, @p1992, @p1993, @p1994, @p1995, @p1996, @p1997, @p1998, @p1999, @p2000, @p2001, @p2002, @p2003, @p2004, @p2005, @p2006, @p2007, @p2008, @p2009, @p2010, @p2011, @p2012, @p2013, @p2014, @p2015, 35), (@p2016, @p2017, @p2018, @p2019, @p2020, @p2021, @p2022, @p2023, @p2024, @p2025, @p2026, @p2027, @p2028, @p2029, @p2030, @p2031, @p2032, @p2033, @p2034, @p2035, @p2036, @p2037, @p2038, @p2039, @p2040, @p2041, @p2042, @p2043, @p2044, @p2045, @p2046, @p2047, @p2048, @p2049, @p2050, @p2051, @p2052, @p2053, @p2054, @p2055, @p2056, @p2057, @p2058, @p2059, @p2060, @p2061, @p2062, @p2063, @p2064, @p2065, @p2066, @p2067, @p2068, @p2069, @p2070, @p2071, 36)) AS i ([addressee_cntry_cd], [addressee_city], [addressee_district], [addressee_email], [addressee_full_address], [addressee_home_address], [addressee_name], [addressee_postcode], [addressee_province], [addressee_subdistrict], [addressee_tel], [create_table], [delivery_code], [delivery_recipient_name], [delivery_relation_id], [delivery_status_id], [dest_outlet_id], [dest_outlet_port], [document_number], [item_barcode], [item_cod], [item_gross_weight], [item_height], [item_length], [item_price], [item_width], [lat], [log_id], [long], [outlet_id], [outlet_port], [podUrl], [remark], [scan_cntry_cd], [scan_cntry_postcode], [sender_cntry_cd], [sender_district], [sender_email], [sender_full_address], [sender_home_address], [member_id], [sender_name], [sender_postcode], [sender_province], [sender_subdistrict], [sender_tel], [server_id], [signatureUrl], [state], [status_code], [status_dtm], [timestamp], [transmit_dtm], [user_id], [wckt_id], [wkstn_no], _Position) ON 1=0 WHEN NOT MATCHED THEN INSERT ([addressee_cntry_cd], [addressee_city], [addressee_district], [addressee_email], [addressee_full_address], [addressee_home_address], [addressee_name], [addressee_postcode], [addressee_province], [addressee_subdistrict], [addressee_tel], [create_table], [delivery_code], [delivery_recipient_name], [delivery_relation_id], [delivery_status_id], [dest_outlet_id], [dest_outlet_port], [document_number], [item_barcode], [item_cod], [item_gross_weight], [item_height], [item_length], [item_price], [item_width], [lat], [log_id], [long], [outlet_id], [outlet_port], [podUrl], [remark], [scan_cntry_cd], [scan_cntry_postcode], [sender_cntry_cd], [sender_district], [sender_email], [sender_full_address], [sender_home_address], [member_id], [sender_name], [sender_postcode], [sender_province], [sender_subdistrict], [sender_tel], [server_id], [signatureUrl], [state], [status_code], [status_dtm], [timestamp], [transmit_dtm], [user_id], [wckt_id], [wkstn_no]) VALUES (i.[addressee_cntry_cd], i.[addressee_city], i.[addressee_district], i.[addressee_email], i.[addressee_full_address], i.[addressee_home_address], i.[addressee_name], i.[addressee_postcode], i.[addressee_province], i.[addressee_subdistrict], i.[addressee_tel], i.[create_table], i.[delivery_code], i.[delivery_recipient_name], i.[delivery_relation_id], i.[delivery_status_id], i.[dest_outlet_id], i.[dest_outlet_port], i.[document_number], i.[item_barcode], i.[item_cod], i.[item_gross_weight], i.[item_height], i.[item_length], i.[item_price], i.[item_width], i.[lat], i.[log_id], i.[long], i.[outlet_id], i.[outlet_port], i.[podUrl], i.[remark], i.[scan_cntry_cd], i.[scan_cntry_postcode], i.[sender_cntry_cd], i.[sender_district], i.[sender_email], i.[sender_full_address], i.[sender_home_address], i.[member_id], i.[sender_name], i.[sender_postcode], i.[sender_province], i.[sender_subdistrict], i.[sender_tel], i.[server_id], i.[signatureUrl], i.[state], i.[status_code], i.[status_dtm], i.[timestamp], i.[transmit_dtm], i.[user_id], i.[wckt_id], i.[wkstn_no]) OUTPUT INSERTED.[item_id], i._Position INTO @inserted0;  SELECT [t].[item_id] FROM [raw_data] t INNER JOIN @inserted0 i ON ([t].[item_id] = [i].[item_id]) ORDER BY [i].[_Position];  ",4,4,0,436,5,4
"(@p0 nvarchar(4000),@p1 nvarchar(4000),@p2 nvarchar(4000),@p3 nvarchar(4000),@p4 nvarchar(4000),@p5 nvarchar(4000),@p6 nvarchar(4000),@p7 nvarchar(4000),@p8 nvarchar(4000),@p9 nvarchar(4000),@p10 nvarchar(4000),@p11 datetime2(7),@p12 nvarchar(4000),@p13 nvarchar(4000),@p14 int,@p15 int,@p16 int,@p17 nvarchar(4000),@p18 nvarchar(4000),@p19 nvarchar(4000),@p20 decimal(18,2),@p21 decimal(18,2),@p22 nvarchar(4000),@p23 nvarchar(4000),@p24 decimal(18,2),@p25 nvarchar(4000),@p26 nvarchar(4000),@p27 nvarchar(4000),@p28 nvarchar(4000),@p29 int,@p30 nvarchar(4000),@p31 nvarchar(4000),@p32 nvarchar(4000),@p33 nvarchar(4000),@p34 nvarchar(4000),@p35 nvarchar(4000),@p36 nvarchar(4000),@p37 nvarchar(4000),@p38 nvarchar(4000),@p39 nvarchar(4000),@p40 int,@p41 nvarchar(4000),@p42 nvarchar(4000),@p43 nvarchar(4000),@p44 nvarchar(4000),@p45 nvarchar(4000),@p46 int,@p47 nvarchar(4000),@p48 int,@p49 int,@p50 datetime2(7),@p51 datetime2(7),@p52 datetime2(7),@p53 nvarchar(4000),@p54 nvarchar(4000),@p55 nvarchar(4000),@p56 nvarchar(4000),@p57 nvarchar(4000),@p58 nvarchar(4000),@p59 nvarchar(4000),@p60 nvarchar(4000),@p61 nvarchar(4000),@p62 nvarchar(4000),@p63 nvarchar(4000),@p64 nvarchar(4000),@p65 nvarchar(4000),@p66 nvarchar(4000),@p67 datetime2(7),@p68 nvarchar(4000),@p69 nvarchar(4000),@p70 int,@p71 int,@p72 int,@p73 nvarchar(4000),@p74 nvarchar(4000),@p75 nvarchar(4000),@p76 decimal(18,2),@p77 decimal(18,2),@p78 nvarchar(4000),@p79 nvarchar(4000),@p80 decimal(18,2),@p81 nvarchar(4000),@p82 nvarchar(4000),@p83 nvarchar(4000),@p84 nvarchar(4000),@p85 int,@p86 nvarchar(4000),@p87 nvarchar(4000),@p88 nvarchar(4000),@p89 nvarchar(4000),@p90 nvarchar(4000),@p91 nvarchar(4000),@p92 nvarchar(4000),@p93 nvarchar(4000),@p94 nvarchar(4000),@p95 nvarchar(4000),@p96 int,@p97 nvarchar(4000),@p98 nvarchar(4000),@p99 nvarchar(4000),@p100 nvarchar(4000),@p101 nvarchar(4000),@p102 int,@p103 nvarchar(4000),@p104 int,@p105 int,@p106 datetime2(7),@p107 datetime2(7),@p108 datetime2(7),@p109 nvarchar(4000),@p110 nvarchar(4000),@p111 nvarchar(4000),@p112 nvarchar(4000),@p113 nvarchar(4000),@p114 nvarchar(4000),@p115 nvarchar(4000),@p116 nvarchar(4000),@p117 nvarchar(4000),@p118 nvarchar(4000),@p119 nvarchar(4000),@p120 nvarchar(4000),@p121 nvarchar(4000),@p122 nvarchar(4000),@p123 datetime2(7),@p124 nvarchar(4000),@p125 nvarchar(4000),@p126 int,@p127 int,@p128 int,@p129 nvarchar(4000),@p130 nvarchar(4000),@p131 nvarchar(4000),@p132 decimal(18,2),@p133 decimal(18,2),@p134 nvarchar(4000),@p135 nvarchar(4000),@p136 decimal(18,2),@p137 nvarchar(4000),@p138 nvarchar(4000),@p139 nvarchar(4000),@p140 nvarchar(4000),@p141 int,@p142 nvarchar(4000),@p143 nvarchar(4000),@p144 nvarchar(4000),@p145 nvarchar(4000),@p146 nvarchar(4000),@p147 nvarchar(4000),@p148 nvarchar(4000),@p149 nvarchar(4000),@p150 nvarchar(4000),@p151 nvarchar(4000),@p152 int,@p153 nvarchar(4000),@p154 nvarchar(4000),@p155 nvarchar(4000),@p156 nvarchar(4000),@p157 nvarchar(4000),@p158 int,@p159 nvarchar(4000),@p160 int,@p161 int,@p162 datetime2(7),@p163 datetime2(7),@p164 datetime2(7),@p165 nvarchar(4000),@p166 nvarchar(4000),@p167 nvarchar(4000),@p168 nvarchar(4000),@p169 nvarchar(4000),@p170 nvarchar(4000),@p171 nvarchar(4000),@p172 nvarchar(4000),@p173 nvarchar(4000),@p174 nvarchar(4000),@p175 nvarchar(4000),@p176 nvarchar(4000),@p177 nvarchar(4000),@p178 nvarchar(4000),@p179 datetime2(7),@p180 nvarchar(4000),@p181 nvarchar(4000),@p182 int,@p183 int,@p184 int,@p185 nvarchar(4000),@p186 nvarchar(4000),@p187 nvarchar(4000),@p188 decimal(18,2),@p189 decimal(18,2),@p190 nvarchar(4000),@p191 nvarchar(4000),@p192 decimal(18,2),@p193 nvarchar(4000),@p194 nvarchar(4000),@p195 nvarchar(4000),@p196 nvarchar(4000),@p197 int,@p198 nvarchar(4000),@p199 nvarchar(4000),@p200 nvarchar(4000),@p201 nvarchar(4000),@p202 nvarchar(4000),@p203 nvarchar(4000),@p204 nvarchar(4000),@p205 nvarchar(4000),@p206 nvarchar(4000),@p207 nvarchar(4000),@p208 int,@p209 nvarchar(4000),@p210 nvarchar(4000),@p211 nvarchar(4000),@p212 nvarchar(4000),@p213 nvarchar(4000),@p214 int,@p215 nvarchar(4000),@p216 int,@p217 int,@p218 datetime2(7),@p219 datetime2(7),@p220 datetime2(7),@p221 nvarchar(4000),@p222 nvarchar(4000),@p223 nvarchar(4000),@p224 nvarchar(4000),@p225 nvarchar(4000),@p226 nvarchar(4000),@p227 nvarchar(4000),@p228 nvarchar(4000),@p229 nvarchar(4000),@p230 nvarchar(4000),@p231 nvarchar(4000),@p232 nvarchar(4000),@p233 nvarchar(4000),@p234 nvarchar(4000),@p235 datetime2(7),@p236 nvarchar(4000),@p237 nvarchar(4000),@p238 int,@p239 int,@p240 int,@p241 nvarchar(4000),@p242 nvarchar(4000),@p243 nvarchar(4000),@p244 decimal(18,2),@p245 decimal(18,2),@p246 nvarchar(4000),@p247 nvarchar(4000),@p248 decimal(18,2),@p249 nvarchar(4000),@p250 nvarchar(4000),@p251 nvarchar(4000),@p252 nvarchar(4000),@p253 int,@p254 nvarchar(4000),@p255 nvarchar(4000),@p256 nvarchar(4000),@p257 nvarchar(4000),@p258 nvarchar(4000),@p259 nvarchar(4000),@p260 nvarchar(4000),@p261 nvarchar(4000),@p262 nvarchar(4000),@p263 nvarchar(4000),@p264 int,@p265 nvarchar(4000),@p266 nvarchar(4000),@p267 nvarchar(4000),@p268 nvarchar(4000),@p269 nvarchar(4000),@p270 int,@p271 nvarchar(4000),@p272 int,@p273 int,@p274 datetime2(7),@p275 datetime2(7),@p276 datetime2(7),@p277 nvarchar(4000),@p278 nvarchar(4000),@p279 nvarchar(4000),@p280 nvarchar(4000),@p281 nvarchar(4000),@p282 nvarchar(4000),@p283 nvarchar(4000),@p284 nvarchar(4000),@p285 nvarchar(4000),@p286 nvarchar(4000),@p287 nvarchar(4000),@p288 nvarchar(4000),@p289 nvarchar(4000),@p290 nvarchar(4000),@p291 datetime2(7),@p292 nvarchar(4000),@p293 nvarchar(4000),@p294 int,@p295 int,@p296 int,@p297 nvarchar(4000),@p298 nvarchar(4000),@p299 nvarchar(4000),@p300 decimal(18,2),@p301 decimal(18,2),@p302 nvarchar(4000),@p303 nvarchar(4000),@p304 decimal(18,2),@p305 nvarchar(4000),@p306 nvarchar(4000),@p307 nvarchar(4000),@p308 nvarchar(4000),@p309 int,@p310 nvarchar(4000),@p311 nvarchar(4000),@p312 nvarchar(4000),@p313 nvarchar(4000),@p314 nvarchar(4000),@p315 nvarchar(4000),@p316 nvarchar(4000),@p317 nvarchar(4000),@p318 nvarchar(4000),@p319 nvarchar(4000),@p320 int,@p321 nvarchar(4000),@p322 nvarchar(4000),@p323 nvarchar(4000),@p324 nvarchar(4000),@p325 nvarchar(4000),@p326 int,@p327 nvarchar(4000),@p328 int,@p329 int,@p330 datetime2(7),@p331 datetime2(7),@p332 datetime2(7),@p333 nvarchar(4000),@p334 nvarchar(4000),@p335 nvarchar(4000),@p336 nvarchar(4000),@p337 nvarchar(4000),@p338 nvarchar(4000),@p339 nvarchar(4000),@p340 nvarchar(4000),@p341 nvarchar(4000),@p342 nvarchar(4000),@p343 nvarchar(4000),@p344 nvarchar(4000),@p345 nvarchar(4000),@p346 nvarchar(4000),@p347 datetime2(7),@p348 nvarchar(4000),@p349 nvarchar(4000),@p350 int,@p351 int,@p352 int,@p353 nvarchar(4000),@p354 nvarchar(4000),@p355 nvarchar(4000),@p356 decimal(18,2),@p357 decimal(18,2),@p358 nvarchar(4000),@p359 nvarchar(4000),@p360 decimal(18,2),@p361 nvarchar(4000),@p362 nvarchar(4000),@p363 nvarchar(4000),@p364 nvarchar(4000),@p365 int,@p366 nvarchar(4000),@p367 nvarchar(4000),@p368 nvarchar(4000),@p369 nvarchar(4000),@p370 nvarchar(4000),@p371 nvarchar(4000),@p372 nvarchar(4000),@p373 nvarchar(4000),@p374 nvarchar(4000),@p375 nvarchar(4000),@p376 int,@p377 nvarchar(4000),@p378 nvarchar(4000),@p379 nvarchar(4000),@p380 nvarchar(4000),@p381 nvarchar(4000),@p382 int,@p383 nvarchar(4000),@p384 int,@p385 int,@p386 datetime2(7),@p387 datetime2(7),@p388 datetime2(7),@p389 nvarchar(4000),@p390 nvarchar(4000),@p391 nvarchar(4000),@p392 nvarchar(4000),@p393 nvarchar(4000),@p394 nvarchar(4000),@p395 nvarchar(4000),@p396 nvarchar(4000),@p397 nvarchar(4000),@p398 nvarchar(4000),@p399 nvarchar(4000),@p400 nvarchar(4000),@p401 nvarchar(4000),@p402 nvarchar(4000),@p403 datetime2(7),@p404 nvarchar(4000),@p405 nvarchar(4000),@p406 int,@p407 int,@p408 int,@p409 nvarchar(4000),@p410 nvarchar(4000),@p411 nvarchar(4000),@p412 decimal(18,2),@p413 decimal(18,2),@p414 nvarchar(4000),@p415 nvarchar(4000),@p416 decimal(18,2),@p417 nvarchar(4000),@p418 nvarchar(4000),@p419 nvarchar(4000),@p420 nvarchar(4000),@p421 int,@p422 nvarchar(4000),@p423 nvarchar(4000),@p424 nvarchar(4000),@p425 nvarchar(4000),@p426 nvarchar(4000),@p427 nvarchar(4000),@p428 nvarchar(4000),@p429 nvarchar(4000),@p430 nvarchar(4000),@p431 nvarchar(4000),@p432 int,@p433 nvarchar(4000),@p434 nvarchar(4000),@p435 nvarchar(4000),@p436 nvarchar(4000),@p437 nvarchar(4000),@p438 int,@p439 nvarchar(4000),@p440 int,@p441 int,@p442 datetime2(7),@p443 datetime2(7),@p444 datetime2(7),@p445 nvarchar(4000),@p446 nvarchar(4000),@p447 nvarchar(4000),@p448 nvarchar(4000),@p449 nvarchar(4000),@p450 nvarchar(4000),@p451 nvarchar(4000),@p452 nvarchar(4000),@p453 nvarchar(4000),@p454 nvarchar(4000),@p455 nvarchar(4000),@p456 nvarchar(4000),@p457 nvarchar(4000),@p458 nvarchar(4000),@p459 datetime2(7),@p460 nvarchar(4000),@p461 nvarchar(4000),@p462 int,@p463 int,@p464 int,@p465 nvarchar(4000),@p466 nvarchar(4000),@p467 nvarchar(4000),@p468 decimal(18,2),@p469 decimal(18,2),@p470 nvarchar(4000),@p471 nvarchar(4000),@p472 decimal(18,2),@p473 nvarchar(4000),@p474 nvarchar(4000),@p475 nvarchar(4000),@p476 nvarchar(4000),@p477 int,@p478 nvarchar(4000),@p479 nvarchar(4000),@p480 nvarchar(4000),@p481 nvarchar(4000),@p482 nvarchar(4000),@p483 nvarchar(4000),@p484 nvarchar(4000),@p485 nvarchar(4000),@p486 nvarchar(4000),@p487 nvarchar(4000),@p488 int,@p489 nvarchar(4000),@p490 nvarchar(4000),@p491 nvarchar(4000),@p492 nvarchar(4000),@p493 nvarchar(4000),@p494 int,@p495 nvarchar(4000),@p496 int,@p497 int,@p498 datetime2(7),@p499 datetime2(7),@p500 datetime2(7),@p501 nvarchar(4000),@p502 nvarchar(4000),@p503 nvarchar(4000),@p504 nvarchar(4000),@p505 nvarchar(4000),@p506 nvarchar(4000),@p507 nvarchar(4000),@p508 nvarchar(4000),@p509 nvarchar(4000),@p510 nvarchar(4000),@p511 nvarchar(4000),@p512 nvarchar(4000),@p513 nvarchar(4000),@p514 nvarchar(4000),@p515 datetime2(7),@p516 nvarchar(4000),@p517 nvarchar(4000),@p518 int,@p519 int,@p520 int,@p521 nvarchar(4000),@p522 nvarchar(4000),@p523 nvarchar(4000),@p524 decimal(18,2),@p525 decimal(18,2),@p526 nvarchar(4000),@p527 nvarchar(4000),@p528 decimal(18,2),@p529 nvarchar(4000),@p530 nvarchar(4000),@p531 nvarchar(4000),@p532 nvarchar(4000),@p533 int,@p534 nvarchar(4000),@p535 nvarchar(4000),@p536 nvarchar(4000),@p537 nvarchar(4000),@p538 nvarchar(4000),@p539 nvarchar(4000),@p540 nvarchar(4000),@p541 nvarchar(4000),@p542 nvarchar(4000),@p543 nvarchar(4000),@p544 int,@p545 nvarchar(4000),@p546 nvarchar(4000),@p547 nvarchar(4000),@p548 nvarchar(4000),@p549 nvarchar(4000),@p550 int,@p551 nvarchar(4000),@p552 int,@p553 int,@p554 datetime2(7),@p555 datetime2(7),@p556 datetime2(7),@p557 nvarchar(4000),@p558 nvarchar(4000),@p559 nvarchar(4000),@p560 nvarchar(4000),@p561 nvarchar(4000),@p562 nvarchar(4000),@p563 nvarchar(4000),@p564 nvarchar(4000),@p565 nvarchar(4000),@p566 nvarchar(4000),@p567 nvarchar(4000),@p568 nvarchar(4000),@p569 nvarchar(4000),@p570 nvarchar(4000),@p571 datetime2(7),@p572 nvarchar(4000),@p573 nvarchar(4000),@p574 int,@p575 int,@p576 int,@p577 nvarchar(4000),@p578 nvarchar(4000),@p579 nvarchar(4000),@p580 decimal(18,2),@p581 decimal(18,2),@p582 nvarchar(4000),@p583 nvarchar(4000),@p584 decimal(18,2),@p585 nvarchar(4000),@p586 nvarchar(4000),@p587 nvarchar(4000),@p588 nvarchar(4000),@p589 int,@p590 nvarchar(4000),@p591 nvarchar(4000),@p592 nvarchar(4000),@p593 nvarchar(4000),@p594 nvarchar(4000),@p595 nvarchar(4000),@p596 nvarchar(4000),@p597 nvarchar(4000),@p598 nvarchar(4000),@p599 nvarchar(4000),@p600 int,@p601 nvarchar(4000),@p602 nvarchar(4000),@p603 nvarchar(4000),@p604 nvarchar(4000),@p605 nvarchar(4000),@p606 int,@p607 nvarchar(4000),@p608 int,@p609 int,@p610 datetime2(7),@p611 datetime2(7),@p612 datetime2(7),@p613 nvarchar(4000),@p614 nvarchar(4000),@p615 nvarchar(4000),@p616 nvarchar(4000),@p617 nvarchar(4000),@p618 nvarchar(4000),@p619 nvarchar(4000),@p620 nvarchar(4000),@p621 nvarchar(4000),@p622 nvarchar(4000),@p623 nvarchar(4000),@p624 nvarchar(4000),@p625 nvarchar(4000),@p626 nvarchar(4000),@p627 datetime2(7),@p628 nvarchar(4000),@p629 nvarchar(4000),@p630 int,@p631 int,@p632 int,@p633 nvarchar(4000),@p634 nvarchar(4000),@p635 nvarchar(4000),@p636 nvarchar(4000),@p637 decimal(18,2),@p638 nvarchar(4000),@p639 nvarchar(4000),@p640 decimal(18,2),@p641 nvarchar(4000),@p642 nvarchar(4000),@p643 nvarchar(4000),@p644 nvarchar(4000),@p645 int,@p646 nvarchar(4000),@p647 nvarchar(4000),@p648 nvarchar(4000),@p649 nvarchar(4000),@p650 nvarchar(4000),@p651 nvarchar(4000),@p652 nvarchar(4000),@p653 nvarchar(4000),@p654 nvarchar(4000),@p655 nvarchar(4000),@p656 int,@p657 nvarchar(4000),@p658 nvarchar(4000),@p659 nvarchar(4000),@p660 nvarchar(4000),@p661 nvarchar(4000),@p662 int,@p663 nvarchar(4000),@p664 int,@p665 int,@p666 datetime2(7),@p667 datetime2(7),@p668 datetime2(7),@p669 nvarchar(4000),@p670 nvarchar(4000),@p671 nvarchar(4000),@p672 nvarchar(4000),@p673 nvarchar(4000),@p674 nvarchar(4000),@p675 nvarchar(4000),@p676 nvarchar(4000),@p677 nvarchar(4000),@p678 nvarchar(4000),@p679 nvarchar(4000),@p680 nvarchar(4000),@p681 nvarchar(4000),@p682 nvarchar(4000),@p683 datetime2(7),@p684 nvarchar(4000),@p685 nvarchar(4000),@p686 int,@p687 int,@p688 int,@p689 nvarchar(4000),@p690 nvarchar(4000),@p691 nvarchar(4000),@p692 nvarchar(4000),@p693 decimal(18,2),@p694 nvarchar(4000),@p695 nvarchar(4000),@p696 decimal(18,2),@p697 nvarchar(4000),@p698 nvarchar(4000),@p699 nvarchar(4000),@p700 nvarchar(4000),@p701 int,@p702 nvarchar(4000),@p703 nvarchar(4000),@p704 nvarchar(4000),@p705 nvarchar(4000),@p706 nvarchar(4000),@p707 nvarchar(4000),@p708 nvarchar(4000),@p709 nvarchar(4000),@p710 nvarchar(4000),@p711 nvarchar(4000),@p712 int,@p713 nvarchar(4000),@p714 nvarchar(4000),@p715 nvarchar(4000),@p716 nvarchar(4000),@p717 nvarchar(4000),@p718 int,@p719 nvarchar(4000),@p720 int,@p721 int,@p722 datetime2(7),@p723 datetime2(7),@p724 datetime2(7),@p725 nvarchar(4000),@p726 nvarchar(4000),@p727 nvarchar(4000),@p728 nvarchar(4000),@p729 nvarchar(4000),@p730 nvarchar(4000),@p731 nvarchar(4000),@p732 nvarchar(4000),@p733 nvarchar(4000),@p734 nvarchar(4000),@p735 nvarchar(4000),@p736 nvarchar(4000),@p737 nvarchar(4000),@p738 nvarchar(4000),@p739 datetime2(7),@p740 nvarchar(4000),@p741 nvarchar(4000),@p742 int,@p743 int,@p744 int,@p745 nvarchar(4000),@p746 nvarchar(4000),@p747 nvarchar(4000),@p748 nvarchar(4000),@p749 decimal(18,2),@p750 nvarchar(4000),@p751 nvarchar(4000),@p752 decimal(18,2),@p753 nvarchar(4000),@p754 nvarchar(4000),@p755 nvarchar(4000),@p756 nvarchar(4000),@p757 int,@p758 nvarchar(4000),@p759 nvarchar(4000),@p760 nvarchar(4000),@p761 nvarchar(4000),@p762 nvarchar(4000),@p763 nvarchar(4000),@p764 nvarchar(4000),@p765 nvarchar(4000),@p766 nvarchar(4000),@p767 nvarchar(4000),@p768 int,@p769 nvarchar(4000),@p770 nvarchar(4000),@p771 nvarchar(4000),@p772 nvarchar(4000),@p773 nvarchar(4000),@p774 int,@p775 nvarchar(4000),@p776 int,@p777 int,@p778 datetime2(7),@p779 datetime2(7),@p780 datetime2(7),@p781 nvarchar(4000),@p782 nvarchar(4000),@p783 nvarchar(4000),@p784 nvarchar(4000),@p785 nvarchar(4000),@p786 nvarchar(4000),@p787 nvarchar(4000),@p788 nvarchar(4000),@p789 nvarchar(4000),@p790 nvarchar(4000),@p791 nvarchar(4000),@p792 nvarchar(4000),@p793 nvarchar(4000),@p794 nvarchar(4000),@p795 datetime2(7),@p796 nvarchar(4000),@p797 nvarchar(4000),@p798 int,@p799 int,@p800 int,@p801 nvarchar(4000),@p802 nvarchar(4000),@p803 nvarchar(4000),@p804 nvarchar(4000),@p805 decimal(18,2),@p806 nvarchar(4000),@p807 nvarchar(4000),@p808 decimal(18,2),@p809 nvarchar(4000),@p810 nvarchar(4000),@p811 nvarchar(4000),@p812 nvarchar(4000),@p813 int,@p814 nvarchar(4000),@p815 nvarchar(4000),@p816 nvarchar(4000),@p817 nvarchar(4000),@p818 nvarchar(4000),@p819 nvarchar(4000),@p820 nvarchar(4000),@p821 nvarchar(4000),@p822 nvarchar(4000),@p823 nvarchar(4000),@p824 int,@p825 nvarchar(4000),@p826 nvarchar(4000),@p827 nvarchar(4000),@p828 nvarchar(4000),@p829 nvarchar(4000),@p830 int,@p831 nvarchar(4000),@p832 int,@p833 int,@p834 datetime2(7),@p835 datetime2(7),@p836 datetime2(7),@p837 nvarchar(4000),@p838 nvarchar(4000),@p839 nvarchar(4000),@p840 nvarchar(4000),@p841 nvarchar(4000),@p842 nvarchar(4000),@p843 nvarchar(4000),@p844 nvarchar(4000),@p845 nvarchar(4000),@p846 nvarchar(4000),@p847 nvarchar(4000),@p848 nvarchar(4000),@p849 nvarchar(4000),@p850 nvarchar(4000),@p851 datetime2(7),@p852 nvarchar(4000),@p853 nvarchar(4000),@p854 int,@p855 int,@p856 int,@p857 nvarchar(4000),@p858 nvarchar(4000),@p859 nvarchar(4000),@p860 nvarchar(4000),@p861 decimal(18,2),@p862 nvarchar(4000),@p863 nvarchar(4000),@p864 decimal(18,2),@p865 nvarchar(4000),@p866 nvarchar(4000),@p867 nvarchar(4000),@p868 nvarchar(4000),@p869 int,@p870 nvarchar(4000),@p871 nvarchar(4000),@p872 nvarchar(4000),@p873 nvarchar(4000),@p874 nvarchar(4000),@p875 nvarchar(4000),@p876 nvarchar(4000),@p877 nvarchar(4000),@p878 nvarchar(4000),@p879 nvarchar(4000),@p880 int,@p881 nvarchar(4000),@p882 nvarchar(4000),@p883 nvarchar(4000),@p884 nvarchar(4000),@p885 nvarchar(4000),@p886 int,@p887 nvarchar(4000),@p888 int,@p889 int,@p890 datetime2(7),@p891 datetime2(7),@p892 datetime2(7),@p893 nvarchar(4000),@p894 nvarchar(4000),@p895 nvarchar(4000),@p896 nvarchar(4000),@p897 nvarchar(4000),@p898 nvarchar(4000),@p899 nvarchar(4000),@p900 nvarchar(4000),@p901 nvarchar(4000),@p902 nvarchar(4000),@p903 nvarchar(4000),@p904 nvarchar(4000),@p905 nvarchar(4000),@p906 nvarchar(4000),@p907 datetime2(7),@p908 nvarchar(4000),@p909 nvarchar(4000),@p910 int,@p911 int,@p912 int,@p913 nvarchar(4000),@p914 nvarchar(4000),@p915 nvarchar(4000),@p916 nvarchar(4000),@p917 decimal(18,2),@p918 nvarchar(4000),@p919 nvarchar(4000),@p920 decimal(18,2),@p921 nvarchar(4000),@p922 nvarchar(4000),@p923 nvarchar(4000),@p924 nvarchar(4000),@p925 int,@p926 nvarchar(4000),@p927 nvarchar(4000),@p928 nvarchar(4000),@p929 nvarchar(4000),@p930 nvarchar(4000),@p931 nvarchar(4000),@p932 nvarchar(4000),@p933 nvarchar(4000),@p934 nvarchar(4000),@p935 nvarchar(4000),@p936 int,@p937 nvarchar(4000),@p938 nvarchar(4000),@p939 nvarchar(4000),@p940 nvarchar(4000),@p941 nvarchar(4000),@p942 int,@p943 nvarchar(4000),@p944 int,@p945 int,@p946 datetime2(7),@p947 datetime2(7),@p948 datetime2(7),@p949 nvarchar(4000),@p950 nvarchar(4000),@p951 nvarchar(4000),@p952 nvarchar(4000),@p953 nvarchar(4000),@p954 nvarchar(4000),@p955 nvarchar(4000),@p956 nvarchar(4000),@p957 nvarchar(4000),@p958 nvarchar(4000),@p959 nvarchar(4000),@p960 nvarchar(4000),@p961 nvarchar(4000),@p962 nvarchar(4000),@p963 datetime2(7),@p964 nvarchar(4000),@p965 nvarchar(4000),@p966 int,@p967 int,@p968 int,@p969 nvarchar(4000),@p970 nvarchar(4000),@p971 nvarchar(4000),@p972 decimal(18,2),@p973 decimal(18,2),@p974 nvarchar(4000),@p975 nvarchar(4000),@p976 decimal(18,2),@p977 nvarchar(4000),@p978 nvarchar(4000),@p979 nvarchar(4000),@p980 nvarchar(4000),@p981 int,@p982 nvarchar(4000),@p983 nvarchar(4000),@p984 nvarchar(4000),@p985 nvarchar(4000),@p986 nvarchar(4000),@p987 nvarchar(4000),@p988 nvarchar(4000),@p989 nvarchar(4000),@p990 nvarchar(4000),@p991 nvarchar(4000),@p992 int,@p993 nvarchar(4000),@p994 nvarchar(4000),@p995 nvarchar(4000),@p996 nvarchar(4000),@p997 nvarchar(4000),@p998 int,@p999 nvarchar(4000),@p1000 int,@p1001 int,@p1002 datetime2(7),@p1003 datetime2(7),@p1004 datetime2(7),@p1005 nvarchar(4000),@p1006 nvarchar(4000),@p1007 nvarchar(4000),@p1008 nvarchar(4000),@p1009 nvarchar(4000),@p1010 nvarchar(4000),@p1011 nvarchar(4000),@p1012 nvarchar(4000),@p1013 nvarchar(4000),@p1014 nvarchar(4000),@p1015 nvarchar(4000),@p1016 nvarchar(4000),@p1017 nvarchar(4000),@p1018 nvarchar(4000),@p1019 datetime2(7),@p1020 nvarchar(4000),@p1021 nvarchar(4000),@p1022 int,@p1023 int,@p1024 int,@p1025 nvarchar(4000),@p1026 nvarchar(4000),@p1027 nvarchar(4000),@p1028 decimal(18,2),@p1029 decimal(18,2),@p1030 nvarchar(4000),@p1031 nvarchar(4000),@p1032 decimal(18,2),@p1033 nvarchar(4000),@p1034 nvarchar(4000),@p1035 nvarchar(4000),@p1036 nvarchar(4000),@p1037 int,@p1038 nvarchar(4000),@p1039 nvarchar(4000),@p1040 nvarchar(4000),@p1041 nvarchar(4000),@p1042 nvarchar(4000),@p1043 nvarchar(4000),@p1044 nvarchar(4000),@p1045 nvarchar(4000),@p1046 nvarchar(4000),@p1047 nvarchar(4000),@p1048 int,@p1049 nvarchar(4000),@p1050 nvarchar(4000),@p1051 nvarchar(4000),@p1052 nvarchar(4000),@p1053 nvarchar(4000),@p1054 int,@p1055 nvarchar(4000),@p1056 int,@p1057 int,@p1058 datetime2(7),@p1059 datetime2(7),@p1060 datetime2(7),@p1061 nvarchar(4000),@p1062 nvarchar(4000),@p1063 nvarchar(4000),@p1064 nvarchar(4000),@p1065 nvarchar(4000),@p1066 nvarchar(4000),@p1067 nvarchar(4000),@p1068 nvarchar(4000),@p1069 nvarchar(4000),@p1070 nvarchar(4000),@p1071 nvarchar(4000),@p1072 nvarchar(4000),@p1073 nvarchar(4000),@p1074 nvarchar(4000),@p1075 datetime2(7),@p1076 nvarchar(4000),@p1077 nvarchar(4000),@p1078 int,@p1079 int,@p1080 int,@p1081 nvarchar(4000),@p1082 nvarchar(4000),@p1083 nvarchar(4000),@p1084 nvarchar(4000),@p1085 decimal(18,2),@p1086 nvarchar(4000),@p1087 nvarchar(4000),@p1088 decimal(18,2),@p1089 nvarchar(4000),@p1090 nvarchar(4000),@p1091 nvarchar(4000),@p1092 nvarchar(4000),@p1093 int,@p1094 nvarchar(4000),@p1095 nvarchar(4000),@p1096 nvarchar(4000),@p1097 nvarchar(4000),@p1098 nvarchar(4000),@p1099 nvarchar(4000),@p1100 nvarchar(4000),@p1101 nvarchar(4000),@p1102 nvarchar(4000),@p1103 nvarchar(4000),@p1104 int,@p1105 nvarchar(4000),@p1106 nvarchar(4000),@p1107 nvarchar(4000),@p1108 nvarchar(4000),@p1109 nvarchar(4000),@p1110 int,@p1111 nvarchar(4000),@p1112 int,@p1113 int,@p1114 datetime2(7),@p1115 datetime2(7),@p1116 datetime2(7),@p1117 nvarchar(4000),@p1118 nvarchar(4000),@p1119 nvarchar(4000),@p1120 nvarchar(4000),@p1121 nvarchar(4000),@p1122 nvarchar(4000),@p1123 nvarchar(4000),@p1124 nvarchar(4000),@p1125 nvarchar(4000),@p1126 nvarchar(4000),@p1127 nvarchar(4000),@p1128 nvarchar(4000),@p1129 nvarchar(4000),@p1130 nvarchar(4000),@p1131 datetime2(7),@p1132 nvarchar(4000),@p1133 nvarchar(4000),@p1134 int,@p1135 int,@p1136 int,@p1137 nvarchar(4000),@p1138 nvarchar(4000),@p1139 nvarchar(4000),@p1140 decimal(18,2),@p1141 decimal(18,2),@p1142 nvarchar(4000),@p1143 nvarchar(4000),@p1144 decimal(18,2),@p1145 nvarchar(4000),@p1146 nvarchar(4000),@p1147 nvarchar(4000),@p1148 nvarchar(4000),@p1149 int,@p1150 nvarchar(4000),@p1151 nvarchar(4000),@p1152 nvarchar(4000),@p1153 nvarchar(4000),@p1154 nvarchar(4000),@p1155 nvarchar(4000),@p1156 nvarchar(4000),@p1157 nvarchar(4000),@p1158 nvarchar(4000),@p1159 nvarchar(4000),@p1160 int,@p1161 nvarchar(4000),@p1162 nvarchar(4000),@p1163 nvarchar(4000),@p1164 nvarchar(4000),@p1165 nvarchar(4000),@p1166 int,@p1167 nvarchar(4000),@p1168 int,@p1169 int,@p1170 datetime2(7),@p1171 datetime2(7),@p1172 datetime2(7),@p1173 nvarchar(4000),@p1174 nvarchar(4000),@p1175 nvarchar(4000),@p1176 nvarchar(4000),@p1177 nvarchar(4000),@p1178 nvarchar(4000),@p1179 nvarchar(4000),@p1180 nvarchar(4000),@p1181 nvarchar(4000),@p1182 nvarchar(4000),@p1183 nvarchar(4000),@p1184 nvarchar(4000),@p1185 nvarchar(4000),@p1186 nvarchar(4000),@p1187 datetime2(7),@p1188 nvarchar(4000),@p1189 nvarchar(4000),@p1190 int,@p1191 int,@p1192 int,@p1193 nvarchar(4000),@p1194 nvarchar(4000),@p1195 nvarchar(4000),@p1196 nvarchar(4000),@p1197 decimal(18,2),@p1198 nvarchar(4000),@p1199 nvarchar(4000),@p1200 decimal(18,2),@p1201 nvarchar(4000),@p1202 nvarchar(4000),@p1203 nvarchar(4000),@p1204 nvarchar(4000),@p1205 int,@p1206 nvarchar(4000),@p1207 nvarchar(4000),@p1208 nvarchar(4000),@p1209 nvarchar(4000),@p1210 nvarchar(4000),@p1211 nvarchar(4000),@p1212 nvarchar(4000),@p1213 nvarchar(4000),@p1214 nvarchar(4000),@p1215 nvarchar(4000),@p1216 int,@p1217 nvarchar(4000),@p1218 nvarchar(4000),@p1219 nvarchar(4000),@p1220 nvarchar(4000),@p1221 nvarchar(4000),@p1222 int,@p1223 nvarchar(4000),@p1224 int,@p1225 int,@p1226 datetime2(7),@p1227 datetime2(7),@p1228 datetime2(7),@p1229 nvarchar(4000),@p1230 nvarchar(4000),@p1231 nvarchar(4000),@p1232 nvarchar(4000),@p1233 nvarchar(4000),@p1234 nvarchar(4000),@p1235 nvarchar(4000),@p1236 nvarchar(4000),@p1237 nvarchar(4000),@p1238 nvarchar(4000),@p1239 nvarchar(4000),@p1240 nvarchar(4000),@p1241 nvarchar(4000),@p1242 nvarchar(4000),@p1243 datetime2(7),@p1244 nvarchar(4000),@p1245 nvarchar(4000),@p1246 int,@p1247 int,@p1248 int,@p1249 nvarchar(4000),@p1250 nvarchar(4000),@p1251 nvarchar(4000),@p1252 decimal(18,2),@p1253 decimal(18,2),@p1254 nvarchar(4000),@p1255 nvarchar(4000),@p1256 decimal(18,2),@p1257 nvarchar(4000),@p1258 nvarchar(4000),@p1259 nvarchar(4000),@p1260 nvarchar(4000),@p1261 int,@p1262 nvarchar(4000),@p1263 nvarchar(4000),@p1264 nvarchar(4000),@p1265 nvarchar(4000),@p1266 nvarchar(4000),@p1267 nvarchar(4000),@p1268 nvarchar(4000),@p1269 nvarchar(4000),@p1270 nvarchar(4000),@p1271 nvarchar(4000),@p1272 int,@p1273 nvarchar(4000),@p1274 nvarchar(4000),@p1275 nvarchar(4000),@p1276 nvarchar(4000),@p1277 nvarchar(4000),@p1278 int,@p1279 nvarchar(4000),@p1280 int,@p1281 int,@p1282 datetime2(7),@p1283 datetime2(7),@p1284 datetime2(7),@p1285 nvarchar(4000),@p1286 nvarchar(4000),@p1287 nvarchar(4000),@p1288 nvarchar(4000),@p1289 nvarchar(4000),@p1290 nvarchar(4000),@p1291 nvarchar(4000),@p1292 nvarchar(4000),@p1293 nvarchar(4000),@p1294 nvarchar(4000),@p1295 nvarchar(4000),@p1296 nvarchar(4000),@p1297 nvarchar(4000),@p1298 nvarchar(4000),@p1299 datetime2(7),@p1300 nvarchar(4000),@p1301 nvarchar(4000),@p1302 int,@p1303 int,@p1304 int,@p1305 nvarchar(4000),@p1306 nvarchar(4000),@p1307 nvarchar(4000),@p1308 decimal(18,2),@p1309 decimal(18,2),@p1310 nvarchar(4000),@p1311 nvarchar(4000),@p1312 decimal(18,2),@p1313 nvarchar(4000),@p1314 nvarchar(4000),@p1315 nvarchar(4000),@p1316 nvarchar(4000),@p1317 int,@p1318 nvarchar(4000),@p1319 nvarchar(4000),@p1320 nvarchar(4000),@p1321 nvarchar(4000),@p1322 nvarchar(4000),@p1323 nvarchar(4000),@p1324 nvarchar(4000),@p1325 nvarchar(4000),@p1326 nvarchar(4000),@p1327 nvarchar(4000),@p1328 int,@p1329 nvarchar(4000),@p1330 nvarchar(4000),@p1331 nvarchar(4000),@p1332 nvarchar(4000),@p1333 nvarchar(4000),@p1334 int,@p1335 nvarchar(4000),@p1336 int,@p1337 int,@p1338 datetime2(7),@p1339 datetime2(7),@p1340 datetime2(7),@p1341 nvarchar(4000),@p1342 nvarchar(4000),@p1343 nvarchar(4000),@p1344 nvarchar(4000),@p1345 nvarchar(4000),@p1346 nvarchar(4000),@p1347 nvarchar(4000),@p1348 nvarchar(4000),@p1349 nvarchar(4000),@p1350 nvarchar(4000),@p1351 nvarchar(4000),@p1352 nvarchar(4000),@p1353 nvarchar(4000),@p1354 nvarchar(4000),@p1355 datetime2(7),@p1356 nvarchar(4000),@p1357 nvarchar(4000),@p1358 int,@p1359 int,@p1360 int,@p1361 nvarchar(4000),@p1362 nvarchar(4000),@p1363 nvarchar(4000),@p1364 decimal(18,2),@p1365 decimal(18,2),@p1366 nvarchar(4000),@p1367 nvarchar(4000),@p1368 decimal(18,2),@p1369 nvarchar(4000),@p1370 nvarchar(4000),@p1371 nvarchar(4000),@p1372 nvarchar(4000),@p1373 int,@p1374 nvarchar(4000),@p1375 nvarchar(4000),@p1376 nvarchar(4000),@p1377 nvarchar(4000),@p1378 nvarchar(4000),@p1379 nvarchar(4000),@p1380 nvarchar(4000),@p1381 nvarchar(4000),@p1382 nvarchar(4000),@p1383 nvarchar(4000),@p1384 int,@p1385 nvarchar(4000),@p1386 nvarchar(4000),@p1387 nvarchar(4000),@p1388 nvarchar(4000),@p1389 nvarchar(4000),@p1390 int,@p1391 nvarchar(4000),@p1392 int,@p1393 int,@p1394 datetime2(7),@p1395 datetime2(7),@p1396 datetime2(7),@p1397 nvarchar(4000),@p1398 nvarchar(4000),@p1399 nvarchar(4000),@p1400 nvarchar(4000),@p1401 nvarchar(4000),@p1402 nvarchar(4000),@p1403 nvarchar(4000),@p1404 nvarchar(4000),@p1405 nvarchar(4000),@p1406 nvarchar(4000),@p1407 nvarchar(4000),@p1408 nvarchar(4000),@p1409 nvarchar(4000),@p1410 nvarchar(4000),@p1411 datetime2(7),@p1412 nvarchar(4000),@p1413 nvarchar(4000),@p1414 int,@p1415 int,@p1416 int,@p1417 nvarchar(4000),@p1418 nvarchar(4000),@p1419 nvarchar(4000),@p1420 decimal(18,2),@p1421 decimal(18,2),@p1422 nvarchar(4000),@p1423 nvarchar(4000),@p1424 decimal(18,2),@p1425 nvarchar(4000),@p1426 nvarchar(4000),@p1427 nvarchar(4000),@p1428 nvarchar(4000),@p1429 int,@p1430 nvarchar(4000),@p1431 nvarchar(4000),@p1432 nvarchar(4000),@p1433 nvarchar(4000),@p1434 nvarchar(4000),@p1435 nvarchar(4000),@p1436 nvarchar(4000),@p1437 nvarchar(4000),@p1438 nvarchar(4000),@p1439 nvarchar(4000),@p1440 int,@p1441 nvarchar(4000),@p1442 nvarchar(4000),@p1443 nvarchar(4000),@p1444 nvarchar(4000),@p1445 nvarchar(4000),@p1446 int,@p1447 nvarchar(4000),@p1448 int,@p1449 int,@p1450 datetime2(7),@p1451 datetime2(7),@p1452 datetime2(7),@p1453 nvarchar(4000),@p1454 nvarchar(4000),@p1455 nvarchar(4000),@p1456 nvarchar(4000),@p1457 nvarchar(4000),@p1458 nvarchar(4000),@p1459 nvarchar(4000),@p1460 nvarchar(4000),@p1461 nvarchar(4000),@p1462 nvarchar(4000),@p1463 nvarchar(4000),@p1464 nvarchar(4000),@p1465 nvarchar(4000),@p1466 nvarchar(4000),@p1467 datetime2(7),@p1468 nvarchar(4000),@p1469 nvarchar(4000),@p1470 int,@p1471 int,@p1472 int,@p1473 nvarchar(4000),@p1474 nvarchar(4000),@p1475 nvarchar(4000),@p1476 decimal(18,2),@p1477 decimal(18,2),@p1478 nvarchar(4000),@p1479 nvarchar(4000),@p1480 decimal(18,2),@p1481 nvarchar(4000),@p1482 nvarchar(4000),@p1483 nvarchar(4000),@p1484 nvarchar(4000),@p1485 int,@p1486 nvarchar(4000),@p1487 nvarchar(4000),@p1488 nvarchar(4000),@p1489 nvarchar(4000),@p1490 nvarchar(4000),@p1491 nvarchar(4000),@p1492 nvarchar(4000),@p1493 nvarchar(4000),@p1494 nvarchar(4000),@p1495 nvarchar(4000),@p1496 int,@p1497 nvarchar(4000),@p1498 nvarchar(4000),@p1499 nvarchar(4000),@p1500 nvarchar(4000),@p1501 nvarchar(4000),@p1502 int,@p1503 nvarchar(4000),@p1504 int,@p1505 int,@p1506 datetime2(7),@p1507 datetime2(7),@p1508 datetime2(7),@p1509 nvarchar(4000),@p1510 nvarchar(4000),@p1511 nvarchar(4000),@p1512 nvarchar(4000),@p1513 nvarchar(4000),@p1514 nvarchar(4000),@p1515 nvarchar(4000),@p1516 nvarchar(4000),@p1517 nvarchar(4000),@p1518 nvarchar(4000),@p1519 nvarchar(4000),@p1520 nvarchar(4000),@p1521 nvarchar(4000),@p1522 nvarchar(4000),@p1523 datetime2(7),@p1524 nvarchar(4000),@p1525 nvarchar(4000),@p1526 int,@p1527 int,@p1528 int,@p1529 nvarchar(4000),@p1530 nvarchar(4000),@p1531 nvarchar(4000),@p1532 decimal(18,2),@p1533 decimal(18,2),@p1534 nvarchar(4000),@p1535 nvarchar(4000),@p1536 decimal(18,2),@p1537 nvarchar(4000),@p1538 nvarchar(4000),@p1539 nvarchar(4000),@p1540 nvarchar(4000),@p1541 int,@p1542 nvarchar(4000),@p1543 nvarchar(4000),@p1544 nvarchar(4000),@p1545 nvarchar(4000),@p1546 nvarchar(4000),@p1547 nvarchar(4000),@p1548 nvarchar(4000),@p1549 nvarchar(4000),@p1550 nvarchar(4000),@p1551 nvarchar(4000),@p1552 int,@p1553 nvarchar(4000),@p1554 nvarchar(4000),@p1555 nvarchar(4000),@p1556 nvarchar(4000),@p1557 nvarchar(4000),@p1558 int,@p1559 nvarchar(4000),@p1560 int,@p1561 int,@p1562 datetime2(7),@p1563 datetime2(7),@p1564 datetime2(7),@p1565 nvarchar(4000),@p1566 nvarchar(4000),@p1567 nvarchar(4000),@p1568 nvarchar(4000),@p1569 nvarchar(4000),@p1570 nvarchar(4000),@p1571 nvarchar(4000),@p1572 nvarchar(4000),@p1573 nvarchar(4000),@p1574 nvarchar(4000),@p1575 nvarchar(4000),@p1576 nvarchar(4000),@p1577 nvarchar(4000),@p1578 nvarchar(4000),@p1579 datetime2(7),@p1580 nvarchar(4000),@p1581 nvarchar(4000),@p1582 int,@p1583 int,@p1584 int,@p1585 nvarchar(4000),@p1586 nvarchar(4000),@p1587 nvarchar(4000),@p1588 decimal(18,2),@p1589 decimal(18,2),@p1590 nvarchar(4000),@p1591 nvarchar(4000),@p1592 decimal(18,2),@p1593 nvarchar(4000),@p1594 nvarchar(4000),@p1595 nvarchar(4000),@p1596 nvarchar(4000),@p1597 int,@p1598 nvarchar(4000),@p1599 nvarchar(4000),@p1600 nvarchar(4000),@p1601 nvarchar(4000),@p1602 nvarchar(4000),@p1603 nvarchar(4000),@p1604 nvarchar(4000),@p1605 nvarchar(4000),@p1606 nvarchar(4000),@p1607 nvarchar(4000),@p1608 int,@p1609 nvarchar(4000),@p1610 nvarchar(4000),@p1611 nvarchar(4000),@p1612 nvarchar(4000),@p1613 nvarchar(4000),@p1614 int,@p1615 nvarchar(4000),@p1616 int,@p1617 int,@p1618 datetime2(7),@p1619 datetime2(7),@p1620 datetime2(7),@p1621 nvarchar(4000),@p1622 nvarchar(4000),@p1623 nvarchar(4000),@p1624 nvarchar(4000),@p1625 nvarchar(4000),@p1626 nvarchar(4000),@p1627 nvarchar(4000),@p1628 nvarchar(4000),@p1629 nvarchar(4000),@p1630 nvarchar(4000),@p1631 nvarchar(4000),@p1632 nvarchar(4000),@p1633 nvarchar(4000),@p1634 nvarchar(4000),@p1635 datetime2(7),@p1636 nvarchar(4000),@p1637 nvarchar(4000),@p1638 int,@p1639 int,@p1640 int,@p1641 nvarchar(4000),@p1642 nvarchar(4000),@p1643 nvarchar(4000),@p1644 decimal(18,2),@p1645 decimal(18,2),@p1646 nvarchar(4000),@p1647 nvarchar(4000),@p1648 decimal(18,2),@p1649 nvarchar(4000),@p1650 nvarchar(4000),@p1651 nvarchar(4000),@p1652 nvarchar(4000),@p1653 int,@p1654 nvarchar(4000),@p1655 nvarchar(4000),@p1656 nvarchar(4000),@p1657 nvarchar(4000),@p1658 nvarchar(4000),@p1659 nvarchar(4000),@p1660 nvarchar(4000),@p1661 nvarchar(4000),@p1662 nvarchar(4000),@p1663 nvarchar(4000),@p1664 int,@p1665 nvarchar(4000),@p1666 nvarchar(4000),@p1667 nvarchar(4000),@p1668 nvarchar(4000),@p1669 nvarchar(4000),@p1670 int,@p1671 nvarchar(4000),@p1672 int,@p1673 int,@p1674 datetime2(7),@p1675 datetime2(7),@p1676 datetime2(7),@p1677 nvarchar(4000),@p1678 nvarchar(4000),@p1679 nvarchar(4000),@p1680 nvarchar(4000),@p1681 nvarchar(4000),@p1682 nvarchar(4000),@p1683 nvarchar(4000),@p1684 nvarchar(4000),@p1685 nvarchar(4000),@p1686 nvarchar(4000),@p1687 nvarchar(4000),@p1688 nvarchar(4000),@p1689 nvarchar(4000),@p1690 nvarchar(4000),@p1691 datetime2(7),@p1692 nvarchar(4000),@p1693 nvarchar(4000),@p1694 int,@p1695 int,@p1696 int,@p1697 nvarchar(4000),@p1698 nvarchar(4000),@p1699 nvarchar(4000),@p1700 decimal(18,2),@p1701 decimal(18,2),@p1702 nvarchar(4000),@p1703 nvarchar(4000),@p1704 decimal(18,2),@p1705 nvarchar(4000),@p1706 nvarchar(4000),@p1707 nvarchar(4000),@p1708 nvarchar(4000),@p1709 int,@p1710 nvarchar(4000),@p1711 nvarchar(4000),@p1712 nvarchar(4000),@p1713 nvarchar(4000),@p1714 nvarchar(4000),@p1715 nvarchar(4000),@p1716 nvarchar(4000),@p1717 nvarchar(4000),@p1718 nvarchar(4000),@p1719 nvarchar(4000),@p1720 int,@p1721 nvarchar(4000),@p1722 nvarchar(4000),@p1723 nvarchar(4000),@p1724 nvarchar(4000),@p1725 nvarchar(4000),@p1726 int,@p1727 nvarchar(4000),@p1728 int,@p1729 int,@p1730 datetime2(7),@p1731 datetime2(7),@p1732 datetime2(7),@p1733 nvarchar(4000),@p1734 nvarchar(4000),@p1735 nvarchar(4000),@p1736 nvarchar(4000),@p1737 nvarchar(4000),@p1738 nvarchar(4000),@p1739 nvarchar(4000),@p1740 nvarchar(4000),@p1741 nvarchar(4000),@p1742 nvarchar(4000),@p1743 nvarchar(4000),@p1744 nvarchar(4000),@p1745 nvarchar(4000),@p1746 nvarchar(4000),@p1747 datetime2(7),@p1748 nvarchar(4000),@p1749 nvarchar(4000),@p1750 int,@p1751 int,@p1752 int,@p1753 nvarchar(4000),@p1754 nvarchar(4000),@p1755 nvarchar(4000),@p1756 nvarchar(4000),@p1757 decimal(18,2),@p1758 nvarchar(4000),@p1759 nvarchar(4000),@p1760 decimal(18,2),@p1761 nvarchar(4000),@p1762 nvarchar(4000),@p1763 nvarchar(4000),@p1764 nvarchar(4000),@p1765 int,@p1766 nvarchar(4000),@p1767 nvarchar(4000),@p1768 nvarchar(4000),@p1769 nvarchar(4000),@p1770 nvarchar(4000),@p1771 nvarchar(4000),@p1772 nvarchar(4000),@p1773 nvarchar(4000),@p1774 nvarchar(4000),@p1775 nvarchar(4000),@p1776 int,@p1777 nvarchar(4000),@p1778 nvarchar(4000),@p1779 nvarchar(4000),@p1780 nvarchar(4000),@p1781 nvarchar(4000),@p1782 int,@p1783 nvarchar(4000),@p1784 int,@p1785 int,@p1786 datetime2(7),@p1787 datetime2(7),@p1788 datetime2(7),@p1789 nvarchar(4000),@p1790 nvarchar(4000),@p1791 nvarchar(4000),@p1792 nvarchar(4000),@p1793 nvarchar(4000),@p1794 nvarchar(4000),@p1795 nvarchar(4000),@p1796 nvarchar(4000),@p1797 nvarchar(4000),@p1798 nvarchar(4000),@p1799 nvarchar(4000),@p1800 nvarchar(4000),@p1801 nvarchar(4000),@p1802 nvarchar(4000),@p1803 datetime2(7),@p1804 nvarchar(4000),@p1805 nvarchar(4000),@p1806 int,@p1807 int,@p1808 int,@p1809 nvarchar(4000),@p1810 nvarchar(4000),@p1811 nvarchar(4000),@p1812 nvarchar(4000),@p1813 decimal(18,2),@p1814 nvarchar(4000),@p1815 nvarchar(4000),@p1816 decimal(18,2),@p1817 nvarchar(4000),@p1818 nvarchar(4000),@p1819 nvarchar(4000),@p1820 nvarchar(4000),@p1821 int,@p1822 nvarchar(4000),@p1823 nvarchar(4000),@p1824 nvarchar(4000),@p1825 nvarchar(4000),@p1826 nvarchar(4000),@p1827 nvarchar(4000),@p1828 nvarchar(4000),@p1829 nvarchar(4000),@p1830 nvarchar(4000),@p1831 nvarchar(4000),@p1832 int,@p1833 nvarchar(4000),@p1834 nvarchar(4000),@p1835 nvarchar(4000),@p1836 nvarchar(4000),@p1837 nvarchar(4000),@p1838 int,@p1839 nvarchar(4000),@p1840 int,@p1841 int,@p1842 datetime2(7),@p1843 datetime2(7),@p1844 datetime2(7),@p1845 nvarchar(4000),@p1846 nvarchar(4000),@p1847 nvarchar(4000),@p1848 nvarchar(4000),@p1849 nvarchar(4000),@p1850 nvarchar(4000),@p1851 nvarchar(4000),@p1852 nvarchar(4000),@p1853 nvarchar(4000),@p1854 nvarchar(4000),@p1855 nvarchar(4000),@p1856 nvarchar(4000),@p1857 nvarchar(4000),@p1858 nvarchar(4000),@p1859 datetime2(7),@p1860 nvarchar(4000),@p1861 nvarchar(4000),@p1862 int,@p1863 int,@p1864 int,@p1865 nvarchar(4000),@p1866 nvarchar(4000),@p1867 nvarchar(4000),@p1868 decimal(18,2),@p1869 decimal(18,2),@p1870 nvarchar(4000),@p1871 nvarchar(4000),@p1872 decimal(18,2),@p1873 nvarchar(4000),@p1874 nvarchar(4000),@p1875 nvarchar(4000),@p1876 nvarchar(4000),@p1877 int,@p1878 nvarchar(4000),@p1879 nvarchar(4000),@p1880 nvarchar(4000),@p1881 nvarchar(4000),@p1882 nvarchar(4000),@p1883 nvarchar(4000),@p1884 nvarchar(4000),@p1885 nvarchar(4000),@p1886 nvarchar(4000),@p1887 nvarchar(4000),@p1888 int,@p1889 nvarchar(4000),@p1890 nvarchar(4000),@p1891 nvarchar(4000),@p1892 nvarchar(4000),@p1893 nvarchar(4000),@p1894 int,@p1895 nvarchar(4000),@p1896 int,@p1897 int,@p1898 datetime2(7),@p1899 datetime2(7),@p1900 datetime2(7),@p1901 nvarchar(4000),@p1902 nvarchar(4000),@p1903 nvarchar(4000),@p1904 nvarchar(4000),@p1905 nvarchar(4000),@p1906 nvarchar(4000),@p1907 nvarchar(4000),@p1908 nvarchar(4000),@p1909 nvarchar(4000),@p1910 nvarchar(4000),@p1911 nvarchar(4000),@p1912 nvarchar(4000),@p1913 nvarchar(4000),@p1914 nvarchar(4000),@p1915 datetime2(7),@p1916 nvarchar(4000),@p1917 nvarchar(4000),@p1918 int,@p1919 int,@p1920 int,@p1921 nvarchar(4000),@p1922 nvarchar(4000),@p1923 nvarchar(4000),@p1924 decimal(18,2),@p1925 decimal(18,2),@p1926 nvarchar(4000),@p1927 nvarchar(4000),@p1928 decimal(18,2),@p1929 nvarchar(4000),@p1930 nvarchar(4000),@p1931 nvarchar(4000),@p1932 nvarchar(4000),@p1933 int,@p1934 nvarchar(4000),@p1935 nvarchar(4000),@p1936 nvarchar(4000),@p1937 nvarchar(4000),@p1938 nvarchar(4000),@p1939 nvarchar(4000),@p1940 nvarchar(4000),@p1941 nvarchar(4000),@p1942 nvarchar(4000),@p1943 nvarchar(4000),@p1944 int,@p1945 nvarchar(4000),@p1946 nvarchar(4000),@p1947 nvarchar(4000),@p1948 nvarchar(4000),@p1949 nvarchar(4000),@p1950 int,@p1951 nvarchar(4000),@p1952 int,@p1953 int,@p1954 datetime2(7),@p1955 datetime2(7),@p1956 datetime2(7),@p1957 nvarchar(4000),@p1958 nvarchar(4000),@p1959 nvarchar(4000),@p1960 nvarchar(4000),@p1961 nvarchar(4000),@p1962 nvarchar(4000),@p1963 nvarchar(4000),@p1964 nvarchar(4000),@p1965 nvarchar(4000),@p1966 nvarchar(4000),@p1967 nvarchar(4000),@p1968 nvarchar(4000),@p1969 nvarchar(4000),@p1970 nvarchar(4000),@p1971 datetime2(7),@p1972 nvarchar(4000),@p1973 nvarchar(4000),@p1974 int,@p1975 int,@p1976 int,@p1977 nvarchar(4000),@p1978 nvarchar(4000),@p1979 nvarchar(4000),@p1980 decimal(18,2),@p1981 decimal(18,2),@p1982 nvarchar(4000),@p1983 nvarchar(4000),@p1984 decimal(18,2),@p1985 nvarchar(4000),@p1986 nvarchar(4000),@p1987 nvarchar(4000),@p1988 nvarchar(4000),@p1989 int,@p1990 nvarchar(4000),@p1991 nvarchar(4000),@p1992 nvarchar(4000),@p1993 nvarchar(4000),@p1994 nvarchar(4000),@p1995 nvarchar(4000),@p1996 nvarchar(4000),@p1997 nvarchar(4000),@p1998 nvarchar(4000),@p1999 nvarchar(4000),@p2000 int,@p2001 nvarchar(4000),@p2002 nvarchar(4000),@p2003 nvarchar(4000),@p2004 nvarchar(4000),@p2005 nvarchar(4000),@p2006 int,@p2007 nvarchar(4000),@p2008 int,@p2009 int,@p2010 datetime2(7),@p2011 datetime2(7),@p2012 datetime2(7),@p2013 nvarchar(4000),@p2014 nvarchar(4000),@p2015 nvarchar(4000),@p2016 nvarchar(4000),@p2017 nvarchar(4000),@p2018 nvarchar(4000),@p2019 nvarchar(4000),@p2020 nvarchar(4000),@p2021 nvarchar(4000),@p2022 nvarchar(4000),@p2023 nvarchar(4000),@p2024 nvarchar(4000),@p2025 nvarchar(4000),@p2026 nvarchar(4000),@p2027 datetime2(7),@p2028 nvarchar(4000),@p2029 nvarchar(4000),@p2030 int,@p2031 int,@p2032 int,@p2033 nvarchar(4000),@p2034 nvarchar(4000),@p2035 nvarchar(4000),@p2036 decimal(18,2),@p2037 decimal(18,2),@p2038 nvarchar(4000),@p2039 nvarchar(4000),@p2040 decimal(18,2),@p2041 nvarchar(4000),@p2042 nvarchar(4000),@p2043 nvarchar(4000),@p2044 nvarchar(4000),@p2045 int,@p2046 nvarchar(4000),@p2047 nvarchar(4000),@p2048 nvarchar(4000),@p2049 nvarchar(4000),@p2050 nvarchar(4000),@p2051 nvarchar(4000),@p2052 nvarchar(4000),@p2053 nvarchar(4000),@p2054 nvarchar(4000),@p2055 nvarchar(4000),@p2056 int,@p2057 nvarchar(4000),@p2058 nvarchar(4000),@p2059 nvarchar(4000),@p2060 nvarchar(4000),@p2061 nvarchar(4000),@p2062 int,@p2063 nvarchar(4000),@p2064 int,@p2065 int,@p2066 datetime2(7),@p2067 datetime2(7),@p2068 datetime2(7),@p2069 nvarchar(4000),@p2070 nvarchar(4000),@p2071 nvarchar(4000))SET NOCOUNT ON; DECLARE @inserted0 TABLE ([item_id] int, [_Position] [int]); MERGE [raw_data] USING ( VALUES (@p0, @p1, @p2, @p3, @p4, @p5, @p6, @p7, @p8, @p9, @p10, @p11, @p12, @p13, @p14, @p15, @p16, @p17, @p18, @p19, @p20, @p21, @p22, @p23, @p24, @p25, @p26, @p27, @p28, @p29, @p30, @p31, @p32, @p33, @p34, @p35, @p36, @p37, @p38, @p39, @p40, @p41, @p42, @p43, @p44, @p45, @p46, @p47, @p48, @p49, @p50, @p51, @p52, @p53, @p54, @p55, 0), (@p56, @p57, @p58, @p59, @p60, @p61, @p62, @p63, @p64, @p65, @p66, @p67, @p68, @p69, @p70, @p71, @p72, @p73, @p74, @p75, @p76, @p77, @p78, @p79, @p80, @p81, @p82, @p83, @p84, @p85, @p86, @p87, @p88, @p89, @p90, @p91, @p92, @p93, @p94, @p95, @p96, @p97, @p98, @p99, @p100, @p101, @p102, @p103, @p104, @p105, @p106, @p107, @p108, @p109, @p110, @p111, 1), (@p112, @p113, @p114, @p115, @p116, @p117, @p118, @p119, @p120, @p121, @p122, @p123, @p124, @p125, @p126, @p127, @p128, @p129, @p130, @p131, @p132, @p133, @p134, @p135, @p136, @p137, @p138, @p139, @p140, @p141, @p142, @p143, @p144, @p145, @p146, @p147, @p148, @p149, @p150, @p151, @p152, @p153, @p154, @p155, @p156, @p157, @p158, @p159, @p160, @p161, @p162, @p163, @p164, @p165, @p166, @p167, 2), (@p168, @p169, @p170, @p171, @p172, @p173, @p174, @p175, @p176, @p177, @p178, @p179, @p180, @p181, @p182, @p183, @p184, @p185, @p186, @p187, @p188, @p189, @p190, @p191, @p192, @p193, @p194, @p195, @p196, @p197, @p198, @p199, @p200, @p201, @p202, @p203, @p204, @p205, @p206, @p207, @p208, @p209, @p210, @p211, @p212, @p213, @p214, @p215, @p216, @p217, @p218, @p219, @p220, @p221, @p222, @p223, 3), (@p224, @p225, @p226, @p227, @p228, @p229, @p230, @p231, @p232, @p233, @p234, @p235, @p236, @p237, @p238, @p239, @p240, @p241, @p242, @p243, @p244, @p245, @p246, @p247, @p248, @p249, @p250, @p251, @p252, @p253, @p254, @p255, @p256, @p257, @p258, @p259, @p260, @p261, @p262, @p263, @p264, @p265, @p266, @p267, @p268, @p269, @p270, @p271, @p272, @p273, @p274, @p275, @p276, @p277, @p278, @p279, 4), (@p280, @p281, @p282, @p283, @p284, @p285, @p286, @p287, @p288, @p289, @p290, @p291, @p292, @p293, @p294, @p295, @p296, @p297, @p298, @p299, @p300, @p301, @p302, @p303, @p304, @p305, @p306, @p307, @p308, @p309, @p310, @p311, @p312, @p313, @p314, @p315, @p316, @p317, @p318, @p319, @p320, @p321, @p322, @p323, @p324, @p325, @p326, @p327, @p328, @p329, @p330, @p331, @p332, @p333, @p334, @p335, 5), (@p336, @p337, @p338, @p339, @p340, @p341, @p342, @p343, @p344, @p345, @p346, @p347, @p348, @p349, @p350, @p351, @p352, @p353, @p354, @p355, @p356, @p357, @p358, @p359, @p360, @p361, @p362, @p363, @p364, @p365, @p366, @p367, @p368, @p369, @p370, @p371, @p372, @p373, @p374, @p375, @p376, @p377, @p378, @p379, @p380, @p381, @p382, @p383, @p384, @p385, @p386, @p387, @p388, @p389, @p390, @p391, 6), (@p392, @p393, @p394, @p395, @p396, @p397, @p398, @p399, @p400, @p401, @p402, @p403, @p404, @p405, @p406, @p407, @p408, @p409, @p410, @p411, @p412, @p413, @p414, @p415, @p416, @p417, @p418, @p419, @p420, @p421, @p422, @p423, @p424, @p425, @p426, @p427, @p428, @p429, @p430, @p431, @p432, @p433, @p434, @p435, @p436, @p437, @p438, @p439, @p440, @p441, @p442, @p443, @p444, @p445, @p446, @p447, 7), (@p448, @p449, @p450, @p451, @p452, @p453, @p454, @p455, @p456, @p457, @p458, @p459, @p460, @p461, @p462, @p463, @p464, @p465, @p466, @p467, @p468, @p469, @p470, @p471, @p472, @p473, @p474, @p475, @p476, @p477, @p478, @p479, @p480, @p481, @p482, @p483, @p484, @p485, @p486, @p487, @p488, @p489, @p490, @p491, @p492, @p493, @p494, @p495, @p496, @p497, @p498, @p499, @p500, @p501, @p502, @p503, 8), (@p504, @p505, @p506, @p507, @p508, @p509, @p510, @p511, @p512, @p513, @p514, @p515, @p516, @p517, @p518, @p519, @p520, @p521, @p522, @p523, @p524, @p525, @p526, @p527, @p528, @p529, @p530, @p531, @p532, @p533, @p534, @p535, @p536, @p537, @p538, @p539, @p540, @p541, @p542, @p543, @p544, @p545, @p546, @p547, @p548, @p549, @p550, @p551, @p552, @p553, @p554, @p555, @p556, @p557, @p558, @p559, 9), (@p560, @p561, @p562, @p563, @p564, @p565, @p566, @p567, @p568, @p569, @p570, @p571, @p572, @p573, @p574, @p575, @p576, @p577, @p578, @p579, @p580, @p581, @p582, @p583, @p584, @p585, @p586, @p587, @p588, @p589, @p590, @p591, @p592, @p593, @p594, @p595, @p596, @p597, @p598, @p599, @p600, @p601, @p602, @p603, @p604, @p605, @p606, @p607, @p608, @p609, @p610, @p611, @p612, @p613, @p614, @p615, 10), (@p616, @p617, @p618, @p619, @p620, @p621, @p622, @p623, @p624, @p625, @p626, @p627, @p628, @p629, @p630, @p631, @p632, @p633, @p634, @p635, @p636, @p637, @p638, @p639, @p640, @p641, @p642, @p643, @p644, @p645, @p646, @p647, @p648, @p649, @p650, @p651, @p652, @p653, @p654, @p655, @p656, @p657, @p658, @p659, @p660, @p661, @p662, @p663, @p664, @p665, @p666, @p667, @p668, @p669, @p670, @p671, 11), (@p672, @p673, @p674, @p675, @p676, @p677, @p678, @p679, @p680, @p681, @p682, @p683, @p684, @p685, @p686, @p687, @p688, @p689, @p690, @p691, @p692, @p693, @p694, @p695, @p696, @p697, @p698, @p699, @p700, @p701, @p702, @p703, @p704, @p705, @p706, @p707, @p708, @p709, @p710, @p711, @p712, @p713, @p714, @p715, @p716, @p717, @p718, @p719, @p720, @p721, @p722, @p723, @p724, @p725, @p726, @p727, 12), (@p728, @p729, @p730, @p731, @p732, @p733, @p734, @p735, @p736, @p737, @p738, @p739, @p740, @p741, @p742, @p743, @p744, @p745, @p746, @p747, @p748, @p749, @p750, @p751, @p752, @p753, @p754, @p755, @p756, @p757, @p758, @p759, @p760, @p761, @p762, @p763, @p764, @p765, @p766, @p767, @p768, @p769, @p770, @p771, @p772, @p773, @p774, @p775, @p776, @p777, @p778, @p779, @p780, @p781, @p782, @p783, 13), (@p784, @p785, @p786, @p787, @p788, @p789, @p790, @p791, @p792, @p793, @p794, @p795, @p796, @p797, @p798, @p799, @p800, @p801, @p802, @p803, @p804, @p805, @p806, @p807, @p808, @p809, @p810, @p811, @p812, @p813, @p814, @p815, @p816, @p817, @p818, @p819, @p820, @p821, @p822, @p823, @p824, @p825, @p826, @p827, @p828, @p829, @p830, @p831, @p832, @p833, @p834, @p835, @p836, @p837, @p838, @p839, 14), (@p840, @p841, @p842, @p843, @p844, @p845, @p846, @p847, @p848, @p849, @p850, @p851, @p852, @p853, @p854, @p855, @p856, @p857, @p858, @p859, @p860, @p861, @p862, @p863, @p864, @p865, @p866, @p867, @p868, @p869, @p870, @p871, @p872, @p873, @p874, @p875, @p876, @p877, @p878, @p879, @p880, @p881, @p882, @p883, @p884, @p885, @p886, @p887, @p888, @p889, @p890, @p891, @p892, @p893, @p894, @p895, 15), (@p896, @p897, @p898, @p899, @p900, @p901, @p902, @p903, @p904, @p905, @p906, @p907, @p908, @p909, @p910, @p911, @p912, @p913, @p914, @p915, @p916, @p917, @p918, @p919, @p920, @p921, @p922, @p923, @p924, @p925, @p926, @p927, @p928, @p929, @p930, @p931, @p932, @p933, @p934, @p935, @p936, @p937, @p938, @p939, @p940, @p941, @p942, @p943, @p944, @p945, @p946, @p947, @p948, @p949, @p950, @p951, 16), (@p952, @p953, @p954, @p955, @p956, @p957, @p958, @p959, @p960, @p961, @p962, @p963, @p964, @p965, @p966, @p967, @p968, @p969, @p970, @p971, @p972, @p973, @p974, @p975, @p976, @p977, @p978, @p979, @p980, @p981, @p982, @p983, @p984, @p985, @p986, @p987, @p988, @p989, @p990, @p991, @p992, @p993, @p994, @p995, @p996, @p997, @p998, @p999, @p1000, @p1001, @p1002, @p1003, @p1004, @p1005, @p1006, @p1007, 17), (@p1008, @p1009, @p1010, @p1011, @p1012, @p1013, @p1014, @p1015, @p1016, @p1017, @p1018, @p1019, @p1020, @p1021, @p1022, @p1023, @p1024, @p1025, @p1026, @p1027, @p1028, @p1029, @p1030, @p1031, @p1032, @p1033, @p1034, @p1035, @p1036, @p1037, @p1038, @p1039, @p1040, @p1041, @p1042, @p1043, @p1044, @p1045, @p1046, @p1047, @p1048, @p1049, @p1050, @p1051, @p1052, @p1053, @p1054, @p1055, @p1056, @p1057, @p1058, @p1059, @p1060, @p1061, @p1062, @p1063, 18), (@p1064, @p1065, @p1066, @p1067, @p1068, @p1069, @p1070, @p1071, @p1072, @p1073, @p1074, @p1075, @p1076, @p1077, @p1078, @p1079, @p1080, @p1081, @p1082, @p1083, @p1084, @p1085, @p1086, @p1087, @p1088, @p1089, @p1090, @p1091, @p1092, @p1093, @p1094, @p1095, @p1096, @p1097, @p1098, @p1099, @p1100, @p1101, @p1102, @p1103, @p1104, @p1105, @p1106, @p1107, @p1108, @p1109, @p1110, @p1111, @p1112, @p1113, @p1114, @p1115, @p1116, @p1117, @p1118, @p1119, 19), (@p1120, @p1121, @p1122, @p1123, @p1124, @p1125, @p1126, @p1127, @p1128, @p1129, @p1130, @p1131, @p1132, @p1133, @p1134, @p1135, @p1136, @p1137, @p1138, @p1139, @p1140, @p1141, @p1142, @p1143, @p1144, @p1145, @p1146, @p1147, @p1148, @p1149, @p1150, @p1151, @p1152, @p1153, @p1154, @p1155, @p1156, @p1157, @p1158, @p1159, @p1160, @p1161, @p1162, @p1163, @p1164, @p1165, @p1166, @p1167, @p1168, @p1169, @p1170, @p1171, @p1172, @p1173, @p1174, @p1175, 20), (@p1176, @p1177, @p1178, @p1179, @p1180, @p1181, @p1182, @p1183, @p1184, @p1185, @p1186, @p1187, @p1188, @p1189, @p1190, @p1191, @p1192, @p1193, @p1194, @p1195, @p1196, @p1197, @p1198, @p1199, @p1200, @p1201, @p1202, @p1203, @p1204, @p1205, @p1206, @p1207, @p1208, @p1209, @p1210, @p1211, @p1212, @p1213, @p1214, @p1215, @p1216, @p1217, @p1218, @p1219, @p1220, @p1221, @p1222, @p1223, @p1224, @p1225, @p1226, @p1227, @p1228, @p1229, @p1230, @p1231, 21), (@p1232, @p1233, @p1234, @p1235, @p1236, @p1237, @p1238, @p1239, @p1240, @p1241, @p1242, @p1243, @p1244, @p1245, @p1246, @p1247, @p1248, @p1249, @p1250, @p1251, @p1252, @p1253, @p1254, @p1255, @p1256, @p1257, @p1258, @p1259, @p1260, @p1261, @p1262, @p1263, @p1264, @p1265, @p1266, @p1267, @p1268, @p1269, @p1270, @p1271, @p1272, @p1273, @p1274, @p1275, @p1276, @p1277, @p1278, @p1279, @p1280, @p1281, @p1282, @p1283, @p1284, @p1285, @p1286, @p1287, 22), (@p1288, @p1289, @p1290, @p1291, @p1292, @p1293, @p1294, @p1295, @p1296, @p1297, @p1298, @p1299, @p1300, @p1301, @p1302, @p1303, @p1304, @p1305, @p1306, @p1307, @p1308, @p1309, @p1310, @p1311, @p1312, @p1313, @p1314, @p1315, @p1316, @p1317, @p1318, @p1319, @p1320, @p1321, @p1322, @p1323, @p1324, @p1325, @p1326, @p1327, @p1328, @p1329, @p1330, @p1331, @p1332, @p1333, @p1334, @p1335, @p1336, @p1337, @p1338, @p1339, @p1340, @p1341, @p1342, @p1343, 23), (@p1344, @p1345, @p1346, @p1347, @p1348, @p1349, @p1350, @p1351, @p1352, @p1353, @p1354, @p1355, @p1356, @p1357, @p1358, @p1359, @p1360, @p1361, @p1362, @p1363, @p1364, @p1365, @p1366, @p1367, @p1368, @p1369, @p1370, @p1371, @p1372, @p1373, @p1374, @p1375, @p1376, @p1377, @p1378, @p1379, @p1380, @p1381, @p1382, @p1383, @p1384, @p1385, @p1386, @p1387, @p1388, @p1389, @p1390, @p1391, @p1392, @p1393, @p1394, @p1395, @p1396, @p1397, @p1398, @p1399, 24), (@p1400, @p1401, @p1402, @p1403, @p1404, @p1405, @p1406, @p1407, @p1408, @p1409, @p1410, @p1411, @p1412, @p1413, @p1414, @p1415, @p1416, @p1417, @p1418, @p1419, @p1420, @p1421, @p1422, @p1423, @p1424, @p1425, @p1426, @p1427, @p1428, @p1429, @p1430, @p1431, @p1432, @p1433, @p1434, @p1435, @p1436, @p1437, @p1438, @p1439, @p1440, @p1441, @p1442, @p1443, @p1444, @p1445, @p1446, @p1447, @p1448, @p1449, @p1450, @p1451, @p1452, @p1453, @p1454, @p1455, 25), (@p1456, @p1457, @p1458, @p1459, @p1460, @p1461, @p1462, @p1463, @p1464, @p1465, @p1466, @p1467, @p1468, @p1469, @p1470, @p1471, @p1472, @p1473, @p1474, @p1475, @p1476, @p1477, @p1478, @p1479, @p1480, @p1481, @p1482, @p1483, @p1484, @p1485, @p1486, @p1487, @p1488, @p1489, @p1490, @p1491, @p1492, @p1493, @p1494, @p1495, @p1496, @p1497, @p1498, @p1499, @p1500, @p1501, @p1502, @p1503, @p1504, @p1505, @p1506, @p1507, @p1508, @p1509, @p1510, @p1511, 26), (@p1512, @p1513, @p1514, @p1515, @p1516, @p1517, @p1518, @p1519, @p1520, @p1521, @p1522, @p1523, @p1524, @p1525, @p1526, @p1527, @p1528, @p1529, @p1530, @p1531, @p1532, @p1533, @p1534, @p1535, @p1536, @p1537, @p1538, @p1539, @p1540, @p1541, @p1542, @p1543, @p1544, @p1545, @p1546, @p1547, @p1548, @p1549, @p1550, @p1551, @p1552, @p1553, @p1554, @p1555, @p1556, @p1557, @p1558, @p1559, @p1560, @p1561, @p1562, @p1563, @p1564, @p1565, @p1566, @p1567, 27), (@p1568, @p1569, @p1570, @p1571, @p1572, @p1573, @p1574, @p1575, @p1576, @p1577, @p1578, @p1579, @p1580, @p1581, @p1582, @p1583, @p1584, @p1585, @p1586, @p1587, @p1588, @p1589, @p1590, @p1591, @p1592, @p1593, @p1594, @p1595, @p1596, @p1597, @p1598, @p1599, @p1600, @p1601, @p1602, @p1603, @p1604, @p1605, @p1606, @p1607, @p1608, @p1609, @p1610, @p1611, @p1612, @p1613, @p1614, @p1615, @p1616, @p1617, @p1618, @p1619, @p1620, @p1621, @p1622, @p1623, 28), (@p1624, @p1625, @p1626, @p1627, @p1628, @p1629, @p1630, @p1631, @p1632, @p1633, @p1634, @p1635, @p1636, @p1637, @p1638, @p1639, @p1640, @p1641, @p1642, @p1643, @p1644, @p1645, @p1646, @p1647, @p1648, @p1649, @p1650, @p1651, @p1652, @p1653, @p1654, @p1655, @p1656, @p1657, @p1658, @p1659, @p1660, @p1661, @p1662, @p1663, @p1664, @p1665, @p1666, @p1667, @p1668, @p1669, @p1670, @p1671, @p1672, @p1673, @p1674, @p1675, @p1676, @p1677, @p1678, @p1679, 29), (@p1680, @p1681, @p1682, @p1683, @p1684, @p1685, @p1686, @p1687, @p1688, @p1689, @p1690, @p1691, @p1692, @p1693, @p1694, @p1695, @p1696, @p1697, @p1698, @p1699, @p1700, @p1701, @p1702, @p1703, @p1704, @p1705, @p1706, @p1707, @p1708, @p1709, @p1710, @p1711, @p1712, @p1713, @p1714, @p1715, @p1716, @p1717, @p1718, @p1719, @p1720, @p1721, @p1722, @p1723, @p1724, @p1725, @p1726, @p1727, @p1728, @p1729, @p1730, @p1731, @p1732, @p1733, @p1734, @p1735, 30), (@p1736, @p1737, @p1738, @p1739, @p1740, @p1741, @p1742, @p1743, @p1744, @p1745, @p1746, @p1747, @p1748, @p1749, @p1750, @p1751, @p1752, @p1753, @p1754, @p1755, @p1756, @p1757, @p1758, @p1759, @p1760, @p1761, @p1762, @p1763, @p1764, @p1765, @p1766, @p1767, @p1768, @p1769, @p1770, @p1771, @p1772, @p1773, @p1774, @p1775, @p1776, @p1777, @p1778, @p1779, @p1780, @p1781, @p1782, @p1783, @p1784, @p1785, @p1786, @p1787, @p1788, @p1789, @p1790, @p1791, 31), (@p1792, @p1793, @p1794, @p1795, @p1796, @p1797, @p1798, @p1799, @p1800, @p1801, @p1802, @p1803, @p1804, @p1805, @p1806, @p1807, @p1808, @p1809, @p1810, @p1811, @p1812, @p1813, @p1814, @p1815, @p1816, @p1817, @p1818, @p1819, @p1820, @p1821, @p1822, @p1823, @p1824, @p1825, @p1826, @p1827, @p1828, @p1829, @p1830, @p1831, @p1832, @p1833, @p1834, @p1835, @p1836, @p1837, @p1838, @p1839, @p1840, @p1841, @p1842, @p1843, @p1844, @p1845, @p1846, @p1847, 32), (@p1848, @p1849, @p1850, @p1851, @p1852, @p1853, @p1854, @p1855, @p1856, @p1857, @p1858, @p1859, @p1860, @p1861, @p1862, @p1863, @p1864, @p1865, @p1866, @p1867, @p1868, @p1869, @p1870, @p1871, @p1872, @p1873, @p1874, @p1875, @p1876, @p1877, @p1878, @p1879, @p1880, @p1881, @p1882, @p1883, @p1884, @p1885, @p1886, @p1887, @p1888, @p1889, @p1890, @p1891, @p1892, @p1893, @p1894, @p1895, @p1896, @p1897, @p1898, @p1899, @p1900, @p1901, @p1902, @p1903, 33), (@p1904, @p1905, @p1906, @p1907, @p1908, @p1909, @p1910, @p1911, @p1912, @p1913, @p1914, @p1915, @p1916, @p1917, @p1918, @p1919, @p1920, @p1921, @p1922, @p1923, @p1924, @p1925, @p1926, @p1927, @p1928, @p1929, @p1930, @p1931, @p1932, @p1933, @p1934, @p1935, @p1936, @p1937, @p1938, @p1939, @p1940, @p1941, @p1942, @p1943, @p1944, @p1945, @p1946, @p1947, @p1948, @p1949, @p1950, @p1951, @p1952, @p1953, @p1954, @p1955, @p1956, @p1957, @p1958, @p1959, 34), (@p1960, @p1961, @p1962, @p1963, @p1964, @p1965, @p1966, @p1967, @p1968, @p1969, @p1970, @p1971, @p1972, @p1973, @p1974, @p1975, @p1976, @p1977, @p1978, @p1979, @p1980, @p1981, @p1982, @p1983, @p1984, @p1985, @p1986, @p1987, @p1988, @p1989, @p1990, @p1991, @p1992, @p1993, @p1994, @p1995, @p1996, @p1997, @p1998, @p1999, @p2000, @p2001, @p2002, @p2003, @p2004, @p2005, @p2006, @p2007, @p2008, @p2009, @p2010, @p2011, @p2012, @p2013, @p2014, @p2015, 35), (@p2016, @p2017, @p2018, @p2019, @p2020, @p2021, @p2022, @p2023, @p2024, @p2025, @p2026, @p2027, @p2028, @p2029, @p2030, @p2031, @p2032, @p2033, @p2034, @p2035, @p2036, @p2037, @p2038, @p2039, @p2040, @p2041, @p2042, @p2043, @p2044, @p2045, @p2046, @p2047, @p2048, @p2049, @p2050, @p2051, @p2052, @p2053, @p2054, @p2055, @p2056, @p2057, @p2058, @p2059, @p2060, @p2061, @p2062, @p2063, @p2064, @p2065, @p2066, @p2067, @p2068, @p2069, @p2070, @p2071, 36)) AS i ([addressee_cntry_cd], [addressee_city], [addressee_district], [addressee_email], [addressee_full_address], [addressee_home_address], [addressee_name], [addressee_postcode], [addressee_province], [addressee_subdistrict], [addressee_tel], [create_table], [delivery_code], [delivery_recipient_name], [delivery_relation_id], [delivery_status_id], [dest_outlet_id], [dest_outlet_port], [document_number], [item_barcode], [item_cod], [item_gross_weight], [item_height], [item_length], [item_price], [item_width], [lat], [log_id], [long], [outlet_id], [outlet_port], [podUrl], [remark], [scan_cntry_cd], [scan_cntry_postcode], [sender_cntry_cd], [sender_district], [sender_email], [sender_full_address], [sender_home_address], [member_id], [sender_name], [sender_postcode], [sender_province], [sender_subdistrict], [sender_tel], [server_id], [signatureUrl], [state], [status_code], [status_dtm], [timestamp], [transmit_dtm], [user_id], [wckt_id], [wkstn_no], _Position) ON 1=0 WHEN NOT MATCHED THEN INSERT ([addressee_cntry_cd], [addressee_city], [addressee_district], [addressee_email], [addressee_full_address], [addressee_home_address], [addressee_name], [addressee_postcode], [addressee_province], [addressee_subdistrict], [addressee_tel], [create_table], [delivery_code], [delivery_recipient_name], [delivery_relation_id], [delivery_status_id], [dest_outlet_id], [dest_outlet_port], [document_number], [item_barcode], [item_cod], [item_gross_weight], [item_height], [item_length], [item_price], [item_width], [lat], [log_id], [long], [outlet_id], [outlet_port], [podUrl], [remark], [scan_cntry_cd], [scan_cntry_postcode], [sender_cntry_cd], [sender_district], [sender_email], [sender_full_address], [sender_home_address], [member_id], [sender_name], [sender_postcode], [sender_province], [sender_subdistrict], [sender_tel], [server_id], [signatureUrl], [state], [status_code], [status_dtm], [timestamp], [transmit_dtm], [user_id], [wckt_id], [wkstn_no]) VALUES (i.[addressee_cntry_cd], i.[addressee_city], i.[addressee_district], i.[addressee_email], i.[addressee_full_address], i.[addressee_home_address], i.[addressee_name], i.[addressee_postcode], i.[addressee_province], i.[addressee_subdistrict], i.[addressee_tel], i.[create_table], i.[delivery_code], i.[delivery_recipient_name], i.[delivery_relation_id], i.[delivery_status_id], i.[dest_outlet_id], i.[dest_outlet_port], i.[document_number], i.[item_barcode], i.[item_cod], i.[item_gross_weight], i.[item_height], i.[item_length], i.[item_price], i.[item_width], i.[lat], i.[log_id], i.[long], i.[outlet_id], i.[outlet_port], i.[podUrl], i.[remark], i.[scan_cntry_cd], i.[scan_cntry_postcode], i.[sender_cntry_cd], i.[sender_district], i.[sender_email], i.[sender_full_address], i.[sender_home_address], i.[member_id], i.[sender_name], i.[sender_postcode], i.[sender_province], i.[sender_subdistrict], i.[sender_tel], i.[server_id], i.[signatureUrl], i.[state], i.[status_code], i.[status_dtm], i.[timestamp], i.[transmit_dtm], i.[user_id], i.[wckt_id], i.[wkstn_no]) OUTPUT INSERTED.[item_id], i._Position INTO @inserted0;  SELECT [t].[item_id] FROM [raw_data] t INNER JOIN @inserted0 i ON ([t].[item_id] = [i].[item_id]) ORDER BY [i].[_Position];  ",4,4,0,451,5,4
"(@p0 nvarchar(4000),@p1 nvarchar(4000),@p2 nvarchar(4000),@p3 nvarchar(4000),@p4 nvarchar(4000),@p5 nvarchar(4000),@p6 nvarchar(4000),@p7 nvarchar(4000),@p8 nvarchar(4000),@p9 nvarchar(4000),@p10 nvarchar(4000),@p11 datetime2(7),@p12 nvarchar(4000),@p13 nvarchar(4000),@p14 int,@p15 int,@p16 int,@p17 nvarchar(4000),@p18 nvarchar(4000),@p19 nvarchar(4000),@p20 nvarchar(4000),@p21 decimal(18,2),@p22 nvarchar(4000),@p23 nvarchar(4000),@p24 decimal(18,2),@p25 nvarchar(4000),@p26 nvarchar(4000),@p27 nvarchar(4000),@p28 nvarchar(4000),@p29 int,@p30 nvarchar(4000),@p31 nvarchar(4000),@p32 nvarchar(4000),@p33 nvarchar(4000),@p34 nvarchar(4000),@p35 nvarchar(4000),@p36 nvarchar(4000),@p37 nvarchar(4000),@p38 nvarchar(4000),@p39 nvarchar(4000),@p40 int,@p41 nvarchar(4000),@p42 nvarchar(4000),@p43 nvarchar(4000),@p44 nvarchar(4000),@p45 nvarchar(4000),@p46 int,@p47 nvarchar(4000),@p48 int,@p49 int,@p50 datetime2(7),@p51 datetime2(7),@p52 datetime2(7),@p53 nvarchar(4000),@p54 nvarchar(4000),@p55 nvarchar(4000),@p56 nvarchar(4000),@p57 nvarchar(4000),@p58 nvarchar(4000),@p59 nvarchar(4000),@p60 nvarchar(4000),@p61 nvarchar(4000),@p62 nvarchar(4000),@p63 nvarchar(4000),@p64 nvarchar(4000),@p65 nvarchar(4000),@p66 nvarchar(4000),@p67 datetime2(7),@p68 nvarchar(4000),@p69 nvarchar(4000),@p70 int,@p71 int,@p72 int,@p73 nvarchar(4000),@p74 nvarchar(4000),@p75 nvarchar(4000),@p76 nvarchar(4000),@p77 decimal(18,2),@p78 nvarchar(4000),@p79 nvarchar(4000),@p80 decimal(18,2),@p81 nvarchar(4000),@p82 nvarchar(4000),@p83 nvarchar(4000),@p84 nvarchar(4000),@p85 int,@p86 nvarchar(4000),@p87 nvarchar(4000),@p88 nvarchar(4000),@p89 nvarchar(4000),@p90 nvarchar(4000),@p91 nvarchar(4000),@p92 nvarchar(4000),@p93 nvarchar(4000),@p94 nvarchar(4000),@p95 nvarchar(4000),@p96 int,@p97 nvarchar(4000),@p98 nvarchar(4000),@p99 nvarchar(4000),@p100 nvarchar(4000),@p101 nvarchar(4000),@p102 int,@p103 nvarchar(4000),@p104 int,@p105 int,@p106 datetime2(7),@p107 datetime2(7),@p108 datetime2(7),@p109 nvarchar(4000),@p110 nvarchar(4000),@p111 nvarchar(4000),@p112 nvarchar(4000),@p113 nvarchar(4000),@p114 nvarchar(4000),@p115 nvarchar(4000),@p116 nvarchar(4000),@p117 nvarchar(4000),@p118 nvarchar(4000),@p119 nvarchar(4000),@p120 nvarchar(4000),@p121 nvarchar(4000),@p122 nvarchar(4000),@p123 datetime2(7),@p124 nvarchar(4000),@p125 nvarchar(4000),@p126 int,@p127 int,@p128 int,@p129 nvarchar(4000),@p130 nvarchar(4000),@p131 nvarchar(4000),@p132 nvarchar(4000),@p133 decimal(18,2),@p134 nvarchar(4000),@p135 nvarchar(4000),@p136 decimal(18,2),@p137 nvarchar(4000),@p138 nvarchar(4000),@p139 nvarchar(4000),@p140 nvarchar(4000),@p141 int,@p142 nvarchar(4000),@p143 nvarchar(4000),@p144 nvarchar(4000),@p145 nvarchar(4000),@p146 nvarchar(4000),@p147 nvarchar(4000),@p148 nvarchar(4000),@p149 nvarchar(4000),@p150 nvarchar(4000),@p151 nvarchar(4000),@p152 int,@p153 nvarchar(4000),@p154 nvarchar(4000),@p155 nvarchar(4000),@p156 nvarchar(4000),@p157 nvarchar(4000),@p158 int,@p159 nvarchar(4000),@p160 int,@p161 int,@p162 datetime2(7),@p163 datetime2(7),@p164 datetime2(7),@p165 nvarchar(4000),@p166 nvarchar(4000),@p167 nvarchar(4000),@p168 nvarchar(4000),@p169 nvarchar(4000),@p170 nvarchar(4000),@p171 nvarchar(4000),@p172 nvarchar(4000),@p173 nvarchar(4000),@p174 nvarchar(4000),@p175 nvarchar(4000),@p176 nvarchar(4000),@p177 nvarchar(4000),@p178 nvarchar(4000),@p179 datetime2(7),@p180 nvarchar(4000),@p181 nvarchar(4000),@p182 int,@p183 int,@p184 int,@p185 nvarchar(4000),@p186 nvarchar(4000),@p187 nvarchar(4000),@p188 nvarchar(4000),@p189 decimal(18,2),@p190 nvarchar(4000),@p191 nvarchar(4000),@p192 decimal(18,2),@p193 nvarchar(4000),@p194 nvarchar(4000),@p195 nvarchar(4000),@p196 nvarchar(4000),@p197 int,@p198 nvarchar(4000),@p199 nvarchar(4000),@p200 nvarchar(4000),@p201 nvarchar(4000),@p202 nvarchar(4000),@p203 nvarchar(4000),@p204 nvarchar(4000),@p205 nvarchar(4000),@p206 nvarchar(4000),@p207 nvarchar(4000),@p208 int,@p209 nvarchar(4000),@p210 nvarchar(4000),@p211 nvarchar(4000),@p212 nvarchar(4000),@p213 nvarchar(4000),@p214 int,@p215 nvarchar(4000),@p216 int,@p217 int,@p218 datetime2(7),@p219 datetime2(7),@p220 datetime2(7),@p221 nvarchar(4000),@p222 nvarchar(4000),@p223 nvarchar(4000),@p224 nvarchar(4000),@p225 nvarchar(4000),@p226 nvarchar(4000),@p227 nvarchar(4000),@p228 nvarchar(4000),@p229 nvarchar(4000),@p230 nvarchar(4000),@p231 nvarchar(4000),@p232 nvarchar(4000),@p233 nvarchar(4000),@p234 nvarchar(4000),@p235 datetime2(7),@p236 nvarchar(4000),@p237 nvarchar(4000),@p238 int,@p239 int,@p240 int,@p241 nvarchar(4000),@p242 nvarchar(4000),@p243 nvarchar(4000),@p244 nvarchar(4000),@p245 decimal(18,2),@p246 nvarchar(4000),@p247 nvarchar(4000),@p248 decimal(18,2),@p249 nvarchar(4000),@p250 nvarchar(4000),@p251 nvarchar(4000),@p252 nvarchar(4000),@p253 int,@p254 nvarchar(4000),@p255 nvarchar(4000),@p256 nvarchar(4000),@p257 nvarchar(4000),@p258 nvarchar(4000),@p259 nvarchar(4000),@p260 nvarchar(4000),@p261 nvarchar(4000),@p262 nvarchar(4000),@p263 nvarchar(4000),@p264 int,@p265 nvarchar(4000),@p266 nvarchar(4000),@p267 nvarchar(4000),@p268 nvarchar(4000),@p269 nvarchar(4000),@p270 int,@p271 nvarchar(4000),@p272 int,@p273 int,@p274 datetime2(7),@p275 datetime2(7),@p276 datetime2(7),@p277 nvarchar(4000),@p278 nvarchar(4000),@p279 nvarchar(4000),@p280 nvarchar(4000),@p281 nvarchar(4000),@p282 nvarchar(4000),@p283 nvarchar(4000),@p284 nvarchar(4000),@p285 nvarchar(4000),@p286 nvarchar(4000),@p287 nvarchar(4000),@p288 nvarchar(4000),@p289 nvarchar(4000),@p290 nvarchar(4000),@p291 datetime2(7),@p292 nvarchar(4000),@p293 nvarchar(4000),@p294 int,@p295 int,@p296 int,@p297 nvarchar(4000),@p298 nvarchar(4000),@p299 nvarchar(4000),@p300 nvarchar(4000),@p301 decimal(18,2),@p302 nvarchar(4000),@p303 nvarchar(4000),@p304 decimal(18,2),@p305 nvarchar(4000),@p306 nvarchar(4000),@p307 nvarchar(4000),@p308 nvarchar(4000),@p309 int,@p310 nvarchar(4000),@p311 nvarchar(4000),@p312 nvarchar(4000),@p313 nvarchar(4000),@p314 nvarchar(4000),@p315 nvarchar(4000),@p316 nvarchar(4000),@p317 nvarchar(4000),@p318 nvarchar(4000),@p319 nvarchar(4000),@p320 int,@p321 nvarchar(4000),@p322 nvarchar(4000),@p323 nvarchar(4000),@p324 nvarchar(4000),@p325 nvarchar(4000),@p326 int,@p327 nvarchar(4000),@p328 int,@p329 int,@p330 datetime2(7),@p331 datetime2(7),@p332 datetime2(7),@p333 nvarchar(4000),@p334 nvarchar(4000),@p335 nvarchar(4000),@p336 nvarchar(4000),@p337 nvarchar(4000),@p338 nvarchar(4000),@p339 nvarchar(4000),@p340 nvarchar(4000),@p341 nvarchar(4000),@p342 nvarchar(4000),@p343 nvarchar(4000),@p344 nvarchar(4000),@p345 nvarchar(4000),@p346 nvarchar(4000),@p347 datetime2(7),@p348 nvarchar(4000),@p349 nvarchar(4000),@p350 int,@p351 int,@p352 int,@p353 nvarchar(4000),@p354 nvarchar(4000),@p355 nvarchar(4000),@p356 nvarchar(4000),@p357 decimal(18,2),@p358 nvarchar(4000),@p359 nvarchar(4000),@p360 decimal(18,2),@p361 nvarchar(4000),@p362 nvarchar(4000),@p363 nvarchar(4000),@p364 nvarchar(4000),@p365 int,@p366 nvarchar(4000),@p367 nvarchar(4000),@p368 nvarchar(4000),@p369 nvarchar(4000),@p370 nvarchar(4000),@p371 nvarchar(4000),@p372 nvarchar(4000),@p373 nvarchar(4000),@p374 nvarchar(4000),@p375 nvarchar(4000),@p376 int,@p377 nvarchar(4000),@p378 nvarchar(4000),@p379 nvarchar(4000),@p380 nvarchar(4000),@p381 nvarchar(4000),@p382 int,@p383 nvarchar(4000),@p384 int,@p385 int,@p386 datetime2(7),@p387 datetime2(7),@p388 datetime2(7),@p389 nvarchar(4000),@p390 nvarchar(4000),@p391 nvarchar(4000),@p392 nvarchar(4000),@p393 nvarchar(4000),@p394 nvarchar(4000),@p395 nvarchar(4000),@p396 nvarchar(4000),@p397 nvarchar(4000),@p398 nvarchar(4000),@p399 nvarchar(4000),@p400 nvarchar(4000),@p401 nvarchar(4000),@p402 nvarchar(4000),@p403 datetime2(7),@p404 nvarchar(4000),@p405 nvarchar(4000),@p406 int,@p407 int,@p408 int,@p409 nvarchar(4000),@p410 nvarchar(4000),@p411 nvarchar(4000),@p412 nvarchar(4000),@p413 decimal(18,2),@p414 nvarchar(4000),@p415 nvarchar(4000),@p416 decimal(18,2),@p417 nvarchar(4000),@p418 nvarchar(4000),@p419 nvarchar(4000),@p420 nvarchar(4000),@p421 int,@p422 nvarchar(4000),@p423 nvarchar(4000),@p424 nvarchar(4000),@p425 nvarchar(4000),@p426 nvarchar(4000),@p427 nvarchar(4000),@p428 nvarchar(4000),@p429 nvarchar(4000),@p430 nvarchar(4000),@p431 nvarchar(4000),@p432 int,@p433 nvarchar(4000),@p434 nvarchar(4000),@p435 nvarchar(4000),@p436 nvarchar(4000),@p437 nvarchar(4000),@p438 int,@p439 nvarchar(4000),@p440 int,@p441 int,@p442 datetime2(7),@p443 datetime2(7),@p444 datetime2(7),@p445 nvarchar(4000),@p446 nvarchar(4000),@p447 nvarchar(4000),@p448 nvarchar(4000),@p449 nvarchar(4000),@p450 nvarchar(4000),@p451 nvarchar(4000),@p452 nvarchar(4000),@p453 nvarchar(4000),@p454 nvarchar(4000),@p455 nvarchar(4000),@p456 nvarchar(4000),@p457 nvarchar(4000),@p458 nvarchar(4000),@p459 datetime2(7),@p460 nvarchar(4000),@p461 nvarchar(4000),@p462 int,@p463 int,@p464 int,@p465 nvarchar(4000),@p466 nvarchar(4000),@p467 nvarchar(4000),@p468 nvarchar(4000),@p469 decimal(18,2),@p470 nvarchar(4000),@p471 nvarchar(4000),@p472 decimal(18,2),@p473 nvarchar(4000),@p474 nvarchar(4000),@p475 nvarchar(4000),@p476 nvarchar(4000),@p477 int,@p478 nvarchar(4000),@p479 nvarchar(4000),@p480 nvarchar(4000),@p481 nvarchar(4000),@p482 nvarchar(4000),@p483 nvarchar(4000),@p484 nvarchar(4000),@p485 nvarchar(4000),@p486 nvarchar(4000),@p487 nvarchar(4000),@p488 int,@p489 nvarchar(4000),@p490 nvarchar(4000),@p491 nvarchar(4000),@p492 nvarchar(4000),@p493 nvarchar(4000),@p494 int,@p495 nvarchar(4000),@p496 int,@p497 int,@p498 datetime2(7),@p499 datetime2(7),@p500 datetime2(7),@p501 nvarchar(4000),@p502 nvarchar(4000),@p503 nvarchar(4000),@p504 nvarchar(4000),@p505 nvarchar(4000),@p506 nvarchar(4000),@p507 nvarchar(4000),@p508 nvarchar(4000),@p509 nvarchar(4000),@p510 nvarchar(4000),@p511 nvarchar(4000),@p512 nvarchar(4000),@p513 nvarchar(4000),@p514 nvarchar(4000),@p515 datetime2(7),@p516 nvarchar(4000),@p517 nvarchar(4000),@p518 int,@p519 int,@p520 int,@p521 nvarchar(4000),@p522 nvarchar(4000),@p523 nvarchar(4000),@p524 nvarchar(4000),@p525 decimal(18,2),@p526 nvarchar(4000),@p527 nvarchar(4000),@p528 decimal(18,2),@p529 nvarchar(4000),@p530 nvarchar(4000),@p531 nvarchar(4000),@p532 nvarchar(4000),@p533 int,@p534 nvarchar(4000),@p535 nvarchar(4000),@p536 nvarchar(4000),@p537 nvarchar(4000),@p538 nvarchar(4000),@p539 nvarchar(4000),@p540 nvarchar(4000),@p541 nvarchar(4000),@p542 nvarchar(4000),@p543 nvarchar(4000),@p544 int,@p545 nvarchar(4000),@p546 nvarchar(4000),@p547 nvarchar(4000),@p548 nvarchar(4000),@p549 nvarchar(4000),@p550 int,@p551 nvarchar(4000),@p552 int,@p553 int,@p554 datetime2(7),@p555 datetime2(7),@p556 datetime2(7),@p557 nvarchar(4000),@p558 nvarchar(4000),@p559 nvarchar(4000),@p560 nvarchar(4000),@p561 nvarchar(4000),@p562 nvarchar(4000),@p563 nvarchar(4000),@p564 nvarchar(4000),@p565 nvarchar(4000),@p566 nvarchar(4000),@p567 nvarchar(4000),@p568 nvarchar(4000),@p569 nvarchar(4000),@p570 nvarchar(4000),@p571 datetime2(7),@p572 nvarchar(4000),@p573 nvarchar(4000),@p574 int,@p575 int,@p576 int,@p577 nvarchar(4000),@p578 nvarchar(4000),@p579 nvarchar(4000),@p580 nvarchar(4000),@p581 decimal(18,2),@p582 nvarchar(4000),@p583 nvarchar(4000),@p584 decimal(18,2),@p585 nvarchar(4000),@p586 nvarchar(4000),@p587 nvarchar(4000),@p588 nvarchar(4000),@p589 int,@p590 nvarchar(4000),@p591 nvarchar(4000),@p592 nvarchar(4000),@p593 nvarchar(4000),@p594 nvarchar(4000),@p595 nvarchar(4000),@p596 nvarchar(4000),@p597 nvarchar(4000),@p598 nvarchar(4000),@p599 nvarchar(4000),@p600 int,@p601 nvarchar(4000),@p602 nvarchar(4000),@p603 nvarchar(4000),@p604 nvarchar(4000),@p605 nvarchar(4000),@p606 int,@p607 nvarchar(4000),@p608 int,@p609 int,@p610 datetime2(7),@p611 datetime2(7),@p612 datetime2(7),@p613 nvarchar(4000),@p614 nvarchar(4000),@p615 nvarchar(4000),@p616 nvarchar(4000),@p617 nvarchar(4000),@p618 nvarchar(4000),@p619 nvarchar(4000),@p620 nvarchar(4000),@p621 nvarchar(4000),@p622 nvarchar(4000),@p623 nvarchar(4000),@p624 nvarchar(4000),@p625 nvarchar(4000),@p626 nvarchar(4000),@p627 datetime2(7),@p628 nvarchar(4000),@p629 nvarchar(4000),@p630 int,@p631 int,@p632 int,@p633 nvarchar(4000),@p634 nvarchar(4000),@p635 nvarchar(4000),@p636 nvarchar(4000),@p637 decimal(18,2),@p638 nvarchar(4000),@p639 nvarchar(4000),@p640 decimal(18,2),@p641 nvarchar(4000),@p642 nvarchar(4000),@p643 nvarchar(4000),@p644 nvarchar(4000),@p645 int,@p646 nvarchar(4000),@p647 nvarchar(4000),@p648 nvarchar(4000),@p649 nvarchar(4000),@p650 nvarchar(4000),@p651 nvarchar(4000),@p652 nvarchar(4000),@p653 nvarchar(4000),@p654 nvarchar(4000),@p655 nvarchar(4000),@p656 int,@p657 nvarchar(4000),@p658 nvarchar(4000),@p659 nvarchar(4000),@p660 nvarchar(4000),@p661 nvarchar(4000),@p662 int,@p663 nvarchar(4000),@p664 int,@p665 int,@p666 datetime2(7),@p667 datetime2(7),@p668 datetime2(7),@p669 nvarchar(4000),@p670 nvarchar(4000),@p671 nvarchar(4000),@p672 nvarchar(4000),@p673 nvarchar(4000),@p674 nvarchar(4000),@p675 nvarchar(4000),@p676 nvarchar(4000),@p677 nvarchar(4000),@p678 nvarchar(4000),@p679 nvarchar(4000),@p680 nvarchar(4000),@p681 nvarchar(4000),@p682 nvarchar(4000),@p683 datetime2(7),@p684 nvarchar(4000),@p685 nvarchar(4000),@p686 int,@p687 int,@p688 int,@p689 nvarchar(4000),@p690 nvarchar(4000),@p691 nvarchar(4000),@p692 nvarchar(4000),@p693 decimal(18,2),@p694 nvarchar(4000),@p695 nvarchar(4000),@p696 decimal(18,2),@p697 nvarchar(4000),@p698 nvarchar(4000),@p699 nvarchar(4000),@p700 nvarchar(4000),@p701 int,@p702 nvarchar(4000),@p703 nvarchar(4000),@p704 nvarchar(4000),@p705 nvarchar(4000),@p706 nvarchar(4000),@p707 nvarchar(4000),@p708 nvarchar(4000),@p709 nvarchar(4000),@p710 nvarchar(4000),@p711 nvarchar(4000),@p712 int,@p713 nvarchar(4000),@p714 nvarchar(4000),@p715 nvarchar(4000),@p716 nvarchar(4000),@p717 nvarchar(4000),@p718 int,@p719 nvarchar(4000),@p720 int,@p721 int,@p722 datetime2(7),@p723 datetime2(7),@p724 datetime2(7),@p725 nvarchar(4000),@p726 nvarchar(4000),@p727 nvarchar(4000),@p728 nvarchar(4000),@p729 nvarchar(4000),@p730 nvarchar(4000),@p731 nvarchar(4000),@p732 nvarchar(4000),@p733 nvarchar(4000),@p734 nvarchar(4000),@p735 nvarchar(4000),@p736 nvarchar(4000),@p737 nvarchar(4000),@p738 nvarchar(4000),@p739 datetime2(7),@p740 nvarchar(4000),@p741 nvarchar(4000),@p742 int,@p743 int,@p744 int,@p745 nvarchar(4000),@p746 nvarchar(4000),@p747 nvarchar(4000),@p748 nvarchar(4000),@p749 decimal(18,2),@p750 nvarchar(4000),@p751 nvarchar(4000),@p752 decimal(18,2),@p753 nvarchar(4000),@p754 nvarchar(4000),@p755 nvarchar(4000),@p756 nvarchar(4000),@p757 int,@p758 nvarchar(4000),@p759 nvarchar(4000),@p760 nvarchar(4000),@p761 nvarchar(4000),@p762 nvarchar(4000),@p763 nvarchar(4000),@p764 nvarchar(4000),@p765 nvarchar(4000),@p766 nvarchar(4000),@p767 nvarchar(4000),@p768 int,@p769 nvarchar(4000),@p770 nvarchar(4000),@p771 nvarchar(4000),@p772 nvarchar(4000),@p773 nvarchar(4000),@p774 int,@p775 nvarchar(4000),@p776 int,@p777 int,@p778 datetime2(7),@p779 datetime2(7),@p780 datetime2(7),@p781 nvarchar(4000),@p782 nvarchar(4000),@p783 nvarchar(4000),@p784 nvarchar(4000),@p785 nvarchar(4000),@p786 nvarchar(4000),@p787 nvarchar(4000),@p788 nvarchar(4000),@p789 nvarchar(4000),@p790 nvarchar(4000),@p791 nvarchar(4000),@p792 nvarchar(4000),@p793 nvarchar(4000),@p794 nvarchar(4000),@p795 datetime2(7),@p796 nvarchar(4000),@p797 nvarchar(4000),@p798 int,@p799 int,@p800 int,@p801 nvarchar(4000),@p802 nvarchar(4000),@p803 nvarchar(4000),@p804 nvarchar(4000),@p805 decimal(18,2),@p806 nvarchar(4000),@p807 nvarchar(4000),@p808 decimal(18,2),@p809 nvarchar(4000),@p810 nvarchar(4000),@p811 nvarchar(4000),@p812 nvarchar(4000),@p813 int,@p814 nvarchar(4000),@p815 nvarchar(4000),@p816 nvarchar(4000),@p817 nvarchar(4000),@p818 nvarchar(4000),@p819 nvarchar(4000),@p820 nvarchar(4000),@p821 nvarchar(4000),@p822 nvarchar(4000),@p823 nvarchar(4000),@p824 int,@p825 nvarchar(4000),@p826 nvarchar(4000),@p827 nvarchar(4000),@p828 nvarchar(4000),@p829 nvarchar(4000),@p830 int,@p831 nvarchar(4000),@p832 int,@p833 int,@p834 datetime2(7),@p835 datetime2(7),@p836 datetime2(7),@p837 nvarchar(4000),@p838 nvarchar(4000),@p839 nvarchar(4000),@p840 nvarchar(4000),@p841 nvarchar(4000),@p842 nvarchar(4000),@p843 nvarchar(4000),@p844 nvarchar(4000),@p845 nvarchar(4000),@p846 nvarchar(4000),@p847 nvarchar(4000),@p848 nvarchar(4000),@p849 nvarchar(4000),@p850 nvarchar(4000),@p851 datetime2(7),@p852 nvarchar(4000),@p853 nvarchar(4000),@p854 int,@p855 int,@p856 int,@p857 nvarchar(4000),@p858 nvarchar(4000),@p859 nvarchar(4000),@p860 nvarchar(4000),@p861 decimal(18,2),@p862 nvarchar(4000),@p863 nvarchar(4000),@p864 decimal(18,2),@p865 nvarchar(4000),@p866 nvarchar(4000),@p867 nvarchar(4000),@p868 nvarchar(4000),@p869 int,@p870 nvarchar(4000),@p871 nvarchar(4000),@p872 nvarchar(4000),@p873 nvarchar(4000),@p874 nvarchar(4000),@p875 nvarchar(4000),@p876 nvarchar(4000),@p877 nvarchar(4000),@p878 nvarchar(4000),@p879 nvarchar(4000),@p880 int,@p881 nvarchar(4000),@p882 nvarchar(4000),@p883 nvarchar(4000),@p884 nvarchar(4000),@p885 nvarchar(4000),@p886 int,@p887 nvarchar(4000),@p888 int,@p889 int,@p890 datetime2(7),@p891 datetime2(7),@p892 datetime2(7),@p893 nvarchar(4000),@p894 nvarchar(4000),@p895 nvarchar(4000),@p896 nvarchar(4000),@p897 nvarchar(4000),@p898 nvarchar(4000),@p899 nvarchar(4000),@p900 nvarchar(4000),@p901 nvarchar(4000),@p902 nvarchar(4000),@p903 nvarchar(4000),@p904 nvarchar(4000),@p905 nvarchar(4000),@p906 nvarchar(4000),@p907 datetime2(7),@p908 nvarchar(4000),@p909 nvarchar(4000),@p910 int,@p911 int,@p912 int,@p913 nvarchar(4000),@p914 nvarchar(4000),@p915 nvarchar(4000),@p916 nvarchar(4000),@p917 decimal(18,2),@p918 nvarchar(4000),@p919 nvarchar(4000),@p920 decimal(18,2),@p921 nvarchar(4000),@p922 nvarchar(4000),@p923 nvarchar(4000),@p924 nvarchar(4000),@p925 int,@p926 nvarchar(4000),@p927 nvarchar(4000),@p928 nvarchar(4000),@p929 nvarchar(4000),@p930 nvarchar(4000),@p931 nvarchar(4000),@p932 nvarchar(4000),@p933 nvarchar(4000),@p934 nvarchar(4000),@p935 nvarchar(4000),@p936 int,@p937 nvarchar(4000),@p938 nvarchar(4000),@p939 nvarchar(4000),@p940 nvarchar(4000),@p941 nvarchar(4000),@p942 int,@p943 nvarchar(4000),@p944 int,@p945 int,@p946 datetime2(7),@p947 datetime2(7),@p948 datetime2(7),@p949 nvarchar(4000),@p950 nvarchar(4000),@p951 nvarchar(4000),@p952 nvarchar(4000),@p953 nvarchar(4000),@p954 nvarchar(4000),@p955 nvarchar(4000),@p956 nvarchar(4000),@p957 nvarchar(4000),@p958 nvarchar(4000),@p959 nvarchar(4000),@p960 nvarchar(4000),@p961 nvarchar(4000),@p962 nvarchar(4000),@p963 datetime2(7),@p964 nvarchar(4000),@p965 nvarchar(4000),@p966 int,@p967 int,@p968 int,@p969 nvarchar(4000),@p970 nvarchar(4000),@p971 nvarchar(4000),@p972 nvarchar(4000),@p973 decimal(18,2),@p974 nvarchar(4000),@p975 nvarchar(4000),@p976 decimal(18,2),@p977 nvarchar(4000),@p978 nvarchar(4000),@p979 nvarchar(4000),@p980 nvarchar(4000),@p981 int,@p982 nvarchar(4000),@p983 nvarchar(4000),@p984 nvarchar(4000),@p985 nvarchar(4000),@p986 nvarchar(4000),@p987 nvarchar(4000),@p988 nvarchar(4000),@p989 nvarchar(4000),@p990 nvarchar(4000),@p991 nvarchar(4000),@p992 int,@p993 nvarchar(4000),@p994 nvarchar(4000),@p995 nvarchar(4000),@p996 nvarchar(4000),@p997 nvarchar(4000),@p998 int,@p999 nvarchar(4000),@p1000 int,@p1001 int,@p1002 datetime2(7),@p1003 datetime2(7),@p1004 datetime2(7),@p1005 nvarchar(4000),@p1006 nvarchar(4000),@p1007 nvarchar(4000),@p1008 nvarchar(4000),@p1009 nvarchar(4000),@p1010 nvarchar(4000),@p1011 nvarchar(4000),@p1012 nvarchar(4000),@p1013 nvarchar(4000),@p1014 nvarchar(4000),@p1015 nvarchar(4000),@p1016 nvarchar(4000),@p1017 nvarchar(4000),@p1018 nvarchar(4000),@p1019 datetime2(7),@p1020 nvarchar(4000),@p1021 nvarchar(4000),@p1022 int,@p1023 int,@p1024 int,@p1025 nvarchar(4000),@p1026 nvarchar(4000),@p1027 nvarchar(4000),@p1028 nvarchar(4000),@p1029 decimal(18,2),@p1030 nvarchar(4000),@p1031 nvarchar(4000),@p1032 decimal(18,2),@p1033 nvarchar(4000),@p1034 nvarchar(4000),@p1035 nvarchar(4000),@p1036 nvarchar(4000),@p1037 int,@p1038 nvarchar(4000),@p1039 nvarchar(4000),@p1040 nvarchar(4000),@p1041 nvarchar(4000),@p1042 nvarchar(4000),@p1043 nvarchar(4000),@p1044 nvarchar(4000),@p1045 nvarchar(4000),@p1046 nvarchar(4000),@p1047 nvarchar(4000),@p1048 int,@p1049 nvarchar(4000),@p1050 nvarchar(4000),@p1051 nvarchar(4000),@p1052 nvarchar(4000),@p1053 nvarchar(4000),@p1054 int,@p1055 nvarchar(4000),@p1056 int,@p1057 int,@p1058 datetime2(7),@p1059 datetime2(7),@p1060 datetime2(7),@p1061 nvarchar(4000),@p1062 nvarchar(4000),@p1063 nvarchar(4000),@p1064 nvarchar(4000),@p1065 nvarchar(4000),@p1066 nvarchar(4000),@p1067 nvarchar(4000),@p1068 nvarchar(4000),@p1069 nvarchar(4000),@p1070 nvarchar(4000),@p1071 nvarchar(4000),@p1072 nvarchar(4000),@p1073 nvarchar(4000),@p1074 nvarchar(4000),@p1075 datetime2(7),@p1076 nvarchar(4000),@p1077 nvarchar(4000),@p1078 int,@p1079 int,@p1080 int,@p1081 nvarchar(4000),@p1082 nvarchar(4000),@p1083 nvarchar(4000),@p1084 nvarchar(4000),@p1085 decimal(18,2),@p1086 nvarchar(4000),@p1087 nvarchar(4000),@p1088 decimal(18,2),@p1089 nvarchar(4000),@p1090 nvarchar(4000),@p1091 nvarchar(4000),@p1092 nvarchar(4000),@p1093 int,@p1094 nvarchar(4000),@p1095 nvarchar(4000),@p1096 nvarchar(4000),@p1097 nvarchar(4000),@p1098 nvarchar(4000),@p1099 nvarchar(4000),@p1100 nvarchar(4000),@p1101 nvarchar(4000),@p1102 nvarchar(4000),@p1103 nvarchar(4000),@p1104 int,@p1105 nvarchar(4000),@p1106 nvarchar(4000),@p1107 nvarchar(4000),@p1108 nvarchar(4000),@p1109 nvarchar(4000),@p1110 int,@p1111 nvarchar(4000),@p1112 int,@p1113 int,@p1114 datetime2(7),@p1115 datetime2(7),@p1116 datetime2(7),@p1117 nvarchar(4000),@p1118 nvarchar(4000),@p1119 nvarchar(4000),@p1120 nvarchar(4000),@p1121 nvarchar(4000),@p1122 nvarchar(4000),@p1123 nvarchar(4000),@p1124 nvarchar(4000),@p1125 nvarchar(4000),@p1126 nvarchar(4000),@p1127 nvarchar(4000),@p1128 nvarchar(4000),@p1129 nvarchar(4000),@p1130 nvarchar(4000),@p1131 datetime2(7),@p1132 nvarchar(4000),@p1133 nvarchar(4000),@p1134 int,@p1135 int,@p1136 int,@p1137 nvarchar(4000),@p1138 nvarchar(4000),@p1139 nvarchar(4000),@p1140 nvarchar(4000),@p1141 decimal(18,2),@p1142 nvarchar(4000),@p1143 nvarchar(4000),@p1144 decimal(18,2),@p1145 nvarchar(4000),@p1146 nvarchar(4000),@p1147 nvarchar(4000),@p1148 nvarchar(4000),@p1149 int,@p1150 nvarchar(4000),@p1151 nvarchar(4000),@p1152 nvarchar(4000),@p1153 nvarchar(4000),@p1154 nvarchar(4000),@p1155 nvarchar(4000),@p1156 nvarchar(4000),@p1157 nvarchar(4000),@p1158 nvarchar(4000),@p1159 nvarchar(4000),@p1160 int,@p1161 nvarchar(4000),@p1162 nvarchar(4000),@p1163 nvarchar(4000),@p1164 nvarchar(4000),@p1165 nvarchar(4000),@p1166 int,@p1167 nvarchar(4000),@p1168 int,@p1169 int,@p1170 datetime2(7),@p1171 datetime2(7),@p1172 datetime2(7),@p1173 nvarchar(4000),@p1174 nvarchar(4000),@p1175 nvarchar(4000),@p1176 nvarchar(4000),@p1177 nvarchar(4000),@p1178 nvarchar(4000),@p1179 nvarchar(4000),@p1180 nvarchar(4000),@p1181 nvarchar(4000),@p1182 nvarchar(4000),@p1183 nvarchar(4000),@p1184 nvarchar(4000),@p1185 nvarchar(4000),@p1186 nvarchar(4000),@p1187 datetime2(7),@p1188 nvarchar(4000),@p1189 nvarchar(4000),@p1190 int,@p1191 int,@p1192 int,@p1193 nvarchar(4000),@p1194 nvarchar(4000),@p1195 nvarchar(4000),@p1196 nvarchar(4000),@p1197 decimal(18,2),@p1198 nvarchar(4000),@p1199 nvarchar(4000),@p1200 decimal(18,2),@p1201 nvarchar(4000),@p1202 nvarchar(4000),@p1203 nvarchar(4000),@p1204 nvarchar(4000),@p1205 int,@p1206 nvarchar(4000),@p1207 nvarchar(4000),@p1208 nvarchar(4000),@p1209 nvarchar(4000),@p1210 nvarchar(4000),@p1211 nvarchar(4000),@p1212 nvarchar(4000),@p1213 nvarchar(4000),@p1214 nvarchar(4000),@p1215 nvarchar(4000),@p1216 int,@p1217 nvarchar(4000),@p1218 nvarchar(4000),@p1219 nvarchar(4000),@p1220 nvarchar(4000),@p1221 nvarchar(4000),@p1222 int,@p1223 nvarchar(4000),@p1224 int,@p1225 int,@p1226 datetime2(7),@p1227 datetime2(7),@p1228 datetime2(7),@p1229 nvarchar(4000),@p1230 nvarchar(4000),@p1231 nvarchar(4000),@p1232 nvarchar(4000),@p1233 nvarchar(4000),@p1234 nvarchar(4000),@p1235 nvarchar(4000),@p1236 nvarchar(4000),@p1237 nvarchar(4000),@p1238 nvarchar(4000),@p1239 nvarchar(4000),@p1240 nvarchar(4000),@p1241 nvarchar(4000),@p1242 nvarchar(4000),@p1243 datetime2(7),@p1244 nvarchar(4000),@p1245 nvarchar(4000),@p1246 int,@p1247 int,@p1248 int,@p1249 nvarchar(4000),@p1250 nvarchar(4000),@p1251 nvarchar(4000),@p1252 nvarchar(4000),@p1253 decimal(18,2),@p1254 nvarchar(4000),@p1255 nvarchar(4000),@p1256 decimal(18,2),@p1257 nvarchar(4000),@p1258 nvarchar(4000),@p1259 nvarchar(4000),@p1260 nvarchar(4000),@p1261 int,@p1262 nvarchar(4000),@p1263 nvarchar(4000),@p1264 nvarchar(4000),@p1265 nvarchar(4000),@p1266 nvarchar(4000),@p1267 nvarchar(4000),@p1268 nvarchar(4000),@p1269 nvarchar(4000),@p1270 nvarchar(4000),@p1271 nvarchar(4000),@p1272 int,@p1273 nvarchar(4000),@p1274 nvarchar(4000),@p1275 nvarchar(4000),@p1276 nvarchar(4000),@p1277 nvarchar(4000),@p1278 int,@p1279 nvarchar(4000),@p1280 int,@p1281 int,@p1282 datetime2(7),@p1283 datetime2(7),@p1284 datetime2(7),@p1285 nvarchar(4000),@p1286 nvarchar(4000),@p1287 nvarchar(4000),@p1288 nvarchar(4000),@p1289 nvarchar(4000),@p1290 nvarchar(4000),@p1291 nvarchar(4000),@p1292 nvarchar(4000),@p1293 nvarchar(4000),@p1294 nvarchar(4000),@p1295 nvarchar(4000),@p1296 nvarchar(4000),@p1297 nvarchar(4000),@p1298 nvarchar(4000),@p1299 datetime2(7),@p1300 nvarchar(4000),@p1301 nvarchar(4000),@p1302 int,@p1303 int,@p1304 int,@p1305 nvarchar(4000),@p1306 nvarchar(4000),@p1307 nvarchar(4000),@p1308 nvarchar(4000),@p1309 decimal(18,2),@p1310 nvarchar(4000),@p1311 nvarchar(4000),@p1312 decimal(18,2),@p1313 nvarchar(4000),@p1314 nvarchar(4000),@p1315 nvarchar(4000),@p1316 nvarchar(4000),@p1317 int,@p1318 nvarchar(4000),@p1319 nvarchar(4000),@p1320 nvarchar(4000),@p1321 nvarchar(4000),@p1322 nvarchar(4000),@p1323 nvarchar(4000),@p1324 nvarchar(4000),@p1325 nvarchar(4000),@p1326 nvarchar(4000),@p1327 nvarchar(4000),@p1328 int,@p1329 nvarchar(4000),@p1330 nvarchar(4000),@p1331 nvarchar(4000),@p1332 nvarchar(4000),@p1333 nvarchar(4000),@p1334 int,@p1335 nvarchar(4000),@p1336 int,@p1337 int,@p1338 datetime2(7),@p1339 datetime2(7),@p1340 datetime2(7),@p1341 nvarchar(4000),@p1342 nvarchar(4000),@p1343 nvarchar(4000),@p1344 nvarchar(4000),@p1345 nvarchar(4000),@p1346 nvarchar(4000),@p1347 nvarchar(4000),@p1348 nvarchar(4000),@p1349 nvarchar(4000),@p1350 nvarchar(4000),@p1351 nvarchar(4000),@p1352 nvarchar(4000),@p1353 nvarchar(4000),@p1354 nvarchar(4000),@p1355 datetime2(7),@p1356 nvarchar(4000),@p1357 nvarchar(4000),@p1358 int,@p1359 int,@p1360 int,@p1361 nvarchar(4000),@p1362 nvarchar(4000),@p1363 nvarchar(4000),@p1364 nvarchar(4000),@p1365 decimal(18,2),@p1366 nvarchar(4000),@p1367 nvarchar(4000),@p1368 decimal(18,2),@p1369 nvarchar(4000),@p1370 nvarchar(4000),@p1371 nvarchar(4000),@p1372 nvarchar(4000),@p1373 int,@p1374 nvarchar(4000),@p1375 nvarchar(4000),@p1376 nvarchar(4000),@p1377 nvarchar(4000),@p1378 nvarchar(4000),@p1379 nvarchar(4000),@p1380 nvarchar(4000),@p1381 nvarchar(4000),@p1382 nvarchar(4000),@p1383 nvarchar(4000),@p1384 int,@p1385 nvarchar(4000),@p1386 nvarchar(4000),@p1387 nvarchar(4000),@p1388 nvarchar(4000),@p1389 nvarchar(4000),@p1390 int,@p1391 nvarchar(4000),@p1392 int,@p1393 int,@p1394 datetime2(7),@p1395 datetime2(7),@p1396 datetime2(7),@p1397 nvarchar(4000),@p1398 nvarchar(4000),@p1399 nvarchar(4000),@p1400 nvarchar(4000),@p1401 nvarchar(4000),@p1402 nvarchar(4000),@p1403 nvarchar(4000),@p1404 nvarchar(4000),@p1405 nvarchar(4000),@p1406 nvarchar(4000),@p1407 nvarchar(4000),@p1408 nvarchar(4000),@p1409 nvarchar(4000),@p1410 nvarchar(4000),@p1411 datetime2(7),@p1412 nvarchar(4000),@p1413 nvarchar(4000),@p1414 int,@p1415 int,@p1416 int,@p1417 nvarchar(4000),@p1418 nvarchar(4000),@p1419 nvarchar(4000),@p1420 nvarchar(4000),@p1421 decimal(18,2),@p1422 nvarchar(4000),@p1423 nvarchar(4000),@p1424 decimal(18,2),@p1425 nvarchar(4000),@p1426 nvarchar(4000),@p1427 nvarchar(4000),@p1428 nvarchar(4000),@p1429 int,@p1430 nvarchar(4000),@p1431 nvarchar(4000),@p1432 nvarchar(4000),@p1433 nvarchar(4000),@p1434 nvarchar(4000),@p1435 nvarchar(4000),@p1436 nvarchar(4000),@p1437 nvarchar(4000),@p1438 nvarchar(4000),@p1439 nvarchar(4000),@p1440 int,@p1441 nvarchar(4000),@p1442 nvarchar(4000),@p1443 nvarchar(4000),@p1444 nvarchar(4000),@p1445 nvarchar(4000),@p1446 int,@p1447 nvarchar(4000),@p1448 int,@p1449 int,@p1450 datetime2(7),@p1451 datetime2(7),@p1452 datetime2(7),@p1453 nvarchar(4000),@p1454 nvarchar(4000),@p1455 nvarchar(4000),@p1456 nvarchar(4000),@p1457 nvarchar(4000),@p1458 nvarchar(4000),@p1459 nvarchar(4000),@p1460 nvarchar(4000),@p1461 nvarchar(4000),@p1462 nvarchar(4000),@p1463 nvarchar(4000),@p1464 nvarchar(4000),@p1465 nvarchar(4000),@p1466 nvarchar(4000),@p1467 datetime2(7),@p1468 nvarchar(4000),@p1469 nvarchar(4000),@p1470 int,@p1471 int,@p1472 int,@p1473 nvarchar(4000),@p1474 nvarchar(4000),@p1475 nvarchar(4000),@p1476 nvarchar(4000),@p1477 decimal(18,2),@p1478 nvarchar(4000),@p1479 nvarchar(4000),@p1480 decimal(18,2),@p1481 nvarchar(4000),@p1482 nvarchar(4000),@p1483 nvarchar(4000),@p1484 nvarchar(4000),@p1485 int,@p1486 nvarchar(4000),@p1487 nvarchar(4000),@p1488 nvarchar(4000),@p1489 nvarchar(4000),@p1490 nvarchar(4000),@p1491 nvarchar(4000),@p1492 nvarchar(4000),@p1493 nvarchar(4000),@p1494 nvarchar(4000),@p1495 nvarchar(4000),@p1496 int,@p1497 nvarchar(4000),@p1498 nvarchar(4000),@p1499 nvarchar(4000),@p1500 nvarchar(4000),@p1501 nvarchar(4000),@p1502 int,@p1503 nvarchar(4000),@p1504 int,@p1505 int,@p1506 datetime2(7),@p1507 datetime2(7),@p1508 datetime2(7),@p1509 nvarchar(4000),@p1510 nvarchar(4000),@p1511 nvarchar(4000),@p1512 nvarchar(4000),@p1513 nvarchar(4000),@p1514 nvarchar(4000),@p1515 nvarchar(4000),@p1516 nvarchar(4000),@p1517 nvarchar(4000),@p1518 nvarchar(4000),@p1519 nvarchar(4000),@p1520 nvarchar(4000),@p1521 nvarchar(4000),@p1522 nvarchar(4000),@p1523 datetime2(7),@p1524 nvarchar(4000),@p1525 nvarchar(4000),@p1526 int,@p1527 int,@p1528 int,@p1529 nvarchar(4000),@p1530 nvarchar(4000),@p1531 nvarchar(4000),@p1532 nvarchar(4000),@p1533 decimal(18,2),@p1534 nvarchar(4000),@p1535 nvarchar(4000),@p1536 decimal(18,2),@p1537 nvarchar(4000),@p1538 nvarchar(4000),@p1539 nvarchar(4000),@p1540 nvarchar(4000),@p1541 int,@p1542 nvarchar(4000),@p1543 nvarchar(4000),@p1544 nvarchar(4000),@p1545 nvarchar(4000),@p1546 nvarchar(4000),@p1547 nvarchar(4000),@p1548 nvarchar(4000),@p1549 nvarchar(4000),@p1550 nvarchar(4000),@p1551 nvarchar(4000),@p1552 int,@p1553 nvarchar(4000),@p1554 nvarchar(4000),@p1555 nvarchar(4000),@p1556 nvarchar(4000),@p1557 nvarchar(4000),@p1558 int,@p1559 nvarchar(4000),@p1560 int,@p1561 int,@p1562 datetime2(7),@p1563 datetime2(7),@p1564 datetime2(7),@p1565 nvarchar(4000),@p1566 nvarchar(4000),@p1567 nvarchar(4000),@p1568 nvarchar(4000),@p1569 nvarchar(4000),@p1570 nvarchar(4000),@p1571 nvarchar(4000),@p1572 nvarchar(4000),@p1573 nvarchar(4000),@p1574 nvarchar(4000),@p1575 nvarchar(4000),@p1576 nvarchar(4000),@p1577 nvarchar(4000),@p1578 nvarchar(4000),@p1579 datetime2(7),@p1580 nvarchar(4000),@p1581 nvarchar(4000),@p1582 int,@p1583 int,@p1584 int,@p1585 nvarchar(4000),@p1586 nvarchar(4000),@p1587 nvarchar(4000),@p1588 nvarchar(4000),@p1589 decimal(18,2),@p1590 nvarchar(4000),@p1591 nvarchar(4000),@p1592 decimal(18,2),@p1593 nvarchar(4000),@p1594 nvarchar(4000),@p1595 nvarchar(4000),@p1596 nvarchar(4000),@p1597 int,@p1598 nvarchar(4000),@p1599 nvarchar(4000),@p1600 nvarchar(4000),@p1601 nvarchar(4000),@p1602 nvarchar(4000),@p1603 nvarchar(4000),@p1604 nvarchar(4000),@p1605 nvarchar(4000),@p1606 nvarchar(4000),@p1607 nvarchar(4000),@p1608 int,@p1609 nvarchar(4000),@p1610 nvarchar(4000),@p1611 nvarchar(4000),@p1612 nvarchar(4000),@p1613 nvarchar(4000),@p1614 int,@p1615 nvarchar(4000),@p1616 int,@p1617 int,@p1618 datetime2(7),@p1619 datetime2(7),@p1620 datetime2(7),@p1621 nvarchar(4000),@p1622 nvarchar(4000),@p1623 nvarchar(4000),@p1624 nvarchar(4000),@p1625 nvarchar(4000),@p1626 nvarchar(4000),@p1627 nvarchar(4000),@p1628 nvarchar(4000),@p1629 nvarchar(4000),@p1630 nvarchar(4000),@p1631 nvarchar(4000),@p1632 nvarchar(4000),@p1633 nvarchar(4000),@p1634 nvarchar(4000),@p1635 datetime2(7),@p1636 nvarchar(4000),@p1637 nvarchar(4000),@p1638 int,@p1639 int,@p1640 int,@p1641 nvarchar(4000),@p1642 nvarchar(4000),@p1643 nvarchar(4000),@p1644 nvarchar(4000),@p1645 decimal(18,2),@p1646 nvarchar(4000),@p1647 nvarchar(4000),@p1648 decimal(18,2),@p1649 nvarchar(4000),@p1650 nvarchar(4000),@p1651 nvarchar(4000),@p1652 nvarchar(4000),@p1653 int,@p1654 nvarchar(4000),@p1655 nvarchar(4000),@p1656 nvarchar(4000),@p1657 nvarchar(4000),@p1658 nvarchar(4000),@p1659 nvarchar(4000),@p1660 nvarchar(4000),@p1661 nvarchar(4000),@p1662 nvarchar(4000),@p1663 nvarchar(4000),@p1664 int,@p1665 nvarchar(4000),@p1666 nvarchar(4000),@p1667 nvarchar(4000),@p1668 nvarchar(4000),@p1669 nvarchar(4000),@p1670 int,@p1671 nvarchar(4000),@p1672 int,@p1673 int,@p1674 datetime2(7),@p1675 datetime2(7),@p1676 datetime2(7),@p1677 nvarchar(4000),@p1678 nvarchar(4000),@p1679 nvarchar(4000),@p1680 nvarchar(4000),@p1681 nvarchar(4000),@p1682 nvarchar(4000),@p1683 nvarchar(4000),@p1684 nvarchar(4000),@p1685 nvarchar(4000),@p1686 nvarchar(4000),@p1687 nvarchar(4000),@p1688 nvarchar(4000),@p1689 nvarchar(4000),@p1690 nvarchar(4000),@p1691 datetime2(7),@p1692 nvarchar(4000),@p1693 nvarchar(4000),@p1694 int,@p1695 int,@p1696 int,@p1697 nvarchar(4000),@p1698 nvarchar(4000),@p1699 nvarchar(4000),@p1700 nvarchar(4000),@p1701 decimal(18,2),@p1702 nvarchar(4000),@p1703 nvarchar(4000),@p1704 decimal(18,2),@p1705 nvarchar(4000),@p1706 nvarchar(4000),@p1707 nvarchar(4000),@p1708 nvarchar(4000),@p1709 int,@p1710 nvarchar(4000),@p1711 nvarchar(4000),@p1712 nvarchar(4000),@p1713 nvarchar(4000),@p1714 nvarchar(4000),@p1715 nvarchar(4000),@p1716 nvarchar(4000),@p1717 nvarchar(4000),@p1718 nvarchar(4000),@p1719 nvarchar(4000),@p1720 int,@p1721 nvarchar(4000),@p1722 nvarchar(4000),@p1723 nvarchar(4000),@p1724 nvarchar(4000),@p1725 nvarchar(4000),@p1726 int,@p1727 nvarchar(4000),@p1728 int,@p1729 int,@p1730 datetime2(7),@p1731 datetime2(7),@p1732 datetime2(7),@p1733 nvarchar(4000),@p1734 nvarchar(4000),@p1735 nvarchar(4000),@p1736 nvarchar(4000),@p1737 nvarchar(4000),@p1738 nvarchar(4000),@p1739 nvarchar(4000),@p1740 nvarchar(4000),@p1741 nvarchar(4000),@p1742 nvarchar(4000),@p1743 nvarchar(4000),@p1744 nvarchar(4000),@p1745 nvarchar(4000),@p1746 nvarchar(4000),@p1747 datetime2(7),@p1748 nvarchar(4000),@p1749 nvarchar(4000),@p1750 int,@p1751 int,@p1752 int,@p1753 nvarchar(4000),@p1754 nvarchar(4000),@p1755 nvarchar(4000),@p1756 decimal(18,2),@p1757 decimal(18,2),@p1758 nvarchar(4000),@p1759 nvarchar(4000),@p1760 decimal(18,2),@p1761 nvarchar(4000),@p1762 nvarchar(4000),@p1763 nvarchar(4000),@p1764 nvarchar(4000),@p1765 int,@p1766 nvarchar(4000),@p1767 nvarchar(4000),@p1768 nvarchar(4000),@p1769 nvarchar(4000),@p1770 nvarchar(4000),@p1771 nvarchar(4000),@p1772 nvarchar(4000),@p1773 nvarchar(4000),@p1774 nvarchar(4000),@p1775 nvarchar(4000),@p1776 int,@p1777 nvarchar(4000),@p1778 nvarchar(4000),@p1779 nvarchar(4000),@p1780 nvarchar(4000),@p1781 nvarchar(4000),@p1782 int,@p1783 nvarchar(4000),@p1784 int,@p1785 int,@p1786 datetime2(7),@p1787 datetime2(7),@p1788 datetime2(7),@p1789 nvarchar(4000),@p1790 nvarchar(4000),@p1791 nvarchar(4000),@p1792 nvarchar(4000),@p1793 nvarchar(4000),@p1794 nvarchar(4000),@p1795 nvarchar(4000),@p1796 nvarchar(4000),@p1797 nvarchar(4000),@p1798 nvarchar(4000),@p1799 nvarchar(4000),@p1800 nvarchar(4000),@p1801 nvarchar(4000),@p1802 nvarchar(4000),@p1803 datetime2(7),@p1804 nvarchar(4000),@p1805 nvarchar(4000),@p1806 int,@p1807 int,@p1808 int,@p1809 nvarchar(4000),@p1810 nvarchar(4000),@p1811 nvarchar(4000),@p1812 nvarchar(4000),@p1813 decimal(18,2),@p1814 nvarchar(4000),@p1815 nvarchar(4000),@p1816 decimal(18,2),@p1817 nvarchar(4000),@p1818 nvarchar(4000),@p1819 nvarchar(4000),@p1820 nvarchar(4000),@p1821 int,@p1822 nvarchar(4000),@p1823 nvarchar(4000),@p1824 nvarchar(4000),@p1825 nvarchar(4000),@p1826 nvarchar(4000),@p1827 nvarchar(4000),@p1828 nvarchar(4000),@p1829 nvarchar(4000),@p1830 nvarchar(4000),@p1831 nvarchar(4000),@p1832 int,@p1833 nvarchar(4000),@p1834 nvarchar(4000),@p1835 nvarchar(4000),@p1836 nvarchar(4000),@p1837 nvarchar(4000),@p1838 int,@p1839 nvarchar(4000),@p1840 int,@p1841 int,@p1842 datetime2(7),@p1843 datetime2(7),@p1844 datetime2(7),@p1845 nvarchar(4000),@p1846 nvarchar(4000),@p1847 nvarchar(4000),@p1848 nvarchar(4000),@p1849 nvarchar(4000),@p1850 nvarchar(4000),@p1851 nvarchar(4000),@p1852 nvarchar(4000),@p1853 nvarchar(4000),@p1854 nvarchar(4000),@p1855 nvarchar(4000),@p1856 nvarchar(4000),@p1857 nvarchar(4000),@p1858 nvarchar(4000),@p1859 datetime2(7),@p1860 nvarchar(4000),@p1861 nvarchar(4000),@p1862 int,@p1863 int,@p1864 int,@p1865 nvarchar(4000),@p1866 nvarchar(4000),@p1867 nvarchar(4000),@p1868 nvarchar(4000),@p1869 decimal(18,2),@p1870 nvarchar(4000),@p1871 nvarchar(4000),@p1872 decimal(18,2),@p1873 nvarchar(4000),@p1874 nvarchar(4000),@p1875 nvarchar(4000),@p1876 nvarchar(4000),@p1877 int,@p1878 nvarchar(4000),@p1879 nvarchar(4000),@p1880 nvarchar(4000),@p1881 nvarchar(4000),@p1882 nvarchar(4000),@p1883 nvarchar(4000),@p1884 nvarchar(4000),@p1885 nvarchar(4000),@p1886 nvarchar(4000),@p1887 nvarchar(4000),@p1888 int,@p1889 nvarchar(4000),@p1890 nvarchar(4000),@p1891 nvarchar(4000),@p1892 nvarchar(4000),@p1893 nvarchar(4000),@p1894 int,@p1895 nvarchar(4000),@p1896 int,@p1897 int,@p1898 datetime2(7),@p1899 datetime2(7),@p1900 datetime2(7),@p1901 nvarchar(4000),@p1902 nvarchar(4000),@p1903 nvarchar(4000),@p1904 nvarchar(4000),@p1905 nvarchar(4000),@p1906 nvarchar(4000),@p1907 nvarchar(4000),@p1908 nvarchar(4000),@p1909 nvarchar(4000),@p1910 nvarchar(4000),@p1911 nvarchar(4000),@p1912 nvarchar(4000),@p1913 nvarchar(4000),@p1914 nvarchar(4000),@p1915 datetime2(7),@p1916 nvarchar(4000),@p1917 nvarchar(4000),@p1918 int,@p1919 int,@p1920 int,@p1921 nvarchar(4000),@p1922 nvarchar(4000),@p1923 nvarchar(4000),@p1924 nvarchar(4000),@p1925 decimal(18,2),@p1926 nvarchar(4000),@p1927 nvarchar(4000),@p1928 decimal(18,2),@p1929 nvarchar(4000),@p1930 nvarchar(4000),@p1931 nvarchar(4000),@p1932 nvarchar(4000),@p1933 int,@p1934 nvarchar(4000),@p1935 nvarchar(4000),@p1936 nvarchar(4000),@p1937 nvarchar(4000),@p1938 nvarchar(4000),@p1939 nvarchar(4000),@p1940 nvarchar(4000),@p1941 nvarchar(4000),@p1942 nvarchar(4000),@p1943 nvarchar(4000),@p1944 int,@p1945 nvarchar(4000),@p1946 nvarchar(4000),@p1947 nvarchar(4000),@p1948 nvarchar(4000),@p1949 nvarchar(4000),@p1950 int,@p1951 nvarchar(4000),@p1952 int,@p1953 int,@p1954 datetime2(7),@p1955 datetime2(7),@p1956 datetime2(7),@p1957 nvarchar(4000),@p1958 nvarchar(4000),@p1959 nvarchar(4000),@p1960 nvarchar(4000),@p1961 nvarchar(4000),@p1962 nvarchar(4000),@p1963 nvarchar(4000),@p1964 nvarchar(4000),@p1965 nvarchar(4000),@p1966 nvarchar(4000),@p1967 nvarchar(4000),@p1968 nvarchar(4000),@p1969 nvarchar(4000),@p1970 nvarchar(4000),@p1971 datetime2(7),@p1972 nvarchar(4000),@p1973 nvarchar(4000),@p1974 int,@p1975 int,@p1976 int,@p1977 nvarchar(4000),@p1978 nvarchar(4000),@p1979 nvarchar(4000),@p1980 nvarchar(4000),@p1981 decimal(18,2),@p1982 nvarchar(4000),@p1983 nvarchar(4000),@p1984 decimal(18,2),@p1985 nvarchar(4000),@p1986 nvarchar(4000),@p1987 nvarchar(4000),@p1988 nvarchar(4000),@p1989 int,@p1990 nvarchar(4000),@p1991 nvarchar(4000),@p1992 nvarchar(4000),@p1993 nvarchar(4000),@p1994 nvarchar(4000),@p1995 nvarchar(4000),@p1996 nvarchar(4000),@p1997 nvarchar(4000),@p1998 nvarchar(4000),@p1999 nvarchar(4000),@p2000 int,@p2001 nvarchar(4000),@p2002 nvarchar(4000),@p2003 nvarchar(4000),@p2004 nvarchar(4000),@p2005 nvarchar(4000),@p2006 int,@p2007 nvarchar(4000),@p2008 int,@p2009 int,@p2010 datetime2(7),@p2011 datetime2(7),@p2012 datetime2(7),@p2013 nvarchar(4000),@p2014 nvarchar(4000),@p2015 nvarchar(4000),@p2016 nvarchar(4000),@p2017 nvarchar(4000),@p2018 nvarchar(4000),@p2019 nvarchar(4000),@p2020 nvarchar(4000),@p2021 nvarchar(4000),@p2022 nvarchar(4000),@p2023 nvarchar(4000),@p2024 nvarchar(4000),@p2025 nvarchar(4000),@p2026 nvarchar(4000),@p2027 datetime2(7),@p2028 nvarchar(4000),@p2029 nvarchar(4000),@p2030 int,@p2031 int,@p2032 int,@p2033 nvarchar(4000),@p2034 nvarchar(4000),@p2035 nvarchar(4000),@p2036 nvarchar(4000),@p2037 decimal(18,2),@p2038 nvarchar(4000),@p2039 nvarchar(4000),@p2040 decimal(18,2),@p2041 nvarchar(4000),@p2042 nvarchar(4000),@p2043 nvarchar(4000),@p2044 nvarchar(4000),@p2045 int,@p2046 nvarchar(4000),@p2047 nvarchar(4000),@p2048 nvarchar(4000),@p2049 nvarchar(4000),@p2050 nvarchar(4000),@p2051 nvarchar(4000),@p2052 nvarchar(4000),@p2053 nvarchar(4000),@p2054 nvarchar(4000),@p2055 nvarchar(4000),@p2056 int,@p2057 nvarchar(4000),@p2058 nvarchar(4000),@p2059 nvarchar(4000),@p2060 nvarchar(4000),@p2061 nvarchar(4000),@p2062 int,@p2063 nvarchar(4000),@p2064 int,@p2065 int,@p2066 datetime2(7),@p2067 datetime2(7),@p2068 datetime2(7),@p2069 nvarchar(4000),@p2070 nvarchar(4000),@p2071 nvarchar(4000))SET NOCOUNT ON; DECLARE @inserted0 TABLE ([item_id] int, [_Position] [int]); MERGE [raw_data] USING ( VALUES (@p0, @p1, @p2, @p3, @p4, @p5, @p6, @p7, @p8, @p9, @p10, @p11, @p12, @p13, @p14, @p15, @p16, @p17, @p18, @p19, @p20, @p21, @p22, @p23, @p24, @p25, @p26, @p27, @p28, @p29, @p30, @p31, @p32, @p33, @p34, @p35, @p36, @p37, @p38, @p39, @p40, @p41, @p42, @p43, @p44, @p45, @p46, @p47, @p48, @p49, @p50, @p51, @p52, @p53, @p54, @p55, 0), (@p56, @p57, @p58, @p59, @p60, @p61, @p62, @p63, @p64, @p65, @p66, @p67, @p68, @p69, @p70, @p71, @p72, @p73, @p74, @p75, @p76, @p77, @p78, @p79, @p80, @p81, @p82, @p83, @p84, @p85, @p86, @p87, @p88, @p89, @p90, @p91, @p92, @p93, @p94, @p95, @p96, @p97, @p98, @p99, @p100, @p101, @p102, @p103, @p104, @p105, @p106, @p107, @p108, @p109, @p110, @p111, 1), (@p112, @p113, @p114, @p115, @p116, @p117, @p118, @p119, @p120, @p121, @p122, @p123, @p124, @p125, @p126, @p127, @p128, @p129, @p130, @p131, @p132, @p133, @p134, @p135, @p136, @p137, @p138, @p139, @p140, @p141, @p142, @p143, @p144, @p145, @p146, @p147, @p148, @p149, @p150, @p151, @p152, @p153, @p154, @p155, @p156, @p157, @p158, @p159, @p160, @p161, @p162, @p163, @p164, @p165, @p166, @p167, 2), (@p168, @p169, @p170, @p171, @p172, @p173, @p174, @p175, @p176, @p177, @p178, @p179, @p180, @p181, @p182, @p183, @p184, @p185, @p186, @p187, @p188, @p189, @p190, @p191, @p192, @p193, @p194, @p195, @p196, @p197, @p198, @p199, @p200, @p201, @p202, @p203, @p204, @p205, @p206, @p207, @p208, @p209, @p210, @p211, @p212, @p213, @p214, @p215, @p216, @p217, @p218, @p219, @p220, @p221, @p222, @p223, 3), (@p224, @p225, @p226, @p227, @p228, @p229, @p230, @p231, @p232, @p233, @p234, @p235, @p236, @p237, @p238, @p239, @p240, @p241, @p242, @p243, @p244, @p245, @p246, @p247, @p248, @p249, @p250, @p251, @p252, @p253, @p254, @p255, @p256, @p257, @p258, @p259, @p260, @p261, @p262, @p263, @p264, @p265, @p266, @p267, @p268, @p269, @p270, @p271, @p272, @p273, @p274, @p275, @p276, @p277, @p278, @p279, 4), (@p280, @p281, @p282, @p283, @p284, @p285, @p286, @p287, @p288, @p289, @p290, @p291, @p292, @p293, @p294, @p295, @p296, @p297, @p298, @p299, @p300, @p301, @p302, @p303, @p304, @p305, @p306, @p307, @p308, @p309, @p310, @p311, @p312, @p313, @p314, @p315, @p316, @p317, @p318, @p319, @p320, @p321, @p322, @p323, @p324, @p325, @p326, @p327, @p328, @p329, @p330, @p331, @p332, @p333, @p334, @p335, 5), (@p336, @p337, @p338, @p339, @p340, @p341, @p342, @p343, @p344, @p345, @p346, @p347, @p348, @p349, @p350, @p351, @p352, @p353, @p354, @p355, @p356, @p357, @p358, @p359, @p360, @p361, @p362, @p363, @p364, @p365, @p366, @p367, @p368, @p369, @p370, @p371, @p372, @p373, @p374, @p375, @p376, @p377, @p378, @p379, @p380, @p381, @p382, @p383, @p384, @p385, @p386, @p387, @p388, @p389, @p390, @p391, 6), (@p392, @p393, @p394, @p395, @p396, @p397, @p398, @p399, @p400, @p401, @p402, @p403, @p404, @p405, @p406, @p407, @p408, @p409, @p410, @p411, @p412, @p413, @p414, @p415, @p416, @p417, @p418, @p419, @p420, @p421, @p422, @p423, @p424, @p425, @p426, @p427, @p428, @p429, @p430, @p431, @p432, @p433, @p434, @p435, @p436, @p437, @p438, @p439, @p440, @p441, @p442, @p443, @p444, @p445, @p446, @p447, 7), (@p448, @p449, @p450, @p451, @p452, @p453, @p454, @p455, @p456, @p457, @p458, @p459, @p460, @p461, @p462, @p463, @p464, @p465, @p466, @p467, @p468, @p469, @p470, @p471, @p472, @p473, @p474, @p475, @p476, @p477, @p478, @p479, @p480, @p481, @p482, @p483, @p484, @p485, @p486, @p487, @p488, @p489, @p490, @p491, @p492, @p493, @p494, @p495, @p496, @p497, @p498, @p499, @p500, @p501, @p502, @p503, 8), (@p504, @p505, @p506, @p507, @p508, @p509, @p510, @p511, @p512, @p513, @p514, @p515, @p516, @p517, @p518, @p519, @p520, @p521, @p522, @p523, @p524, @p525, @p526, @p527, @p528, @p529, @p530, @p531, @p532, @p533, @p534, @p535, @p536, @p537, @p538, @p539, @p540, @p541, @p542, @p543, @p544, @p545, @p546, @p547, @p548, @p549, @p550, @p551, @p552, @p553, @p554, @p555, @p556, @p557, @p558, @p559, 9), (@p560, @p561, @p562, @p563, @p564, @p565, @p566, @p567, @p568, @p569, @p570, @p571, @p572, @p573, @p574, @p575, @p576, @p577, @p578, @p579, @p580, @p581, @p582, @p583, @p584, @p585, @p586, @p587, @p588, @p589, @p590, @p591, @p592, @p593, @p594, @p595, @p596, @p597, @p598, @p599, @p600, @p601, @p602, @p603, @p604, @p605, @p606, @p607, @p608, @p609, @p610, @p611, @p612, @p613, @p614, @p615, 10), (@p616, @p617, @p618, @p619, @p620, @p621, @p622, @p623, @p624, @p625, @p626, @p627, @p628, @p629, @p630, @p631, @p632, @p633, @p634, @p635, @p636, @p637, @p638, @p639, @p640, @p641, @p642, @p643, @p644, @p645, @p646, @p647, @p648, @p649, @p650, @p651, @p652, @p653, @p654, @p655, @p656, @p657, @p658, @p659, @p660, @p661, @p662, @p663, @p664, @p665, @p666, @p667, @p668, @p669, @p670, @p671, 11), (@p672, @p673, @p674, @p675, @p676, @p677, @p678, @p679, @p680, @p681, @p682, @p683, @p684, @p685, @p686, @p687, @p688, @p689, @p690, @p691, @p692, @p693, @p694, @p695, @p696, @p697, @p698, @p699, @p700, @p701, @p702, @p703, @p704, @p705, @p706, @p707, @p708, @p709, @p710, @p711, @p712, @p713, @p714, @p715, @p716, @p717, @p718, @p719, @p720, @p721, @p722, @p723, @p724, @p725, @p726, @p727, 12), (@p728, @p729, @p730, @p731, @p732, @p733, @p734, @p735, @p736, @p737, @p738, @p739, @p740, @p741, @p742, @p743, @p744, @p745, @p746, @p747, @p748, @p749, @p750, @p751, @p752, @p753, @p754, @p755, @p756, @p757, @p758, @p759, @p760, @p761, @p762, @p763, @p764, @p765, @p766, @p767, @p768, @p769, @p770, @p771, @p772, @p773, @p774, @p775, @p776, @p777, @p778, @p779, @p780, @p781, @p782, @p783, 13), (@p784, @p785, @p786, @p787, @p788, @p789, @p790, @p791, @p792, @p793, @p794, @p795, @p796, @p797, @p798, @p799, @p800, @p801, @p802, @p803, @p804, @p805, @p806, @p807, @p808, @p809, @p810, @p811, @p812, @p813, @p814, @p815, @p816, @p817, @p818, @p819, @p820, @p821, @p822, @p823, @p824, @p825, @p826, @p827, @p828, @p829, @p830, @p831, @p832, @p833, @p834, @p835, @p836, @p837, @p838, @p839, 14), (@p840, @p841, @p842, @p843, @p844, @p845, @p846, @p847, @p848, @p849, @p850, @p851, @p852, @p853, @p854, @p855, @p856, @p857, @p858, @p859, @p860, @p861, @p862, @p863, @p864, @p865, @p866, @p867, @p868, @p869, @p870, @p871, @p872, @p873, @p874, @p875, @p876, @p877, @p878, @p879, @p880, @p881, @p882, @p883, @p884, @p885, @p886, @p887, @p888, @p889, @p890, @p891, @p892, @p893, @p894, @p895, 15), (@p896, @p897, @p898, @p899, @p900, @p901, @p902, @p903, @p904, @p905, @p906, @p907, @p908, @p909, @p910, @p911, @p912, @p913, @p914, @p915, @p916, @p917, @p918, @p919, @p920, @p921, @p922, @p923, @p924, @p925, @p926, @p927, @p928, @p929, @p930, @p931, @p932, @p933, @p934, @p935, @p936, @p937, @p938, @p939, @p940, @p941, @p942, @p943, @p944, @p945, @p946, @p947, @p948, @p949, @p950, @p951, 16), (@p952, @p953, @p954, @p955, @p956, @p957, @p958, @p959, @p960, @p961, @p962, @p963, @p964, @p965, @p966, @p967, @p968, @p969, @p970, @p971, @p972, @p973, @p974, @p975, @p976, @p977, @p978, @p979, @p980, @p981, @p982, @p983, @p984, @p985, @p986, @p987, @p988, @p989, @p990, @p991, @p992, @p993, @p994, @p995, @p996, @p997, @p998, @p999, @p1000, @p1001, @p1002, @p1003, @p1004, @p1005, @p1006, @p1007, 17), (@p1008, @p1009, @p1010, @p1011, @p1012, @p1013, @p1014, @p1015, @p1016, @p1017, @p1018, @p1019, @p1020, @p1021, @p1022, @p1023, @p1024, @p1025, @p1026, @p1027, @p1028, @p1029, @p1030, @p1031, @p1032, @p1033, @p1034, @p1035, @p1036, @p1037, @p1038, @p1039, @p1040, @p1041, @p1042, @p1043, @p1044, @p1045, @p1046, @p1047, @p1048, @p1049, @p1050, @p1051, @p1052, @p1053, @p1054, @p1055, @p1056, @p1057, @p1058, @p1059, @p1060, @p1061, @p1062, @p1063, 18), (@p1064, @p1065, @p1066, @p1067, @p1068, @p1069, @p1070, @p1071, @p1072, @p1073, @p1074, @p1075, @p1076, @p1077, @p1078, @p1079, @p1080, @p1081, @p1082, @p1083, @p1084, @p1085, @p1086, @p1087, @p1088, @p1089, @p1090, @p1091, @p1092, @p1093, @p1094, @p1095, @p1096, @p1097, @p1098, @p1099, @p1100, @p1101, @p1102, @p1103, @p1104, @p1105, @p1106, @p1107, @p1108, @p1109, @p1110, @p1111, @p1112, @p1113, @p1114, @p1115, @p1116, @p1117, @p1118, @p1119, 19), (@p1120, @p1121, @p1122, @p1123, @p1124, @p1125, @p1126, @p1127, @p1128, @p1129, @p1130, @p1131, @p1132, @p1133, @p1134, @p1135, @p1136, @p1137, @p1138, @p1139, @p1140, @p1141, @p1142, @p1143, @p1144, @p1145, @p1146, @p1147, @p1148, @p1149, @p1150, @p1151, @p1152, @p1153, @p1154, @p1155, @p1156, @p1157, @p1158, @p1159, @p1160, @p1161, @p1162, @p1163, @p1164, @p1165, @p1166, @p1167, @p1168, @p1169, @p1170, @p1171, @p1172, @p1173, @p1174, @p1175, 20), (@p1176, @p1177, @p1178, @p1179, @p1180, @p1181, @p1182, @p1183, @p1184, @p1185, @p1186, @p1187, @p1188, @p1189, @p1190, @p1191, @p1192, @p1193, @p1194, @p1195, @p1196, @p1197, @p1198, @p1199, @p1200, @p1201, @p1202, @p1203, @p1204, @p1205, @p1206, @p1207, @p1208, @p1209, @p1210, @p1211, @p1212, @p1213, @p1214, @p1215, @p1216, @p1217, @p1218, @p1219, @p1220, @p1221, @p1222, @p1223, @p1224, @p1225, @p1226, @p1227, @p1228, @p1229, @p1230, @p1231, 21), (@p1232, @p1233, @p1234, @p1235, @p1236, @p1237, @p1238, @p1239, @p1240, @p1241, @p1242, @p1243, @p1244, @p1245, @p1246, @p1247, @p1248, @p1249, @p1250, @p1251, @p1252, @p1253, @p1254, @p1255, @p1256, @p1257, @p1258, @p1259, @p1260, @p1261, @p1262, @p1263, @p1264, @p1265, @p1266, @p1267, @p1268, @p1269, @p1270, @p1271, @p1272, @p1273, @p1274, @p1275, @p1276, @p1277, @p1278, @p1279, @p1280, @p1281, @p1282, @p1283, @p1284, @p1285, @p1286, @p1287, 22), (@p1288, @p1289, @p1290, @p1291, @p1292, @p1293, @p1294, @p1295, @p1296, @p1297, @p1298, @p1299, @p1300, @p1301, @p1302, @p1303, @p1304, @p1305, @p1306, @p1307, @p1308, @p1309, @p1310, @p1311, @p1312, @p1313, @p1314, @p1315, @p1316, @p1317, @p1318, @p1319, @p1320, @p1321, @p1322, @p1323, @p1324, @p1325, @p1326, @p1327, @p1328, @p1329, @p1330, @p1331, @p1332, @p1333, @p1334, @p1335, @p1336, @p1337, @p1338, @p1339, @p1340, @p1341, @p1342, @p1343, 23), (@p1344, @p1345, @p1346, @p1347, @p1348, @p1349, @p1350, @p1351, @p1352, @p1353, @p1354, @p1355, @p1356, @p1357, @p1358, @p1359, @p1360, @p1361, @p1362, @p1363, @p1364, @p1365, @p1366, @p1367, @p1368, @p1369, @p1370, @p1371, @p1372, @p1373, @p1374, @p1375, @p1376, @p1377, @p1378, @p1379, @p1380, @p1381, @p1382, @p1383, @p1384, @p1385, @p1386, @p1387, @p1388, @p1389, @p1390, @p1391, @p1392, @p1393, @p1394, @p1395, @p1396, @p1397, @p1398, @p1399, 24), (@p1400, @p1401, @p1402, @p1403, @p1404, @p1405, @p1406, @p1407, @p1408, @p1409, @p1410, @p1411, @p1412, @p1413, @p1414, @p1415, @p1416, @p1417, @p1418, @p1419, @p1420, @p1421, @p1422, @p1423, @p1424, @p1425, @p1426, @p1427, @p1428, @p1429, @p1430, @p1431, @p1432, @p1433, @p1434, @p1435, @p1436, @p1437, @p1438, @p1439, @p1440, @p1441, @p1442, @p1443, @p1444, @p1445, @p1446, @p1447, @p1448, @p1449, @p1450, @p1451, @p1452, @p1453, @p1454, @p1455, 25), (@p1456, @p1457, @p1458, @p1459, @p1460, @p1461, @p1462, @p1463, @p1464, @p1465, @p1466, @p1467, @p1468, @p1469, @p1470, @p1471, @p1472, @p1473, @p1474, @p1475, @p1476, @p1477, @p1478, @p1479, @p1480, @p1481, @p1482, @p1483, @p1484, @p1485, @p1486, @p1487, @p1488, @p1489, @p1490, @p1491, @p1492, @p1493, @p1494, @p1495, @p1496, @p1497, @p1498, @p1499, @p1500, @p1501, @p1502, @p1503, @p1504, @p1505, @p1506, @p1507, @p1508, @p1509, @p1510, @p1511, 26), (@p1512, @p1513, @p1514, @p1515, @p1516, @p1517, @p1518, @p1519, @p1520, @p1521, @p1522, @p1523, @p1524, @p1525, @p1526, @p1527, @p1528, @p1529, @p1530, @p1531, @p1532, @p1533, @p1534, @p1535, @p1536, @p1537, @p1538, @p1539, @p1540, @p1541, @p1542, @p1543, @p1544, @p1545, @p1546, @p1547, @p1548, @p1549, @p1550, @p1551, @p1552, @p1553, @p1554, @p1555, @p1556, @p1557, @p1558, @p1559, @p1560, @p1561, @p1562, @p1563, @p1564, @p1565, @p1566, @p1567, 27), (@p1568, @p1569, @p1570, @p1571, @p1572, @p1573, @p1574, @p1575, @p1576, @p1577, @p1578, @p1579, @p1580, @p1581, @p1582, @p1583, @p1584, @p1585, @p1586, @p1587, @p1588, @p1589, @p1590, @p1591, @p1592, @p1593, @p1594, @p1595, @p1596, @p1597, @p1598, @p1599, @p1600, @p1601, @p1602, @p1603, @p1604, @p1605, @p1606, @p1607, @p1608, @p1609, @p1610, @p1611, @p1612, @p1613, @p1614, @p1615, @p1616, @p1617, @p1618, @p1619, @p1620, @p1621, @p1622, @p1623, 28), (@p1624, @p1625, @p1626, @p1627, @p1628, @p1629, @p1630, @p1631, @p1632, @p1633, @p1634, @p1635, @p1636, @p1637, @p1638, @p1639, @p1640, @p1641, @p1642, @p1643, @p1644, @p1645, @p1646, @p1647, @p1648, @p1649, @p1650, @p1651, @p1652, @p1653, @p1654, @p1655, @p1656, @p1657, @p1658, @p1659, @p1660, @p1661, @p1662, @p1663, @p1664, @p1665, @p1666, @p1667, @p1668, @p1669, @p1670, @p1671, @p1672, @p1673, @p1674, @p1675, @p1676, @p1677, @p1678, @p1679, 29), (@p1680, @p1681, @p1682, @p1683, @p1684, @p1685, @p1686, @p1687, @p1688, @p1689, @p1690, @p1691, @p1692, @p1693, @p1694, @p1695, @p1696, @p1697, @p1698, @p1699, @p1700, @p1701, @p1702, @p1703, @p1704, @p1705, @p1706, @p1707, @p1708, @p1709, @p1710, @p1711, @p1712, @p1713, @p1714, @p1715, @p1716, @p1717, @p1718, @p1719, @p1720, @p1721, @p1722, @p1723, @p1724, @p1725, @p1726, @p1727, @p1728, @p1729, @p1730, @p1731, @p1732, @p1733, @p1734, @p1735, 30), (@p1736, @p1737, @p1738, @p1739, @p1740, @p1741, @p1742, @p1743, @p1744, @p1745, @p1746, @p1747, @p1748, @p1749, @p1750, @p1751, @p1752, @p1753, @p1754, @p1755, @p1756, @p1757, @p1758, @p1759, @p1760, @p1761, @p1762, @p1763, @p1764, @p1765, @p1766, @p1767, @p1768, @p1769, @p1770, @p1771, @p1772, @p1773, @p1774, @p1775, @p1776, @p1777, @p1778, @p1779, @p1780, @p1781, @p1782, @p1783, @p1784, @p1785, @p1786, @p1787, @p1788, @p1789, @p1790, @p1791, 31), (@p1792, @p1793, @p1794, @p1795, @p1796, @p1797, @p1798, @p1799, @p1800, @p1801, @p1802, @p1803, @p1804, @p1805, @p1806, @p1807, @p1808, @p1809, @p1810, @p1811, @p1812, @p1813, @p1814, @p1815, @p1816, @p1817, @p1818, @p1819, @p1820, @p1821, @p1822, @p1823, @p1824, @p1825, @p1826, @p1827, @p1828, @p1829, @p1830, @p1831, @p1832, @p1833, @p1834, @p1835, @p1836, @p1837, @p1838, @p1839, @p1840, @p1841, @p1842, @p1843, @p1844, @p1845, @p1846, @p1847, 32), (@p1848, @p1849, @p1850, @p1851, @p1852, @p1853, @p1854, @p1855, @p1856, @p1857, @p1858, @p1859, @p1860, @p1861, @p1862, @p1863, @p1864, @p1865, @p1866, @p1867, @p1868, @p1869, @p1870, @p1871, @p1872, @p1873, @p1874, @p1875, @p1876, @p1877, @p1878, @p1879, @p1880, @p1881, @p1882, @p1883, @p1884, @p1885, @p1886, @p1887, @p1888, @p1889, @p1890, @p1891, @p1892, @p1893, @p1894, @p1895, @p1896, @p1897, @p1898, @p1899, @p1900, @p1901, @p1902, @p1903, 33), (@p1904, @p1905, @p1906, @p1907, @p1908, @p1909, @p1910, @p1911, @p1912, @p1913, @p1914, @p1915, @p1916, @p1917, @p1918, @p1919, @p1920, @p1921, @p1922, @p1923, @p1924, @p1925, @p1926, @p1927, @p1928, @p1929, @p1930, @p1931, @p1932, @p1933, @p1934, @p1935, @p1936, @p1937, @p1938, @p1939, @p1940, @p1941, @p1942, @p1943, @p1944, @p1945, @p1946, @p1947, @p1948, @p1949, @p1950, @p1951, @p1952, @p1953, @p1954, @p1955, @p1956, @p1957, @p1958, @p1959, 34), (@p1960, @p1961, @p1962, @p1963, @p1964, @p1965, @p1966, @p1967, @p1968, @p1969, @p1970, @p1971, @p1972, @p1973, @p1974, @p1975, @p1976, @p1977, @p1978, @p1979, @p1980, @p1981, @p1982, @p1983, @p1984, @p1985, @p1986, @p1987, @p1988, @p1989, @p1990, @p1991, @p1992, @p1993, @p1994, @p1995, @p1996, @p1997, @p1998, @p1999, @p2000, @p2001, @p2002, @p2003, @p2004, @p2005, @p2006, @p2007, @p2008, @p2009, @p2010, @p2011, @p2012, @p2013, @p2014, @p2015, 35), (@p2016, @p2017, @p2018, @p2019, @p2020, @p2021, @p2022, @p2023, @p2024, @p2025, @p2026, @p2027, @p2028, @p2029, @p2030, @p2031, @p2032, @p2033, @p2034, @p2035, @p2036, @p2037, @p2038, @p2039, @p2040, @p2041, @p2042, @p2043, @p2044, @p2045, @p2046, @p2047, @p2048, @p2049, @p2050, @p2051, @p2052, @p2053, @p2054, @p2055, @p2056, @p2057, @p2058, @p2059, @p2060, @p2061, @p2062, @p2063, @p2064, @p2065, @p2066, @p2067, @p2068, @p2069, @p2070, @p2071, 36)) AS i ([addressee_cntry_cd], [addressee_city], [addressee_district], [addressee_email], [addressee_full_address], [addressee_home_address], [addressee_name], [addressee_postcode], [addressee_province], [addressee_subdistrict], [addressee_tel], [create_table], [delivery_code], [delivery_recipient_name], [delivery_relation_id], [delivery_status_id], [dest_outlet_id], [dest_outlet_port], [document_number], [item_barcode], [item_cod], [item_gross_weight], [item_height], [item_length], [item_price], [item_width], [lat], [log_id], [long], [outlet_id], [outlet_port], [podUrl], [remark], [scan_cntry_cd], [scan_cntry_postcode], [sender_cntry_cd], [sender_district], [sender_email], [sender_full_address], [sender_home_address], [member_id], [sender_name], [sender_postcode], [sender_province], [sender_subdistrict], [sender_tel], [server_id], [signatureUrl], [state], [status_code], [status_dtm], [timestamp], [transmit_dtm], [user_id], [wckt_id], [wkstn_no], _Position) ON 1=0 WHEN NOT MATCHED THEN INSERT ([addressee_cntry_cd], [addressee_city], [addressee_district], [addressee_email], [addressee_full_address], [addressee_home_address], [addressee_name], [addressee_postcode], [addressee_province], [addressee_subdistrict], [addressee_tel], [create_table], [delivery_code], [delivery_recipient_name], [delivery_relation_id], [delivery_status_id], [dest_outlet_id], [dest_outlet_port], [document_number], [item_barcode], [item_cod], [item_gross_weight], [item_height], [item_length], [item_price], [item_width], [lat], [log_id], [long], [outlet_id], [outlet_port], [podUrl], [remark], [scan_cntry_cd], [scan_cntry_postcode], [sender_cntry_cd], [sender_district], [sender_email], [sender_full_address], [sender_home_address], [member_id], [sender_name], [sender_postcode], [sender_province], [sender_subdistrict], [sender_tel], [server_id], [signatureUrl], [state], [status_code], [status_dtm], [timestamp], [transmit_dtm], [user_id], [wckt_id], [wkstn_no]) VALUES (i.[addressee_cntry_cd], i.[addressee_city], i.[addressee_district], i.[addressee_email], i.[addressee_full_address], i.[addressee_home_address], i.[addressee_name], i.[addressee_postcode], i.[addressee_province], i.[addressee_subdistrict], i.[addressee_tel], i.[create_table], i.[delivery_code], i.[delivery_recipient_name], i.[delivery_relation_id], i.[delivery_status_id], i.[dest_outlet_id], i.[dest_outlet_port], i.[document_number], i.[item_barcode], i.[item_cod], i.[item_gross_weight], i.[item_height], i.[item_length], i.[item_price], i.[item_width], i.[lat], i.[log_id], i.[long], i.[outlet_id], i.[outlet_port], i.[podUrl], i.[remark], i.[scan_cntry_cd], i.[scan_cntry_postcode], i.[sender_cntry_cd], i.[sender_district], i.[sender_email], i.[sender_full_address], i.[sender_home_address], i.[member_id], i.[sender_name], i.[sender_postcode], i.[sender_province], i.[sender_subdistrict], i.[sender_tel], i.[server_id], i.[signatureUrl], i.[state], i.[status_code], i.[status_dtm], i.[timestamp], i.[transmit_dtm], i.[user_id], i.[wckt_id], i.[wkstn_no]) OUTPUT INSERTED.[item_id], i._Position INTO @inserted0;  SELECT [t].[item_id] FROM [raw_data] t INNER JOIN @inserted0 i ON ([t].[item_id] = [i].[item_id]) ORDER BY [i].[_Position];  ",4,4,0,450,7,4
"(@p0 nvarchar(4000),@p1 nvarchar(4000),@p2 nvarchar(4000),@p3 nvarchar(4000),@p4 nvarchar(4000),@p5 nvarchar(4000),@p6 nvarchar(4000),@p7 nvarchar(4000),@p8 nvarchar(4000),@p9 nvarchar(4000),@p10 nvarchar(4000),@p11 datetime2(7),@p12 nvarchar(4000),@p13 nvarchar(4000),@p14 int,@p15 int,@p16 int,@p17 nvarchar(4000),@p18 nvarchar(4000),@p19 nvarchar(4000),@p20 nvarchar(4000),@p21 decimal(18,2),@p22 nvarchar(4000),@p23 nvarchar(4000),@p24 decimal(18,2),@p25 nvarchar(4000),@p26 nvarchar(4000),@p27 nvarchar(4000),@p28 nvarchar(4000),@p29 int,@p30 nvarchar(4000),@p31 nvarchar(4000),@p32 nvarchar(4000),@p33 nvarchar(4000),@p34 nvarchar(4000),@p35 nvarchar(4000),@p36 nvarchar(4000),@p37 nvarchar(4000),@p38 nvarchar(4000),@p39 nvarchar(4000),@p40 int,@p41 nvarchar(4000),@p42 nvarchar(4000),@p43 nvarchar(4000),@p44 nvarchar(4000),@p45 nvarchar(4000),@p46 int,@p47 nvarchar(4000),@p48 int,@p49 int,@p50 datetime2(7),@p51 datetime2(7),@p52 datetime2(7),@p53 nvarchar(4000),@p54 nvarchar(4000),@p55 nvarchar(4000),@p56 nvarchar(4000),@p57 nvarchar(4000),@p58 nvarchar(4000),@p59 nvarchar(4000),@p60 nvarchar(4000),@p61 nvarchar(4000),@p62 nvarchar(4000),@p63 nvarchar(4000),@p64 nvarchar(4000),@p65 nvarchar(4000),@p66 nvarchar(4000),@p67 datetime2(7),@p68 nvarchar(4000),@p69 nvarchar(4000),@p70 int,@p71 int,@p72 int,@p73 nvarchar(4000),@p74 nvarchar(4000),@p75 nvarchar(4000),@p76 nvarchar(4000),@p77 decimal(18,2),@p78 nvarchar(4000),@p79 nvarchar(4000),@p80 decimal(18,2),@p81 nvarchar(4000),@p82 nvarchar(4000),@p83 nvarchar(4000),@p84 nvarchar(4000),@p85 int,@p86 nvarchar(4000),@p87 nvarchar(4000),@p88 nvarchar(4000),@p89 nvarchar(4000),@p90 nvarchar(4000),@p91 nvarchar(4000),@p92 nvarchar(4000),@p93 nvarchar(4000),@p94 nvarchar(4000),@p95 nvarchar(4000),@p96 int,@p97 nvarchar(4000),@p98 nvarchar(4000),@p99 nvarchar(4000),@p100 nvarchar(4000),@p101 nvarchar(4000),@p102 int,@p103 nvarchar(4000),@p104 int,@p105 int,@p106 datetime2(7),@p107 datetime2(7),@p108 datetime2(7),@p109 nvarchar(4000),@p110 nvarchar(4000),@p111 nvarchar(4000),@p112 nvarchar(4000),@p113 nvarchar(4000),@p114 nvarchar(4000),@p115 nvarchar(4000),@p116 nvarchar(4000),@p117 nvarchar(4000),@p118 nvarchar(4000),@p119 nvarchar(4000),@p120 nvarchar(4000),@p121 nvarchar(4000),@p122 nvarchar(4000),@p123 datetime2(7),@p124 nvarchar(4000),@p125 nvarchar(4000),@p126 int,@p127 int,@p128 int,@p129 nvarchar(4000),@p130 nvarchar(4000),@p131 nvarchar(4000),@p132 nvarchar(4000),@p133 decimal(18,2),@p134 nvarchar(4000),@p135 nvarchar(4000),@p136 decimal(18,2),@p137 nvarchar(4000),@p138 nvarchar(4000),@p139 nvarchar(4000),@p140 nvarchar(4000),@p141 int,@p142 nvarchar(4000),@p143 nvarchar(4000),@p144 nvarchar(4000),@p145 nvarchar(4000),@p146 nvarchar(4000),@p147 nvarchar(4000),@p148 nvarchar(4000),@p149 nvarchar(4000),@p150 nvarchar(4000),@p151 nvarchar(4000),@p152 int,@p153 nvarchar(4000),@p154 nvarchar(4000),@p155 nvarchar(4000),@p156 nvarchar(4000),@p157 nvarchar(4000),@p158 int,@p159 nvarchar(4000),@p160 int,@p161 int,@p162 datetime2(7),@p163 datetime2(7),@p164 datetime2(7),@p165 nvarchar(4000),@p166 nvarchar(4000),@p167 nvarchar(4000),@p168 nvarchar(4000),@p169 nvarchar(4000),@p170 nvarchar(4000),@p171 nvarchar(4000),@p172 nvarchar(4000),@p173 nvarchar(4000),@p174 nvarchar(4000),@p175 nvarchar(4000),@p176 nvarchar(4000),@p177 nvarchar(4000),@p178 nvarchar(4000),@p179 datetime2(7),@p180 nvarchar(4000),@p181 nvarchar(4000),@p182 int,@p183 int,@p184 int,@p185 nvarchar(4000),@p186 nvarchar(4000),@p187 nvarchar(4000),@p188 nvarchar(4000),@p189 decimal(18,2),@p190 nvarchar(4000),@p191 nvarchar(4000),@p192 decimal(18,2),@p193 nvarchar(4000),@p194 nvarchar(4000),@p195 nvarchar(4000),@p196 nvarchar(4000),@p197 int,@p198 nvarchar(4000),@p199 nvarchar(4000),@p200 nvarchar(4000),@p201 nvarchar(4000),@p202 nvarchar(4000),@p203 nvarchar(4000),@p204 nvarchar(4000),@p205 nvarchar(4000),@p206 nvarchar(4000),@p207 nvarchar(4000),@p208 int,@p209 nvarchar(4000),@p210 nvarchar(4000),@p211 nvarchar(4000),@p212 nvarchar(4000),@p213 nvarchar(4000),@p214 int,@p215 nvarchar(4000),@p216 int,@p217 int,@p218 datetime2(7),@p219 datetime2(7),@p220 datetime2(7),@p221 nvarchar(4000),@p222 nvarchar(4000),@p223 nvarchar(4000),@p224 nvarchar(4000),@p225 nvarchar(4000),@p226 nvarchar(4000),@p227 nvarchar(4000),@p228 nvarchar(4000),@p229 nvarchar(4000),@p230 nvarchar(4000),@p231 nvarchar(4000),@p232 nvarchar(4000),@p233 nvarchar(4000),@p234 nvarchar(4000),@p235 datetime2(7),@p236 nvarchar(4000),@p237 nvarchar(4000),@p238 int,@p239 int,@p240 int,@p241 nvarchar(4000),@p242 nvarchar(4000),@p243 nvarchar(4000),@p244 nvarchar(4000),@p245 decimal(18,2),@p246 nvarchar(4000),@p247 nvarchar(4000),@p248 decimal(18,2),@p249 nvarchar(4000),@p250 nvarchar(4000),@p251 nvarchar(4000),@p252 nvarchar(4000),@p253 int,@p254 nvarchar(4000),@p255 nvarchar(4000),@p256 nvarchar(4000),@p257 nvarchar(4000),@p258 nvarchar(4000),@p259 nvarchar(4000),@p260 nvarchar(4000),@p261 nvarchar(4000),@p262 nvarchar(4000),@p263 nvarchar(4000),@p264 int,@p265 nvarchar(4000),@p266 nvarchar(4000),@p267 nvarchar(4000),@p268 nvarchar(4000),@p269 nvarchar(4000),@p270 int,@p271 nvarchar(4000),@p272 int,@p273 int,@p274 datetime2(7),@p275 datetime2(7),@p276 datetime2(7),@p277 nvarchar(4000),@p278 nvarchar(4000),@p279 nvarchar(4000),@p280 nvarchar(4000),@p281 nvarchar(4000),@p282 nvarchar(4000),@p283 nvarchar(4000),@p284 nvarchar(4000),@p285 nvarchar(4000),@p286 nvarchar(4000),@p287 nvarchar(4000),@p288 nvarchar(4000),@p289 nvarchar(4000),@p290 nvarchar(4000),@p291 datetime2(7),@p292 nvarchar(4000),@p293 nvarchar(4000),@p294 int,@p295 int,@p296 int,@p297 nvarchar(4000),@p298 nvarchar(4000),@p299 nvarchar(4000),@p300 nvarchar(4000),@p301 decimal(18,2),@p302 nvarchar(4000),@p303 nvarchar(4000),@p304 decimal(18,2),@p305 nvarchar(4000),@p306 nvarchar(4000),@p307 nvarchar(4000),@p308 nvarchar(4000),@p309 int,@p310 nvarchar(4000),@p311 nvarchar(4000),@p312 nvarchar(4000),@p313 nvarchar(4000),@p314 nvarchar(4000),@p315 nvarchar(4000),@p316 nvarchar(4000),@p317 nvarchar(4000),@p318 nvarchar(4000),@p319 nvarchar(4000),@p320 int,@p321 nvarchar(4000),@p322 nvarchar(4000),@p323 nvarchar(4000),@p324 nvarchar(4000),@p325 nvarchar(4000),@p326 int,@p327 nvarchar(4000),@p328 int,@p329 int,@p330 datetime2(7),@p331 datetime2(7),@p332 datetime2(7),@p333 nvarchar(4000),@p334 nvarchar(4000),@p335 nvarchar(4000),@p336 nvarchar(4000),@p337 nvarchar(4000),@p338 nvarchar(4000),@p339 nvarchar(4000),@p340 nvarchar(4000),@p341 nvarchar(4000),@p342 nvarchar(4000),@p343 nvarchar(4000),@p344 nvarchar(4000),@p345 nvarchar(4000),@p346 nvarchar(4000),@p347 datetime2(7),@p348 nvarchar(4000),@p349 nvarchar(4000),@p350 int,@p351 int,@p352 int,@p353 nvarchar(4000),@p354 nvarchar(4000),@p355 nvarchar(4000),@p356 nvarchar(4000),@p357 decimal(18,2),@p358 nvarchar(4000),@p359 nvarchar(4000),@p360 decimal(18,2),@p361 nvarchar(4000),@p362 nvarchar(4000),@p363 nvarchar(4000),@p364 nvarchar(4000),@p365 int,@p366 nvarchar(4000),@p367 nvarchar(4000),@p368 nvarchar(4000),@p369 nvarchar(4000),@p370 nvarchar(4000),@p371 nvarchar(4000),@p372 nvarchar(4000),@p373 nvarchar(4000),@p374 nvarchar(4000),@p375 nvarchar(4000),@p376 int,@p377 nvarchar(4000),@p378 nvarchar(4000),@p379 nvarchar(4000),@p380 nvarchar(4000),@p381 nvarchar(4000),@p382 int,@p383 nvarchar(4000),@p384 int,@p385 int,@p386 datetime2(7),@p387 datetime2(7),@p388 datetime2(7),@p389 nvarchar(4000),@p390 nvarchar(4000),@p391 nvarchar(4000),@p392 nvarchar(4000),@p393 nvarchar(4000),@p394 nvarchar(4000),@p395 nvarchar(4000),@p396 nvarchar(4000),@p397 nvarchar(4000),@p398 nvarchar(4000),@p399 nvarchar(4000),@p400 nvarchar(4000),@p401 nvarchar(4000),@p402 nvarchar(4000),@p403 datetime2(7),@p404 nvarchar(4000),@p405 nvarchar(4000),@p406 int,@p407 int,@p408 int,@p409 nvarchar(4000),@p410 nvarchar(4000),@p411 nvarchar(4000),@p412 decimal(18,2),@p413 decimal(18,2),@p414 nvarchar(4000),@p415 nvarchar(4000),@p416 decimal(18,2),@p417 nvarchar(4000),@p418 nvarchar(4000),@p419 nvarchar(4000),@p420 nvarchar(4000),@p421 int,@p422 nvarchar(4000),@p423 nvarchar(4000),@p424 nvarchar(4000),@p425 nvarchar(4000),@p426 nvarchar(4000),@p427 nvarchar(4000),@p428 nvarchar(4000),@p429 nvarchar(4000),@p430 nvarchar(4000),@p431 nvarchar(4000),@p432 int,@p433 nvarchar(4000),@p434 nvarchar(4000),@p435 nvarchar(4000),@p436 nvarchar(4000),@p437 nvarchar(4000),@p438 int,@p439 nvarchar(4000),@p440 int,@p441 int,@p442 datetime2(7),@p443 datetime2(7),@p444 datetime2(7),@p445 nvarchar(4000),@p446 nvarchar(4000),@p447 nvarchar(4000),@p448 nvarchar(4000),@p449 nvarchar(4000),@p450 nvarchar(4000),@p451 nvarchar(4000),@p452 nvarchar(4000),@p453 nvarchar(4000),@p454 nvarchar(4000),@p455 nvarchar(4000),@p456 nvarchar(4000),@p457 nvarchar(4000),@p458 nvarchar(4000),@p459 datetime2(7),@p460 nvarchar(4000),@p461 nvarchar(4000),@p462 int,@p463 int,@p464 int,@p465 nvarchar(4000),@p466 nvarchar(4000),@p467 nvarchar(4000),@p468 decimal(18,2),@p469 decimal(18,2),@p470 nvarchar(4000),@p471 nvarchar(4000),@p472 decimal(18,2),@p473 nvarchar(4000),@p474 nvarchar(4000),@p475 nvarchar(4000),@p476 nvarchar(4000),@p477 int,@p478 nvarchar(4000),@p479 nvarchar(4000),@p480 nvarchar(4000),@p481 nvarchar(4000),@p482 nvarchar(4000),@p483 nvarchar(4000),@p484 nvarchar(4000),@p485 nvarchar(4000),@p486 nvarchar(4000),@p487 nvarchar(4000),@p488 int,@p489 nvarchar(4000),@p490 nvarchar(4000),@p491 nvarchar(4000),@p492 nvarchar(4000),@p493 nvarchar(4000),@p494 int,@p495 nvarchar(4000),@p496 int,@p497 int,@p498 datetime2(7),@p499 datetime2(7),@p500 datetime2(7),@p501 nvarchar(4000),@p502 nvarchar(4000),@p503 nvarchar(4000),@p504 nvarchar(4000),@p505 nvarchar(4000),@p506 nvarchar(4000),@p507 nvarchar(4000),@p508 nvarchar(4000),@p509 nvarchar(4000),@p510 nvarchar(4000),@p511 nvarchar(4000),@p512 nvarchar(4000),@p513 nvarchar(4000),@p514 nvarchar(4000),@p515 datetime2(7),@p516 nvarchar(4000),@p517 nvarchar(4000),@p518 int,@p519 int,@p520 int,@p521 nvarchar(4000),@p522 nvarchar(4000),@p523 nvarchar(4000),@p524 decimal(18,2),@p525 decimal(18,2),@p526 nvarchar(4000),@p527 nvarchar(4000),@p528 decimal(18,2),@p529 nvarchar(4000),@p530 nvarchar(4000),@p531 nvarchar(4000),@p532 nvarchar(4000),@p533 int,@p534 nvarchar(4000),@p535 nvarchar(4000),@p536 nvarchar(4000),@p537 nvarchar(4000),@p538 nvarchar(4000),@p539 nvarchar(4000),@p540 nvarchar(4000),@p541 nvarchar(4000),@p542 nvarchar(4000),@p543 nvarchar(4000),@p544 int,@p545 nvarchar(4000),@p546 nvarchar(4000),@p547 nvarchar(4000),@p548 nvarchar(4000),@p549 nvarchar(4000),@p550 int,@p551 nvarchar(4000),@p552 int,@p553 int,@p554 datetime2(7),@p555 datetime2(7),@p556 datetime2(7),@p557 nvarchar(4000),@p558 nvarchar(4000),@p559 nvarchar(4000),@p560 nvarchar(4000),@p561 nvarchar(4000),@p562 nvarchar(4000),@p563 nvarchar(4000),@p564 nvarchar(4000),@p565 nvarchar(4000),@p566 nvarchar(4000),@p567 nvarchar(4000),@p568 nvarchar(4000),@p569 nvarchar(4000),@p570 nvarchar(4000),@p571 datetime2(7),@p572 nvarchar(4000),@p573 nvarchar(4000),@p574 int,@p575 int,@p576 int,@p577 nvarchar(4000),@p578 nvarchar(4000),@p579 nvarchar(4000),@p580 decimal(18,2),@p581 decimal(18,2),@p582 nvarchar(4000),@p583 nvarchar(4000),@p584 decimal(18,2),@p585 nvarchar(4000),@p586 nvarchar(4000),@p587 nvarchar(4000),@p588 nvarchar(4000),@p589 int,@p590 nvarchar(4000),@p591 nvarchar(4000),@p592 nvarchar(4000),@p593 nvarchar(4000),@p594 nvarchar(4000),@p595 nvarchar(4000),@p596 nvarchar(4000),@p597 nvarchar(4000),@p598 nvarchar(4000),@p599 nvarchar(4000),@p600 int,@p601 nvarchar(4000),@p602 nvarchar(4000),@p603 nvarchar(4000),@p604 nvarchar(4000),@p605 nvarchar(4000),@p606 int,@p607 nvarchar(4000),@p608 int,@p609 int,@p610 datetime2(7),@p611 datetime2(7),@p612 datetime2(7),@p613 nvarchar(4000),@p614 nvarchar(4000),@p615 nvarchar(4000),@p616 nvarchar(4000),@p617 nvarchar(4000),@p618 nvarchar(4000),@p619 nvarchar(4000),@p620 nvarchar(4000),@p621 nvarchar(4000),@p622 nvarchar(4000),@p623 nvarchar(4000),@p624 nvarchar(4000),@p625 nvarchar(4000),@p626 nvarchar(4000),@p627 datetime2(7),@p628 nvarchar(4000),@p629 nvarchar(4000),@p630 int,@p631 int,@p632 int,@p633 nvarchar(4000),@p634 nvarchar(4000),@p635 nvarchar(4000),@p636 decimal(18,2),@p637 decimal(18,2),@p638 nvarchar(4000),@p639 nvarchar(4000),@p640 decimal(18,2),@p641 nvarchar(4000),@p642 nvarchar(4000),@p643 nvarchar(4000),@p644 nvarchar(4000),@p645 int,@p646 nvarchar(4000),@p647 nvarchar(4000),@p648 nvarchar(4000),@p649 nvarchar(4000),@p650 nvarchar(4000),@p651 nvarchar(4000),@p652 nvarchar(4000),@p653 nvarchar(4000),@p654 nvarchar(4000),@p655 nvarchar(4000),@p656 int,@p657 nvarchar(4000),@p658 nvarchar(4000),@p659 nvarchar(4000),@p660 nvarchar(4000),@p661 nvarchar(4000),@p662 int,@p663 nvarchar(4000),@p664 int,@p665 int,@p666 datetime2(7),@p667 datetime2(7),@p668 datetime2(7),@p669 nvarchar(4000),@p670 nvarchar(4000),@p671 nvarchar(4000),@p672 nvarchar(4000),@p673 nvarchar(4000),@p674 nvarchar(4000),@p675 nvarchar(4000),@p676 nvarchar(4000),@p677 nvarchar(4000),@p678 nvarchar(4000),@p679 nvarchar(4000),@p680 nvarchar(4000),@p681 nvarchar(4000),@p682 nvarchar(4000),@p683 datetime2(7),@p684 nvarchar(4000),@p685 nvarchar(4000),@p686 int,@p687 int,@p688 int,@p689 nvarchar(4000),@p690 nvarchar(4000),@p691 nvarchar(4000),@p692 decimal(18,2),@p693 decimal(18,2),@p694 nvarchar(4000),@p695 nvarchar(4000),@p696 decimal(18,2),@p697 nvarchar(4000),@p698 nvarchar(4000),@p699 nvarchar(4000),@p700 nvarchar(4000),@p701 int,@p702 nvarchar(4000),@p703 nvarchar(4000),@p704 nvarchar(4000),@p705 nvarchar(4000),@p706 nvarchar(4000),@p707 nvarchar(4000),@p708 nvarchar(4000),@p709 nvarchar(4000),@p710 nvarchar(4000),@p711 nvarchar(4000),@p712 int,@p713 nvarchar(4000),@p714 nvarchar(4000),@p715 nvarchar(4000),@p716 nvarchar(4000),@p717 nvarchar(4000),@p718 int,@p719 nvarchar(4000),@p720 int,@p721 int,@p722 datetime2(7),@p723 datetime2(7),@p724 datetime2(7),@p725 nvarchar(4000),@p726 nvarchar(4000),@p727 nvarchar(4000),@p728 nvarchar(4000),@p729 nvarchar(4000),@p730 nvarchar(4000),@p731 nvarchar(4000),@p732 nvarchar(4000),@p733 nvarchar(4000),@p734 nvarchar(4000),@p735 nvarchar(4000),@p736 nvarchar(4000),@p737 nvarchar(4000),@p738 nvarchar(4000),@p739 datetime2(7),@p740 nvarchar(4000),@p741 nvarchar(4000),@p742 int,@p743 int,@p744 int,@p745 nvarchar(4000),@p746 nvarchar(4000),@p747 nvarchar(4000),@p748 decimal(18,2),@p749 decimal(18,2),@p750 nvarchar(4000),@p751 nvarchar(4000),@p752 decimal(18,2),@p753 nvarchar(4000),@p754 nvarchar(4000),@p755 nvarchar(4000),@p756 nvarchar(4000),@p757 int,@p758 nvarchar(4000),@p759 nvarchar(4000),@p760 nvarchar(4000),@p761 nvarchar(4000),@p762 nvarchar(4000),@p763 nvarchar(4000),@p764 nvarchar(4000),@p765 nvarchar(4000),@p766 nvarchar(4000),@p767 nvarchar(4000),@p768 int,@p769 nvarchar(4000),@p770 nvarchar(4000),@p771 nvarchar(4000),@p772 nvarchar(4000),@p773 nvarchar(4000),@p774 int,@p775 nvarchar(4000),@p776 int,@p777 int,@p778 datetime2(7),@p779 datetime2(7),@p780 datetime2(7),@p781 nvarchar(4000),@p782 nvarchar(4000),@p783 nvarchar(4000),@p784 nvarchar(4000),@p785 nvarchar(4000),@p786 nvarchar(4000),@p787 nvarchar(4000),@p788 nvarchar(4000),@p789 nvarchar(4000),@p790 nvarchar(4000),@p791 nvarchar(4000),@p792 nvarchar(4000),@p793 nvarchar(4000),@p794 nvarchar(4000),@p795 datetime2(7),@p796 nvarchar(4000),@p797 nvarchar(4000),@p798 int,@p799 int,@p800 int,@p801 nvarchar(4000),@p802 nvarchar(4000),@p803 nvarchar(4000),@p804 decimal(18,2),@p805 decimal(18,2),@p806 nvarchar(4000),@p807 nvarchar(4000),@p808 decimal(18,2),@p809 nvarchar(4000),@p810 nvarchar(4000),@p811 nvarchar(4000),@p812 nvarchar(4000),@p813 int,@p814 nvarchar(4000),@p815 nvarchar(4000),@p816 nvarchar(4000),@p817 nvarchar(4000),@p818 nvarchar(4000),@p819 nvarchar(4000),@p820 nvarchar(4000),@p821 nvarchar(4000),@p822 nvarchar(4000),@p823 nvarchar(4000),@p824 int,@p825 nvarchar(4000),@p826 nvarchar(4000),@p827 nvarchar(4000),@p828 nvarchar(4000),@p829 nvarchar(4000),@p830 int,@p831 nvarchar(4000),@p832 int,@p833 int,@p834 datetime2(7),@p835 datetime2(7),@p836 datetime2(7),@p837 nvarchar(4000),@p838 nvarchar(4000),@p839 nvarchar(4000),@p840 nvarchar(4000),@p841 nvarchar(4000),@p842 nvarchar(4000),@p843 nvarchar(4000),@p844 nvarchar(4000),@p845 nvarchar(4000),@p846 nvarchar(4000),@p847 nvarchar(4000),@p848 nvarchar(4000),@p849 nvarchar(4000),@p850 nvarchar(4000),@p851 datetime2(7),@p852 nvarchar(4000),@p853 nvarchar(4000),@p854 int,@p855 int,@p856 int,@p857 nvarchar(4000),@p858 nvarchar(4000),@p859 nvarchar(4000),@p860 decimal(18,2),@p861 decimal(18,2),@p862 nvarchar(4000),@p863 nvarchar(4000),@p864 decimal(18,2),@p865 nvarchar(4000),@p866 nvarchar(4000),@p867 nvarchar(4000),@p868 nvarchar(4000),@p869 int,@p870 nvarchar(4000),@p871 nvarchar(4000),@p872 nvarchar(4000),@p873 nvarchar(4000),@p874 nvarchar(4000),@p875 nvarchar(4000),@p876 nvarchar(4000),@p877 nvarchar(4000),@p878 nvarchar(4000),@p879 nvarchar(4000),@p880 int,@p881 nvarchar(4000),@p882 nvarchar(4000),@p883 nvarchar(4000),@p884 nvarchar(4000),@p885 nvarchar(4000),@p886 int,@p887 nvarchar(4000),@p888 int,@p889 int,@p890 datetime2(7),@p891 datetime2(7),@p892 datetime2(7),@p893 nvarchar(4000),@p894 nvarchar(4000),@p895 nvarchar(4000),@p896 nvarchar(4000),@p897 nvarchar(4000),@p898 nvarchar(4000),@p899 nvarchar(4000),@p900 nvarchar(4000),@p901 nvarchar(4000),@p902 nvarchar(4000),@p903 nvarchar(4000),@p904 nvarchar(4000),@p905 nvarchar(4000),@p906 nvarchar(4000),@p907 datetime2(7),@p908 nvarchar(4000),@p909 nvarchar(4000),@p910 int,@p911 int,@p912 int,@p913 nvarchar(4000),@p914 nvarchar(4000),@p915 nvarchar(4000),@p916 decimal(18,2),@p917 decimal(18,2),@p918 nvarchar(4000),@p919 nvarchar(4000),@p920 decimal(18,2),@p921 nvarchar(4000),@p922 nvarchar(4000),@p923 nvarchar(4000),@p924 nvarchar(4000),@p925 int,@p926 nvarchar(4000),@p927 nvarchar(4000),@p928 nvarchar(4000),@p929 nvarchar(4000),@p930 nvarchar(4000),@p931 nvarchar(4000),@p932 nvarchar(4000),@p933 nvarchar(4000),@p934 nvarchar(4000),@p935 nvarchar(4000),@p936 int,@p937 nvarchar(4000),@p938 nvarchar(4000),@p939 nvarchar(4000),@p940 nvarchar(4000),@p941 nvarchar(4000),@p942 int,@p943 nvarchar(4000),@p944 int,@p945 int,@p946 datetime2(7),@p947 datetime2(7),@p948 datetime2(7),@p949 nvarchar(4000),@p950 nvarchar(4000),@p951 nvarchar(4000),@p952 nvarchar(4000),@p953 nvarchar(4000),@p954 nvarchar(4000),@p955 nvarchar(4000),@p956 nvarchar(4000),@p957 nvarchar(4000),@p958 nvarchar(4000),@p959 nvarchar(4000),@p960 nvarchar(4000),@p961 nvarchar(4000),@p962 nvarchar(4000),@p963 datetime2(7),@p964 nvarchar(4000),@p965 nvarchar(4000),@p966 int,@p967 int,@p968 int,@p969 nvarchar(4000),@p970 nvarchar(4000),@p971 nvarchar(4000),@p972 decimal(18,2),@p973 decimal(18,2),@p974 nvarchar(4000),@p975 nvarchar(4000),@p976 decimal(18,2),@p977 nvarchar(4000),@p978 nvarchar(4000),@p979 nvarchar(4000),@p980 nvarchar(4000),@p981 int,@p982 nvarchar(4000),@p983 nvarchar(4000),@p984 nvarchar(4000),@p985 nvarchar(4000),@p986 nvarchar(4000),@p987 nvarchar(4000),@p988 nvarchar(4000),@p989 nvarchar(4000),@p990 nvarchar(4000),@p991 nvarchar(4000),@p992 int,@p993 nvarchar(4000),@p994 nvarchar(4000),@p995 nvarchar(4000),@p996 nvarchar(4000),@p997 nvarchar(4000),@p998 int,@p999 nvarchar(4000),@p1000 int,@p1001 int,@p1002 datetime2(7),@p1003 datetime2(7),@p1004 datetime2(7),@p1005 nvarchar(4000),@p1006 nvarchar(4000),@p1007 nvarchar(4000),@p1008 nvarchar(4000),@p1009 nvarchar(4000),@p1010 nvarchar(4000),@p1011 nvarchar(4000),@p1012 nvarchar(4000),@p1013 nvarchar(4000),@p1014 nvarchar(4000),@p1015 nvarchar(4000),@p1016 nvarchar(4000),@p1017 nvarchar(4000),@p1018 nvarchar(4000),@p1019 datetime2(7),@p1020 nvarchar(4000),@p1021 nvarchar(4000),@p1022 int,@p1023 int,@p1024 int,@p1025 nvarchar(4000),@p1026 nvarchar(4000),@p1027 nvarchar(4000),@p1028 decimal(18,2),@p1029 decimal(18,2),@p1030 nvarchar(4000),@p1031 nvarchar(4000),@p1032 decimal(18,2),@p1033 nvarchar(4000),@p1034 nvarchar(4000),@p1035 nvarchar(4000),@p1036 nvarchar(4000),@p1037 int,@p1038 nvarchar(4000),@p1039 nvarchar(4000),@p1040 nvarchar(4000),@p1041 nvarchar(4000),@p1042 nvarchar(4000),@p1043 nvarchar(4000),@p1044 nvarchar(4000),@p1045 nvarchar(4000),@p1046 nvarchar(4000),@p1047 nvarchar(4000),@p1048 int,@p1049 nvarchar(4000),@p1050 nvarchar(4000),@p1051 nvarchar(4000),@p1052 nvarchar(4000),@p1053 nvarchar(4000),@p1054 int,@p1055 nvarchar(4000),@p1056 int,@p1057 int,@p1058 datetime2(7),@p1059 datetime2(7),@p1060 datetime2(7),@p1061 nvarchar(4000),@p1062 nvarchar(4000),@p1063 nvarchar(4000),@p1064 nvarchar(4000),@p1065 nvarchar(4000),@p1066 nvarchar(4000),@p1067 nvarchar(4000),@p1068 nvarchar(4000),@p1069 nvarchar(4000),@p1070 nvarchar(4000),@p1071 nvarchar(4000),@p1072 nvarchar(4000),@p1073 nvarchar(4000),@p1074 nvarchar(4000),@p1075 datetime2(7),@p1076 nvarchar(4000),@p1077 nvarchar(4000),@p1078 int,@p1079 int,@p1080 int,@p1081 nvarchar(4000),@p1082 nvarchar(4000),@p1083 nvarchar(4000),@p1084 decimal(18,2),@p1085 decimal(18,2),@p1086 nvarchar(4000),@p1087 nvarchar(4000),@p1088 decimal(18,2),@p1089 nvarchar(4000),@p1090 nvarchar(4000),@p1091 nvarchar(4000),@p1092 nvarchar(4000),@p1093 int,@p1094 nvarchar(4000),@p1095 nvarchar(4000),@p1096 nvarchar(4000),@p1097 nvarchar(4000),@p1098 nvarchar(4000),@p1099 nvarchar(4000),@p1100 nvarchar(4000),@p1101 nvarchar(4000),@p1102 nvarchar(4000),@p1103 nvarchar(4000),@p1104 int,@p1105 nvarchar(4000),@p1106 nvarchar(4000),@p1107 nvarchar(4000),@p1108 nvarchar(4000),@p1109 nvarchar(4000),@p1110 int,@p1111 nvarchar(4000),@p1112 int,@p1113 int,@p1114 datetime2(7),@p1115 datetime2(7),@p1116 datetime2(7),@p1117 nvarchar(4000),@p1118 nvarchar(4000),@p1119 nvarchar(4000),@p1120 nvarchar(4000),@p1121 nvarchar(4000),@p1122 nvarchar(4000),@p1123 nvarchar(4000),@p1124 nvarchar(4000),@p1125 nvarchar(4000),@p1126 nvarchar(4000),@p1127 nvarchar(4000),@p1128 nvarchar(4000),@p1129 nvarchar(4000),@p1130 nvarchar(4000),@p1131 datetime2(7),@p1132 nvarchar(4000),@p1133 nvarchar(4000),@p1134 int,@p1135 int,@p1136 int,@p1137 nvarchar(4000),@p1138 nvarchar(4000),@p1139 nvarchar(4000),@p1140 decimal(18,2),@p1141 decimal(18,2),@p1142 nvarchar(4000),@p1143 nvarchar(4000),@p1144 decimal(18,2),@p1145 nvarchar(4000),@p1146 nvarchar(4000),@p1147 nvarchar(4000),@p1148 nvarchar(4000),@p1149 int,@p1150 nvarchar(4000),@p1151 nvarchar(4000),@p1152 nvarchar(4000),@p1153 nvarchar(4000),@p1154 nvarchar(4000),@p1155 nvarchar(4000),@p1156 nvarchar(4000),@p1157 nvarchar(4000),@p1158 nvarchar(4000),@p1159 nvarchar(4000),@p1160 int,@p1161 nvarchar(4000),@p1162 nvarchar(4000),@p1163 nvarchar(4000),@p1164 nvarchar(4000),@p1165 nvarchar(4000),@p1166 int,@p1167 nvarchar(4000),@p1168 int,@p1169 int,@p1170 datetime2(7),@p1171 datetime2(7),@p1172 datetime2(7),@p1173 nvarchar(4000),@p1174 nvarchar(4000),@p1175 nvarchar(4000),@p1176 nvarchar(4000),@p1177 nvarchar(4000),@p1178 nvarchar(4000),@p1179 nvarchar(4000),@p1180 nvarchar(4000),@p1181 nvarchar(4000),@p1182 nvarchar(4000),@p1183 nvarchar(4000),@p1184 nvarchar(4000),@p1185 nvarchar(4000),@p1186 nvarchar(4000),@p1187 datetime2(7),@p1188 nvarchar(4000),@p1189 nvarchar(4000),@p1190 int,@p1191 int,@p1192 int,@p1193 nvarchar(4000),@p1194 nvarchar(4000),@p1195 nvarchar(4000),@p1196 decimal(18,2),@p1197 decimal(18,2),@p1198 nvarchar(4000),@p1199 nvarchar(4000),@p1200 decimal(18,2),@p1201 nvarchar(4000),@p1202 nvarchar(4000),@p1203 nvarchar(4000),@p1204 nvarchar(4000),@p1205 int,@p1206 nvarchar(4000),@p1207 nvarchar(4000),@p1208 nvarchar(4000),@p1209 nvarchar(4000),@p1210 nvarchar(4000),@p1211 nvarchar(4000),@p1212 nvarchar(4000),@p1213 nvarchar(4000),@p1214 nvarchar(4000),@p1215 nvarchar(4000),@p1216 int,@p1217 nvarchar(4000),@p1218 nvarchar(4000),@p1219 nvarchar(4000),@p1220 nvarchar(4000),@p1221 nvarchar(4000),@p1222 int,@p1223 nvarchar(4000),@p1224 int,@p1225 int,@p1226 datetime2(7),@p1227 datetime2(7),@p1228 datetime2(7),@p1229 nvarchar(4000),@p1230 nvarchar(4000),@p1231 nvarchar(4000),@p1232 nvarchar(4000),@p1233 nvarchar(4000),@p1234 nvarchar(4000),@p1235 nvarchar(4000),@p1236 nvarchar(4000),@p1237 nvarchar(4000),@p1238 nvarchar(4000),@p1239 nvarchar(4000),@p1240 nvarchar(4000),@p1241 nvarchar(4000),@p1242 nvarchar(4000),@p1243 datetime2(7),@p1244 nvarchar(4000),@p1245 nvarchar(4000),@p1246 int,@p1247 int,@p1248 int,@p1249 nvarchar(4000),@p1250 nvarchar(4000),@p1251 nvarchar(4000),@p1252 decimal(18,2),@p1253 decimal(18,2),@p1254 nvarchar(4000),@p1255 nvarchar(4000),@p1256 decimal(18,2),@p1257 nvarchar(4000),@p1258 nvarchar(4000),@p1259 nvarchar(4000),@p1260 nvarchar(4000),@p1261 int,@p1262 nvarchar(4000),@p1263 nvarchar(4000),@p1264 nvarchar(4000),@p1265 nvarchar(4000),@p1266 nvarchar(4000),@p1267 nvarchar(4000),@p1268 nvarchar(4000),@p1269 nvarchar(4000),@p1270 nvarchar(4000),@p1271 nvarchar(4000),@p1272 int,@p1273 nvarchar(4000),@p1274 nvarchar(4000),@p1275 nvarchar(4000),@p1276 nvarchar(4000),@p1277 nvarchar(4000),@p1278 int,@p1279 nvarchar(4000),@p1280 int,@p1281 int,@p1282 datetime2(7),@p1283 datetime2(7),@p1284 datetime2(7),@p1285 nvarchar(4000),@p1286 nvarchar(4000),@p1287 nvarchar(4000),@p1288 nvarchar(4000),@p1289 nvarchar(4000),@p1290 nvarchar(4000),@p1291 nvarchar(4000),@p1292 nvarchar(4000),@p1293 nvarchar(4000),@p1294 nvarchar(4000),@p1295 nvarchar(4000),@p1296 nvarchar(4000),@p1297 nvarchar(4000),@p1298 nvarchar(4000),@p1299 datetime2(7),@p1300 nvarchar(4000),@p1301 nvarchar(4000),@p1302 int,@p1303 int,@p1304 int,@p1305 nvarchar(4000),@p1306 nvarchar(4000),@p1307 nvarchar(4000),@p1308 decimal(18,2),@p1309 decimal(18,2),@p1310 nvarchar(4000),@p1311 nvarchar(4000),@p1312 decimal(18,2),@p1313 nvarchar(4000),@p1314 nvarchar(4000),@p1315 nvarchar(4000),@p1316 nvarchar(4000),@p1317 int,@p1318 nvarchar(4000),@p1319 nvarchar(4000),@p1320 nvarchar(4000),@p1321 nvarchar(4000),@p1322 nvarchar(4000),@p1323 nvarchar(4000),@p1324 nvarchar(4000),@p1325 nvarchar(4000),@p1326 nvarchar(4000),@p1327 nvarchar(4000),@p1328 int,@p1329 nvarchar(4000),@p1330 nvarchar(4000),@p1331 nvarchar(4000),@p1332 nvarchar(4000),@p1333 nvarchar(4000),@p1334 int,@p1335 nvarchar(4000),@p1336 int,@p1337 int,@p1338 datetime2(7),@p1339 datetime2(7),@p1340 datetime2(7),@p1341 nvarchar(4000),@p1342 nvarchar(4000),@p1343 nvarchar(4000),@p1344 nvarchar(4000),@p1345 nvarchar(4000),@p1346 nvarchar(4000),@p1347 nvarchar(4000),@p1348 nvarchar(4000),@p1349 nvarchar(4000),@p1350 nvarchar(4000),@p1351 nvarchar(4000),@p1352 nvarchar(4000),@p1353 nvarchar(4000),@p1354 nvarchar(4000),@p1355 datetime2(7),@p1356 nvarchar(4000),@p1357 nvarchar(4000),@p1358 int,@p1359 int,@p1360 int,@p1361 nvarchar(4000),@p1362 nvarchar(4000),@p1363 nvarchar(4000),@p1364 decimal(18,2),@p1365 decimal(18,2),@p1366 nvarchar(4000),@p1367 nvarchar(4000),@p1368 decimal(18,2),@p1369 nvarchar(4000),@p1370 nvarchar(4000),@p1371 nvarchar(4000),@p1372 nvarchar(4000),@p1373 int,@p1374 nvarchar(4000),@p1375 nvarchar(4000),@p1376 nvarchar(4000),@p1377 nvarchar(4000),@p1378 nvarchar(4000),@p1379 nvarchar(4000),@p1380 nvarchar(4000),@p1381 nvarchar(4000),@p1382 nvarchar(4000),@p1383 nvarchar(4000),@p1384 int,@p1385 nvarchar(4000),@p1386 nvarchar(4000),@p1387 nvarchar(4000),@p1388 nvarchar(4000),@p1389 nvarchar(4000),@p1390 int,@p1391 nvarchar(4000),@p1392 int,@p1393 int,@p1394 datetime2(7),@p1395 datetime2(7),@p1396 datetime2(7),@p1397 nvarchar(4000),@p1398 nvarchar(4000),@p1399 nvarchar(4000),@p1400 nvarchar(4000),@p1401 nvarchar(4000),@p1402 nvarchar(4000),@p1403 nvarchar(4000),@p1404 nvarchar(4000),@p1405 nvarchar(4000),@p1406 nvarchar(4000),@p1407 nvarchar(4000),@p1408 nvarchar(4000),@p1409 nvarchar(4000),@p1410 nvarchar(4000),@p1411 datetime2(7),@p1412 nvarchar(4000),@p1413 nvarchar(4000),@p1414 int,@p1415 int,@p1416 int,@p1417 nvarchar(4000),@p1418 nvarchar(4000),@p1419 nvarchar(4000),@p1420 decimal(18,2),@p1421 decimal(18,2),@p1422 nvarchar(4000),@p1423 nvarchar(4000),@p1424 decimal(18,2),@p1425 nvarchar(4000),@p1426 nvarchar(4000),@p1427 nvarchar(4000),@p1428 nvarchar(4000),@p1429 int,@p1430 nvarchar(4000),@p1431 nvarchar(4000),@p1432 nvarchar(4000),@p1433 nvarchar(4000),@p1434 nvarchar(4000),@p1435 nvarchar(4000),@p1436 nvarchar(4000),@p1437 nvarchar(4000),@p1438 nvarchar(4000),@p1439 nvarchar(4000),@p1440 int,@p1441 nvarchar(4000),@p1442 nvarchar(4000),@p1443 nvarchar(4000),@p1444 nvarchar(4000),@p1445 nvarchar(4000),@p1446 int,@p1447 nvarchar(4000),@p1448 int,@p1449 int,@p1450 datetime2(7),@p1451 datetime2(7),@p1452 datetime2(7),@p1453 nvarchar(4000),@p1454 nvarchar(4000),@p1455 nvarchar(4000),@p1456 nvarchar(4000),@p1457 nvarchar(4000),@p1458 nvarchar(4000),@p1459 nvarchar(4000),@p1460 nvarchar(4000),@p1461 nvarchar(4000),@p1462 nvarchar(4000),@p1463 nvarchar(4000),@p1464 nvarchar(4000),@p1465 nvarchar(4000),@p1466 nvarchar(4000),@p1467 datetime2(7),@p1468 nvarchar(4000),@p1469 nvarchar(4000),@p1470 int,@p1471 int,@p1472 int,@p1473 nvarchar(4000),@p1474 nvarchar(4000),@p1475 nvarchar(4000),@p1476 decimal(18,2),@p1477 decimal(18,2),@p1478 nvarchar(4000),@p1479 nvarchar(4000),@p1480 decimal(18,2),@p1481 nvarchar(4000),@p1482 nvarchar(4000),@p1483 nvarchar(4000),@p1484 nvarchar(4000),@p1485 int,@p1486 nvarchar(4000),@p1487 nvarchar(4000),@p1488 nvarchar(4000),@p1489 nvarchar(4000),@p1490 nvarchar(4000),@p1491 nvarchar(4000),@p1492 nvarchar(4000),@p1493 nvarchar(4000),@p1494 nvarchar(4000),@p1495 nvarchar(4000),@p1496 int,@p1497 nvarchar(4000),@p1498 nvarchar(4000),@p1499 nvarchar(4000),@p1500 nvarchar(4000),@p1501 nvarchar(4000),@p1502 int,@p1503 nvarchar(4000),@p1504 int,@p1505 int,@p1506 datetime2(7),@p1507 datetime2(7),@p1508 datetime2(7),@p1509 nvarchar(4000),@p1510 nvarchar(4000),@p1511 nvarchar(4000),@p1512 nvarchar(4000),@p1513 nvarchar(4000),@p1514 nvarchar(4000),@p1515 nvarchar(4000),@p1516 nvarchar(4000),@p1517 nvarchar(4000),@p1518 nvarchar(4000),@p1519 nvarchar(4000),@p1520 nvarchar(4000),@p1521 nvarchar(4000),@p1522 nvarchar(4000),@p1523 datetime2(7),@p1524 nvarchar(4000),@p1525 nvarchar(4000),@p1526 int,@p1527 int,@p1528 int,@p1529 nvarchar(4000),@p1530 nvarchar(4000),@p1531 nvarchar(4000),@p1532 decimal(18,2),@p1533 decimal(18,2),@p1534 nvarchar(4000),@p1535 nvarchar(4000),@p1536 decimal(18,2),@p1537 nvarchar(4000),@p1538 nvarchar(4000),@p1539 nvarchar(4000),@p1540 nvarchar(4000),@p1541 int,@p1542 nvarchar(4000),@p1543 nvarchar(4000),@p1544 nvarchar(4000),@p1545 nvarchar(4000),@p1546 nvarchar(4000),@p1547 nvarchar(4000),@p1548 nvarchar(4000),@p1549 nvarchar(4000),@p1550 nvarchar(4000),@p1551 nvarchar(4000),@p1552 int,@p1553 nvarchar(4000),@p1554 nvarchar(4000),@p1555 nvarchar(4000),@p1556 nvarchar(4000),@p1557 nvarchar(4000),@p1558 int,@p1559 nvarchar(4000),@p1560 int,@p1561 int,@p1562 datetime2(7),@p1563 datetime2(7),@p1564 datetime2(7),@p1565 nvarchar(4000),@p1566 nvarchar(4000),@p1567 nvarchar(4000),@p1568 nvarchar(4000),@p1569 nvarchar(4000),@p1570 nvarchar(4000),@p1571 nvarchar(4000),@p1572 nvarchar(4000),@p1573 nvarchar(4000),@p1574 nvarchar(4000),@p1575 nvarchar(4000),@p1576 nvarchar(4000),@p1577 nvarchar(4000),@p1578 nvarchar(4000),@p1579 datetime2(7),@p1580 nvarchar(4000),@p1581 nvarchar(4000),@p1582 int,@p1583 int,@p1584 int,@p1585 nvarchar(4000),@p1586 nvarchar(4000),@p1587 nvarchar(4000),@p1588 decimal(18,2),@p1589 decimal(18,2),@p1590 nvarchar(4000),@p1591 nvarchar(4000),@p1592 decimal(18,2),@p1593 nvarchar(4000),@p1594 nvarchar(4000),@p1595 nvarchar(4000),@p1596 nvarchar(4000),@p1597 int,@p1598 nvarchar(4000),@p1599 nvarchar(4000),@p1600 nvarchar(4000),@p1601 nvarchar(4000),@p1602 nvarchar(4000),@p1603 nvarchar(4000),@p1604 nvarchar(4000),@p1605 nvarchar(4000),@p1606 nvarchar(4000),@p1607 nvarchar(4000),@p1608 int,@p1609 nvarchar(4000),@p1610 nvarchar(4000),@p1611 nvarchar(4000),@p1612 nvarchar(4000),@p1613 nvarchar(4000),@p1614 int,@p1615 nvarchar(4000),@p1616 int,@p1617 int,@p1618 datetime2(7),@p1619 datetime2(7),@p1620 datetime2(7),@p1621 nvarchar(4000),@p1622 nvarchar(4000),@p1623 nvarchar(4000),@p1624 nvarchar(4000),@p1625 nvarchar(4000),@p1626 nvarchar(4000),@p1627 nvarchar(4000),@p1628 nvarchar(4000),@p1629 nvarchar(4000),@p1630 nvarchar(4000),@p1631 nvarchar(4000),@p1632 nvarchar(4000),@p1633 nvarchar(4000),@p1634 nvarchar(4000),@p1635 datetime2(7),@p1636 nvarchar(4000),@p1637 nvarchar(4000),@p1638 int,@p1639 int,@p1640 int,@p1641 nvarchar(4000),@p1642 nvarchar(4000),@p1643 nvarchar(4000),@p1644 decimal(18,2),@p1645 decimal(18,2),@p1646 nvarchar(4000),@p1647 nvarchar(4000),@p1648 decimal(18,2),@p1649 nvarchar(4000),@p1650 nvarchar(4000),@p1651 nvarchar(4000),@p1652 nvarchar(4000),@p1653 int,@p1654 nvarchar(4000),@p1655 nvarchar(4000),@p1656 nvarchar(4000),@p1657 nvarchar(4000),@p1658 nvarchar(4000),@p1659 nvarchar(4000),@p1660 nvarchar(4000),@p1661 nvarchar(4000),@p1662 nvarchar(4000),@p1663 nvarchar(4000),@p1664 int,@p1665 nvarchar(4000),@p1666 nvarchar(4000),@p1667 nvarchar(4000),@p1668 nvarchar(4000),@p1669 nvarchar(4000),@p1670 int,@p1671 nvarchar(4000),@p1672 int,@p1673 int,@p1674 datetime2(7),@p1675 datetime2(7),@p1676 datetime2(7),@p1677 nvarchar(4000),@p1678 nvarchar(4000),@p1679 nvarchar(4000),@p1680 nvarchar(4000),@p1681 nvarchar(4000),@p1682 nvarchar(4000),@p1683 nvarchar(4000),@p1684 nvarchar(4000),@p1685 nvarchar(4000),@p1686 nvarchar(4000),@p1687 nvarchar(4000),@p1688 nvarchar(4000),@p1689 nvarchar(4000),@p1690 nvarchar(4000),@p1691 datetime2(7),@p1692 nvarchar(4000),@p1693 nvarchar(4000),@p1694 int,@p1695 int,@p1696 int,@p1697 nvarchar(4000),@p1698 nvarchar(4000),@p1699 nvarchar(4000),@p1700 decimal(18,2),@p1701 decimal(18,2),@p1702 nvarchar(4000),@p1703 nvarchar(4000),@p1704 decimal(18,2),@p1705 nvarchar(4000),@p1706 nvarchar(4000),@p1707 nvarchar(4000),@p1708 nvarchar(4000),@p1709 int,@p1710 nvarchar(4000),@p1711 nvarchar(4000),@p1712 nvarchar(4000),@p1713 nvarchar(4000),@p1714 nvarchar(4000),@p1715 nvarchar(4000),@p1716 nvarchar(4000),@p1717 nvarchar(4000),@p1718 nvarchar(4000),@p1719 nvarchar(4000),@p1720 int,@p1721 nvarchar(4000),@p1722 nvarchar(4000),@p1723 nvarchar(4000),@p1724 nvarchar(4000),@p1725 nvarchar(4000),@p1726 int,@p1727 nvarchar(4000),@p1728 int,@p1729 int,@p1730 datetime2(7),@p1731 datetime2(7),@p1732 datetime2(7),@p1733 nvarchar(4000),@p1734 nvarchar(4000),@p1735 nvarchar(4000),@p1736 nvarchar(4000),@p1737 nvarchar(4000),@p1738 nvarchar(4000),@p1739 nvarchar(4000),@p1740 nvarchar(4000),@p1741 nvarchar(4000),@p1742 nvarchar(4000),@p1743 nvarchar(4000),@p1744 nvarchar(4000),@p1745 nvarchar(4000),@p1746 nvarchar(4000),@p1747 datetime2(7),@p1748 nvarchar(4000),@p1749 nvarchar(4000),@p1750 int,@p1751 int,@p1752 int,@p1753 nvarchar(4000),@p1754 nvarchar(4000),@p1755 nvarchar(4000),@p1756 decimal(18,2),@p1757 decimal(18,2),@p1758 nvarchar(4000),@p1759 nvarchar(4000),@p1760 decimal(18,2),@p1761 nvarchar(4000),@p1762 nvarchar(4000),@p1763 nvarchar(4000),@p1764 nvarchar(4000),@p1765 int,@p1766 nvarchar(4000),@p1767 nvarchar(4000),@p1768 nvarchar(4000),@p1769 nvarchar(4000),@p1770 nvarchar(4000),@p1771 nvarchar(4000),@p1772 nvarchar(4000),@p1773 nvarchar(4000),@p1774 nvarchar(4000),@p1775 nvarchar(4000),@p1776 int,@p1777 nvarchar(4000),@p1778 nvarchar(4000),@p1779 nvarchar(4000),@p1780 nvarchar(4000),@p1781 nvarchar(4000),@p1782 int,@p1783 nvarchar(4000),@p1784 int,@p1785 int,@p1786 datetime2(7),@p1787 datetime2(7),@p1788 datetime2(7),@p1789 nvarchar(4000),@p1790 nvarchar(4000),@p1791 nvarchar(4000),@p1792 nvarchar(4000),@p1793 nvarchar(4000),@p1794 nvarchar(4000),@p1795 nvarchar(4000),@p1796 nvarchar(4000),@p1797 nvarchar(4000),@p1798 nvarchar(4000),@p1799 nvarchar(4000),@p1800 nvarchar(4000),@p1801 nvarchar(4000),@p1802 nvarchar(4000),@p1803 datetime2(7),@p1804 nvarchar(4000),@p1805 nvarchar(4000),@p1806 int,@p1807 int,@p1808 int,@p1809 nvarchar(4000),@p1810 nvarchar(4000),@p1811 nvarchar(4000),@p1812 decimal(18,2),@p1813 decimal(18,2),@p1814 nvarchar(4000),@p1815 nvarchar(4000),@p1816 decimal(18,2),@p1817 nvarchar(4000),@p1818 nvarchar(4000),@p1819 nvarchar(4000),@p1820 nvarchar(4000),@p1821 int,@p1822 nvarchar(4000),@p1823 nvarchar(4000),@p1824 nvarchar(4000),@p1825 nvarchar(4000),@p1826 nvarchar(4000),@p1827 nvarchar(4000),@p1828 nvarchar(4000),@p1829 nvarchar(4000),@p1830 nvarchar(4000),@p1831 nvarchar(4000),@p1832 int,@p1833 nvarchar(4000),@p1834 nvarchar(4000),@p1835 nvarchar(4000),@p1836 nvarchar(4000),@p1837 nvarchar(4000),@p1838 int,@p1839 nvarchar(4000),@p1840 int,@p1841 int,@p1842 datetime2(7),@p1843 datetime2(7),@p1844 datetime2(7),@p1845 nvarchar(4000),@p1846 nvarchar(4000),@p1847 nvarchar(4000),@p1848 nvarchar(4000),@p1849 nvarchar(4000),@p1850 nvarchar(4000),@p1851 nvarchar(4000),@p1852 nvarchar(4000),@p1853 nvarchar(4000),@p1854 nvarchar(4000),@p1855 nvarchar(4000),@p1856 nvarchar(4000),@p1857 nvarchar(4000),@p1858 nvarchar(4000),@p1859 datetime2(7),@p1860 nvarchar(4000),@p1861 nvarchar(4000),@p1862 int,@p1863 int,@p1864 int,@p1865 nvarchar(4000),@p1866 nvarchar(4000),@p1867 nvarchar(4000),@p1868 decimal(18,2),@p1869 decimal(18,2),@p1870 nvarchar(4000),@p1871 nvarchar(4000),@p1872 decimal(18,2),@p1873 nvarchar(4000),@p1874 nvarchar(4000),@p1875 nvarchar(4000),@p1876 nvarchar(4000),@p1877 int,@p1878 nvarchar(4000),@p1879 nvarchar(4000),@p1880 nvarchar(4000),@p1881 nvarchar(4000),@p1882 nvarchar(4000),@p1883 nvarchar(4000),@p1884 nvarchar(4000),@p1885 nvarchar(4000),@p1886 nvarchar(4000),@p1887 nvarchar(4000),@p1888 int,@p1889 nvarchar(4000),@p1890 nvarchar(4000),@p1891 nvarchar(4000),@p1892 nvarchar(4000),@p1893 nvarchar(4000),@p1894 int,@p1895 nvarchar(4000),@p1896 int,@p1897 int,@p1898 datetime2(7),@p1899 datetime2(7),@p1900 datetime2(7),@p1901 nvarchar(4000),@p1902 nvarchar(4000),@p1903 nvarchar(4000),@p1904 nvarchar(4000),@p1905 nvarchar(4000),@p1906 nvarchar(4000),@p1907 nvarchar(4000),@p1908 nvarchar(4000),@p1909 nvarchar(4000),@p1910 nvarchar(4000),@p1911 nvarchar(4000),@p1912 nvarchar(4000),@p1913 nvarchar(4000),@p1914 nvarchar(4000),@p1915 datetime2(7),@p1916 nvarchar(4000),@p1917 nvarchar(4000),@p1918 int,@p1919 int,@p1920 int,@p1921 nvarchar(4000),@p1922 nvarchar(4000),@p1923 nvarchar(4000),@p1924 decimal(18,2),@p1925 decimal(18,2),@p1926 nvarchar(4000),@p1927 nvarchar(4000),@p1928 decimal(18,2),@p1929 nvarchar(4000),@p1930 nvarchar(4000),@p1931 nvarchar(4000),@p1932 nvarchar(4000),@p1933 int,@p1934 nvarchar(4000),@p1935 nvarchar(4000),@p1936 nvarchar(4000),@p1937 nvarchar(4000),@p1938 nvarchar(4000),@p1939 nvarchar(4000),@p1940 nvarchar(4000),@p1941 nvarchar(4000),@p1942 nvarchar(4000),@p1943 nvarchar(4000),@p1944 int,@p1945 nvarchar(4000),@p1946 nvarchar(4000),@p1947 nvarchar(4000),@p1948 nvarchar(4000),@p1949 nvarchar(4000),@p1950 int,@p1951 nvarchar(4000),@p1952 int,@p1953 int,@p1954 datetime2(7),@p1955 datetime2(7),@p1956 datetime2(7),@p1957 nvarchar(4000),@p1958 nvarchar(4000),@p1959 nvarchar(4000),@p1960 nvarchar(4000),@p1961 nvarchar(4000),@p1962 nvarchar(4000),@p1963 nvarchar(4000),@p1964 nvarchar(4000),@p1965 nvarchar(4000),@p1966 nvarchar(4000),@p1967 nvarchar(4000),@p1968 nvarchar(4000),@p1969 nvarchar(4000),@p1970 nvarchar(4000),@p1971 datetime2(7),@p1972 nvarchar(4000),@p1973 nvarchar(4000),@p1974 int,@p1975 int,@p1976 int,@p1977 nvarchar(4000),@p1978 nvarchar(4000),@p1979 nvarchar(4000),@p1980 decimal(18,2),@p1981 decimal(18,2),@p1982 nvarchar(4000),@p1983 nvarchar(4000),@p1984 decimal(18,2),@p1985 nvarchar(4000),@p1986 nvarchar(4000),@p1987 nvarchar(4000),@p1988 nvarchar(4000),@p1989 int,@p1990 nvarchar(4000),@p1991 nvarchar(4000),@p1992 nvarchar(4000),@p1993 nvarchar(4000),@p1994 nvarchar(4000),@p1995 nvarchar(4000),@p1996 nvarchar(4000),@p1997 nvarchar(4000),@p1998 nvarchar(4000),@p1999 nvarchar(4000),@p2000 int,@p2001 nvarchar(4000),@p2002 nvarchar(4000),@p2003 nvarchar(4000),@p2004 nvarchar(4000),@p2005 nvarchar(4000),@p2006 int,@p2007 nvarchar(4000),@p2008 int,@p2009 int,@p2010 datetime2(7),@p2011 datetime2(7),@p2012 datetime2(7),@p2013 nvarchar(4000),@p2014 nvarchar(4000),@p2015 nvarchar(4000),@p2016 nvarchar(4000),@p2017 nvarchar(4000),@p2018 nvarchar(4000),@p2019 nvarchar(4000),@p2020 nvarchar(4000),@p2021 nvarchar(4000),@p2022 nvarchar(4000),@p2023 nvarchar(4000),@p2024 nvarchar(4000),@p2025 nvarchar(4000),@p2026 nvarchar(4000),@p2027 datetime2(7),@p2028 nvarchar(4000),@p2029 nvarchar(4000),@p2030 int,@p2031 int,@p2032 int,@p2033 nvarchar(4000),@p2034 nvarchar(4000),@p2035 nvarchar(4000),@p2036 decimal(18,2),@p2037 decimal(18,2),@p2038 nvarchar(4000),@p2039 nvarchar(4000),@p2040 decimal(18,2),@p2041 nvarchar(4000),@p2042 nvarchar(4000),@p2043 nvarchar(4000),@p2044 nvarchar(4000),@p2045 int,@p2046 nvarchar(4000),@p2047 nvarchar(4000),@p2048 nvarchar(4000),@p2049 nvarchar(4000),@p2050 nvarchar(4000),@p2051 nvarchar(4000),@p2052 nvarchar(4000),@p2053 nvarchar(4000),@p2054 nvarchar(4000),@p2055 nvarchar(4000),@p2056 int,@p2057 nvarchar(4000),@p2058 nvarchar(4000),@p2059 nvarchar(4000),@p2060 nvarchar(4000),@p2061 nvarchar(4000),@p2062 int,@p2063 nvarchar(4000),@p2064 int,@p2065 int,@p2066 datetime2(7),@p2067 datetime2(7),@p2068 datetime2(7),@p2069 nvarchar(4000),@p2070 nvarchar(4000),@p2071 nvarchar(4000))SET NOCOUNT ON; DECLARE @inserted0 TABLE ([item_id] int, [_Position] [int]); MERGE [raw_data] USING ( VALUES (@p0, @p1, @p2, @p3, @p4, @p5, @p6, @p7, @p8, @p9, @p10, @p11, @p12, @p13, @p14, @p15, @p16, @p17, @p18, @p19, @p20, @p21, @p22, @p23, @p24, @p25, @p26, @p27, @p28, @p29, @p30, @p31, @p32, @p33, @p34, @p35, @p36, @p37, @p38, @p39, @p40, @p41, @p42, @p43, @p44, @p45, @p46, @p47, @p48, @p49, @p50, @p51, @p52, @p53, @p54, @p55, 0), (@p56, @p57, @p58, @p59, @p60, @p61, @p62, @p63, @p64, @p65, @p66, @p67, @p68, @p69, @p70, @p71, @p72, @p73, @p74, @p75, @p76, @p77, @p78, @p79, @p80, @p81, @p82, @p83, @p84, @p85, @p86, @p87, @p88, @p89, @p90, @p91, @p92, @p93, @p94, @p95, @p96, @p97, @p98, @p99, @p100, @p101, @p102, @p103, @p104, @p105, @p106, @p107, @p108, @p109, @p110, @p111, 1), (@p112, @p113, @p114, @p115, @p116, @p117, @p118, @p119, @p120, @p121, @p122, @p123, @p124, @p125, @p126, @p127, @p128, @p129, @p130, @p131, @p132, @p133, @p134, @p135, @p136, @p137, @p138, @p139, @p140, @p141, @p142, @p143, @p144, @p145, @p146, @p147, @p148, @p149, @p150, @p151, @p152, @p153, @p154, @p155, @p156, @p157, @p158, @p159, @p160, @p161, @p162, @p163, @p164, @p165, @p166, @p167, 2), (@p168, @p169, @p170, @p171, @p172, @p173, @p174, @p175, @p176, @p177, @p178, @p179, @p180, @p181, @p182, @p183, @p184, @p185, @p186, @p187, @p188, @p189, @p190, @p191, @p192, @p193, @p194, @p195, @p196, @p197, @p198, @p199, @p200, @p201, @p202, @p203, @p204, @p205, @p206, @p207, @p208, @p209, @p210, @p211, @p212, @p213, @p214, @p215, @p216, @p217, @p218, @p219, @p220, @p221, @p222, @p223, 3), (@p224, @p225, @p226, @p227, @p228, @p229, @p230, @p231, @p232, @p233, @p234, @p235, @p236, @p237, @p238, @p239, @p240, @p241, @p242, @p243, @p244, @p245, @p246, @p247, @p248, @p249, @p250, @p251, @p252, @p253, @p254, @p255, @p256, @p257, @p258, @p259, @p260, @p261, @p262, @p263, @p264, @p265, @p266, @p267, @p268, @p269, @p270, @p271, @p272, @p273, @p274, @p275, @p276, @p277, @p278, @p279, 4), (@p280, @p281, @p282, @p283, @p284, @p285, @p286, @p287, @p288, @p289, @p290, @p291, @p292, @p293, @p294, @p295, @p296, @p297, @p298, @p299, @p300, @p301, @p302, @p303, @p304, @p305, @p306, @p307, @p308, @p309, @p310, @p311, @p312, @p313, @p314, @p315, @p316, @p317, @p318, @p319, @p320, @p321, @p322, @p323, @p324, @p325, @p326, @p327, @p328, @p329, @p330, @p331, @p332, @p333, @p334, @p335, 5), (@p336, @p337, @p338, @p339, @p340, @p341, @p342, @p343, @p344, @p345, @p346, @p347, @p348, @p349, @p350, @p351, @p352, @p353, @p354, @p355, @p356, @p357, @p358, @p359, @p360, @p361, @p362, @p363, @p364, @p365, @p366, @p367, @p368, @p369, @p370, @p371, @p372, @p373, @p374, @p375, @p376, @p377, @p378, @p379, @p380, @p381, @p382, @p383, @p384, @p385, @p386, @p387, @p388, @p389, @p390, @p391, 6), (@p392, @p393, @p394, @p395, @p396, @p397, @p398, @p399, @p400, @p401, @p402, @p403, @p404, @p405, @p406, @p407, @p408, @p409, @p410, @p411, @p412, @p413, @p414, @p415, @p416, @p417, @p418, @p419, @p420, @p421, @p422, @p423, @p424, @p425, @p426, @p427, @p428, @p429, @p430, @p431, @p432, @p433, @p434, @p435, @p436, @p437, @p438, @p439, @p440, @p441, @p442, @p443, @p444, @p445, @p446, @p447, 7), (@p448, @p449, @p450, @p451, @p452, @p453, @p454, @p455, @p456, @p457, @p458, @p459, @p460, @p461, @p462, @p463, @p464, @p465, @p466, @p467, @p468, @p469, @p470, @p471, @p472, @p473, @p474, @p475, @p476, @p477, @p478, @p479, @p480, @p481, @p482, @p483, @p484, @p485, @p486, @p487, @p488, @p489, @p490, @p491, @p492, @p493, @p494, @p495, @p496, @p497, @p498, @p499, @p500, @p501, @p502, @p503, 8), (@p504, @p505, @p506, @p507, @p508, @p509, @p510, @p511, @p512, @p513, @p514, @p515, @p516, @p517, @p518, @p519, @p520, @p521, @p522, @p523, @p524, @p525, @p526, @p527, @p528, @p529, @p530, @p531, @p532, @p533, @p534, @p535, @p536, @p537, @p538, @p539, @p540, @p541, @p542, @p543, @p544, @p545, @p546, @p547, @p548, @p549, @p550, @p551, @p552, @p553, @p554, @p555, @p556, @p557, @p558, @p559, 9), (@p560, @p561, @p562, @p563, @p564, @p565, @p566, @p567, @p568, @p569, @p570, @p571, @p572, @p573, @p574, @p575, @p576, @p577, @p578, @p579, @p580, @p581, @p582, @p583, @p584, @p585, @p586, @p587, @p588, @p589, @p590, @p591, @p592, @p593, @p594, @p595, @p596, @p597, @p598, @p599, @p600, @p601, @p602, @p603, @p604, @p605, @p606, @p607, @p608, @p609, @p610, @p611, @p612, @p613, @p614, @p615, 10), (@p616, @p617, @p618, @p619, @p620, @p621, @p622, @p623, @p624, @p625, @p626, @p627, @p628, @p629, @p630, @p631, @p632, @p633, @p634, @p635, @p636, @p637, @p638, @p639, @p640, @p641, @p642, @p643, @p644, @p645, @p646, @p647, @p648, @p649, @p650, @p651, @p652, @p653, @p654, @p655, @p656, @p657, @p658, @p659, @p660, @p661, @p662, @p663, @p664, @p665, @p666, @p667, @p668, @p669, @p670, @p671, 11), (@p672, @p673, @p674, @p675, @p676, @p677, @p678, @p679, @p680, @p681, @p682, @p683, @p684, @p685, @p686, @p687, @p688, @p689, @p690, @p691, @p692, @p693, @p694, @p695, @p696, @p697, @p698, @p699, @p700, @p701, @p702, @p703, @p704, @p705, @p706, @p707, @p708, @p709, @p710, @p711, @p712, @p713, @p714, @p715, @p716, @p717, @p718, @p719, @p720, @p721, @p722, @p723, @p724, @p725, @p726, @p727, 12), (@p728, @p729, @p730, @p731, @p732, @p733, @p734, @p735, @p736, @p737, @p738, @p739, @p740, @p741, @p742, @p743, @p744, @p745, @p746, @p747, @p748, @p749, @p750, @p751, @p752, @p753, @p754, @p755, @p756, @p757, @p758, @p759, @p760, @p761, @p762, @p763, @p764, @p765, @p766, @p767, @p768, @p769, @p770, @p771, @p772, @p773, @p774, @p775, @p776, @p777, @p778, @p779, @p780, @p781, @p782, @p783, 13), (@p784, @p785, @p786, @p787, @p788, @p789, @p790, @p791, @p792, @p793, @p794, @p795, @p796, @p797, @p798, @p799, @p800, @p801, @p802, @p803, @p804, @p805, @p806, @p807, @p808, @p809, @p810, @p811, @p812, @p813, @p814, @p815, @p816, @p817, @p818, @p819, @p820, @p821, @p822, @p823, @p824, @p825, @p826, @p827, @p828, @p829, @p830, @p831, @p832, @p833, @p834, @p835, @p836, @p837, @p838, @p839, 14), (@p840, @p841, @p842, @p843, @p844, @p845, @p846, @p847, @p848, @p849, @p850, @p851, @p852, @p853, @p854, @p855, @p856, @p857, @p858, @p859, @p860, @p861, @p862, @p863, @p864, @p865, @p866, @p867, @p868, @p869, @p870, @p871, @p872, @p873, @p874, @p875, @p876, @p877, @p878, @p879, @p880, @p881, @p882, @p883, @p884, @p885, @p886, @p887, @p888, @p889, @p890, @p891, @p892, @p893, @p894, @p895, 15), (@p896, @p897, @p898, @p899, @p900, @p901, @p902, @p903, @p904, @p905, @p906, @p907, @p908, @p909, @p910, @p911, @p912, @p913, @p914, @p915, @p916, @p917, @p918, @p919, @p920, @p921, @p922, @p923, @p924, @p925, @p926, @p927, @p928, @p929, @p930, @p931, @p932, @p933, @p934, @p935, @p936, @p937, @p938, @p939, @p940, @p941, @p942, @p943, @p944, @p945, @p946, @p947, @p948, @p949, @p950, @p951, 16), (@p952, @p953, @p954, @p955, @p956, @p957, @p958, @p959, @p960, @p961, @p962, @p963, @p964, @p965, @p966, @p967, @p968, @p969, @p970, @p971, @p972, @p973, @p974, @p975, @p976, @p977, @p978, @p979, @p980, @p981, @p982, @p983, @p984, @p985, @p986, @p987, @p988, @p989, @p990, @p991, @p992, @p993, @p994, @p995, @p996, @p997, @p998, @p999, @p1000, @p1001, @p1002, @p1003, @p1004, @p1005, @p1006, @p1007, 17), (@p1008, @p1009, @p1010, @p1011, @p1012, @p1013, @p1014, @p1015, @p1016, @p1017, @p1018, @p1019, @p1020, @p1021, @p1022, @p1023, @p1024, @p1025, @p1026, @p1027, @p1028, @p1029, @p1030, @p1031, @p1032, @p1033, @p1034, @p1035, @p1036, @p1037, @p1038, @p1039, @p1040, @p1041, @p1042, @p1043, @p1044, @p1045, @p1046, @p1047, @p1048, @p1049, @p1050, @p1051, @p1052, @p1053, @p1054, @p1055, @p1056, @p1057, @p1058, @p1059, @p1060, @p1061, @p1062, @p1063, 18), (@p1064, @p1065, @p1066, @p1067, @p1068, @p1069, @p1070, @p1071, @p1072, @p1073, @p1074, @p1075, @p1076, @p1077, @p1078, @p1079, @p1080, @p1081, @p1082, @p1083, @p1084, @p1085, @p1086, @p1087, @p1088, @p1089, @p1090, @p1091, @p1092, @p1093, @p1094, @p1095, @p1096, @p1097, @p1098, @p1099, @p1100, @p1101, @p1102, @p1103, @p1104, @p1105, @p1106, @p1107, @p1108, @p1109, @p1110, @p1111, @p1112, @p1113, @p1114, @p1115, @p1116, @p1117, @p1118, @p1119, 19), (@p1120, @p1121, @p1122, @p1123, @p1124, @p1125, @p1126, @p1127, @p1128, @p1129, @p1130, @p1131, @p1132, @p1133, @p1134, @p1135, @p1136, @p1137, @p1138, @p1139, @p1140, @p1141, @p1142, @p1143, @p1144, @p1145, @p1146, @p1147, @p1148, @p1149, @p1150, @p1151, @p1152, @p1153, @p1154, @p1155, @p1156, @p1157, @p1158, @p1159, @p1160, @p1161, @p1162, @p1163, @p1164, @p1165, @p1166, @p1167, @p1168, @p1169, @p1170, @p1171, @p1172, @p1173, @p1174, @p1175, 20), (@p1176, @p1177, @p1178, @p1179, @p1180, @p1181, @p1182, @p1183, @p1184, @p1185, @p1186, @p1187, @p1188, @p1189, @p1190, @p1191, @p1192, @p1193, @p1194, @p1195, @p1196, @p1197, @p1198, @p1199, @p1200, @p1201, @p1202, @p1203, @p1204, @p1205, @p1206, @p1207, @p1208, @p1209, @p1210, @p1211, @p1212, @p1213, @p1214, @p1215, @p1216, @p1217, @p1218, @p1219, @p1220, @p1221, @p1222, @p1223, @p1224, @p1225, @p1226, @p1227, @p1228, @p1229, @p1230, @p1231, 21), (@p1232, @p1233, @p1234, @p1235, @p1236, @p1237, @p1238, @p1239, @p1240, @p1241, @p1242, @p1243, @p1244, @p1245, @p1246, @p1247, @p1248, @p1249, @p1250, @p1251, @p1252, @p1253, @p1254, @p1255, @p1256, @p1257, @p1258, @p1259, @p1260, @p1261, @p1262, @p1263, @p1264, @p1265, @p1266, @p1267, @p1268, @p1269, @p1270, @p1271, @p1272, @p1273, @p1274, @p1275, @p1276, @p1277, @p1278, @p1279, @p1280, @p1281, @p1282, @p1283, @p1284, @p1285, @p1286, @p1287, 22), (@p1288, @p1289, @p1290, @p1291, @p1292, @p1293, @p1294, @p1295, @p1296, @p1297, @p1298, @p1299, @p1300, @p1301, @p1302, @p1303, @p1304, @p1305, @p1306, @p1307, @p1308, @p1309, @p1310, @p1311, @p1312, @p1313, @p1314, @p1315, @p1316, @p1317, @p1318, @p1319, @p1320, @p1321, @p1322, @p1323, @p1324, @p1325, @p1326, @p1327, @p1328, @p1329, @p1330, @p1331, @p1332, @p1333, @p1334, @p1335, @p1336, @p1337, @p1338, @p1339, @p1340, @p1341, @p1342, @p1343, 23), (@p1344, @p1345, @p1346, @p1347, @p1348, @p1349, @p1350, @p1351, @p1352, @p1353, @p1354, @p1355, @p1356, @p1357, @p1358, @p1359, @p1360, @p1361, @p1362, @p1363, @p1364, @p1365, @p1366, @p1367, @p1368, @p1369, @p1370, @p1371, @p1372, @p1373, @p1374, @p1375, @p1376, @p1377, @p1378, @p1379, @p1380, @p1381, @p1382, @p1383, @p1384, @p1385, @p1386, @p1387, @p1388, @p1389, @p1390, @p1391, @p1392, @p1393, @p1394, @p1395, @p1396, @p1397, @p1398, @p1399, 24), (@p1400, @p1401, @p1402, @p1403, @p1404, @p1405, @p1406, @p1407, @p1408, @p1409, @p1410, @p1411, @p1412, @p1413, @p1414, @p1415, @p1416, @p1417, @p1418, @p1419, @p1420, @p1421, @p1422, @p1423, @p1424, @p1425, @p1426, @p1427, @p1428, @p1429, @p1430, @p1431, @p1432, @p1433, @p1434, @p1435, @p1436, @p1437, @p1438, @p1439, @p1440, @p1441, @p1442, @p1443, @p1444, @p1445, @p1446, @p1447, @p1448, @p1449, @p1450, @p1451, @p1452, @p1453, @p1454, @p1455, 25), (@p1456, @p1457, @p1458, @p1459, @p1460, @p1461, @p1462, @p1463, @p1464, @p1465, @p1466, @p1467, @p1468, @p1469, @p1470, @p1471, @p1472, @p1473, @p1474, @p1475, @p1476, @p1477, @p1478, @p1479, @p1480, @p1481, @p1482, @p1483, @p1484, @p1485, @p1486, @p1487, @p1488, @p1489, @p1490, @p1491, @p1492, @p1493, @p1494, @p1495, @p1496, @p1497, @p1498, @p1499, @p1500, @p1501, @p1502, @p1503, @p1504, @p1505, @p1506, @p1507, @p1508, @p1509, @p1510, @p1511, 26), (@p1512, @p1513, @p1514, @p1515, @p1516, @p1517, @p1518, @p1519, @p1520, @p1521, @p1522, @p1523, @p1524, @p1525, @p1526, @p1527, @p1528, @p1529, @p1530, @p1531, @p1532, @p1533, @p1534, @p1535, @p1536, @p1537, @p1538, @p1539, @p1540, @p1541, @p1542, @p1543, @p1544, @p1545, @p1546, @p1547, @p1548, @p1549, @p1550, @p1551, @p1552, @p1553, @p1554, @p1555, @p1556, @p1557, @p1558, @p1559, @p1560, @p1561, @p1562, @p1563, @p1564, @p1565, @p1566, @p1567, 27), (@p1568, @p1569, @p1570, @p1571, @p1572, @p1573, @p1574, @p1575, @p1576, @p1577, @p1578, @p1579, @p1580, @p1581, @p1582, @p1583, @p1584, @p1585, @p1586, @p1587, @p1588, @p1589, @p1590, @p1591, @p1592, @p1593, @p1594, @p1595, @p1596, @p1597, @p1598, @p1599, @p1600, @p1601, @p1602, @p1603, @p1604, @p1605, @p1606, @p1607, @p1608, @p1609, @p1610, @p1611, @p1612, @p1613, @p1614, @p1615, @p1616, @p1617, @p1618, @p1619, @p1620, @p1621, @p1622, @p1623, 28), (@p1624, @p1625, @p1626, @p1627, @p1628, @p1629, @p1630, @p1631, @p1632, @p1633, @p1634, @p1635, @p1636, @p1637, @p1638, @p1639, @p1640, @p1641, @p1642, @p1643, @p1644, @p1645, @p1646, @p1647, @p1648, @p1649, @p1650, @p1651, @p1652, @p1653, @p1654, @p1655, @p1656, @p1657, @p1658, @p1659, @p1660, @p1661, @p1662, @p1663, @p1664, @p1665, @p1666, @p1667, @p1668, @p1669, @p1670, @p1671, @p1672, @p1673, @p1674, @p1675, @p1676, @p1677, @p1678, @p1679, 29), (@p1680, @p1681, @p1682, @p1683, @p1684, @p1685, @p1686, @p1687, @p1688, @p1689, @p1690, @p1691, @p1692, @p1693, @p1694, @p1695, @p1696, @p1697, @p1698, @p1699, @p1700, @p1701, @p1702, @p1703, @p1704, @p1705, @p1706, @p1707, @p1708, @p1709, @p1710, @p1711, @p1712, @p1713, @p1714, @p1715, @p1716, @p1717, @p1718, @p1719, @p1720, @p1721, @p1722, @p1723, @p1724, @p1725, @p1726, @p1727, @p1728, @p1729, @p1730, @p1731, @p1732, @p1733, @p1734, @p1735, 30), (@p1736, @p1737, @p1738, @p1739, @p1740, @p1741, @p1742, @p1743, @p1744, @p1745, @p1746, @p1747, @p1748, @p1749, @p1750, @p1751, @p1752, @p1753, @p1754, @p1755, @p1756, @p1757, @p1758, @p1759, @p1760, @p1761, @p1762, @p1763, @p1764, @p1765, @p1766, @p1767, @p1768, @p1769, @p1770, @p1771, @p1772, @p1773, @p1774, @p1775, @p1776, @p1777, @p1778, @p1779, @p1780, @p1781, @p1782, @p1783, @p1784, @p1785, @p1786, @p1787, @p1788, @p1789, @p1790, @p1791, 31), (@p1792, @p1793, @p1794, @p1795, @p1796, @p1797, @p1798, @p1799, @p1800, @p1801, @p1802, @p1803, @p1804, @p1805, @p1806, @p1807, @p1808, @p1809, @p1810, @p1811, @p1812, @p1813, @p1814, @p1815, @p1816, @p1817, @p1818, @p1819, @p1820, @p1821, @p1822, @p1823, @p1824, @p1825, @p1826, @p1827, @p1828, @p1829, @p1830, @p1831, @p1832, @p1833, @p1834, @p1835, @p1836, @p1837, @p1838, @p1839, @p1840, @p1841, @p1842, @p1843, @p1844, @p1845, @p1846, @p1847, 32), (@p1848, @p1849, @p1850, @p1851, @p1852, @p1853, @p1854, @p1855, @p1856, @p1857, @p1858, @p1859, @p1860, @p1861, @p1862, @p1863, @p1864, @p1865, @p1866, @p1867, @p1868, @p1869, @p1870, @p1871, @p1872, @p1873, @p1874, @p1875, @p1876, @p1877, @p1878, @p1879, @p1880, @p1881, @p1882, @p1883, @p1884, @p1885, @p1886, @p1887, @p1888, @p1889, @p1890, @p1891, @p1892, @p1893, @p1894, @p1895, @p1896, @p1897, @p1898, @p1899, @p1900, @p1901, @p1902, @p1903, 33), (@p1904, @p1905, @p1906, @p1907, @p1908, @p1909, @p1910, @p1911, @p1912, @p1913, @p1914, @p1915, @p1916, @p1917, @p1918, @p1919, @p1920, @p1921, @p1922, @p1923, @p1924, @p1925, @p1926, @p1927, @p1928, @p1929, @p1930, @p1931, @p1932, @p1933, @p1934, @p1935, @p1936, @p1937, @p1938, @p1939, @p1940, @p1941, @p1942, @p1943, @p1944, @p1945, @p1946, @p1947, @p1948, @p1949, @p1950, @p1951, @p1952, @p1953, @p1954, @p1955, @p1956, @p1957, @p1958, @p1959, 34), (@p1960, @p1961, @p1962, @p1963, @p1964, @p1965, @p1966, @p1967, @p1968, @p1969, @p1970, @p1971, @p1972, @p1973, @p1974, @p1975, @p1976, @p1977, @p1978, @p1979, @p1980, @p1981, @p1982, @p1983, @p1984, @p1985, @p1986, @p1987, @p1988, @p1989, @p1990, @p1991, @p1992, @p1993, @p1994, @p1995, @p1996, @p1997, @p1998, @p1999, @p2000, @p2001, @p2002, @p2003, @p2004, @p2005, @p2006, @p2007, @p2008, @p2009, @p2010, @p2011, @p2012, @p2013, @p2014, @p2015, 35), (@p2016, @p2017, @p2018, @p2019, @p2020, @p2021, @p2022, @p2023, @p2024, @p2025, @p2026, @p2027, @p2028, @p2029, @p2030, @p2031, @p2032, @p2033, @p2034, @p2035, @p2036, @p2037, @p2038, @p2039, @p2040, @p2041, @p2042, @p2043, @p2044, @p2045, @p2046, @p2047, @p2048, @p2049, @p2050, @p2051, @p2052, @p2053, @p2054, @p2055, @p2056, @p2057, @p2058, @p2059, @p2060, @p2061, @p2062, @p2063, @p2064, @p2065, @p2066, @p2067, @p2068, @p2069, @p2070, @p2071, 36)) AS i ([addressee_cntry_cd], [addressee_city], [addressee_district], [addressee_email], [addressee_full_address], [addressee_home_address], [addressee_name], [addressee_postcode], [addressee_province], [addressee_subdistrict], [addressee_tel], [create_table], [delivery_code], [delivery_recipient_name], [delivery_relation_id], [delivery_status_id], [dest_outlet_id], [dest_outlet_port], [document_number], [item_barcode], [item_cod], [item_gross_weight], [item_height], [item_length], [item_price], [item_width], [lat], [log_id], [long], [outlet_id], [outlet_port], [podUrl], [remark], [scan_cntry_cd], [scan_cntry_postcode], [sender_cntry_cd], [sender_district], [sender_email], [sender_full_address], [sender_home_address], [member_id], [sender_name], [sender_postcode], [sender_province], [sender_subdistrict], [sender_tel], [server_id], [signatureUrl], [state], [status_code], [status_dtm], [timestamp], [transmit_dtm], [user_id], [wckt_id], [wkstn_no], _Position) ON 1=0 WHEN NOT MATCHED THEN INSERT ([addressee_cntry_cd], [addressee_city], [addressee_district], [addressee_email], [addressee_full_address], [addressee_home_address], [addressee_name], [addressee_postcode], [addressee_province], [addressee_subdistrict], [addressee_tel], [create_table], [delivery_code], [delivery_recipient_name], [delivery_relation_id], [delivery_status_id], [dest_outlet_id], [dest_outlet_port], [document_number], [item_barcode], [item_cod], [item_gross_weight], [item_height], [item_length], [item_price], [item_width], [lat], [log_id], [long], [outlet_id], [outlet_port], [podUrl], [remark], [scan_cntry_cd], [scan_cntry_postcode], [sender_cntry_cd], [sender_district], [sender_email], [sender_full_address], [sender_home_address], [member_id], [sender_name], [sender_postcode], [sender_province], [sender_subdistrict], [sender_tel], [server_id], [signatureUrl], [state], [status_code], [status_dtm], [timestamp], [transmit_dtm], [user_id], [wckt_id], [wkstn_no]) VALUES (i.[addressee_cntry_cd], i.[addressee_city], i.[addressee_district], i.[addressee_email], i.[addressee_full_address], i.[addressee_home_address], i.[addressee_name], i.[addressee_postcode], i.[addressee_province], i.[addressee_subdistrict], i.[addressee_tel], i.[create_table], i.[delivery_code], i.[delivery_recipient_name], i.[delivery_relation_id], i.[delivery_status_id], i.[dest_outlet_id], i.[dest_outlet_port], i.[document_number], i.[item_barcode], i.[item_cod], i.[item_gross_weight], i.[item_height], i.[item_length], i.[item_price], i.[item_width], i.[lat], i.[log_id], i.[long], i.[outlet_id], i.[outlet_port], i.[podUrl], i.[remark], i.[scan_cntry_cd], i.[scan_cntry_postcode], i.[sender_cntry_cd], i.[sender_district], i.[sender_email], i.[sender_full_address], i.[sender_home_address], i.[member_id], i.[sender_name], i.[sender_postcode], i.[sender_province], i.[sender_subdistrict], i.[sender_tel], i.[server_id], i.[signatureUrl], i.[state], i.[status_code], i.[status_dtm], i.[timestamp], i.[transmit_dtm], i.[user_id], i.[wckt_id], i.[wkstn_no]) OUTPUT INSERTED.[item_id], i._Position INTO @inserted0;  SELECT [t].[item_id] FROM [raw_data] t INNER JOIN @inserted0 i ON ([t].[item_id] = [i].[item_id]) ORDER BY [i].[_Position];  ",4,4,0,441,2,4
"(@p0 nvarchar(4000),@p1 nvarchar(4000),@p2 nvarchar(4000),@p3 nvarchar(4000),@p4 nvarchar(4000),@p5 nvarchar(4000),@p6 nvarchar(4000),@p7 nvarchar(4000),@p8 nvarchar(4000),@p9 nvarchar(4000),@p10 nvarchar(4000),@p11 datetime2(7),@p12 nvarchar(4000),@p13 nvarchar(4000),@p14 int,@p15 int,@p16 int,@p17 nvarchar(4000),@p18 nvarchar(4000),@p19 nvarchar(4000),@p20 nvarchar(4000),@p21 decimal(18,2),@p22 nvarchar(4000),@p23 nvarchar(4000),@p24 decimal(18,2),@p25 nvarchar(4000),@p26 nvarchar(4000),@p27 nvarchar(4000),@p28 nvarchar(4000),@p29 int,@p30 nvarchar(4000),@p31 nvarchar(4000),@p32 nvarchar(4000),@p33 nvarchar(4000),@p34 nvarchar(4000),@p35 nvarchar(4000),@p36 nvarchar(4000),@p37 nvarchar(4000),@p38 nvarchar(4000),@p39 nvarchar(4000),@p40 int,@p41 nvarchar(4000),@p42 nvarchar(4000),@p43 nvarchar(4000),@p44 nvarchar(4000),@p45 nvarchar(4000),@p46 int,@p47 nvarchar(4000),@p48 int,@p49 int,@p50 datetime2(7),@p51 datetime2(7),@p52 datetime2(7),@p53 nvarchar(4000),@p54 nvarchar(4000),@p55 nvarchar(4000),@p56 nvarchar(4000),@p57 nvarchar(4000),@p58 nvarchar(4000),@p59 nvarchar(4000),@p60 nvarchar(4000),@p61 nvarchar(4000),@p62 nvarchar(4000),@p63 nvarchar(4000),@p64 nvarchar(4000),@p65 nvarchar(4000),@p66 nvarchar(4000),@p67 datetime2(7),@p68 nvarchar(4000),@p69 nvarchar(4000),@p70 int,@p71 int,@p72 int,@p73 nvarchar(4000),@p74 nvarchar(4000),@p75 nvarchar(4000),@p76 nvarchar(4000),@p77 decimal(18,2),@p78 nvarchar(4000),@p79 nvarchar(4000),@p80 decimal(18,2),@p81 nvarchar(4000),@p82 nvarchar(4000),@p83 nvarchar(4000),@p84 nvarchar(4000),@p85 int,@p86 nvarchar(4000),@p87 nvarchar(4000),@p88 nvarchar(4000),@p89 nvarchar(4000),@p90 nvarchar(4000),@p91 nvarchar(4000),@p92 nvarchar(4000),@p93 nvarchar(4000),@p94 nvarchar(4000),@p95 nvarchar(4000),@p96 int,@p97 nvarchar(4000),@p98 nvarchar(4000),@p99 nvarchar(4000),@p100 nvarchar(4000),@p101 nvarchar(4000),@p102 int,@p103 nvarchar(4000),@p104 int,@p105 int,@p106 datetime2(7),@p107 datetime2(7),@p108 datetime2(7),@p109 nvarchar(4000),@p110 nvarchar(4000),@p111 nvarchar(4000),@p112 nvarchar(4000),@p113 nvarchar(4000),@p114 nvarchar(4000),@p115 nvarchar(4000),@p116 nvarchar(4000),@p117 nvarchar(4000),@p118 nvarchar(4000),@p119 nvarchar(4000),@p120 nvarchar(4000),@p121 nvarchar(4000),@p122 nvarchar(4000),@p123 datetime2(7),@p124 nvarchar(4000),@p125 nvarchar(4000),@p126 int,@p127 int,@p128 int,@p129 nvarchar(4000),@p130 nvarchar(4000),@p131 nvarchar(4000),@p132 nvarchar(4000),@p133 decimal(18,2),@p134 nvarchar(4000),@p135 nvarchar(4000),@p136 decimal(18,2),@p137 nvarchar(4000),@p138 nvarchar(4000),@p139 nvarchar(4000),@p140 nvarchar(4000),@p141 int,@p142 nvarchar(4000),@p143 nvarchar(4000),@p144 nvarchar(4000),@p145 nvarchar(4000),@p146 nvarchar(4000),@p147 nvarchar(4000),@p148 nvarchar(4000),@p149 nvarchar(4000),@p150 nvarchar(4000),@p151 nvarchar(4000),@p152 int,@p153 nvarchar(4000),@p154 nvarchar(4000),@p155 nvarchar(4000),@p156 nvarchar(4000),@p157 nvarchar(4000),@p158 int,@p159 nvarchar(4000),@p160 int,@p161 int,@p162 datetime2(7),@p163 datetime2(7),@p164 datetime2(7),@p165 nvarchar(4000),@p166 nvarchar(4000),@p167 nvarchar(4000),@p168 nvarchar(4000),@p169 nvarchar(4000),@p170 nvarchar(4000),@p171 nvarchar(4000),@p172 nvarchar(4000),@p173 nvarchar(4000),@p174 nvarchar(4000),@p175 nvarchar(4000),@p176 nvarchar(4000),@p177 nvarchar(4000),@p178 nvarchar(4000),@p179 datetime2(7),@p180 nvarchar(4000),@p181 nvarchar(4000),@p182 int,@p183 int,@p184 int,@p185 nvarchar(4000),@p186 nvarchar(4000),@p187 nvarchar(4000),@p188 nvarchar(4000),@p189 decimal(18,2),@p190 nvarchar(4000),@p191 nvarchar(4000),@p192 decimal(18,2),@p193 nvarchar(4000),@p194 nvarchar(4000),@p195 nvarchar(4000),@p196 nvarchar(4000),@p197 int,@p198 nvarchar(4000),@p199 nvarchar(4000),@p200 nvarchar(4000),@p201 nvarchar(4000),@p202 nvarchar(4000),@p203 nvarchar(4000),@p204 nvarchar(4000),@p205 nvarchar(4000),@p206 nvarchar(4000),@p207 nvarchar(4000),@p208 int,@p209 nvarchar(4000),@p210 nvarchar(4000),@p211 nvarchar(4000),@p212 nvarchar(4000),@p213 nvarchar(4000),@p214 int,@p215 nvarchar(4000),@p216 int,@p217 int,@p218 datetime2(7),@p219 datetime2(7),@p220 datetime2(7),@p221 nvarchar(4000),@p222 nvarchar(4000),@p223 nvarchar(4000),@p224 nvarchar(4000),@p225 nvarchar(4000),@p226 nvarchar(4000),@p227 nvarchar(4000),@p228 nvarchar(4000),@p229 nvarchar(4000),@p230 nvarchar(4000),@p231 nvarchar(4000),@p232 nvarchar(4000),@p233 nvarchar(4000),@p234 nvarchar(4000),@p235 datetime2(7),@p236 nvarchar(4000),@p237 nvarchar(4000),@p238 int,@p239 int,@p240 int,@p241 nvarchar(4000),@p242 nvarchar(4000),@p243 nvarchar(4000),@p244 nvarchar(4000),@p245 decimal(18,2),@p246 nvarchar(4000),@p247 nvarchar(4000),@p248 decimal(18,2),@p249 nvarchar(4000),@p250 nvarchar(4000),@p251 nvarchar(4000),@p252 nvarchar(4000),@p253 int,@p254 nvarchar(4000),@p255 nvarchar(4000),@p256 nvarchar(4000),@p257 nvarchar(4000),@p258 nvarchar(4000),@p259 nvarchar(4000),@p260 nvarchar(4000),@p261 nvarchar(4000),@p262 nvarchar(4000),@p263 nvarchar(4000),@p264 int,@p265 nvarchar(4000),@p266 nvarchar(4000),@p267 nvarchar(4000),@p268 nvarchar(4000),@p269 nvarchar(4000),@p270 int,@p271 nvarchar(4000),@p272 int,@p273 int,@p274 datetime2(7),@p275 datetime2(7),@p276 datetime2(7),@p277 nvarchar(4000),@p278 nvarchar(4000),@p279 nvarchar(4000),@p280 nvarchar(4000),@p281 nvarchar(4000),@p282 nvarchar(4000),@p283 nvarchar(4000),@p284 nvarchar(4000),@p285 nvarchar(4000),@p286 nvarchar(4000),@p287 nvarchar(4000),@p288 nvarchar(4000),@p289 nvarchar(4000),@p290 nvarchar(4000),@p291 datetime2(7),@p292 nvarchar(4000),@p293 nvarchar(4000),@p294 int,@p295 int,@p296 int,@p297 nvarchar(4000),@p298 nvarchar(4000),@p299 nvarchar(4000),@p300 nvarchar(4000),@p301 decimal(18,2),@p302 nvarchar(4000),@p303 nvarchar(4000),@p304 decimal(18,2),@p305 nvarchar(4000),@p306 nvarchar(4000),@p307 nvarchar(4000),@p308 nvarchar(4000),@p309 int,@p310 nvarchar(4000),@p311 nvarchar(4000),@p312 nvarchar(4000),@p313 nvarchar(4000),@p314 nvarchar(4000),@p315 nvarchar(4000),@p316 nvarchar(4000),@p317 nvarchar(4000),@p318 nvarchar(4000),@p319 nvarchar(4000),@p320 int,@p321 nvarchar(4000),@p322 nvarchar(4000),@p323 nvarchar(4000),@p324 nvarchar(4000),@p325 nvarchar(4000),@p326 int,@p327 nvarchar(4000),@p328 int,@p329 int,@p330 datetime2(7),@p331 datetime2(7),@p332 datetime2(7),@p333 nvarchar(4000),@p334 nvarchar(4000),@p335 nvarchar(4000),@p336 nvarchar(4000),@p337 nvarchar(4000),@p338 nvarchar(4000),@p339 nvarchar(4000),@p340 nvarchar(4000),@p341 nvarchar(4000),@p342 nvarchar(4000),@p343 nvarchar(4000),@p344 nvarchar(4000),@p345 nvarchar(4000),@p346 nvarchar(4000),@p347 datetime2(7),@p348 nvarchar(4000),@p349 nvarchar(4000),@p350 int,@p351 int,@p352 int,@p353 nvarchar(4000),@p354 nvarchar(4000),@p355 nvarchar(4000),@p356 nvarchar(4000),@p357 decimal(18,2),@p358 nvarchar(4000),@p359 nvarchar(4000),@p360 decimal(18,2),@p361 nvarchar(4000),@p362 nvarchar(4000),@p363 nvarchar(4000),@p364 nvarchar(4000),@p365 int,@p366 nvarchar(4000),@p367 nvarchar(4000),@p368 nvarchar(4000),@p369 nvarchar(4000),@p370 nvarchar(4000),@p371 nvarchar(4000),@p372 nvarchar(4000),@p373 nvarchar(4000),@p374 nvarchar(4000),@p375 nvarchar(4000),@p376 int,@p377 nvarchar(4000),@p378 nvarchar(4000),@p379 nvarchar(4000),@p380 nvarchar(4000),@p381 nvarchar(4000),@p382 int,@p383 nvarchar(4000),@p384 int,@p385 int,@p386 datetime2(7),@p387 datetime2(7),@p388 datetime2(7),@p389 nvarchar(4000),@p390 nvarchar(4000),@p391 nvarchar(4000),@p392 nvarchar(4000),@p393 nvarchar(4000),@p394 nvarchar(4000),@p395 nvarchar(4000),@p396 nvarchar(4000),@p397 nvarchar(4000),@p398 nvarchar(4000),@p399 nvarchar(4000),@p400 nvarchar(4000),@p401 nvarchar(4000),@p402 nvarchar(4000),@p403 datetime2(7),@p404 nvarchar(4000),@p405 nvarchar(4000),@p406 int,@p407 int,@p408 int,@p409 nvarchar(4000),@p410 nvarchar(4000),@p411 nvarchar(4000),@p412 nvarchar(4000),@p413 decimal(18,2),@p414 nvarchar(4000),@p415 nvarchar(4000),@p416 decimal(18,2),@p417 nvarchar(4000),@p418 nvarchar(4000),@p419 nvarchar(4000),@p420 nvarchar(4000),@p421 int,@p422 nvarchar(4000),@p423 nvarchar(4000),@p424 nvarchar(4000),@p425 nvarchar(4000),@p426 nvarchar(4000),@p427 nvarchar(4000),@p428 nvarchar(4000),@p429 nvarchar(4000),@p430 nvarchar(4000),@p431 nvarchar(4000),@p432 int,@p433 nvarchar(4000),@p434 nvarchar(4000),@p435 nvarchar(4000),@p436 nvarchar(4000),@p437 nvarchar(4000),@p438 int,@p439 nvarchar(4000),@p440 int,@p441 int,@p442 datetime2(7),@p443 datetime2(7),@p444 datetime2(7),@p445 nvarchar(4000),@p446 nvarchar(4000),@p447 nvarchar(4000),@p448 nvarchar(4000),@p449 nvarchar(4000),@p450 nvarchar(4000),@p451 nvarchar(4000),@p452 nvarchar(4000),@p453 nvarchar(4000),@p454 nvarchar(4000),@p455 nvarchar(4000),@p456 nvarchar(4000),@p457 nvarchar(4000),@p458 nvarchar(4000),@p459 datetime2(7),@p460 nvarchar(4000),@p461 nvarchar(4000),@p462 int,@p463 int,@p464 int,@p465 nvarchar(4000),@p466 nvarchar(4000),@p467 nvarchar(4000),@p468 nvarchar(4000),@p469 decimal(18,2),@p470 nvarchar(4000),@p471 nvarchar(4000),@p472 decimal(18,2),@p473 nvarchar(4000),@p474 nvarchar(4000),@p475 nvarchar(4000),@p476 nvarchar(4000),@p477 int,@p478 nvarchar(4000),@p479 nvarchar(4000),@p480 nvarchar(4000),@p481 nvarchar(4000),@p482 nvarchar(4000),@p483 nvarchar(4000),@p484 nvarchar(4000),@p485 nvarchar(4000),@p486 nvarchar(4000),@p487 nvarchar(4000),@p488 int,@p489 nvarchar(4000),@p490 nvarchar(4000),@p491 nvarchar(4000),@p492 nvarchar(4000),@p493 nvarchar(4000),@p494 int,@p495 nvarchar(4000),@p496 int,@p497 int,@p498 datetime2(7),@p499 datetime2(7),@p500 datetime2(7),@p501 nvarchar(4000),@p502 nvarchar(4000),@p503 nvarchar(4000),@p504 nvarchar(4000),@p505 nvarchar(4000),@p506 nvarchar(4000),@p507 nvarchar(4000),@p508 nvarchar(4000),@p509 nvarchar(4000),@p510 nvarchar(4000),@p511 nvarchar(4000),@p512 nvarchar(4000),@p513 nvarchar(4000),@p514 nvarchar(4000),@p515 datetime2(7),@p516 nvarchar(4000),@p517 nvarchar(4000),@p518 int,@p519 int,@p520 int,@p521 nvarchar(4000),@p522 nvarchar(4000),@p523 nvarchar(4000),@p524 nvarchar(4000),@p525 decimal(18,2),@p526 nvarchar(4000),@p527 nvarchar(4000),@p528 decimal(18,2),@p529 nvarchar(4000),@p530 nvarchar(4000),@p531 nvarchar(4000),@p532 nvarchar(4000),@p533 int,@p534 nvarchar(4000),@p535 nvarchar(4000),@p536 nvarchar(4000),@p537 nvarchar(4000),@p538 nvarchar(4000),@p539 nvarchar(4000),@p540 nvarchar(4000),@p541 nvarchar(4000),@p542 nvarchar(4000),@p543 nvarchar(4000),@p544 int,@p545 nvarchar(4000),@p546 nvarchar(4000),@p547 nvarchar(4000),@p548 nvarchar(4000),@p549 nvarchar(4000),@p550 int,@p551 nvarchar(4000),@p552 int,@p553 int,@p554 datetime2(7),@p555 datetime2(7),@p556 datetime2(7),@p557 nvarchar(4000),@p558 nvarchar(4000),@p559 nvarchar(4000),@p560 nvarchar(4000),@p561 nvarchar(4000),@p562 nvarchar(4000),@p563 nvarchar(4000),@p564 nvarchar(4000),@p565 nvarchar(4000),@p566 nvarchar(4000),@p567 nvarchar(4000),@p568 nvarchar(4000),@p569 nvarchar(4000),@p570 nvarchar(4000),@p571 datetime2(7),@p572 nvarchar(4000),@p573 nvarchar(4000),@p574 int,@p575 int,@p576 int,@p577 nvarchar(4000),@p578 nvarchar(4000),@p579 nvarchar(4000),@p580 nvarchar(4000),@p581 decimal(18,2),@p582 nvarchar(4000),@p583 nvarchar(4000),@p584 decimal(18,2),@p585 nvarchar(4000),@p586 nvarchar(4000),@p587 nvarchar(4000),@p588 nvarchar(4000),@p589 int,@p590 nvarchar(4000),@p591 nvarchar(4000),@p592 nvarchar(4000),@p593 nvarchar(4000),@p594 nvarchar(4000),@p595 nvarchar(4000),@p596 nvarchar(4000),@p597 nvarchar(4000),@p598 nvarchar(4000),@p599 nvarchar(4000),@p600 int,@p601 nvarchar(4000),@p602 nvarchar(4000),@p603 nvarchar(4000),@p604 nvarchar(4000),@p605 nvarchar(4000),@p606 int,@p607 nvarchar(4000),@p608 int,@p609 int,@p610 datetime2(7),@p611 datetime2(7),@p612 datetime2(7),@p613 nvarchar(4000),@p614 nvarchar(4000),@p615 nvarchar(4000),@p616 nvarchar(4000),@p617 nvarchar(4000),@p618 nvarchar(4000),@p619 nvarchar(4000),@p620 nvarchar(4000),@p621 nvarchar(4000),@p622 nvarchar(4000),@p623 nvarchar(4000),@p624 nvarchar(4000),@p625 nvarchar(4000),@p626 nvarchar(4000),@p627 datetime2(7),@p628 nvarchar(4000),@p629 nvarchar(4000),@p630 int,@p631 int,@p632 int,@p633 nvarchar(4000),@p634 nvarchar(4000),@p635 nvarchar(4000),@p636 nvarchar(4000),@p637 decimal(18,2),@p638 nvarchar(4000),@p639 nvarchar(4000),@p640 decimal(18,2),@p641 nvarchar(4000),@p642 nvarchar(4000),@p643 nvarchar(4000),@p644 nvarchar(4000),@p645 int,@p646 nvarchar(4000),@p647 nvarchar(4000),@p648 nvarchar(4000),@p649 nvarchar(4000),@p650 nvarchar(4000),@p651 nvarchar(4000),@p652 nvarchar(4000),@p653 nvarchar(4000),@p654 nvarchar(4000),@p655 nvarchar(4000),@p656 int,@p657 nvarchar(4000),@p658 nvarchar(4000),@p659 nvarchar(4000),@p660 nvarchar(4000),@p661 nvarchar(4000),@p662 int,@p663 nvarchar(4000),@p664 int,@p665 int,@p666 datetime2(7),@p667 datetime2(7),@p668 datetime2(7),@p669 nvarchar(4000),@p670 nvarchar(4000),@p671 nvarchar(4000),@p672 nvarchar(4000),@p673 nvarchar(4000),@p674 nvarchar(4000),@p675 nvarchar(4000),@p676 nvarchar(4000),@p677 nvarchar(4000),@p678 nvarchar(4000),@p679 nvarchar(4000),@p680 nvarchar(4000),@p681 nvarchar(4000),@p682 nvarchar(4000),@p683 datetime2(7),@p684 nvarchar(4000),@p685 nvarchar(4000),@p686 int,@p687 int,@p688 int,@p689 nvarchar(4000),@p690 nvarchar(4000),@p691 nvarchar(4000),@p692 decimal(18,2),@p693 decimal(18,2),@p694 nvarchar(4000),@p695 nvarchar(4000),@p696 decimal(18,2),@p697 nvarchar(4000),@p698 nvarchar(4000),@p699 nvarchar(4000),@p700 nvarchar(4000),@p701 int,@p702 nvarchar(4000),@p703 nvarchar(4000),@p704 nvarchar(4000),@p705 nvarchar(4000),@p706 nvarchar(4000),@p707 nvarchar(4000),@p708 nvarchar(4000),@p709 nvarchar(4000),@p710 nvarchar(4000),@p711 nvarchar(4000),@p712 int,@p713 nvarchar(4000),@p714 nvarchar(4000),@p715 nvarchar(4000),@p716 nvarchar(4000),@p717 nvarchar(4000),@p718 int,@p719 nvarchar(4000),@p720 int,@p721 int,@p722 datetime2(7),@p723 datetime2(7),@p724 datetime2(7),@p725 nvarchar(4000),@p726 nvarchar(4000),@p727 nvarchar(4000),@p728 nvarchar(4000),@p729 nvarchar(4000),@p730 nvarchar(4000),@p731 nvarchar(4000),@p732 nvarchar(4000),@p733 nvarchar(4000),@p734 nvarchar(4000),@p735 nvarchar(4000),@p736 nvarchar(4000),@p737 nvarchar(4000),@p738 nvarchar(4000),@p739 datetime2(7),@p740 nvarchar(4000),@p741 nvarchar(4000),@p742 int,@p743 int,@p744 int,@p745 nvarchar(4000),@p746 nvarchar(4000),@p747 nvarchar(4000),@p748 decimal(18,2),@p749 decimal(18,2),@p750 nvarchar(4000),@p751 nvarchar(4000),@p752 decimal(18,2),@p753 nvarchar(4000),@p754 nvarchar(4000),@p755 nvarchar(4000),@p756 nvarchar(4000),@p757 int,@p758 nvarchar(4000),@p759 nvarchar(4000),@p760 nvarchar(4000),@p761 nvarchar(4000),@p762 nvarchar(4000),@p763 nvarchar(4000),@p764 nvarchar(4000),@p765 nvarchar(4000),@p766 nvarchar(4000),@p767 nvarchar(4000),@p768 int,@p769 nvarchar(4000),@p770 nvarchar(4000),@p771 nvarchar(4000),@p772 nvarchar(4000),@p773 nvarchar(4000),@p774 int,@p775 nvarchar(4000),@p776 int,@p777 int,@p778 datetime2(7),@p779 datetime2(7),@p780 datetime2(7),@p781 nvarchar(4000),@p782 nvarchar(4000),@p783 nvarchar(4000),@p784 nvarchar(4000),@p785 nvarchar(4000),@p786 nvarchar(4000),@p787 nvarchar(4000),@p788 nvarchar(4000),@p789 nvarchar(4000),@p790 nvarchar(4000),@p791 nvarchar(4000),@p792 nvarchar(4000),@p793 nvarchar(4000),@p794 nvarchar(4000),@p795 datetime2(7),@p796 nvarchar(4000),@p797 nvarchar(4000),@p798 int,@p799 int,@p800 int,@p801 nvarchar(4000),@p802 nvarchar(4000),@p803 nvarchar(4000),@p804 decimal(18,2),@p805 decimal(18,2),@p806 nvarchar(4000),@p807 nvarchar(4000),@p808 decimal(18,2),@p809 nvarchar(4000),@p810 nvarchar(4000),@p811 nvarchar(4000),@p812 nvarchar(4000),@p813 int,@p814 nvarchar(4000),@p815 nvarchar(4000),@p816 nvarchar(4000),@p817 nvarchar(4000),@p818 nvarchar(4000),@p819 nvarchar(4000),@p820 nvarchar(4000),@p821 nvarchar(4000),@p822 nvarchar(4000),@p823 nvarchar(4000),@p824 int,@p825 nvarchar(4000),@p826 nvarchar(4000),@p827 nvarchar(4000),@p828 nvarchar(4000),@p829 nvarchar(4000),@p830 int,@p831 nvarchar(4000),@p832 int,@p833 int,@p834 datetime2(7),@p835 datetime2(7),@p836 datetime2(7),@p837 nvarchar(4000),@p838 nvarchar(4000),@p839 nvarchar(4000),@p840 nvarchar(4000),@p841 nvarchar(4000),@p842 nvarchar(4000),@p843 nvarchar(4000),@p844 nvarchar(4000),@p845 nvarchar(4000),@p846 nvarchar(4000),@p847 nvarchar(4000),@p848 nvarchar(4000),@p849 nvarchar(4000),@p850 nvarchar(4000),@p851 datetime2(7),@p852 nvarchar(4000),@p853 nvarchar(4000),@p854 int,@p855 int,@p856 int,@p857 nvarchar(4000),@p858 nvarchar(4000),@p859 nvarchar(4000),@p860 decimal(18,2),@p861 decimal(18,2),@p862 nvarchar(4000),@p863 nvarchar(4000),@p864 decimal(18,2),@p865 nvarchar(4000),@p866 nvarchar(4000),@p867 nvarchar(4000),@p868 nvarchar(4000),@p869 int,@p870 nvarchar(4000),@p871 nvarchar(4000),@p872 nvarchar(4000),@p873 nvarchar(4000),@p874 nvarchar(4000),@p875 nvarchar(4000),@p876 nvarchar(4000),@p877 nvarchar(4000),@p878 nvarchar(4000),@p879 nvarchar(4000),@p880 int,@p881 nvarchar(4000),@p882 nvarchar(4000),@p883 nvarchar(4000),@p884 nvarchar(4000),@p885 nvarchar(4000),@p886 int,@p887 nvarchar(4000),@p888 int,@p889 int,@p890 datetime2(7),@p891 datetime2(7),@p892 datetime2(7),@p893 nvarchar(4000),@p894 nvarchar(4000),@p895 nvarchar(4000),@p896 nvarchar(4000),@p897 nvarchar(4000),@p898 nvarchar(4000),@p899 nvarchar(4000),@p900 nvarchar(4000),@p901 nvarchar(4000),@p902 nvarchar(4000),@p903 nvarchar(4000),@p904 nvarchar(4000),@p905 nvarchar(4000),@p906 nvarchar(4000),@p907 datetime2(7),@p908 nvarchar(4000),@p909 nvarchar(4000),@p910 int,@p911 int,@p912 int,@p913 nvarchar(4000),@p914 nvarchar(4000),@p915 nvarchar(4000),@p916 decimal(18,2),@p917 decimal(18,2),@p918 nvarchar(4000),@p919 nvarchar(4000),@p920 decimal(18,2),@p921 nvarchar(4000),@p922 nvarchar(4000),@p923 nvarchar(4000),@p924 nvarchar(4000),@p925 int,@p926 nvarchar(4000),@p927 nvarchar(4000),@p928 nvarchar(4000),@p929 nvarchar(4000),@p930 nvarchar(4000),@p931 nvarchar(4000),@p932 nvarchar(4000),@p933 nvarchar(4000),@p934 nvarchar(4000),@p935 nvarchar(4000),@p936 int,@p937 nvarchar(4000),@p938 nvarchar(4000),@p939 nvarchar(4000),@p940 nvarchar(4000),@p941 nvarchar(4000),@p942 int,@p943 nvarchar(4000),@p944 int,@p945 int,@p946 datetime2(7),@p947 datetime2(7),@p948 datetime2(7),@p949 nvarchar(4000),@p950 nvarchar(4000),@p951 nvarchar(4000),@p952 nvarchar(4000),@p953 nvarchar(4000),@p954 nvarchar(4000),@p955 nvarchar(4000),@p956 nvarchar(4000),@p957 nvarchar(4000),@p958 nvarchar(4000),@p959 nvarchar(4000),@p960 nvarchar(4000),@p961 nvarchar(4000),@p962 nvarchar(4000),@p963 datetime2(7),@p964 nvarchar(4000),@p965 nvarchar(4000),@p966 int,@p967 int,@p968 int,@p969 nvarchar(4000),@p970 nvarchar(4000),@p971 nvarchar(4000),@p972 decimal(18,2),@p973 decimal(18,2),@p974 nvarchar(4000),@p975 nvarchar(4000),@p976 decimal(18,2),@p977 nvarchar(4000),@p978 nvarchar(4000),@p979 nvarchar(4000),@p980 nvarchar(4000),@p981 int,@p982 nvarchar(4000),@p983 nvarchar(4000),@p984 nvarchar(4000),@p985 nvarchar(4000),@p986 nvarchar(4000),@p987 nvarchar(4000),@p988 nvarchar(4000),@p989 nvarchar(4000),@p990 nvarchar(4000),@p991 nvarchar(4000),@p992 int,@p993 nvarchar(4000),@p994 nvarchar(4000),@p995 nvarchar(4000),@p996 nvarchar(4000),@p997 nvarchar(4000),@p998 int,@p999 nvarchar(4000),@p1000 int,@p1001 int,@p1002 datetime2(7),@p1003 datetime2(7),@p1004 datetime2(7),@p1005 nvarchar(4000),@p1006 nvarchar(4000),@p1007 nvarchar(4000),@p1008 nvarchar(4000),@p1009 nvarchar(4000),@p1010 nvarchar(4000),@p1011 nvarchar(4000),@p1012 nvarchar(4000),@p1013 nvarchar(4000),@p1014 nvarchar(4000),@p1015 nvarchar(4000),@p1016 nvarchar(4000),@p1017 nvarchar(4000),@p1018 nvarchar(4000),@p1019 datetime2(7),@p1020 nvarchar(4000),@p1021 nvarchar(4000),@p1022 int,@p1023 int,@p1024 int,@p1025 nvarchar(4000),@p1026 nvarchar(4000),@p1027 nvarchar(4000),@p1028 decimal(18,2),@p1029 decimal(18,2),@p1030 nvarchar(4000),@p1031 nvarchar(4000),@p1032 decimal(18,2),@p1033 nvarchar(4000),@p1034 nvarchar(4000),@p1035 nvarchar(4000),@p1036 nvarchar(4000),@p1037 int,@p1038 nvarchar(4000),@p1039 nvarchar(4000),@p1040 nvarchar(4000),@p1041 nvarchar(4000),@p1042 nvarchar(4000),@p1043 nvarchar(4000),@p1044 nvarchar(4000),@p1045 nvarchar(4000),@p1046 nvarchar(4000),@p1047 nvarchar(4000),@p1048 int,@p1049 nvarchar(4000),@p1050 nvarchar(4000),@p1051 nvarchar(4000),@p1052 nvarchar(4000),@p1053 nvarchar(4000),@p1054 int,@p1055 nvarchar(4000),@p1056 int,@p1057 int,@p1058 datetime2(7),@p1059 datetime2(7),@p1060 datetime2(7),@p1061 nvarchar(4000),@p1062 nvarchar(4000),@p1063 nvarchar(4000),@p1064 nvarchar(4000),@p1065 nvarchar(4000),@p1066 nvarchar(4000),@p1067 nvarchar(4000),@p1068 nvarchar(4000),@p1069 nvarchar(4000),@p1070 nvarchar(4000),@p1071 nvarchar(4000),@p1072 nvarchar(4000),@p1073 nvarchar(4000),@p1074 nvarchar(4000),@p1075 datetime2(7),@p1076 nvarchar(4000),@p1077 nvarchar(4000),@p1078 int,@p1079 int,@p1080 int,@p1081 nvarchar(4000),@p1082 nvarchar(4000),@p1083 nvarchar(4000),@p1084 decimal(18,2),@p1085 decimal(18,2),@p1086 nvarchar(4000),@p1087 nvarchar(4000),@p1088 decimal(18,2),@p1089 nvarchar(4000),@p1090 nvarchar(4000),@p1091 nvarchar(4000),@p1092 nvarchar(4000),@p1093 int,@p1094 nvarchar(4000),@p1095 nvarchar(4000),@p1096 nvarchar(4000),@p1097 nvarchar(4000),@p1098 nvarchar(4000),@p1099 nvarchar(4000),@p1100 nvarchar(4000),@p1101 nvarchar(4000),@p1102 nvarchar(4000),@p1103 nvarchar(4000),@p1104 int,@p1105 nvarchar(4000),@p1106 nvarchar(4000),@p1107 nvarchar(4000),@p1108 nvarchar(4000),@p1109 nvarchar(4000),@p1110 int,@p1111 nvarchar(4000),@p1112 int,@p1113 int,@p1114 datetime2(7),@p1115 datetime2(7),@p1116 datetime2(7),@p1117 nvarchar(4000),@p1118 nvarchar(4000),@p1119 nvarchar(4000),@p1120 nvarchar(4000),@p1121 nvarchar(4000),@p1122 nvarchar(4000),@p1123 nvarchar(4000),@p1124 nvarchar(4000),@p1125 nvarchar(4000),@p1126 nvarchar(4000),@p1127 nvarchar(4000),@p1128 nvarchar(4000),@p1129 nvarchar(4000),@p1130 nvarchar(4000),@p1131 datetime2(7),@p1132 nvarchar(4000),@p1133 nvarchar(4000),@p1134 int,@p1135 int,@p1136 int,@p1137 nvarchar(4000),@p1138 nvarchar(4000),@p1139 nvarchar(4000),@p1140 decimal(18,2),@p1141 decimal(18,2),@p1142 nvarchar(4000),@p1143 nvarchar(4000),@p1144 decimal(18,2),@p1145 nvarchar(4000),@p1146 nvarchar(4000),@p1147 nvarchar(4000),@p1148 nvarchar(4000),@p1149 int,@p1150 nvarchar(4000),@p1151 nvarchar(4000),@p1152 nvarchar(4000),@p1153 nvarchar(4000),@p1154 nvarchar(4000),@p1155 nvarchar(4000),@p1156 nvarchar(4000),@p1157 nvarchar(4000),@p1158 nvarchar(4000),@p1159 nvarchar(4000),@p1160 int,@p1161 nvarchar(4000),@p1162 nvarchar(4000),@p1163 nvarchar(4000),@p1164 nvarchar(4000),@p1165 nvarchar(4000),@p1166 int,@p1167 nvarchar(4000),@p1168 int,@p1169 int,@p1170 datetime2(7),@p1171 datetime2(7),@p1172 datetime2(7),@p1173 nvarchar(4000),@p1174 nvarchar(4000),@p1175 nvarchar(4000),@p1176 nvarchar(4000),@p1177 nvarchar(4000),@p1178 nvarchar(4000),@p1179 nvarchar(4000),@p1180 nvarchar(4000),@p1181 nvarchar(4000),@p1182 nvarchar(4000),@p1183 nvarchar(4000),@p1184 nvarchar(4000),@p1185 nvarchar(4000),@p1186 nvarchar(4000),@p1187 datetime2(7),@p1188 nvarchar(4000),@p1189 nvarchar(4000),@p1190 int,@p1191 int,@p1192 int,@p1193 nvarchar(4000),@p1194 nvarchar(4000),@p1195 nvarchar(4000),@p1196 decimal(18,2),@p1197 decimal(18,2),@p1198 nvarchar(4000),@p1199 nvarchar(4000),@p1200 decimal(18,2),@p1201 nvarchar(4000),@p1202 nvarchar(4000),@p1203 nvarchar(4000),@p1204 nvarchar(4000),@p1205 int,@p1206 nvarchar(4000),@p1207 nvarchar(4000),@p1208 nvarchar(4000),@p1209 nvarchar(4000),@p1210 nvarchar(4000),@p1211 nvarchar(4000),@p1212 nvarchar(4000),@p1213 nvarchar(4000),@p1214 nvarchar(4000),@p1215 nvarchar(4000),@p1216 int,@p1217 nvarchar(4000),@p1218 nvarchar(4000),@p1219 nvarchar(4000),@p1220 nvarchar(4000),@p1221 nvarchar(4000),@p1222 int,@p1223 nvarchar(4000),@p1224 int,@p1225 int,@p1226 datetime2(7),@p1227 datetime2(7),@p1228 datetime2(7),@p1229 nvarchar(4000),@p1230 nvarchar(4000),@p1231 nvarchar(4000),@p1232 nvarchar(4000),@p1233 nvarchar(4000),@p1234 nvarchar(4000),@p1235 nvarchar(4000),@p1236 nvarchar(4000),@p1237 nvarchar(4000),@p1238 nvarchar(4000),@p1239 nvarchar(4000),@p1240 nvarchar(4000),@p1241 nvarchar(4000),@p1242 nvarchar(4000),@p1243 datetime2(7),@p1244 nvarchar(4000),@p1245 nvarchar(4000),@p1246 int,@p1247 int,@p1248 int,@p1249 nvarchar(4000),@p1250 nvarchar(4000),@p1251 nvarchar(4000),@p1252 nvarchar(4000),@p1253 decimal(18,2),@p1254 nvarchar(4000),@p1255 nvarchar(4000),@p1256 decimal(18,2),@p1257 nvarchar(4000),@p1258 nvarchar(4000),@p1259 nvarchar(4000),@p1260 nvarchar(4000),@p1261 int,@p1262 nvarchar(4000),@p1263 nvarchar(4000),@p1264 nvarchar(4000),@p1265 nvarchar(4000),@p1266 nvarchar(4000),@p1267 nvarchar(4000),@p1268 nvarchar(4000),@p1269 nvarchar(4000),@p1270 nvarchar(4000),@p1271 nvarchar(4000),@p1272 int,@p1273 nvarchar(4000),@p1274 nvarchar(4000),@p1275 nvarchar(4000),@p1276 nvarchar(4000),@p1277 nvarchar(4000),@p1278 int,@p1279 nvarchar(4000),@p1280 int,@p1281 int,@p1282 datetime2(7),@p1283 datetime2(7),@p1284 datetime2(7),@p1285 nvarchar(4000),@p1286 nvarchar(4000),@p1287 nvarchar(4000),@p1288 nvarchar(4000),@p1289 nvarchar(4000),@p1290 nvarchar(4000),@p1291 nvarchar(4000),@p1292 nvarchar(4000),@p1293 nvarchar(4000),@p1294 nvarchar(4000),@p1295 nvarchar(4000),@p1296 nvarchar(4000),@p1297 nvarchar(4000),@p1298 nvarchar(4000),@p1299 datetime2(7),@p1300 nvarchar(4000),@p1301 nvarchar(4000),@p1302 int,@p1303 int,@p1304 int,@p1305 nvarchar(4000),@p1306 nvarchar(4000),@p1307 nvarchar(4000),@p1308 nvarchar(4000),@p1309 decimal(18,2),@p1310 nvarchar(4000),@p1311 nvarchar(4000),@p1312 decimal(18,2),@p1313 nvarchar(4000),@p1314 nvarchar(4000),@p1315 nvarchar(4000),@p1316 nvarchar(4000),@p1317 int,@p1318 nvarchar(4000),@p1319 nvarchar(4000),@p1320 nvarchar(4000),@p1321 nvarchar(4000),@p1322 nvarchar(4000),@p1323 nvarchar(4000),@p1324 nvarchar(4000),@p1325 nvarchar(4000),@p1326 nvarchar(4000),@p1327 nvarchar(4000),@p1328 int,@p1329 nvarchar(4000),@p1330 nvarchar(4000),@p1331 nvarchar(4000),@p1332 nvarchar(4000),@p1333 nvarchar(4000),@p1334 int,@p1335 nvarchar(4000),@p1336 int,@p1337 int,@p1338 datetime2(7),@p1339 datetime2(7),@p1340 datetime2(7),@p1341 nvarchar(4000),@p1342 nvarchar(4000),@p1343 nvarchar(4000),@p1344 nvarchar(4000),@p1345 nvarchar(4000),@p1346 nvarchar(4000),@p1347 nvarchar(4000),@p1348 nvarchar(4000),@p1349 nvarchar(4000),@p1350 nvarchar(4000),@p1351 nvarchar(4000),@p1352 nvarchar(4000),@p1353 nvarchar(4000),@p1354 nvarchar(4000),@p1355 datetime2(7),@p1356 nvarchar(4000),@p1357 nvarchar(4000),@p1358 int,@p1359 int,@p1360 int,@p1361 nvarchar(4000),@p1362 nvarchar(4000),@p1363 nvarchar(4000),@p1364 nvarchar(4000),@p1365 decimal(18,2),@p1366 nvarchar(4000),@p1367 nvarchar(4000),@p1368 decimal(18,2),@p1369 nvarchar(4000),@p1370 nvarchar(4000),@p1371 nvarchar(4000),@p1372 nvarchar(4000),@p1373 int,@p1374 nvarchar(4000),@p1375 nvarchar(4000),@p1376 nvarchar(4000),@p1377 nvarchar(4000),@p1378 nvarchar(4000),@p1379 nvarchar(4000),@p1380 nvarchar(4000),@p1381 nvarchar(4000),@p1382 nvarchar(4000),@p1383 nvarchar(4000),@p1384 int,@p1385 nvarchar(4000),@p1386 nvarchar(4000),@p1387 nvarchar(4000),@p1388 nvarchar(4000),@p1389 nvarchar(4000),@p1390 int,@p1391 nvarchar(4000),@p1392 int,@p1393 int,@p1394 datetime2(7),@p1395 datetime2(7),@p1396 datetime2(7),@p1397 nvarchar(4000),@p1398 nvarchar(4000),@p1399 nvarchar(4000),@p1400 nvarchar(4000),@p1401 nvarchar(4000),@p1402 nvarchar(4000),@p1403 nvarchar(4000),@p1404 nvarchar(4000),@p1405 nvarchar(4000),@p1406 nvarchar(4000),@p1407 nvarchar(4000),@p1408 nvarchar(4000),@p1409 nvarchar(4000),@p1410 nvarchar(4000),@p1411 datetime2(7),@p1412 nvarchar(4000),@p1413 nvarchar(4000),@p1414 int,@p1415 int,@p1416 int,@p1417 nvarchar(4000),@p1418 nvarchar(4000),@p1419 nvarchar(4000),@p1420 nvarchar(4000),@p1421 decimal(18,2),@p1422 nvarchar(4000),@p1423 nvarchar(4000),@p1424 decimal(18,2),@p1425 nvarchar(4000),@p1426 nvarchar(4000),@p1427 nvarchar(4000),@p1428 nvarchar(4000),@p1429 int,@p1430 nvarchar(4000),@p1431 nvarchar(4000),@p1432 nvarchar(4000),@p1433 nvarchar(4000),@p1434 nvarchar(4000),@p1435 nvarchar(4000),@p1436 nvarchar(4000),@p1437 nvarchar(4000),@p1438 nvarchar(4000),@p1439 nvarchar(4000),@p1440 int,@p1441 nvarchar(4000),@p1442 nvarchar(4000),@p1443 nvarchar(4000),@p1444 nvarchar(4000),@p1445 nvarchar(4000),@p1446 int,@p1447 nvarchar(4000),@p1448 int,@p1449 int,@p1450 datetime2(7),@p1451 datetime2(7),@p1452 datetime2(7),@p1453 nvarchar(4000),@p1454 nvarchar(4000),@p1455 nvarchar(4000),@p1456 nvarchar(4000),@p1457 nvarchar(4000),@p1458 nvarchar(4000),@p1459 nvarchar(4000),@p1460 nvarchar(4000),@p1461 nvarchar(4000),@p1462 nvarchar(4000),@p1463 nvarchar(4000),@p1464 nvarchar(4000),@p1465 nvarchar(4000),@p1466 nvarchar(4000),@p1467 datetime2(7),@p1468 nvarchar(4000),@p1469 nvarchar(4000),@p1470 int,@p1471 int,@p1472 int,@p1473 nvarchar(4000),@p1474 nvarchar(4000),@p1475 nvarchar(4000),@p1476 nvarchar(4000),@p1477 decimal(18,2),@p1478 nvarchar(4000),@p1479 nvarchar(4000),@p1480 decimal(18,2),@p1481 nvarchar(4000),@p1482 nvarchar(4000),@p1483 nvarchar(4000),@p1484 nvarchar(4000),@p1485 int,@p1486 nvarchar(4000),@p1487 nvarchar(4000),@p1488 nvarchar(4000),@p1489 nvarchar(4000),@p1490 nvarchar(4000),@p1491 nvarchar(4000),@p1492 nvarchar(4000),@p1493 nvarchar(4000),@p1494 nvarchar(4000),@p1495 nvarchar(4000),@p1496 int,@p1497 nvarchar(4000),@p1498 nvarchar(4000),@p1499 nvarchar(4000),@p1500 nvarchar(4000),@p1501 nvarchar(4000),@p1502 int,@p1503 nvarchar(4000),@p1504 int,@p1505 int,@p1506 datetime2(7),@p1507 datetime2(7),@p1508 datetime2(7),@p1509 nvarchar(4000),@p1510 nvarchar(4000),@p1511 nvarchar(4000),@p1512 nvarchar(4000),@p1513 nvarchar(4000),@p1514 nvarchar(4000),@p1515 nvarchar(4000),@p1516 nvarchar(4000),@p1517 nvarchar(4000),@p1518 nvarchar(4000),@p1519 nvarchar(4000),@p1520 nvarchar(4000),@p1521 nvarchar(4000),@p1522 nvarchar(4000),@p1523 datetime2(7),@p1524 nvarchar(4000),@p1525 nvarchar(4000),@p1526 int,@p1527 int,@p1528 int,@p1529 nvarchar(4000),@p1530 nvarchar(4000),@p1531 nvarchar(4000),@p1532 nvarchar(4000),@p1533 decimal(18,2),@p1534 nvarchar(4000),@p1535 nvarchar(4000),@p1536 decimal(18,2),@p1537 nvarchar(4000),@p1538 nvarchar(4000),@p1539 nvarchar(4000),@p1540 nvarchar(4000),@p1541 int,@p1542 nvarchar(4000),@p1543 nvarchar(4000),@p1544 nvarchar(4000),@p1545 nvarchar(4000),@p1546 nvarchar(4000),@p1547 nvarchar(4000),@p1548 nvarchar(4000),@p1549 nvarchar(4000),@p1550 nvarchar(4000),@p1551 nvarchar(4000),@p1552 int,@p1553 nvarchar(4000),@p1554 nvarchar(4000),@p1555 nvarchar(4000),@p1556 nvarchar(4000),@p1557 nvarchar(4000),@p1558 int,@p1559 nvarchar(4000),@p1560 int,@p1561 int,@p1562 datetime2(7),@p1563 datetime2(7),@p1564 datetime2(7),@p1565 nvarchar(4000),@p1566 nvarchar(4000),@p1567 nvarchar(4000),@p1568 nvarchar(4000),@p1569 nvarchar(4000),@p1570 nvarchar(4000),@p1571 nvarchar(4000),@p1572 nvarchar(4000),@p1573 nvarchar(4000),@p1574 nvarchar(4000),@p1575 nvarchar(4000),@p1576 nvarchar(4000),@p1577 nvarchar(4000),@p1578 nvarchar(4000),@p1579 datetime2(7),@p1580 nvarchar(4000),@p1581 nvarchar(4000),@p1582 int,@p1583 int,@p1584 int,@p1585 nvarchar(4000),@p1586 nvarchar(4000),@p1587 nvarchar(4000),@p1588 nvarchar(4000),@p1589 decimal(18,2),@p1590 nvarchar(4000),@p1591 nvarchar(4000),@p1592 decimal(18,2),@p1593 nvarchar(4000),@p1594 nvarchar(4000),@p1595 nvarchar(4000),@p1596 nvarchar(4000),@p1597 int,@p1598 nvarchar(4000),@p1599 nvarchar(4000),@p1600 nvarchar(4000),@p1601 nvarchar(4000),@p1602 nvarchar(4000),@p1603 nvarchar(4000),@p1604 nvarchar(4000),@p1605 nvarchar(4000),@p1606 nvarchar(4000),@p1607 nvarchar(4000),@p1608 int,@p1609 nvarchar(4000),@p1610 nvarchar(4000),@p1611 nvarchar(4000),@p1612 nvarchar(4000),@p1613 nvarchar(4000),@p1614 int,@p1615 nvarchar(4000),@p1616 int,@p1617 int,@p1618 datetime2(7),@p1619 datetime2(7),@p1620 datetime2(7),@p1621 nvarchar(4000),@p1622 nvarchar(4000),@p1623 nvarchar(4000),@p1624 nvarchar(4000),@p1625 nvarchar(4000),@p1626 nvarchar(4000),@p1627 nvarchar(4000),@p1628 nvarchar(4000),@p1629 nvarchar(4000),@p1630 nvarchar(4000),@p1631 nvarchar(4000),@p1632 nvarchar(4000),@p1633 nvarchar(4000),@p1634 nvarchar(4000),@p1635 datetime2(7),@p1636 nvarchar(4000),@p1637 nvarchar(4000),@p1638 int,@p1639 int,@p1640 int,@p1641 nvarchar(4000),@p1642 nvarchar(4000),@p1643 nvarchar(4000),@p1644 nvarchar(4000),@p1645 decimal(18,2),@p1646 nvarchar(4000),@p1647 nvarchar(4000),@p1648 decimal(18,2),@p1649 nvarchar(4000),@p1650 nvarchar(4000),@p1651 nvarchar(4000),@p1652 nvarchar(4000),@p1653 int,@p1654 nvarchar(4000),@p1655 nvarchar(4000),@p1656 nvarchar(4000),@p1657 nvarchar(4000),@p1658 nvarchar(4000),@p1659 nvarchar(4000),@p1660 nvarchar(4000),@p1661 nvarchar(4000),@p1662 nvarchar(4000),@p1663 nvarchar(4000),@p1664 int,@p1665 nvarchar(4000),@p1666 nvarchar(4000),@p1667 nvarchar(4000),@p1668 nvarchar(4000),@p1669 nvarchar(4000),@p1670 int,@p1671 nvarchar(4000),@p1672 int,@p1673 int,@p1674 datetime2(7),@p1675 datetime2(7),@p1676 datetime2(7),@p1677 nvarchar(4000),@p1678 nvarchar(4000),@p1679 nvarchar(4000),@p1680 nvarchar(4000),@p1681 nvarchar(4000),@p1682 nvarchar(4000),@p1683 nvarchar(4000),@p1684 nvarchar(4000),@p1685 nvarchar(4000),@p1686 nvarchar(4000),@p1687 nvarchar(4000),@p1688 nvarchar(4000),@p1689 nvarchar(4000),@p1690 nvarchar(4000),@p1691 datetime2(7),@p1692 nvarchar(4000),@p1693 nvarchar(4000),@p1694 int,@p1695 int,@p1696 int,@p1697 nvarchar(4000),@p1698 nvarchar(4000),@p1699 nvarchar(4000),@p1700 nvarchar(4000),@p1701 decimal(18,2),@p1702 nvarchar(4000),@p1703 nvarchar(4000),@p1704 decimal(18,2),@p1705 nvarchar(4000),@p1706 nvarchar(4000),@p1707 nvarchar(4000),@p1708 nvarchar(4000),@p1709 int,@p1710 nvarchar(4000),@p1711 nvarchar(4000),@p1712 nvarchar(4000),@p1713 nvarchar(4000),@p1714 nvarchar(4000),@p1715 nvarchar(4000),@p1716 nvarchar(4000),@p1717 nvarchar(4000),@p1718 nvarchar(4000),@p1719 nvarchar(4000),@p1720 int,@p1721 nvarchar(4000),@p1722 nvarchar(4000),@p1723 nvarchar(4000),@p1724 nvarchar(4000),@p1725 nvarchar(4000),@p1726 int,@p1727 nvarchar(4000),@p1728 int,@p1729 int,@p1730 datetime2(7),@p1731 datetime2(7),@p1732 datetime2(7),@p1733 nvarchar(4000),@p1734 nvarchar(4000),@p1735 nvarchar(4000),@p1736 nvarchar(4000),@p1737 nvarchar(4000),@p1738 nvarchar(4000),@p1739 nvarchar(4000),@p1740 nvarchar(4000),@p1741 nvarchar(4000),@p1742 nvarchar(4000),@p1743 nvarchar(4000),@p1744 nvarchar(4000),@p1745 nvarchar(4000),@p1746 nvarchar(4000),@p1747 datetime2(7),@p1748 nvarchar(4000),@p1749 nvarchar(4000),@p1750 int,@p1751 int,@p1752 int,@p1753 nvarchar(4000),@p1754 nvarchar(4000),@p1755 nvarchar(4000),@p1756 nvarchar(4000),@p1757 decimal(18,2),@p1758 nvarchar(4000),@p1759 nvarchar(4000),@p1760 decimal(18,2),@p1761 nvarchar(4000),@p1762 nvarchar(4000),@p1763 nvarchar(4000),@p1764 nvarchar(4000),@p1765 int,@p1766 nvarchar(4000),@p1767 nvarchar(4000),@p1768 nvarchar(4000),@p1769 nvarchar(4000),@p1770 nvarchar(4000),@p1771 nvarchar(4000),@p1772 nvarchar(4000),@p1773 nvarchar(4000),@p1774 nvarchar(4000),@p1775 nvarchar(4000),@p1776 int,@p1777 nvarchar(4000),@p1778 nvarchar(4000),@p1779 nvarchar(4000),@p1780 nvarchar(4000),@p1781 nvarchar(4000),@p1782 int,@p1783 nvarchar(4000),@p1784 int,@p1785 int,@p1786 datetime2(7),@p1787 datetime2(7),@p1788 datetime2(7),@p1789 nvarchar(4000),@p1790 nvarchar(4000),@p1791 nvarchar(4000),@p1792 nvarchar(4000),@p1793 nvarchar(4000),@p1794 nvarchar(4000),@p1795 nvarchar(4000),@p1796 nvarchar(4000),@p1797 nvarchar(4000),@p1798 nvarchar(4000),@p1799 nvarchar(4000),@p1800 nvarchar(4000),@p1801 nvarchar(4000),@p1802 nvarchar(4000),@p1803 datetime2(7),@p1804 nvarchar(4000),@p1805 nvarchar(4000),@p1806 int,@p1807 int,@p1808 int,@p1809 nvarchar(4000),@p1810 nvarchar(4000),@p1811 nvarchar(4000),@p1812 nvarchar(4000),@p1813 decimal(18,2),@p1814 nvarchar(4000),@p1815 nvarchar(4000),@p1816 decimal(18,2),@p1817 nvarchar(4000),@p1818 nvarchar(4000),@p1819 nvarchar(4000),@p1820 nvarchar(4000),@p1821 int,@p1822 nvarchar(4000),@p1823 nvarchar(4000),@p1824 nvarchar(4000),@p1825 nvarchar(4000),@p1826 nvarchar(4000),@p1827 nvarchar(4000),@p1828 nvarchar(4000),@p1829 nvarchar(4000),@p1830 nvarchar(4000),@p1831 nvarchar(4000),@p1832 int,@p1833 nvarchar(4000),@p1834 nvarchar(4000),@p1835 nvarchar(4000),@p1836 nvarchar(4000),@p1837 nvarchar(4000),@p1838 int,@p1839 nvarchar(4000),@p1840 int,@p1841 int,@p1842 datetime2(7),@p1843 datetime2(7),@p1844 datetime2(7),@p1845 nvarchar(4000),@p1846 nvarchar(4000),@p1847 nvarchar(4000),@p1848 nvarchar(4000),@p1849 nvarchar(4000),@p1850 nvarchar(4000),@p1851 nvarchar(4000),@p1852 nvarchar(4000),@p1853 nvarchar(4000),@p1854 nvarchar(4000),@p1855 nvarchar(4000),@p1856 nvarchar(4000),@p1857 nvarchar(4000),@p1858 nvarchar(4000),@p1859 datetime2(7),@p1860 nvarchar(4000),@p1861 nvarchar(4000),@p1862 int,@p1863 int,@p1864 int,@p1865 nvarchar(4000),@p1866 nvarchar(4000),@p1867 nvarchar(4000),@p1868 nvarchar(4000),@p1869 decimal(18,2),@p1870 nvarchar(4000),@p1871 nvarchar(4000),@p1872 decimal(18,2),@p1873 nvarchar(4000),@p1874 nvarchar(4000),@p1875 nvarchar(4000),@p1876 nvarchar(4000),@p1877 int,@p1878 nvarchar(4000),@p1879 nvarchar(4000),@p1880 nvarchar(4000),@p1881 nvarchar(4000),@p1882 nvarchar(4000),@p1883 nvarchar(4000),@p1884 nvarchar(4000),@p1885 nvarchar(4000),@p1886 nvarchar(4000),@p1887 nvarchar(4000),@p1888 int,@p1889 nvarchar(4000),@p1890 nvarchar(4000),@p1891 nvarchar(4000),@p1892 nvarchar(4000),@p1893 nvarchar(4000),@p1894 int,@p1895 nvarchar(4000),@p1896 int,@p1897 int,@p1898 datetime2(7),@p1899 datetime2(7),@p1900 datetime2(7),@p1901 nvarchar(4000),@p1902 nvarchar(4000),@p1903 nvarchar(4000),@p1904 nvarchar(4000),@p1905 nvarchar(4000),@p1906 nvarchar(4000),@p1907 nvarchar(4000),@p1908 nvarchar(4000),@p1909 nvarchar(4000),@p1910 nvarchar(4000),@p1911 nvarchar(4000),@p1912 nvarchar(4000),@p1913 nvarchar(4000),@p1914 nvarchar(4000),@p1915 datetime2(7),@p1916 nvarchar(4000),@p1917 nvarchar(4000),@p1918 int,@p1919 int,@p1920 int,@p1921 nvarchar(4000),@p1922 nvarchar(4000),@p1923 nvarchar(4000),@p1924 nvarchar(4000),@p1925 decimal(18,2),@p1926 nvarchar(4000),@p1927 nvarchar(4000),@p1928 decimal(18,2),@p1929 nvarchar(4000),@p1930 nvarchar(4000),@p1931 nvarchar(4000),@p1932 nvarchar(4000),@p1933 int,@p1934 nvarchar(4000),@p1935 nvarchar(4000),@p1936 nvarchar(4000),@p1937 nvarchar(4000),@p1938 nvarchar(4000),@p1939 nvarchar(4000),@p1940 nvarchar(4000),@p1941 nvarchar(4000),@p1942 nvarchar(4000),@p1943 nvarchar(4000),@p1944 int,@p1945 nvarchar(4000),@p1946 nvarchar(4000),@p1947 nvarchar(4000),@p1948 nvarchar(4000),@p1949 nvarchar(4000),@p1950 int,@p1951 nvarchar(4000),@p1952 int,@p1953 int,@p1954 datetime2(7),@p1955 datetime2(7),@p1956 datetime2(7),@p1957 nvarchar(4000),@p1958 nvarchar(4000),@p1959 nvarchar(4000),@p1960 nvarchar(4000),@p1961 nvarchar(4000),@p1962 nvarchar(4000),@p1963 nvarchar(4000),@p1964 nvarchar(4000),@p1965 nvarchar(4000),@p1966 nvarchar(4000),@p1967 nvarchar(4000),@p1968 nvarchar(4000),@p1969 nvarchar(4000),@p1970 nvarchar(4000),@p1971 datetime2(7),@p1972 nvarchar(4000),@p1973 nvarchar(4000),@p1974 int,@p1975 int,@p1976 int,@p1977 nvarchar(4000),@p1978 nvarchar(4000),@p1979 nvarchar(4000),@p1980 nvarchar(4000),@p1981 decimal(18,2),@p1982 nvarchar(4000),@p1983 nvarchar(4000),@p1984 decimal(18,2),@p1985 nvarchar(4000),@p1986 nvarchar(4000),@p1987 nvarchar(4000),@p1988 nvarchar(4000),@p1989 int,@p1990 nvarchar(4000),@p1991 nvarchar(4000),@p1992 nvarchar(4000),@p1993 nvarchar(4000),@p1994 nvarchar(4000),@p1995 nvarchar(4000),@p1996 nvarchar(4000),@p1997 nvarchar(4000),@p1998 nvarchar(4000),@p1999 nvarchar(4000),@p2000 int,@p2001 nvarchar(4000),@p2002 nvarchar(4000),@p2003 nvarchar(4000),@p2004 nvarchar(4000),@p2005 nvarchar(4000),@p2006 int,@p2007 nvarchar(4000),@p2008 int,@p2009 int,@p2010 datetime2(7),@p2011 datetime2(7),@p2012 datetime2(7),@p2013 nvarchar(4000),@p2014 nvarchar(4000),@p2015 nvarchar(4000),@p2016 nvarchar(4000),@p2017 nvarchar(4000),@p2018 nvarchar(4000),@p2019 nvarchar(4000),@p2020 nvarchar(4000),@p2021 nvarchar(4000),@p2022 nvarchar(4000),@p2023 nvarchar(4000),@p2024 nvarchar(4000),@p2025 nvarchar(4000),@p2026 nvarchar(4000),@p2027 datetime2(7),@p2028 nvarchar(4000),@p2029 nvarchar(4000),@p2030 int,@p2031 int,@p2032 int,@p2033 nvarchar(4000),@p2034 nvarchar(4000),@p2035 nvarchar(4000),@p2036 nvarchar(4000),@p2037 decimal(18,2),@p2038 nvarchar(4000),@p2039 nvarchar(4000),@p2040 decimal(18,2),@p2041 nvarchar(4000),@p2042 nvarchar(4000),@p2043 nvarchar(4000),@p2044 nvarchar(4000),@p2045 int,@p2046 nvarchar(4000),@p2047 nvarchar(4000),@p2048 nvarchar(4000),@p2049 nvarchar(4000),@p2050 nvarchar(4000),@p2051 nvarchar(4000),@p2052 nvarchar(4000),@p2053 nvarchar(4000),@p2054 nvarchar(4000),@p2055 nvarchar(4000),@p2056 int,@p2057 nvarchar(4000),@p2058 nvarchar(4000),@p2059 nvarchar(4000),@p2060 nvarchar(4000),@p2061 nvarchar(4000),@p2062 int,@p2063 nvarchar(4000),@p2064 int,@p2065 int,@p2066 datetime2(7),@p2067 datetime2(7),@p2068 datetime2(7),@p2069 nvarchar(4000),@p2070 nvarchar(4000),@p2071 nvarchar(4000))SET NOCOUNT ON; DECLARE @inserted0 TABLE ([item_id] int, [_Position] [int]); MERGE [raw_data] USING ( VALUES (@p0, @p1, @p2, @p3, @p4, @p5, @p6, @p7, @p8, @p9, @p10, @p11, @p12, @p13, @p14, @p15, @p16, @p17, @p18, @p19, @p20, @p21, @p22, @p23, @p24, @p25, @p26, @p27, @p28, @p29, @p30, @p31, @p32, @p33, @p34, @p35, @p36, @p37, @p38, @p39, @p40, @p41, @p42, @p43, @p44, @p45, @p46, @p47, @p48, @p49, @p50, @p51, @p52, @p53, @p54, @p55, 0), (@p56, @p57, @p58, @p59, @p60, @p61, @p62, @p63, @p64, @p65, @p66, @p67, @p68, @p69, @p70, @p71, @p72, @p73, @p74, @p75, @p76, @p77, @p78, @p79, @p80, @p81, @p82, @p83, @p84, @p85, @p86, @p87, @p88, @p89, @p90, @p91, @p92, @p93, @p94, @p95, @p96, @p97, @p98, @p99, @p100, @p101, @p102, @p103, @p104, @p105, @p106, @p107, @p108, @p109, @p110, @p111, 1), (@p112, @p113, @p114, @p115, @p116, @p117, @p118, @p119, @p120, @p121, @p122, @p123, @p124, @p125, @p126, @p127, @p128, @p129, @p130, @p131, @p132, @p133, @p134, @p135, @p136, @p137, @p138, @p139, @p140, @p141, @p142, @p143, @p144, @p145, @p146, @p147, @p148, @p149, @p150, @p151, @p152, @p153, @p154, @p155, @p156, @p157, @p158, @p159, @p160, @p161, @p162, @p163, @p164, @p165, @p166, @p167, 2), (@p168, @p169, @p170, @p171, @p172, @p173, @p174, @p175, @p176, @p177, @p178, @p179, @p180, @p181, @p182, @p183, @p184, @p185, @p186, @p187, @p188, @p189, @p190, @p191, @p192, @p193, @p194, @p195, @p196, @p197, @p198, @p199, @p200, @p201, @p202, @p203, @p204, @p205, @p206, @p207, @p208, @p209, @p210, @p211, @p212, @p213, @p214, @p215, @p216, @p217, @p218, @p219, @p220, @p221, @p222, @p223, 3), (@p224, @p225, @p226, @p227, @p228, @p229, @p230, @p231, @p232, @p233, @p234, @p235, @p236, @p237, @p238, @p239, @p240, @p241, @p242, @p243, @p244, @p245, @p246, @p247, @p248, @p249, @p250, @p251, @p252, @p253, @p254, @p255, @p256, @p257, @p258, @p259, @p260, @p261, @p262, @p263, @p264, @p265, @p266, @p267, @p268, @p269, @p270, @p271, @p272, @p273, @p274, @p275, @p276, @p277, @p278, @p279, 4), (@p280, @p281, @p282, @p283, @p284, @p285, @p286, @p287, @p288, @p289, @p290, @p291, @p292, @p293, @p294, @p295, @p296, @p297, @p298, @p299, @p300, @p301, @p302, @p303, @p304, @p305, @p306, @p307, @p308, @p309, @p310, @p311, @p312, @p313, @p314, @p315, @p316, @p317, @p318, @p319, @p320, @p321, @p322, @p323, @p324, @p325, @p326, @p327, @p328, @p329, @p330, @p331, @p332, @p333, @p334, @p335, 5), (@p336, @p337, @p338, @p339, @p340, @p341, @p342, @p343, @p344, @p345, @p346, @p347, @p348, @p349, @p350, @p351, @p352, @p353, @p354, @p355, @p356, @p357, @p358, @p359, @p360, @p361, @p362, @p363, @p364, @p365, @p366, @p367, @p368, @p369, @p370, @p371, @p372, @p373, @p374, @p375, @p376, @p377, @p378, @p379, @p380, @p381, @p382, @p383, @p384, @p385, @p386, @p387, @p388, @p389, @p390, @p391, 6), (@p392, @p393, @p394, @p395, @p396, @p397, @p398, @p399, @p400, @p401, @p402, @p403, @p404, @p405, @p406, @p407, @p408, @p409, @p410, @p411, @p412, @p413, @p414, @p415, @p416, @p417, @p418, @p419, @p420, @p421, @p422, @p423, @p424, @p425, @p426, @p427, @p428, @p429, @p430, @p431, @p432, @p433, @p434, @p435, @p436, @p437, @p438, @p439, @p440, @p441, @p442, @p443, @p444, @p445, @p446, @p447, 7), (@p448, @p449, @p450, @p451, @p452, @p453, @p454, @p455, @p456, @p457, @p458, @p459, @p460, @p461, @p462, @p463, @p464, @p465, @p466, @p467, @p468, @p469, @p470, @p471, @p472, @p473, @p474, @p475, @p476, @p477, @p478, @p479, @p480, @p481, @p482, @p483, @p484, @p485, @p486, @p487, @p488, @p489, @p490, @p491, @p492, @p493, @p494, @p495, @p496, @p497, @p498, @p499, @p500, @p501, @p502, @p503, 8), (@p504, @p505, @p506, @p507, @p508, @p509, @p510, @p511, @p512, @p513, @p514, @p515, @p516, @p517, @p518, @p519, @p520, @p521, @p522, @p523, @p524, @p525, @p526, @p527, @p528, @p529, @p530, @p531, @p532, @p533, @p534, @p535, @p536, @p537, @p538, @p539, @p540, @p541, @p542, @p543, @p544, @p545, @p546, @p547, @p548, @p549, @p550, @p551, @p552, @p553, @p554, @p555, @p556, @p557, @p558, @p559, 9), (@p560, @p561, @p562, @p563, @p564, @p565, @p566, @p567, @p568, @p569, @p570, @p571, @p572, @p573, @p574, @p575, @p576, @p577, @p578, @p579, @p580, @p581, @p582, @p583, @p584, @p585, @p586, @p587, @p588, @p589, @p590, @p591, @p592, @p593, @p594, @p595, @p596, @p597, @p598, @p599, @p600, @p601, @p602, @p603, @p604, @p605, @p606, @p607, @p608, @p609, @p610, @p611, @p612, @p613, @p614, @p615, 10), (@p616, @p617, @p618, @p619, @p620, @p621, @p622, @p623, @p624, @p625, @p626, @p627, @p628, @p629, @p630, @p631, @p632, @p633, @p634, @p635, @p636, @p637, @p638, @p639, @p640, @p641, @p642, @p643, @p644, @p645, @p646, @p647, @p648, @p649, @p650, @p651, @p652, @p653, @p654, @p655, @p656, @p657, @p658, @p659, @p660, @p661, @p662, @p663, @p664, @p665, @p666, @p667, @p668, @p669, @p670, @p671, 11), (@p672, @p673, @p674, @p675, @p676, @p677, @p678, @p679, @p680, @p681, @p682, @p683, @p684, @p685, @p686, @p687, @p688, @p689, @p690, @p691, @p692, @p693, @p694, @p695, @p696, @p697, @p698, @p699, @p700, @p701, @p702, @p703, @p704, @p705, @p706, @p707, @p708, @p709, @p710, @p711, @p712, @p713, @p714, @p715, @p716, @p717, @p718, @p719, @p720, @p721, @p722, @p723, @p724, @p725, @p726, @p727, 12), (@p728, @p729, @p730, @p731, @p732, @p733, @p734, @p735, @p736, @p737, @p738, @p739, @p740, @p741, @p742, @p743, @p744, @p745, @p746, @p747, @p748, @p749, @p750, @p751, @p752, @p753, @p754, @p755, @p756, @p757, @p758, @p759, @p760, @p761, @p762, @p763, @p764, @p765, @p766, @p767, @p768, @p769, @p770, @p771, @p772, @p773, @p774, @p775, @p776, @p777, @p778, @p779, @p780, @p781, @p782, @p783, 13), (@p784, @p785, @p786, @p787, @p788, @p789, @p790, @p791, @p792, @p793, @p794, @p795, @p796, @p797, @p798, @p799, @p800, @p801, @p802, @p803, @p804, @p805, @p806, @p807, @p808, @p809, @p810, @p811, @p812, @p813, @p814, @p815, @p816, @p817, @p818, @p819, @p820, @p821, @p822, @p823, @p824, @p825, @p826, @p827, @p828, @p829, @p830, @p831, @p832, @p833, @p834, @p835, @p836, @p837, @p838, @p839, 14), (@p840, @p841, @p842, @p843, @p844, @p845, @p846, @p847, @p848, @p849, @p850, @p851, @p852, @p853, @p854, @p855, @p856, @p857, @p858, @p859, @p860, @p861, @p862, @p863, @p864, @p865, @p866, @p867, @p868, @p869, @p870, @p871, @p872, @p873, @p874, @p875, @p876, @p877, @p878, @p879, @p880, @p881, @p882, @p883, @p884, @p885, @p886, @p887, @p888, @p889, @p890, @p891, @p892, @p893, @p894, @p895, 15), (@p896, @p897, @p898, @p899, @p900, @p901, @p902, @p903, @p904, @p905, @p906, @p907, @p908, @p909, @p910, @p911, @p912, @p913, @p914, @p915, @p916, @p917, @p918, @p919, @p920, @p921, @p922, @p923, @p924, @p925, @p926, @p927, @p928, @p929, @p930, @p931, @p932, @p933, @p934, @p935, @p936, @p937, @p938, @p939, @p940, @p941, @p942, @p943, @p944, @p945, @p946, @p947, @p948, @p949, @p950, @p951, 16), (@p952, @p953, @p954, @p955, @p956, @p957, @p958, @p959, @p960, @p961, @p962, @p963, @p964, @p965, @p966, @p967, @p968, @p969, @p970, @p971, @p972, @p973, @p974, @p975, @p976, @p977, @p978, @p979, @p980, @p981, @p982, @p983, @p984, @p985, @p986, @p987, @p988, @p989, @p990, @p991, @p992, @p993, @p994, @p995, @p996, @p997, @p998, @p999, @p1000, @p1001, @p1002, @p1003, @p1004, @p1005, @p1006, @p1007, 17), (@p1008, @p1009, @p1010, @p1011, @p1012, @p1013, @p1014, @p1015, @p1016, @p1017, @p1018, @p1019, @p1020, @p1021, @p1022, @p1023, @p1024, @p1025, @p1026, @p1027, @p1028, @p1029, @p1030, @p1031, @p1032, @p1033, @p1034, @p1035, @p1036, @p1037, @p1038, @p1039, @p1040, @p1041, @p1042, @p1043, @p1044, @p1045, @p1046, @p1047, @p1048, @p1049, @p1050, @p1051, @p1052, @p1053, @p1054, @p1055, @p1056, @p1057, @p1058, @p1059, @p1060, @p1061, @p1062, @p1063, 18), (@p1064, @p1065, @p1066, @p1067, @p1068, @p1069, @p1070, @p1071, @p1072, @p1073, @p1074, @p1075, @p1076, @p1077, @p1078, @p1079, @p1080, @p1081, @p1082, @p1083, @p1084, @p1085, @p1086, @p1087, @p1088, @p1089, @p1090, @p1091, @p1092, @p1093, @p1094, @p1095, @p1096, @p1097, @p1098, @p1099, @p1100, @p1101, @p1102, @p1103, @p1104, @p1105, @p1106, @p1107, @p1108, @p1109, @p1110, @p1111, @p1112, @p1113, @p1114, @p1115, @p1116, @p1117, @p1118, @p1119, 19), (@p1120, @p1121, @p1122, @p1123, @p1124, @p1125, @p1126, @p1127, @p1128, @p1129, @p1130, @p1131, @p1132, @p1133, @p1134, @p1135, @p1136, @p1137, @p1138, @p1139, @p1140, @p1141, @p1142, @p1143, @p1144, @p1145, @p1146, @p1147, @p1148, @p1149, @p1150, @p1151, @p1152, @p1153, @p1154, @p1155, @p1156, @p1157, @p1158, @p1159, @p1160, @p1161, @p1162, @p1163, @p1164, @p1165, @p1166, @p1167, @p1168, @p1169, @p1170, @p1171, @p1172, @p1173, @p1174, @p1175, 20), (@p1176, @p1177, @p1178, @p1179, @p1180, @p1181, @p1182, @p1183, @p1184, @p1185, @p1186, @p1187, @p1188, @p1189, @p1190, @p1191, @p1192, @p1193, @p1194, @p1195, @p1196, @p1197, @p1198, @p1199, @p1200, @p1201, @p1202, @p1203, @p1204, @p1205, @p1206, @p1207, @p1208, @p1209, @p1210, @p1211, @p1212, @p1213, @p1214, @p1215, @p1216, @p1217, @p1218, @p1219, @p1220, @p1221, @p1222, @p1223, @p1224, @p1225, @p1226, @p1227, @p1228, @p1229, @p1230, @p1231, 21), (@p1232, @p1233, @p1234, @p1235, @p1236, @p1237, @p1238, @p1239, @p1240, @p1241, @p1242, @p1243, @p1244, @p1245, @p1246, @p1247, @p1248, @p1249, @p1250, @p1251, @p1252, @p1253, @p1254, @p1255, @p1256, @p1257, @p1258, @p1259, @p1260, @p1261, @p1262, @p1263, @p1264, @p1265, @p1266, @p1267, @p1268, @p1269, @p1270, @p1271, @p1272, @p1273, @p1274, @p1275, @p1276, @p1277, @p1278, @p1279, @p1280, @p1281, @p1282, @p1283, @p1284, @p1285, @p1286, @p1287, 22), (@p1288, @p1289, @p1290, @p1291, @p1292, @p1293, @p1294, @p1295, @p1296, @p1297, @p1298, @p1299, @p1300, @p1301, @p1302, @p1303, @p1304, @p1305, @p1306, @p1307, @p1308, @p1309, @p1310, @p1311, @p1312, @p1313, @p1314, @p1315, @p1316, @p1317, @p1318, @p1319, @p1320, @p1321, @p1322, @p1323, @p1324, @p1325, @p1326, @p1327, @p1328, @p1329, @p1330, @p1331, @p1332, @p1333, @p1334, @p1335, @p1336, @p1337, @p1338, @p1339, @p1340, @p1341, @p1342, @p1343, 23), (@p1344, @p1345, @p1346, @p1347, @p1348, @p1349, @p1350, @p1351, @p1352, @p1353, @p1354, @p1355, @p1356, @p1357, @p1358, @p1359, @p1360, @p1361, @p1362, @p1363, @p1364, @p1365, @p1366, @p1367, @p1368, @p1369, @p1370, @p1371, @p1372, @p1373, @p1374, @p1375, @p1376, @p1377, @p1378, @p1379, @p1380, @p1381, @p1382, @p1383, @p1384, @p1385, @p1386, @p1387, @p1388, @p1389, @p1390, @p1391, @p1392, @p1393, @p1394, @p1395, @p1396, @p1397, @p1398, @p1399, 24), (@p1400, @p1401, @p1402, @p1403, @p1404, @p1405, @p1406, @p1407, @p1408, @p1409, @p1410, @p1411, @p1412, @p1413, @p1414, @p1415, @p1416, @p1417, @p1418, @p1419, @p1420, @p1421, @p1422, @p1423, @p1424, @p1425, @p1426, @p1427, @p1428, @p1429, @p1430, @p1431, @p1432, @p1433, @p1434, @p1435, @p1436, @p1437, @p1438, @p1439, @p1440, @p1441, @p1442, @p1443, @p1444, @p1445, @p1446, @p1447, @p1448, @p1449, @p1450, @p1451, @p1452, @p1453, @p1454, @p1455, 25), (@p1456, @p1457, @p1458, @p1459, @p1460, @p1461, @p1462, @p1463, @p1464, @p1465, @p1466, @p1467, @p1468, @p1469, @p1470, @p1471, @p1472, @p1473, @p1474, @p1475, @p1476, @p1477, @p1478, @p1479, @p1480, @p1481, @p1482, @p1483, @p1484, @p1485, @p1486, @p1487, @p1488, @p1489, @p1490, @p1491, @p1492, @p1493, @p1494, @p1495, @p1496, @p1497, @p1498, @p1499, @p1500, @p1501, @p1502, @p1503, @p1504, @p1505, @p1506, @p1507, @p1508, @p1509, @p1510, @p1511, 26), (@p1512, @p1513, @p1514, @p1515, @p1516, @p1517, @p1518, @p1519, @p1520, @p1521, @p1522, @p1523, @p1524, @p1525, @p1526, @p1527, @p1528, @p1529, @p1530, @p1531, @p1532, @p1533, @p1534, @p1535, @p1536, @p1537, @p1538, @p1539, @p1540, @p1541, @p1542, @p1543, @p1544, @p1545, @p1546, @p1547, @p1548, @p1549, @p1550, @p1551, @p1552, @p1553, @p1554, @p1555, @p1556, @p1557, @p1558, @p1559, @p1560, @p1561, @p1562, @p1563, @p1564, @p1565, @p1566, @p1567, 27), (@p1568, @p1569, @p1570, @p1571, @p1572, @p1573, @p1574, @p1575, @p1576, @p1577, @p1578, @p1579, @p1580, @p1581, @p1582, @p1583, @p1584, @p1585, @p1586, @p1587, @p1588, @p1589, @p1590, @p1591, @p1592, @p1593, @p1594, @p1595, @p1596, @p1597, @p1598, @p1599, @p1600, @p1601, @p1602, @p1603, @p1604, @p1605, @p1606, @p1607, @p1608, @p1609, @p1610, @p1611, @p1612, @p1613, @p1614, @p1615, @p1616, @p1617, @p1618, @p1619, @p1620, @p1621, @p1622, @p1623, 28), (@p1624, @p1625, @p1626, @p1627, @p1628, @p1629, @p1630, @p1631, @p1632, @p1633, @p1634, @p1635, @p1636, @p1637, @p1638, @p1639, @p1640, @p1641, @p1642, @p1643, @p1644, @p1645, @p1646, @p1647, @p1648, @p1649, @p1650, @p1651, @p1652, @p1653, @p1654, @p1655, @p1656, @p1657, @p1658, @p1659, @p1660, @p1661, @p1662, @p1663, @p1664, @p1665, @p1666, @p1667, @p1668, @p1669, @p1670, @p1671, @p1672, @p1673, @p1674, @p1675, @p1676, @p1677, @p1678, @p1679, 29), (@p1680, @p1681, @p1682, @p1683, @p1684, @p1685, @p1686, @p1687, @p1688, @p1689, @p1690, @p1691, @p1692, @p1693, @p1694, @p1695, @p1696, @p1697, @p1698, @p1699, @p1700, @p1701, @p1702, @p1703, @p1704, @p1705, @p1706, @p1707, @p1708, @p1709, @p1710, @p1711, @p1712, @p1713, @p1714, @p1715, @p1716, @p1717, @p1718, @p1719, @p1720, @p1721, @p1722, @p1723, @p1724, @p1725, @p1726, @p1727, @p1728, @p1729, @p1730, @p1731, @p1732, @p1733, @p1734, @p1735, 30), (@p1736, @p1737, @p1738, @p1739, @p1740, @p1741, @p1742, @p1743, @p1744, @p1745, @p1746, @p1747, @p1748, @p1749, @p1750, @p1751, @p1752, @p1753, @p1754, @p1755, @p1756, @p1757, @p1758, @p1759, @p1760, @p1761, @p1762, @p1763, @p1764, @p1765, @p1766, @p1767, @p1768, @p1769, @p1770, @p1771, @p1772, @p1773, @p1774, @p1775, @p1776, @p1777, @p1778, @p1779, @p1780, @p1781, @p1782, @p1783, @p1784, @p1785, @p1786, @p1787, @p1788, @p1789, @p1790, @p1791, 31), (@p1792, @p1793, @p1794, @p1795, @p1796, @p1797, @p1798, @p1799, @p1800, @p1801, @p1802, @p1803, @p1804, @p1805, @p1806, @p1807, @p1808, @p1809, @p1810, @p1811, @p1812, @p1813, @p1814, @p1815, @p1816, @p1817, @p1818, @p1819, @p1820, @p1821, @p1822, @p1823, @p1824, @p1825, @p1826, @p1827, @p1828, @p1829, @p1830, @p1831, @p1832, @p1833, @p1834, @p1835, @p1836, @p1837, @p1838, @p1839, @p1840, @p1841, @p1842, @p1843, @p1844, @p1845, @p1846, @p1847, 32), (@p1848, @p1849, @p1850, @p1851, @p1852, @p1853, @p1854, @p1855, @p1856, @p1857, @p1858, @p1859, @p1860, @p1861, @p1862, @p1863, @p1864, @p1865, @p1866, @p1867, @p1868, @p1869, @p1870, @p1871, @p1872, @p1873, @p1874, @p1875, @p1876, @p1877, @p1878, @p1879, @p1880, @p1881, @p1882, @p1883, @p1884, @p1885, @p1886, @p1887, @p1888, @p1889, @p1890, @p1891, @p1892, @p1893, @p1894, @p1895, @p1896, @p1897, @p1898, @p1899, @p1900, @p1901, @p1902, @p1903, 33), (@p1904, @p1905, @p1906, @p1907, @p1908, @p1909, @p1910, @p1911, @p1912, @p1913, @p1914, @p1915, @p1916, @p1917, @p1918, @p1919, @p1920, @p1921, @p1922, @p1923, @p1924, @p1925, @p1926, @p1927, @p1928, @p1929, @p1930, @p1931, @p1932, @p1933, @p1934, @p1935, @p1936, @p1937, @p1938, @p1939, @p1940, @p1941, @p1942, @p1943, @p1944, @p1945, @p1946, @p1947, @p1948, @p1949, @p1950, @p1951, @p1952, @p1953, @p1954, @p1955, @p1956, @p1957, @p1958, @p1959, 34), (@p1960, @p1961, @p1962, @p1963, @p1964, @p1965, @p1966, @p1967, @p1968, @p1969, @p1970, @p1971, @p1972, @p1973, @p1974, @p1975, @p1976, @p1977, @p1978, @p1979, @p1980, @p1981, @p1982, @p1983, @p1984, @p1985, @p1986, @p1987, @p1988, @p1989, @p1990, @p1991, @p1992, @p1993, @p1994, @p1995, @p1996, @p1997, @p1998, @p1999, @p2000, @p2001, @p2002, @p2003, @p2004, @p2005, @p2006, @p2007, @p2008, @p2009, @p2010, @p2011, @p2012, @p2013, @p2014, @p2015, 35), (@p2016, @p2017, @p2018, @p2019, @p2020, @p2021, @p2022, @p2023, @p2024, @p2025, @p2026, @p2027, @p2028, @p2029, @p2030, @p2031, @p2032, @p2033, @p2034, @p2035, @p2036, @p2037, @p2038, @p2039, @p2040, @p2041, @p2042, @p2043, @p2044, @p2045, @p2046, @p2047, @p2048, @p2049, @p2050, @p2051, @p2052, @p2053, @p2054, @p2055, @p2056, @p2057, @p2058, @p2059, @p2060, @p2061, @p2062, @p2063, @p2064, @p2065, @p2066, @p2067, @p2068, @p2069, @p2070, @p2071, 36)) AS i ([addressee_cntry_cd], [addressee_city], [addressee_district], [addressee_email], [addressee_full_address], [addressee_home_address], [addressee_name], [addressee_postcode], [addressee_province], [addressee_subdistrict], [addressee_tel], [create_table], [delivery_code], [delivery_recipient_name], [delivery_relation_id], [delivery_status_id], [dest_outlet_id], [dest_outlet_port], [document_number], [item_barcode], [item_cod], [item_gross_weight], [item_height], [item_length], [item_price], [item_width], [lat], [log_id], [long], [outlet_id], [outlet_port], [podUrl], [remark], [scan_cntry_cd], [scan_cntry_postcode], [sender_cntry_cd], [sender_district], [sender_email], [sender_full_address], [sender_home_address], [member_id], [sender_name], [sender_postcode], [sender_province], [sender_subdistrict], [sender_tel], [server_id], [signatureUrl], [state], [status_code], [status_dtm], [timestamp], [transmit_dtm], [user_id], [wckt_id], [wkstn_no], _Position) ON 1=0 WHEN NOT MATCHED THEN INSERT ([addressee_cntry_cd], [addressee_city], [addressee_district], [addressee_email], [addressee_full_address], [addressee_home_address], [addressee_name], [addressee_postcode], [addressee_province], [addressee_subdistrict], [addressee_tel], [create_table], [delivery_code], [delivery_recipient_name], [delivery_relation_id], [delivery_status_id], [dest_outlet_id], [dest_outlet_port], [document_number], [item_barcode], [item_cod], [item_gross_weight], [item_height], [item_length], [item_price], [item_width], [lat], [log_id], [long], [outlet_id], [outlet_port], [podUrl], [remark], [scan_cntry_cd], [scan_cntry_postcode], [sender_cntry_cd], [sender_district], [sender_email], [sender_full_address], [sender_home_address], [member_id], [sender_name], [sender_postcode], [sender_province], [sender_subdistrict], [sender_tel], [server_id], [signatureUrl], [state], [status_code], [status_dtm], [timestamp], [transmit_dtm], [user_id], [wckt_id], [wkstn_no]) VALUES (i.[addressee_cntry_cd], i.[addressee_city], i.[addressee_district], i.[addressee_email], i.[addressee_full_address], i.[addressee_home_address], i.[addressee_name], i.[addressee_postcode], i.[addressee_province], i.[addressee_subdistrict], i.[addressee_tel], i.[create_table], i.[delivery_code], i.[delivery_recipient_name], i.[delivery_relation_id], i.[delivery_status_id], i.[dest_outlet_id], i.[dest_outlet_port], i.[document_number], i.[item_barcode], i.[item_cod], i.[item_gross_weight], i.[item_height], i.[item_length], i.[item_price], i.[item_width], i.[lat], i.[log_id], i.[long], i.[outlet_id], i.[outlet_port], i.[podUrl], i.[remark], i.[scan_cntry_cd], i.[scan_cntry_postcode], i.[sender_cntry_cd], i.[sender_district], i.[sender_email], i.[sender_full_address], i.[sender_home_address], i.[member_id], i.[sender_name], i.[sender_postcode], i.[sender_province], i.[sender_subdistrict], i.[sender_tel], i.[server_id], i.[signatureUrl], i.[state], i.[status_code], i.[status_dtm], i.[timestamp], i.[transmit_dtm], i.[user_id], i.[wckt_id], i.[wkstn_no]) OUTPUT INSERTED.[item_id], i._Position INTO @inserted0;  SELECT [t].[item_id] FROM [raw_data] t INNER JOIN @inserted0 i ON ([t].[item_id] = [i].[item_id]) ORDER BY [i].[_Position];  ",4,4,0,442,2,4
"(@p0 nvarchar(4000),@p1 nvarchar(4000),@p2 nvarchar(4000),@p3 nvarchar(4000),@p4 nvarchar(4000),@p5 nvarchar(4000),@p6 nvarchar(4000),@p7 nvarchar(4000),@p8 nvarchar(4000),@p9 nvarchar(4000),@p10 nvarchar(4000),@p11 datetime2(7),@p12 nvarchar(4000),@p13 nvarchar(4000),@p14 int,@p15 int,@p16 int,@p17 nvarchar(4000),@p18 nvarchar(4000),@p19 nvarchar(4000),@p20 decimal(18,2),@p21 decimal(18,2),@p22 nvarchar(4000),@p23 nvarchar(4000),@p24 decimal(18,2),@p25 nvarchar(4000),@p26 nvarchar(4000),@p27 nvarchar(4000),@p28 nvarchar(4000),@p29 int,@p30 nvarchar(4000),@p31 nvarchar(4000),@p32 nvarchar(4000),@p33 nvarchar(4000),@p34 nvarchar(4000),@p35 nvarchar(4000),@p36 nvarchar(4000),@p37 nvarchar(4000),@p38 nvarchar(4000),@p39 nvarchar(4000),@p40 int,@p41 nvarchar(4000),@p42 nvarchar(4000),@p43 nvarchar(4000),@p44 nvarchar(4000),@p45 nvarchar(4000),@p46 int,@p47 nvarchar(4000),@p48 int,@p49 int,@p50 datetime2(7),@p51 datetime2(7),@p52 datetime2(7),@p53 nvarchar(4000),@p54 nvarchar(4000),@p55 nvarchar(4000),@p56 nvarchar(4000),@p57 nvarchar(4000),@p58 nvarchar(4000),@p59 nvarchar(4000),@p60 nvarchar(4000),@p61 nvarchar(4000),@p62 nvarchar(4000),@p63 nvarchar(4000),@p64 nvarchar(4000),@p65 nvarchar(4000),@p66 nvarchar(4000),@p67 datetime2(7),@p68 nvarchar(4000),@p69 nvarchar(4000),@p70 int,@p71 int,@p72 int,@p73 nvarchar(4000),@p74 nvarchar(4000),@p75 nvarchar(4000),@p76 decimal(18,2),@p77 decimal(18,2),@p78 nvarchar(4000),@p79 nvarchar(4000),@p80 decimal(18,2),@p81 nvarchar(4000),@p82 nvarchar(4000),@p83 nvarchar(4000),@p84 nvarchar(4000),@p85 int,@p86 nvarchar(4000),@p87 nvarchar(4000),@p88 nvarchar(4000),@p89 nvarchar(4000),@p90 nvarchar(4000),@p91 nvarchar(4000),@p92 nvarchar(4000),@p93 nvarchar(4000),@p94 nvarchar(4000),@p95 nvarchar(4000),@p96 int,@p97 nvarchar(4000),@p98 nvarchar(4000),@p99 nvarchar(4000),@p100 nvarchar(4000),@p101 nvarchar(4000),@p102 int,@p103 nvarchar(4000),@p104 int,@p105 int,@p106 datetime2(7),@p107 datetime2(7),@p108 datetime2(7),@p109 nvarchar(4000),@p110 nvarchar(4000),@p111 nvarchar(4000),@p112 nvarchar(4000),@p113 nvarchar(4000),@p114 nvarchar(4000),@p115 nvarchar(4000),@p116 nvarchar(4000),@p117 nvarchar(4000),@p118 nvarchar(4000),@p119 nvarchar(4000),@p120 nvarchar(4000),@p121 nvarchar(4000),@p122 nvarchar(4000),@p123 datetime2(7),@p124 nvarchar(4000),@p125 nvarchar(4000),@p126 int,@p127 int,@p128 int,@p129 nvarchar(4000),@p130 nvarchar(4000),@p131 nvarchar(4000),@p132 decimal(18,2),@p133 decimal(18,2),@p134 nvarchar(4000),@p135 nvarchar(4000),@p136 decimal(18,2),@p137 nvarchar(4000),@p138 nvarchar(4000),@p139 nvarchar(4000),@p140 nvarchar(4000),@p141 int,@p142 nvarchar(4000),@p143 nvarchar(4000),@p144 nvarchar(4000),@p145 nvarchar(4000),@p146 nvarchar(4000),@p147 nvarchar(4000),@p148 nvarchar(4000),@p149 nvarchar(4000),@p150 nvarchar(4000),@p151 nvarchar(4000),@p152 int,@p153 nvarchar(4000),@p154 nvarchar(4000),@p155 nvarchar(4000),@p156 nvarchar(4000),@p157 nvarchar(4000),@p158 int,@p159 nvarchar(4000),@p160 int,@p161 int,@p162 datetime2(7),@p163 datetime2(7),@p164 datetime2(7),@p165 nvarchar(4000),@p166 nvarchar(4000),@p167 nvarchar(4000),@p168 nvarchar(4000),@p169 nvarchar(4000),@p170 nvarchar(4000),@p171 nvarchar(4000),@p172 nvarchar(4000),@p173 nvarchar(4000),@p174 nvarchar(4000),@p175 nvarchar(4000),@p176 nvarchar(4000),@p177 nvarchar(4000),@p178 nvarchar(4000),@p179 datetime2(7),@p180 nvarchar(4000),@p181 nvarchar(4000),@p182 int,@p183 int,@p184 int,@p185 nvarchar(4000),@p186 nvarchar(4000),@p187 nvarchar(4000),@p188 nvarchar(4000),@p189 decimal(18,2),@p190 nvarchar(4000),@p191 nvarchar(4000),@p192 decimal(18,2),@p193 nvarchar(4000),@p194 nvarchar(4000),@p195 nvarchar(4000),@p196 nvarchar(4000),@p197 int,@p198 nvarchar(4000),@p199 nvarchar(4000),@p200 nvarchar(4000),@p201 nvarchar(4000),@p202 nvarchar(4000),@p203 nvarchar(4000),@p204 nvarchar(4000),@p205 nvarchar(4000),@p206 nvarchar(4000),@p207 nvarchar(4000),@p208 int,@p209 nvarchar(4000),@p210 nvarchar(4000),@p211 nvarchar(4000),@p212 nvarchar(4000),@p213 nvarchar(4000),@p214 int,@p215 nvarchar(4000),@p216 int,@p217 int,@p218 datetime2(7),@p219 datetime2(7),@p220 datetime2(7),@p221 nvarchar(4000),@p222 nvarchar(4000),@p223 nvarchar(4000),@p224 nvarchar(4000),@p225 nvarchar(4000),@p226 nvarchar(4000),@p227 nvarchar(4000),@p228 nvarchar(4000),@p229 nvarchar(4000),@p230 nvarchar(4000),@p231 nvarchar(4000),@p232 nvarchar(4000),@p233 nvarchar(4000),@p234 nvarchar(4000),@p235 datetime2(7),@p236 nvarchar(4000),@p237 nvarchar(4000),@p238 int,@p239 int,@p240 int,@p241 nvarchar(4000),@p242 nvarchar(4000),@p243 nvarchar(4000),@p244 decimal(18,2),@p245 decimal(18,2),@p246 nvarchar(4000),@p247 nvarchar(4000),@p248 decimal(18,2),@p249 nvarchar(4000),@p250 nvarchar(4000),@p251 nvarchar(4000),@p252 nvarchar(4000),@p253 int,@p254 nvarchar(4000),@p255 nvarchar(4000),@p256 nvarchar(4000),@p257 nvarchar(4000),@p258 nvarchar(4000),@p259 nvarchar(4000),@p260 nvarchar(4000),@p261 nvarchar(4000),@p262 nvarchar(4000),@p263 nvarchar(4000),@p264 int,@p265 nvarchar(4000),@p266 nvarchar(4000),@p267 nvarchar(4000),@p268 nvarchar(4000),@p269 nvarchar(4000),@p270 int,@p271 nvarchar(4000),@p272 int,@p273 int,@p274 datetime2(7),@p275 datetime2(7),@p276 datetime2(7),@p277 nvarchar(4000),@p278 nvarchar(4000),@p279 nvarchar(4000),@p280 nvarchar(4000),@p281 nvarchar(4000),@p282 nvarchar(4000),@p283 nvarchar(4000),@p284 nvarchar(4000),@p285 nvarchar(4000),@p286 nvarchar(4000),@p287 nvarchar(4000),@p288 nvarchar(4000),@p289 nvarchar(4000),@p290 nvarchar(4000),@p291 datetime2(7),@p292 nvarchar(4000),@p293 nvarchar(4000),@p294 int,@p295 int,@p296 int,@p297 nvarchar(4000),@p298 nvarchar(4000),@p299 nvarchar(4000),@p300 decimal(18,2),@p301 decimal(18,2),@p302 nvarchar(4000),@p303 nvarchar(4000),@p304 decimal(18,2),@p305 nvarchar(4000),@p306 nvarchar(4000),@p307 nvarchar(4000),@p308 nvarchar(4000),@p309 int,@p310 nvarchar(4000),@p311 nvarchar(4000),@p312 nvarchar(4000),@p313 nvarchar(4000),@p314 nvarchar(4000),@p315 nvarchar(4000),@p316 nvarchar(4000),@p317 nvarchar(4000),@p318 nvarchar(4000),@p319 nvarchar(4000),@p320 int,@p321 nvarchar(4000),@p322 nvarchar(4000),@p323 nvarchar(4000),@p324 nvarchar(4000),@p325 nvarchar(4000),@p326 int,@p327 nvarchar(4000),@p328 int,@p329 int,@p330 datetime2(7),@p331 datetime2(7),@p332 datetime2(7),@p333 nvarchar(4000),@p334 nvarchar(4000),@p335 nvarchar(4000),@p336 nvarchar(4000),@p337 nvarchar(4000),@p338 nvarchar(4000),@p339 nvarchar(4000),@p340 nvarchar(4000),@p341 nvarchar(4000),@p342 nvarchar(4000),@p343 nvarchar(4000),@p344 nvarchar(4000),@p345 nvarchar(4000),@p346 nvarchar(4000),@p347 datetime2(7),@p348 nvarchar(4000),@p349 nvarchar(4000),@p350 int,@p351 int,@p352 int,@p353 nvarchar(4000),@p354 nvarchar(4000),@p355 nvarchar(4000),@p356 decimal(18,2),@p357 decimal(18,2),@p358 nvarchar(4000),@p359 nvarchar(4000),@p360 decimal(18,2),@p361 nvarchar(4000),@p362 nvarchar(4000),@p363 nvarchar(4000),@p364 nvarchar(4000),@p365 int,@p366 nvarchar(4000),@p367 nvarchar(4000),@p368 nvarchar(4000),@p369 nvarchar(4000),@p370 nvarchar(4000),@p371 nvarchar(4000),@p372 nvarchar(4000),@p373 nvarchar(4000),@p374 nvarchar(4000),@p375 nvarchar(4000),@p376 int,@p377 nvarchar(4000),@p378 nvarchar(4000),@p379 nvarchar(4000),@p380 nvarchar(4000),@p381 nvarchar(4000),@p382 int,@p383 nvarchar(4000),@p384 int,@p385 int,@p386 datetime2(7),@p387 datetime2(7),@p388 datetime2(7),@p389 nvarchar(4000),@p390 nvarchar(4000),@p391 nvarchar(4000),@p392 nvarchar(4000),@p393 nvarchar(4000),@p394 nvarchar(4000),@p395 nvarchar(4000),@p396 nvarchar(4000),@p397 nvarchar(4000),@p398 nvarchar(4000),@p399 nvarchar(4000),@p400 nvarchar(4000),@p401 nvarchar(4000),@p402 nvarchar(4000),@p403 datetime2(7),@p404 nvarchar(4000),@p405 nvarchar(4000),@p406 int,@p407 int,@p408 int,@p409 nvarchar(4000),@p410 nvarchar(4000),@p411 nvarchar(4000),@p412 decimal(18,2),@p413 decimal(18,2),@p414 nvarchar(4000),@p415 nvarchar(4000),@p416 decimal(18,2),@p417 nvarchar(4000),@p418 nvarchar(4000),@p419 nvarchar(4000),@p420 nvarchar(4000),@p421 int,@p422 nvarchar(4000),@p423 nvarchar(4000),@p424 nvarchar(4000),@p425 nvarchar(4000),@p426 nvarchar(4000),@p427 nvarchar(4000),@p428 nvarchar(4000),@p429 nvarchar(4000),@p430 nvarchar(4000),@p431 nvarchar(4000),@p432 int,@p433 nvarchar(4000),@p434 nvarchar(4000),@p435 nvarchar(4000),@p436 nvarchar(4000),@p437 nvarchar(4000),@p438 int,@p439 nvarchar(4000),@p440 int,@p441 int,@p442 datetime2(7),@p443 datetime2(7),@p444 datetime2(7),@p445 nvarchar(4000),@p446 nvarchar(4000),@p447 nvarchar(4000),@p448 nvarchar(4000),@p449 nvarchar(4000),@p450 nvarchar(4000),@p451 nvarchar(4000),@p452 nvarchar(4000),@p453 nvarchar(4000),@p454 nvarchar(4000),@p455 nvarchar(4000),@p456 nvarchar(4000),@p457 nvarchar(4000),@p458 nvarchar(4000),@p459 datetime2(7),@p460 nvarchar(4000),@p461 nvarchar(4000),@p462 int,@p463 int,@p464 int,@p465 nvarchar(4000),@p466 nvarchar(4000),@p467 nvarchar(4000),@p468 decimal(18,2),@p469 decimal(18,2),@p470 nvarchar(4000),@p471 nvarchar(4000),@p472 decimal(18,2),@p473 nvarchar(4000),@p474 nvarchar(4000),@p475 nvarchar(4000),@p476 nvarchar(4000),@p477 int,@p478 nvarchar(4000),@p479 nvarchar(4000),@p480 nvarchar(4000),@p481 nvarchar(4000),@p482 nvarchar(4000),@p483 nvarchar(4000),@p484 nvarchar(4000),@p485 nvarchar(4000),@p486 nvarchar(4000),@p487 nvarchar(4000),@p488 int,@p489 nvarchar(4000),@p490 nvarchar(4000),@p491 nvarchar(4000),@p492 nvarchar(4000),@p493 nvarchar(4000),@p494 int,@p495 nvarchar(4000),@p496 int,@p497 int,@p498 datetime2(7),@p499 datetime2(7),@p500 datetime2(7),@p501 nvarchar(4000),@p502 nvarchar(4000),@p503 nvarchar(4000),@p504 nvarchar(4000),@p505 nvarchar(4000),@p506 nvarchar(4000),@p507 nvarchar(4000),@p508 nvarchar(4000),@p509 nvarchar(4000),@p510 nvarchar(4000),@p511 nvarchar(4000),@p512 nvarchar(4000),@p513 nvarchar(4000),@p514 nvarchar(4000),@p515 datetime2(7),@p516 nvarchar(4000),@p517 nvarchar(4000),@p518 int,@p519 int,@p520 int,@p521 nvarchar(4000),@p522 nvarchar(4000),@p523 nvarchar(4000),@p524 decimal(18,2),@p525 decimal(18,2),@p526 nvarchar(4000),@p527 nvarchar(4000),@p528 decimal(18,2),@p529 nvarchar(4000),@p530 nvarchar(4000),@p531 nvarchar(4000),@p532 nvarchar(4000),@p533 int,@p534 nvarchar(4000),@p535 nvarchar(4000),@p536 nvarchar(4000),@p537 nvarchar(4000),@p538 nvarchar(4000),@p539 nvarchar(4000),@p540 nvarchar(4000),@p541 nvarchar(4000),@p542 nvarchar(4000),@p543 nvarchar(4000),@p544 int,@p545 nvarchar(4000),@p546 nvarchar(4000),@p547 nvarchar(4000),@p548 nvarchar(4000),@p549 nvarchar(4000),@p550 int,@p551 nvarchar(4000),@p552 int,@p553 int,@p554 datetime2(7),@p555 datetime2(7),@p556 datetime2(7),@p557 nvarchar(4000),@p558 nvarchar(4000),@p559 nvarchar(4000),@p560 nvarchar(4000),@p561 nvarchar(4000),@p562 nvarchar(4000),@p563 nvarchar(4000),@p564 nvarchar(4000),@p565 nvarchar(4000),@p566 nvarchar(4000),@p567 nvarchar(4000),@p568 nvarchar(4000),@p569 nvarchar(4000),@p570 nvarchar(4000),@p571 datetime2(7),@p572 nvarchar(4000),@p573 nvarchar(4000),@p574 int,@p575 int,@p576 int,@p577 nvarchar(4000),@p578 nvarchar(4000),@p579 nvarchar(4000),@p580 decimal(18,2),@p581 decimal(18,2),@p582 nvarchar(4000),@p583 nvarchar(4000),@p584 decimal(18,2),@p585 nvarchar(4000),@p586 nvarchar(4000),@p587 nvarchar(4000),@p588 nvarchar(4000),@p589 int,@p590 nvarchar(4000),@p591 nvarchar(4000),@p592 nvarchar(4000),@p593 nvarchar(4000),@p594 nvarchar(4000),@p595 nvarchar(4000),@p596 nvarchar(4000),@p597 nvarchar(4000),@p598 nvarchar(4000),@p599 nvarchar(4000),@p600 int,@p601 nvarchar(4000),@p602 nvarchar(4000),@p603 nvarchar(4000),@p604 nvarchar(4000),@p605 nvarchar(4000),@p606 int,@p607 nvarchar(4000),@p608 int,@p609 int,@p610 datetime2(7),@p611 datetime2(7),@p612 datetime2(7),@p613 nvarchar(4000),@p614 nvarchar(4000),@p615 nvarchar(4000),@p616 nvarchar(4000),@p617 nvarchar(4000),@p618 nvarchar(4000),@p619 nvarchar(4000),@p620 nvarchar(4000),@p621 nvarchar(4000),@p622 nvarchar(4000),@p623 nvarchar(4000),@p624 nvarchar(4000),@p625 nvarchar(4000),@p626 nvarchar(4000),@p627 datetime2(7),@p628 nvarchar(4000),@p629 nvarchar(4000),@p630 int,@p631 int,@p632 int,@p633 nvarchar(4000),@p634 nvarchar(4000),@p635 nvarchar(4000),@p636 decimal(18,2),@p637 decimal(18,2),@p638 nvarchar(4000),@p639 nvarchar(4000),@p640 decimal(18,2),@p641 nvarchar(4000),@p642 nvarchar(4000),@p643 nvarchar(4000),@p644 nvarchar(4000),@p645 int,@p646 nvarchar(4000),@p647 nvarchar(4000),@p648 nvarchar(4000),@p649 nvarchar(4000),@p650 nvarchar(4000),@p651 nvarchar(4000),@p652 nvarchar(4000),@p653 nvarchar(4000),@p654 nvarchar(4000),@p655 nvarchar(4000),@p656 int,@p657 nvarchar(4000),@p658 nvarchar(4000),@p659 nvarchar(4000),@p660 nvarchar(4000),@p661 nvarchar(4000),@p662 int,@p663 nvarchar(4000),@p664 int,@p665 int,@p666 datetime2(7),@p667 datetime2(7),@p668 datetime2(7),@p669 nvarchar(4000),@p670 nvarchar(4000),@p671 nvarchar(4000),@p672 nvarchar(4000),@p673 nvarchar(4000),@p674 nvarchar(4000),@p675 nvarchar(4000),@p676 nvarchar(4000),@p677 nvarchar(4000),@p678 nvarchar(4000),@p679 nvarchar(4000),@p680 nvarchar(4000),@p681 nvarchar(4000),@p682 nvarchar(4000),@p683 datetime2(7),@p684 nvarchar(4000),@p685 nvarchar(4000),@p686 int,@p687 int,@p688 int,@p689 nvarchar(4000),@p690 nvarchar(4000),@p691 nvarchar(4000),@p692 decimal(18,2),@p693 decimal(18,2),@p694 nvarchar(4000),@p695 nvarchar(4000),@p696 decimal(18,2),@p697 nvarchar(4000),@p698 nvarchar(4000),@p699 nvarchar(4000),@p700 nvarchar(4000),@p701 int,@p702 nvarchar(4000),@p703 nvarchar(4000),@p704 nvarchar(4000),@p705 nvarchar(4000),@p706 nvarchar(4000),@p707 nvarchar(4000),@p708 nvarchar(4000),@p709 nvarchar(4000),@p710 nvarchar(4000),@p711 nvarchar(4000),@p712 int,@p713 nvarchar(4000),@p714 nvarchar(4000),@p715 nvarchar(4000),@p716 nvarchar(4000),@p717 nvarchar(4000),@p718 int,@p719 nvarchar(4000),@p720 int,@p721 int,@p722 datetime2(7),@p723 datetime2(7),@p724 datetime2(7),@p725 nvarchar(4000),@p726 nvarchar(4000),@p727 nvarchar(4000),@p728 nvarchar(4000),@p729 nvarchar(4000),@p730 nvarchar(4000),@p731 nvarchar(4000),@p732 nvarchar(4000),@p733 nvarchar(4000),@p734 nvarchar(4000),@p735 nvarchar(4000),@p736 nvarchar(4000),@p737 nvarchar(4000),@p738 nvarchar(4000),@p739 datetime2(7),@p740 nvarchar(4000),@p741 nvarchar(4000),@p742 int,@p743 int,@p744 int,@p745 nvarchar(4000),@p746 nvarchar(4000),@p747 nvarchar(4000),@p748 decimal(18,2),@p749 decimal(18,2),@p750 nvarchar(4000),@p751 nvarchar(4000),@p752 decimal(18,2),@p753 nvarchar(4000),@p754 nvarchar(4000),@p755 nvarchar(4000),@p756 nvarchar(4000),@p757 int,@p758 nvarchar(4000),@p759 nvarchar(4000),@p760 nvarchar(4000),@p761 nvarchar(4000),@p762 nvarchar(4000),@p763 nvarchar(4000),@p764 nvarchar(4000),@p765 nvarchar(4000),@p766 nvarchar(4000),@p767 nvarchar(4000),@p768 int,@p769 nvarchar(4000),@p770 nvarchar(4000),@p771 nvarchar(4000),@p772 nvarchar(4000),@p773 nvarchar(4000),@p774 int,@p775 nvarchar(4000),@p776 int,@p777 int,@p778 datetime2(7),@p779 datetime2(7),@p780 datetime2(7),@p781 nvarchar(4000),@p782 nvarchar(4000),@p783 nvarchar(4000),@p784 nvarchar(4000),@p785 nvarchar(4000),@p786 nvarchar(4000),@p787 nvarchar(4000),@p788 nvarchar(4000),@p789 nvarchar(4000),@p790 nvarchar(4000),@p791 nvarchar(4000),@p792 nvarchar(4000),@p793 nvarchar(4000),@p794 nvarchar(4000),@p795 datetime2(7),@p796 nvarchar(4000),@p797 nvarchar(4000),@p798 int,@p799 int,@p800 int,@p801 nvarchar(4000),@p802 nvarchar(4000),@p803 nvarchar(4000),@p804 decimal(18,2),@p805 decimal(18,2),@p806 nvarchar(4000),@p807 nvarchar(4000),@p808 decimal(18,2),@p809 nvarchar(4000),@p810 nvarchar(4000),@p811 nvarchar(4000),@p812 nvarchar(4000),@p813 int,@p814 nvarchar(4000),@p815 nvarchar(4000),@p816 nvarchar(4000),@p817 nvarchar(4000),@p818 nvarchar(4000),@p819 nvarchar(4000),@p820 nvarchar(4000),@p821 nvarchar(4000),@p822 nvarchar(4000),@p823 nvarchar(4000),@p824 int,@p825 nvarchar(4000),@p826 nvarchar(4000),@p827 nvarchar(4000),@p828 nvarchar(4000),@p829 nvarchar(4000),@p830 int,@p831 nvarchar(4000),@p832 int,@p833 int,@p834 datetime2(7),@p835 datetime2(7),@p836 datetime2(7),@p837 nvarchar(4000),@p838 nvarchar(4000),@p839 nvarchar(4000),@p840 nvarchar(4000),@p841 nvarchar(4000),@p842 nvarchar(4000),@p843 nvarchar(4000),@p844 nvarchar(4000),@p845 nvarchar(4000),@p846 nvarchar(4000),@p847 nvarchar(4000),@p848 nvarchar(4000),@p849 nvarchar(4000),@p850 nvarchar(4000),@p851 datetime2(7),@p852 nvarchar(4000),@p853 nvarchar(4000),@p854 int,@p855 int,@p856 int,@p857 nvarchar(4000),@p858 nvarchar(4000),@p859 nvarchar(4000),@p860 nvarchar(4000),@p861 decimal(18,2),@p862 nvarchar(4000),@p863 nvarchar(4000),@p864 decimal(18,2),@p865 nvarchar(4000),@p866 nvarchar(4000),@p867 nvarchar(4000),@p868 nvarchar(4000),@p869 int,@p870 nvarchar(4000),@p871 nvarchar(4000),@p872 nvarchar(4000),@p873 nvarchar(4000),@p874 nvarchar(4000),@p875 nvarchar(4000),@p876 nvarchar(4000),@p877 nvarchar(4000),@p878 nvarchar(4000),@p879 nvarchar(4000),@p880 int,@p881 nvarchar(4000),@p882 nvarchar(4000),@p883 nvarchar(4000),@p884 nvarchar(4000),@p885 nvarchar(4000),@p886 int,@p887 nvarchar(4000),@p888 int,@p889 int,@p890 datetime2(7),@p891 datetime2(7),@p892 datetime2(7),@p893 nvarchar(4000),@p894 nvarchar(4000),@p895 nvarchar(4000),@p896 nvarchar(4000),@p897 nvarchar(4000),@p898 nvarchar(4000),@p899 nvarchar(4000),@p900 nvarchar(4000),@p901 nvarchar(4000),@p902 nvarchar(4000),@p903 nvarchar(4000),@p904 nvarchar(4000),@p905 nvarchar(4000),@p906 nvarchar(4000),@p907 datetime2(7),@p908 nvarchar(4000),@p909 nvarchar(4000),@p910 int,@p911 int,@p912 int,@p913 nvarchar(4000),@p914 nvarchar(4000),@p915 nvarchar(4000),@p916 decimal(18,2),@p917 decimal(18,2),@p918 nvarchar(4000),@p919 nvarchar(4000),@p920 decimal(18,2),@p921 nvarchar(4000),@p922 nvarchar(4000),@p923 nvarchar(4000),@p924 nvarchar(4000),@p925 int,@p926 nvarchar(4000),@p927 nvarchar(4000),@p928 nvarchar(4000),@p929 nvarchar(4000),@p930 nvarchar(4000),@p931 nvarchar(4000),@p932 nvarchar(4000),@p933 nvarchar(4000),@p934 nvarchar(4000),@p935 nvarchar(4000),@p936 int,@p937 nvarchar(4000),@p938 nvarchar(4000),@p939 nvarchar(4000),@p940 nvarchar(4000),@p941 nvarchar(4000),@p942 int,@p943 nvarchar(4000),@p944 int,@p945 int,@p946 datetime2(7),@p947 datetime2(7),@p948 datetime2(7),@p949 nvarchar(4000),@p950 nvarchar(4000),@p951 nvarchar(4000),@p952 nvarchar(4000),@p953 nvarchar(4000),@p954 nvarchar(4000),@p955 nvarchar(4000),@p956 nvarchar(4000),@p957 nvarchar(4000),@p958 nvarchar(4000),@p959 nvarchar(4000),@p960 nvarchar(4000),@p961 nvarchar(4000),@p962 nvarchar(4000),@p963 datetime2(7),@p964 nvarchar(4000),@p965 nvarchar(4000),@p966 int,@p967 int,@p968 int,@p969 nvarchar(4000),@p970 nvarchar(4000),@p971 nvarchar(4000),@p972 decimal(18,2),@p973 decimal(18,2),@p974 nvarchar(4000),@p975 nvarchar(4000),@p976 decimal(18,2),@p977 nvarchar(4000),@p978 nvarchar(4000),@p979 nvarchar(4000),@p980 nvarchar(4000),@p981 int,@p982 nvarchar(4000),@p983 nvarchar(4000),@p984 nvarchar(4000),@p985 nvarchar(4000),@p986 nvarchar(4000),@p987 nvarchar(4000),@p988 nvarchar(4000),@p989 nvarchar(4000),@p990 nvarchar(4000),@p991 nvarchar(4000),@p992 int,@p993 nvarchar(4000),@p994 nvarchar(4000),@p995 nvarchar(4000),@p996 nvarchar(4000),@p997 nvarchar(4000),@p998 int,@p999 nvarchar(4000),@p1000 int,@p1001 int,@p1002 datetime2(7),@p1003 datetime2(7),@p1004 datetime2(7),@p1005 nvarchar(4000),@p1006 nvarchar(4000),@p1007 nvarchar(4000),@p1008 nvarchar(4000),@p1009 nvarchar(4000),@p1010 nvarchar(4000),@p1011 nvarchar(4000),@p1012 nvarchar(4000),@p1013 nvarchar(4000),@p1014 nvarchar(4000),@p1015 nvarchar(4000),@p1016 nvarchar(4000),@p1017 nvarchar(4000),@p1018 nvarchar(4000),@p1019 datetime2(7),@p1020 nvarchar(4000),@p1021 nvarchar(4000),@p1022 int,@p1023 int,@p1024 int,@p1025 nvarchar(4000),@p1026 nvarchar(4000),@p1027 nvarchar(4000),@p1028 decimal(18,2),@p1029 decimal(18,2),@p1030 nvarchar(4000),@p1031 nvarchar(4000),@p1032 decimal(18,2),@p1033 nvarchar(4000),@p1034 nvarchar(4000),@p1035 nvarchar(4000),@p1036 nvarchar(4000),@p1037 int,@p1038 nvarchar(4000),@p1039 nvarchar(4000),@p1040 nvarchar(4000),@p1041 nvarchar(4000),@p1042 nvarchar(4000),@p1043 nvarchar(4000),@p1044 nvarchar(4000),@p1045 nvarchar(4000),@p1046 nvarchar(4000),@p1047 nvarchar(4000),@p1048 int,@p1049 nvarchar(4000),@p1050 nvarchar(4000),@p1051 nvarchar(4000),@p1052 nvarchar(4000),@p1053 nvarchar(4000),@p1054 int,@p1055 nvarchar(4000),@p1056 int,@p1057 int,@p1058 datetime2(7),@p1059 datetime2(7),@p1060 datetime2(7),@p1061 nvarchar(4000),@p1062 nvarchar(4000),@p1063 nvarchar(4000),@p1064 nvarchar(4000),@p1065 nvarchar(4000),@p1066 nvarchar(4000),@p1067 nvarchar(4000),@p1068 nvarchar(4000),@p1069 nvarchar(4000),@p1070 nvarchar(4000),@p1071 nvarchar(4000),@p1072 nvarchar(4000),@p1073 nvarchar(4000),@p1074 nvarchar(4000),@p1075 datetime2(7),@p1076 nvarchar(4000),@p1077 nvarchar(4000),@p1078 int,@p1079 int,@p1080 int,@p1081 nvarchar(4000),@p1082 nvarchar(4000),@p1083 nvarchar(4000),@p1084 decimal(18,2),@p1085 decimal(18,2),@p1086 nvarchar(4000),@p1087 nvarchar(4000),@p1088 decimal(18,2),@p1089 nvarchar(4000),@p1090 nvarchar(4000),@p1091 nvarchar(4000),@p1092 nvarchar(4000),@p1093 int,@p1094 nvarchar(4000),@p1095 nvarchar(4000),@p1096 nvarchar(4000),@p1097 nvarchar(4000),@p1098 nvarchar(4000),@p1099 nvarchar(4000),@p1100 nvarchar(4000),@p1101 nvarchar(4000),@p1102 nvarchar(4000),@p1103 nvarchar(4000),@p1104 int,@p1105 nvarchar(4000),@p1106 nvarchar(4000),@p1107 nvarchar(4000),@p1108 nvarchar(4000),@p1109 nvarchar(4000),@p1110 int,@p1111 nvarchar(4000),@p1112 int,@p1113 int,@p1114 datetime2(7),@p1115 datetime2(7),@p1116 datetime2(7),@p1117 nvarchar(4000),@p1118 nvarchar(4000),@p1119 nvarchar(4000),@p1120 nvarchar(4000),@p1121 nvarchar(4000),@p1122 nvarchar(4000),@p1123 nvarchar(4000),@p1124 nvarchar(4000),@p1125 nvarchar(4000),@p1126 nvarchar(4000),@p1127 nvarchar(4000),@p1128 nvarchar(4000),@p1129 nvarchar(4000),@p1130 nvarchar(4000),@p1131 datetime2(7),@p1132 nvarchar(4000),@p1133 nvarchar(4000),@p1134 int,@p1135 int,@p1136 int,@p1137 nvarchar(4000),@p1138 nvarchar(4000),@p1139 nvarchar(4000),@p1140 decimal(18,2),@p1141 decimal(18,2),@p1142 nvarchar(4000),@p1143 nvarchar(4000),@p1144 decimal(18,2),@p1145 nvarchar(4000),@p1146 nvarchar(4000),@p1147 nvarchar(4000),@p1148 nvarchar(4000),@p1149 int,@p1150 nvarchar(4000),@p1151 nvarchar(4000),@p1152 nvarchar(4000),@p1153 nvarchar(4000),@p1154 nvarchar(4000),@p1155 nvarchar(4000),@p1156 nvarchar(4000),@p1157 nvarchar(4000),@p1158 nvarchar(4000),@p1159 nvarchar(4000),@p1160 int,@p1161 nvarchar(4000),@p1162 nvarchar(4000),@p1163 nvarchar(4000),@p1164 nvarchar(4000),@p1165 nvarchar(4000),@p1166 int,@p1167 nvarchar(4000),@p1168 int,@p1169 int,@p1170 datetime2(7),@p1171 datetime2(7),@p1172 datetime2(7),@p1173 nvarchar(4000),@p1174 nvarchar(4000),@p1175 nvarchar(4000),@p1176 nvarchar(4000),@p1177 nvarchar(4000),@p1178 nvarchar(4000),@p1179 nvarchar(4000),@p1180 nvarchar(4000),@p1181 nvarchar(4000),@p1182 nvarchar(4000),@p1183 nvarchar(4000),@p1184 nvarchar(4000),@p1185 nvarchar(4000),@p1186 nvarchar(4000),@p1187 datetime2(7),@p1188 nvarchar(4000),@p1189 nvarchar(4000),@p1190 int,@p1191 int,@p1192 int,@p1193 nvarchar(4000),@p1194 nvarchar(4000),@p1195 nvarchar(4000),@p1196 decimal(18,2),@p1197 decimal(18,2),@p1198 nvarchar(4000),@p1199 nvarchar(4000),@p1200 decimal(18,2),@p1201 nvarchar(4000),@p1202 nvarchar(4000),@p1203 nvarchar(4000),@p1204 nvarchar(4000),@p1205 int,@p1206 nvarchar(4000),@p1207 nvarchar(4000),@p1208 nvarchar(4000),@p1209 nvarchar(4000),@p1210 nvarchar(4000),@p1211 nvarchar(4000),@p1212 nvarchar(4000),@p1213 nvarchar(4000),@p1214 nvarchar(4000),@p1215 nvarchar(4000),@p1216 int,@p1217 nvarchar(4000),@p1218 nvarchar(4000),@p1219 nvarchar(4000),@p1220 nvarchar(4000),@p1221 nvarchar(4000),@p1222 int,@p1223 nvarchar(4000),@p1224 int,@p1225 int,@p1226 datetime2(7),@p1227 datetime2(7),@p1228 datetime2(7),@p1229 nvarchar(4000),@p1230 nvarchar(4000),@p1231 nvarchar(4000),@p1232 nvarchar(4000),@p1233 nvarchar(4000),@p1234 nvarchar(4000),@p1235 nvarchar(4000),@p1236 nvarchar(4000),@p1237 nvarchar(4000),@p1238 nvarchar(4000),@p1239 nvarchar(4000),@p1240 nvarchar(4000),@p1241 nvarchar(4000),@p1242 nvarchar(4000),@p1243 datetime2(7),@p1244 nvarchar(4000),@p1245 nvarchar(4000),@p1246 int,@p1247 int,@p1248 int,@p1249 nvarchar(4000),@p1250 nvarchar(4000),@p1251 nvarchar(4000),@p1252 decimal(18,2),@p1253 decimal(18,2),@p1254 nvarchar(4000),@p1255 nvarchar(4000),@p1256 decimal(18,2),@p1257 nvarchar(4000),@p1258 nvarchar(4000),@p1259 nvarchar(4000),@p1260 nvarchar(4000),@p1261 int,@p1262 nvarchar(4000),@p1263 nvarchar(4000),@p1264 nvarchar(4000),@p1265 nvarchar(4000),@p1266 nvarchar(4000),@p1267 nvarchar(4000),@p1268 nvarchar(4000),@p1269 nvarchar(4000),@p1270 nvarchar(4000),@p1271 nvarchar(4000),@p1272 int,@p1273 nvarchar(4000),@p1274 nvarchar(4000),@p1275 nvarchar(4000),@p1276 nvarchar(4000),@p1277 nvarchar(4000),@p1278 int,@p1279 nvarchar(4000),@p1280 int,@p1281 int,@p1282 datetime2(7),@p1283 datetime2(7),@p1284 datetime2(7),@p1285 nvarchar(4000),@p1286 nvarchar(4000),@p1287 nvarchar(4000),@p1288 nvarchar(4000),@p1289 nvarchar(4000),@p1290 nvarchar(4000),@p1291 nvarchar(4000),@p1292 nvarchar(4000),@p1293 nvarchar(4000),@p1294 nvarchar(4000),@p1295 nvarchar(4000),@p1296 nvarchar(4000),@p1297 nvarchar(4000),@p1298 nvarchar(4000),@p1299 datetime2(7),@p1300 nvarchar(4000),@p1301 nvarchar(4000),@p1302 int,@p1303 int,@p1304 int,@p1305 nvarchar(4000),@p1306 nvarchar(4000),@p1307 nvarchar(4000),@p1308 decimal(18,2),@p1309 decimal(18,2),@p1310 nvarchar(4000),@p1311 nvarchar(4000),@p1312 decimal(18,2),@p1313 nvarchar(4000),@p1314 nvarchar(4000),@p1315 nvarchar(4000),@p1316 nvarchar(4000),@p1317 int,@p1318 nvarchar(4000),@p1319 nvarchar(4000),@p1320 nvarchar(4000),@p1321 nvarchar(4000),@p1322 nvarchar(4000),@p1323 nvarchar(4000),@p1324 nvarchar(4000),@p1325 nvarchar(4000),@p1326 nvarchar(4000),@p1327 nvarchar(4000),@p1328 int,@p1329 nvarchar(4000),@p1330 nvarchar(4000),@p1331 nvarchar(4000),@p1332 nvarchar(4000),@p1333 nvarchar(4000),@p1334 int,@p1335 nvarchar(4000),@p1336 int,@p1337 int,@p1338 datetime2(7),@p1339 datetime2(7),@p1340 datetime2(7),@p1341 nvarchar(4000),@p1342 nvarchar(4000),@p1343 nvarchar(4000),@p1344 nvarchar(4000),@p1345 nvarchar(4000),@p1346 nvarchar(4000),@p1347 nvarchar(4000),@p1348 nvarchar(4000),@p1349 nvarchar(4000),@p1350 nvarchar(4000),@p1351 nvarchar(4000),@p1352 nvarchar(4000),@p1353 nvarchar(4000),@p1354 nvarchar(4000),@p1355 datetime2(7),@p1356 nvarchar(4000),@p1357 nvarchar(4000),@p1358 int,@p1359 int,@p1360 int,@p1361 nvarchar(4000),@p1362 nvarchar(4000),@p1363 nvarchar(4000),@p1364 decimal(18,2),@p1365 decimal(18,2),@p1366 nvarchar(4000),@p1367 nvarchar(4000),@p1368 decimal(18,2),@p1369 nvarchar(4000),@p1370 nvarchar(4000),@p1371 nvarchar(4000),@p1372 nvarchar(4000),@p1373 int,@p1374 nvarchar(4000),@p1375 nvarchar(4000),@p1376 nvarchar(4000),@p1377 nvarchar(4000),@p1378 nvarchar(4000),@p1379 nvarchar(4000),@p1380 nvarchar(4000),@p1381 nvarchar(4000),@p1382 nvarchar(4000),@p1383 nvarchar(4000),@p1384 int,@p1385 nvarchar(4000),@p1386 nvarchar(4000),@p1387 nvarchar(4000),@p1388 nvarchar(4000),@p1389 nvarchar(4000),@p1390 int,@p1391 nvarchar(4000),@p1392 int,@p1393 int,@p1394 datetime2(7),@p1395 datetime2(7),@p1396 datetime2(7),@p1397 nvarchar(4000),@p1398 nvarchar(4000),@p1399 nvarchar(4000),@p1400 nvarchar(4000),@p1401 nvarchar(4000),@p1402 nvarchar(4000),@p1403 nvarchar(4000),@p1404 nvarchar(4000),@p1405 nvarchar(4000),@p1406 nvarchar(4000),@p1407 nvarchar(4000),@p1408 nvarchar(4000),@p1409 nvarchar(4000),@p1410 nvarchar(4000),@p1411 datetime2(7),@p1412 nvarchar(4000),@p1413 nvarchar(4000),@p1414 int,@p1415 int,@p1416 int,@p1417 nvarchar(4000),@p1418 nvarchar(4000),@p1419 nvarchar(4000),@p1420 decimal(18,2),@p1421 decimal(18,2),@p1422 nvarchar(4000),@p1423 nvarchar(4000),@p1424 decimal(18,2),@p1425 nvarchar(4000),@p1426 nvarchar(4000),@p1427 nvarchar(4000),@p1428 nvarchar(4000),@p1429 int,@p1430 nvarchar(4000),@p1431 nvarchar(4000),@p1432 nvarchar(4000),@p1433 nvarchar(4000),@p1434 nvarchar(4000),@p1435 nvarchar(4000),@p1436 nvarchar(4000),@p1437 nvarchar(4000),@p1438 nvarchar(4000),@p1439 nvarchar(4000),@p1440 int,@p1441 nvarchar(4000),@p1442 nvarchar(4000),@p1443 nvarchar(4000),@p1444 nvarchar(4000),@p1445 nvarchar(4000),@p1446 int,@p1447 nvarchar(4000),@p1448 int,@p1449 int,@p1450 datetime2(7),@p1451 datetime2(7),@p1452 datetime2(7),@p1453 nvarchar(4000),@p1454 nvarchar(4000),@p1455 nvarchar(4000),@p1456 nvarchar(4000),@p1457 nvarchar(4000),@p1458 nvarchar(4000),@p1459 nvarchar(4000),@p1460 nvarchar(4000),@p1461 nvarchar(4000),@p1462 nvarchar(4000),@p1463 nvarchar(4000),@p1464 nvarchar(4000),@p1465 nvarchar(4000),@p1466 nvarchar(4000),@p1467 datetime2(7),@p1468 nvarchar(4000),@p1469 nvarchar(4000),@p1470 int,@p1471 int,@p1472 int,@p1473 nvarchar(4000),@p1474 nvarchar(4000),@p1475 nvarchar(4000),@p1476 decimal(18,2),@p1477 decimal(18,2),@p1478 nvarchar(4000),@p1479 nvarchar(4000),@p1480 decimal(18,2),@p1481 nvarchar(4000),@p1482 nvarchar(4000),@p1483 nvarchar(4000),@p1484 nvarchar(4000),@p1485 int,@p1486 nvarchar(4000),@p1487 nvarchar(4000),@p1488 nvarchar(4000),@p1489 nvarchar(4000),@p1490 nvarchar(4000),@p1491 nvarchar(4000),@p1492 nvarchar(4000),@p1493 nvarchar(4000),@p1494 nvarchar(4000),@p1495 nvarchar(4000),@p1496 int,@p1497 nvarchar(4000),@p1498 nvarchar(4000),@p1499 nvarchar(4000),@p1500 nvarchar(4000),@p1501 nvarchar(4000),@p1502 int,@p1503 nvarchar(4000),@p1504 int,@p1505 int,@p1506 datetime2(7),@p1507 datetime2(7),@p1508 datetime2(7),@p1509 nvarchar(4000),@p1510 nvarchar(4000),@p1511 nvarchar(4000),@p1512 nvarchar(4000),@p1513 nvarchar(4000),@p1514 nvarchar(4000),@p1515 nvarchar(4000),@p1516 nvarchar(4000),@p1517 nvarchar(4000),@p1518 nvarchar(4000),@p1519 nvarchar(4000),@p1520 nvarchar(4000),@p1521 nvarchar(4000),@p1522 nvarchar(4000),@p1523 datetime2(7),@p1524 nvarchar(4000),@p1525 nvarchar(4000),@p1526 int,@p1527 int,@p1528 int,@p1529 nvarchar(4000),@p1530 nvarchar(4000),@p1531 nvarchar(4000),@p1532 decimal(18,2),@p1533 decimal(18,2),@p1534 nvarchar(4000),@p1535 nvarchar(4000),@p1536 decimal(18,2),@p1537 nvarchar(4000),@p1538 nvarchar(4000),@p1539 nvarchar(4000),@p1540 nvarchar(4000),@p1541 int,@p1542 nvarchar(4000),@p1543 nvarchar(4000),@p1544 nvarchar(4000),@p1545 nvarchar(4000),@p1546 nvarchar(4000),@p1547 nvarchar(4000),@p1548 nvarchar(4000),@p1549 nvarchar(4000),@p1550 nvarchar(4000),@p1551 nvarchar(4000),@p1552 int,@p1553 nvarchar(4000),@p1554 nvarchar(4000),@p1555 nvarchar(4000),@p1556 nvarchar(4000),@p1557 nvarchar(4000),@p1558 int,@p1559 nvarchar(4000),@p1560 int,@p1561 int,@p1562 datetime2(7),@p1563 datetime2(7),@p1564 datetime2(7),@p1565 nvarchar(4000),@p1566 nvarchar(4000),@p1567 nvarchar(4000),@p1568 nvarchar(4000),@p1569 nvarchar(4000),@p1570 nvarchar(4000),@p1571 nvarchar(4000),@p1572 nvarchar(4000),@p1573 nvarchar(4000),@p1574 nvarchar(4000),@p1575 nvarchar(4000),@p1576 nvarchar(4000),@p1577 nvarchar(4000),@p1578 nvarchar(4000),@p1579 datetime2(7),@p1580 nvarchar(4000),@p1581 nvarchar(4000),@p1582 int,@p1583 int,@p1584 int,@p1585 nvarchar(4000),@p1586 nvarchar(4000),@p1587 nvarchar(4000),@p1588 decimal(18,2),@p1589 decimal(18,2),@p1590 nvarchar(4000),@p1591 nvarchar(4000),@p1592 decimal(18,2),@p1593 nvarchar(4000),@p1594 nvarchar(4000),@p1595 nvarchar(4000),@p1596 nvarchar(4000),@p1597 int,@p1598 nvarchar(4000),@p1599 nvarchar(4000),@p1600 nvarchar(4000),@p1601 nvarchar(4000),@p1602 nvarchar(4000),@p1603 nvarchar(4000),@p1604 nvarchar(4000),@p1605 nvarchar(4000),@p1606 nvarchar(4000),@p1607 nvarchar(4000),@p1608 int,@p1609 nvarchar(4000),@p1610 nvarchar(4000),@p1611 nvarchar(4000),@p1612 nvarchar(4000),@p1613 nvarchar(4000),@p1614 int,@p1615 nvarchar(4000),@p1616 int,@p1617 int,@p1618 datetime2(7),@p1619 datetime2(7),@p1620 datetime2(7),@p1621 nvarchar(4000),@p1622 nvarchar(4000),@p1623 nvarchar(4000),@p1624 nvarchar(4000),@p1625 nvarchar(4000),@p1626 nvarchar(4000),@p1627 nvarchar(4000),@p1628 nvarchar(4000),@p1629 nvarchar(4000),@p1630 nvarchar(4000),@p1631 nvarchar(4000),@p1632 nvarchar(4000),@p1633 nvarchar(4000),@p1634 nvarchar(4000),@p1635 datetime2(7),@p1636 nvarchar(4000),@p1637 nvarchar(4000),@p1638 int,@p1639 int,@p1640 int,@p1641 nvarchar(4000),@p1642 nvarchar(4000),@p1643 nvarchar(4000),@p1644 decimal(18,2),@p1645 decimal(18,2),@p1646 nvarchar(4000),@p1647 nvarchar(4000),@p1648 decimal(18,2),@p1649 nvarchar(4000),@p1650 nvarchar(4000),@p1651 nvarchar(4000),@p1652 nvarchar(4000),@p1653 int,@p1654 nvarchar(4000),@p1655 nvarchar(4000),@p1656 nvarchar(4000),@p1657 nvarchar(4000),@p1658 nvarchar(4000),@p1659 nvarchar(4000),@p1660 nvarchar(4000),@p1661 nvarchar(4000),@p1662 nvarchar(4000),@p1663 nvarchar(4000),@p1664 int,@p1665 nvarchar(4000),@p1666 nvarchar(4000),@p1667 nvarchar(4000),@p1668 nvarchar(4000),@p1669 nvarchar(4000),@p1670 int,@p1671 nvarchar(4000),@p1672 int,@p1673 int,@p1674 datetime2(7),@p1675 datetime2(7),@p1676 datetime2(7),@p1677 nvarchar(4000),@p1678 nvarchar(4000),@p1679 nvarchar(4000),@p1680 nvarchar(4000),@p1681 nvarchar(4000),@p1682 nvarchar(4000),@p1683 nvarchar(4000),@p1684 nvarchar(4000),@p1685 nvarchar(4000),@p1686 nvarchar(4000),@p1687 nvarchar(4000),@p1688 nvarchar(4000),@p1689 nvarchar(4000),@p1690 nvarchar(4000),@p1691 datetime2(7),@p1692 nvarchar(4000),@p1693 nvarchar(4000),@p1694 int,@p1695 int,@p1696 int,@p1697 nvarchar(4000),@p1698 nvarchar(4000),@p1699 nvarchar(4000),@p1700 decimal(18,2),@p1701 decimal(18,2),@p1702 nvarchar(4000),@p1703 nvarchar(4000),@p1704 decimal(18,2),@p1705 nvarchar(4000),@p1706 nvarchar(4000),@p1707 nvarchar(4000),@p1708 nvarchar(4000),@p1709 int,@p1710 nvarchar(4000),@p1711 nvarchar(4000),@p1712 nvarchar(4000),@p1713 nvarchar(4000),@p1714 nvarchar(4000),@p1715 nvarchar(4000),@p1716 nvarchar(4000),@p1717 nvarchar(4000),@p1718 nvarchar(4000),@p1719 nvarchar(4000),@p1720 int,@p1721 nvarchar(4000),@p1722 nvarchar(4000),@p1723 nvarchar(4000),@p1724 nvarchar(4000),@p1725 nvarchar(4000),@p1726 int,@p1727 nvarchar(4000),@p1728 int,@p1729 int,@p1730 datetime2(7),@p1731 datetime2(7),@p1732 datetime2(7),@p1733 nvarchar(4000),@p1734 nvarchar(4000),@p1735 nvarchar(4000),@p1736 nvarchar(4000),@p1737 nvarchar(4000),@p1738 nvarchar(4000),@p1739 nvarchar(4000),@p1740 nvarchar(4000),@p1741 nvarchar(4000),@p1742 nvarchar(4000),@p1743 nvarchar(4000),@p1744 nvarchar(4000),@p1745 nvarchar(4000),@p1746 nvarchar(4000),@p1747 datetime2(7),@p1748 nvarchar(4000),@p1749 nvarchar(4000),@p1750 int,@p1751 int,@p1752 int,@p1753 nvarchar(4000),@p1754 nvarchar(4000),@p1755 nvarchar(4000),@p1756 decimal(18,2),@p1757 decimal(18,2),@p1758 nvarchar(4000),@p1759 nvarchar(4000),@p1760 decimal(18,2),@p1761 nvarchar(4000),@p1762 nvarchar(4000),@p1763 nvarchar(4000),@p1764 nvarchar(4000),@p1765 int,@p1766 nvarchar(4000),@p1767 nvarchar(4000),@p1768 nvarchar(4000),@p1769 nvarchar(4000),@p1770 nvarchar(4000),@p1771 nvarchar(4000),@p1772 nvarchar(4000),@p1773 nvarchar(4000),@p1774 nvarchar(4000),@p1775 nvarchar(4000),@p1776 int,@p1777 nvarchar(4000),@p1778 nvarchar(4000),@p1779 nvarchar(4000),@p1780 nvarchar(4000),@p1781 nvarchar(4000),@p1782 int,@p1783 nvarchar(4000),@p1784 int,@p1785 int,@p1786 datetime2(7),@p1787 datetime2(7),@p1788 datetime2(7),@p1789 nvarchar(4000),@p1790 nvarchar(4000),@p1791 nvarchar(4000),@p1792 nvarchar(4000),@p1793 nvarchar(4000),@p1794 nvarchar(4000),@p1795 nvarchar(4000),@p1796 nvarchar(4000),@p1797 nvarchar(4000),@p1798 nvarchar(4000),@p1799 nvarchar(4000),@p1800 nvarchar(4000),@p1801 nvarchar(4000),@p1802 nvarchar(4000),@p1803 datetime2(7),@p1804 nvarchar(4000),@p1805 nvarchar(4000),@p1806 int,@p1807 int,@p1808 int,@p1809 nvarchar(4000),@p1810 nvarchar(4000),@p1811 nvarchar(4000),@p1812 decimal(18,2),@p1813 decimal(18,2),@p1814 nvarchar(4000),@p1815 nvarchar(4000),@p1816 decimal(18,2),@p1817 nvarchar(4000),@p1818 nvarchar(4000),@p1819 nvarchar(4000),@p1820 nvarchar(4000),@p1821 int,@p1822 nvarchar(4000),@p1823 nvarchar(4000),@p1824 nvarchar(4000),@p1825 nvarchar(4000),@p1826 nvarchar(4000),@p1827 nvarchar(4000),@p1828 nvarchar(4000),@p1829 nvarchar(4000),@p1830 nvarchar(4000),@p1831 nvarchar(4000),@p1832 int,@p1833 nvarchar(4000),@p1834 nvarchar(4000),@p1835 nvarchar(4000),@p1836 nvarchar(4000),@p1837 nvarchar(4000),@p1838 int,@p1839 nvarchar(4000),@p1840 int,@p1841 int,@p1842 datetime2(7),@p1843 datetime2(7),@p1844 datetime2(7),@p1845 nvarchar(4000),@p1846 nvarchar(4000),@p1847 nvarchar(4000),@p1848 nvarchar(4000),@p1849 nvarchar(4000),@p1850 nvarchar(4000),@p1851 nvarchar(4000),@p1852 nvarchar(4000),@p1853 nvarchar(4000),@p1854 nvarchar(4000),@p1855 nvarchar(4000),@p1856 nvarchar(4000),@p1857 nvarchar(4000),@p1858 nvarchar(4000),@p1859 datetime2(7),@p1860 nvarchar(4000),@p1861 nvarchar(4000),@p1862 int,@p1863 int,@p1864 int,@p1865 nvarchar(4000),@p1866 nvarchar(4000),@p1867 nvarchar(4000),@p1868 decimal(18,2),@p1869 decimal(18,2),@p1870 nvarchar(4000),@p1871 nvarchar(4000),@p1872 decimal(18,2),@p1873 nvarchar(4000),@p1874 nvarchar(4000),@p1875 nvarchar(4000),@p1876 nvarchar(4000),@p1877 int,@p1878 nvarchar(4000),@p1879 nvarchar(4000),@p1880 nvarchar(4000),@p1881 nvarchar(4000),@p1882 nvarchar(4000),@p1883 nvarchar(4000),@p1884 nvarchar(4000),@p1885 nvarchar(4000),@p1886 nvarchar(4000),@p1887 nvarchar(4000),@p1888 int,@p1889 nvarchar(4000),@p1890 nvarchar(4000),@p1891 nvarchar(4000),@p1892 nvarchar(4000),@p1893 nvarchar(4000),@p1894 int,@p1895 nvarchar(4000),@p1896 int,@p1897 int,@p1898 datetime2(7),@p1899 datetime2(7),@p1900 datetime2(7),@p1901 nvarchar(4000),@p1902 nvarchar(4000),@p1903 nvarchar(4000),@p1904 nvarchar(4000),@p1905 nvarchar(4000),@p1906 nvarchar(4000),@p1907 nvarchar(4000),@p1908 nvarchar(4000),@p1909 nvarchar(4000),@p1910 nvarchar(4000),@p1911 nvarchar(4000),@p1912 nvarchar(4000),@p1913 nvarchar(4000),@p1914 nvarchar(4000),@p1915 datetime2(7),@p1916 nvarchar(4000),@p1917 nvarchar(4000),@p1918 int,@p1919 int,@p1920 int,@p1921 nvarchar(4000),@p1922 nvarchar(4000),@p1923 nvarchar(4000),@p1924 decimal(18,2),@p1925 decimal(18,2),@p1926 nvarchar(4000),@p1927 nvarchar(4000),@p1928 decimal(18,2),@p1929 nvarchar(4000),@p1930 nvarchar(4000),@p1931 nvarchar(4000),@p1932 nvarchar(4000),@p1933 int,@p1934 nvarchar(4000),@p1935 nvarchar(4000),@p1936 nvarchar(4000),@p1937 nvarchar(4000),@p1938 nvarchar(4000),@p1939 nvarchar(4000),@p1940 nvarchar(4000),@p1941 nvarchar(4000),@p1942 nvarchar(4000),@p1943 nvarchar(4000),@p1944 int,@p1945 nvarchar(4000),@p1946 nvarchar(4000),@p1947 nvarchar(4000),@p1948 nvarchar(4000),@p1949 nvarchar(4000),@p1950 int,@p1951 nvarchar(4000),@p1952 int,@p1953 int,@p1954 datetime2(7),@p1955 datetime2(7),@p1956 datetime2(7),@p1957 nvarchar(4000),@p1958 nvarchar(4000),@p1959 nvarchar(4000),@p1960 nvarchar(4000),@p1961 nvarchar(4000),@p1962 nvarchar(4000),@p1963 nvarchar(4000),@p1964 nvarchar(4000),@p1965 nvarchar(4000),@p1966 nvarchar(4000),@p1967 nvarchar(4000),@p1968 nvarchar(4000),@p1969 nvarchar(4000),@p1970 nvarchar(4000),@p1971 datetime2(7),@p1972 nvarchar(4000),@p1973 nvarchar(4000),@p1974 int,@p1975 int,@p1976 int,@p1977 nvarchar(4000),@p1978 nvarchar(4000),@p1979 nvarchar(4000),@p1980 decimal(18,2),@p1981 decimal(18,2),@p1982 nvarchar(4000),@p1983 nvarchar(4000),@p1984 decimal(18,2),@p1985 nvarchar(4000),@p1986 nvarchar(4000),@p1987 nvarchar(4000),@p1988 nvarchar(4000),@p1989 int,@p1990 nvarchar(4000),@p1991 nvarchar(4000),@p1992 nvarchar(4000),@p1993 nvarchar(4000),@p1994 nvarchar(4000),@p1995 nvarchar(4000),@p1996 nvarchar(4000),@p1997 nvarchar(4000),@p1998 nvarchar(4000),@p1999 nvarchar(4000),@p2000 int,@p2001 nvarchar(4000),@p2002 nvarchar(4000),@p2003 nvarchar(4000),@p2004 nvarchar(4000),@p2005 nvarchar(4000),@p2006 int,@p2007 nvarchar(4000),@p2008 int,@p2009 int,@p2010 datetime2(7),@p2011 datetime2(7),@p2012 datetime2(7),@p2013 nvarchar(4000),@p2014 nvarchar(4000),@p2015 nvarchar(4000),@p2016 nvarchar(4000),@p2017 nvarchar(4000),@p2018 nvarchar(4000),@p2019 nvarchar(4000),@p2020 nvarchar(4000),@p2021 nvarchar(4000),@p2022 nvarchar(4000),@p2023 nvarchar(4000),@p2024 nvarchar(4000),@p2025 nvarchar(4000),@p2026 nvarchar(4000),@p2027 datetime2(7),@p2028 nvarchar(4000),@p2029 nvarchar(4000),@p2030 int,@p2031 int,@p2032 int,@p2033 nvarchar(4000),@p2034 nvarchar(4000),@p2035 nvarchar(4000),@p2036 decimal(18,2),@p2037 decimal(18,2),@p2038 nvarchar(4000),@p2039 nvarchar(4000),@p2040 decimal(18,2),@p2041 nvarchar(4000),@p2042 nvarchar(4000),@p2043 nvarchar(4000),@p2044 nvarchar(4000),@p2045 int,@p2046 nvarchar(4000),@p2047 nvarchar(4000),@p2048 nvarchar(4000),@p2049 nvarchar(4000),@p2050 nvarchar(4000),@p2051 nvarchar(4000),@p2052 nvarchar(4000),@p2053 nvarchar(4000),@p2054 nvarchar(4000),@p2055 nvarchar(4000),@p2056 int,@p2057 nvarchar(4000),@p2058 nvarchar(4000),@p2059 nvarchar(4000),@p2060 nvarchar(4000),@p2061 nvarchar(4000),@p2062 int,@p2063 nvarchar(4000),@p2064 int,@p2065 int,@p2066 datetime2(7),@p2067 datetime2(7),@p2068 datetime2(7),@p2069 nvarchar(4000),@p2070 nvarchar(4000),@p2071 nvarchar(4000))SET NOCOUNT ON; DECLARE @inserted0 TABLE ([item_id] int, [_Position] [int]); MERGE [raw_data] USING ( VALUES (@p0, @p1, @p2, @p3, @p4, @p5, @p6, @p7, @p8, @p9, @p10, @p11, @p12, @p13, @p14, @p15, @p16, @p17, @p18, @p19, @p20, @p21, @p22, @p23, @p24, @p25, @p26, @p27, @p28, @p29, @p30, @p31, @p32, @p33, @p34, @p35, @p36, @p37, @p38, @p39, @p40, @p41, @p42, @p43, @p44, @p45, @p46, @p47, @p48, @p49, @p50, @p51, @p52, @p53, @p54, @p55, 0), (@p56, @p57, @p58, @p59, @p60, @p61, @p62, @p63, @p64, @p65, @p66, @p67, @p68, @p69, @p70, @p71, @p72, @p73, @p74, @p75, @p76, @p77, @p78, @p79, @p80, @p81, @p82, @p83, @p84, @p85, @p86, @p87, @p88, @p89, @p90, @p91, @p92, @p93, @p94, @p95, @p96, @p97, @p98, @p99, @p100, @p101, @p102, @p103, @p104, @p105, @p106, @p107, @p108, @p109, @p110, @p111, 1), (@p112, @p113, @p114, @p115, @p116, @p117, @p118, @p119, @p120, @p121, @p122, @p123, @p124, @p125, @p126, @p127, @p128, @p129, @p130, @p131, @p132, @p133, @p134, @p135, @p136, @p137, @p138, @p139, @p140, @p141, @p142, @p143, @p144, @p145, @p146, @p147, @p148, @p149, @p150, @p151, @p152, @p153, @p154, @p155, @p156, @p157, @p158, @p159, @p160, @p161, @p162, @p163, @p164, @p165, @p166, @p167, 2), (@p168, @p169, @p170, @p171, @p172, @p173, @p174, @p175, @p176, @p177, @p178, @p179, @p180, @p181, @p182, @p183, @p184, @p185, @p186, @p187, @p188, @p189, @p190, @p191, @p192, @p193, @p194, @p195, @p196, @p197, @p198, @p199, @p200, @p201, @p202, @p203, @p204, @p205, @p206, @p207, @p208, @p209, @p210, @p211, @p212, @p213, @p214, @p215, @p216, @p217, @p218, @p219, @p220, @p221, @p222, @p223, 3), (@p224, @p225, @p226, @p227, @p228, @p229, @p230, @p231, @p232, @p233, @p234, @p235, @p236, @p237, @p238, @p239, @p240, @p241, @p242, @p243, @p244, @p245, @p246, @p247, @p248, @p249, @p250, @p251, @p252, @p253, @p254, @p255, @p256, @p257, @p258, @p259, @p260, @p261, @p262, @p263, @p264, @p265, @p266, @p267, @p268, @p269, @p270, @p271, @p272, @p273, @p274, @p275, @p276, @p277, @p278, @p279, 4), (@p280, @p281, @p282, @p283, @p284, @p285, @p286, @p287, @p288, @p289, @p290, @p291, @p292, @p293, @p294, @p295, @p296, @p297, @p298, @p299, @p300, @p301, @p302, @p303, @p304, @p305, @p306, @p307, @p308, @p309, @p310, @p311, @p312, @p313, @p314, @p315, @p316, @p317, @p318, @p319, @p320, @p321, @p322, @p323, @p324, @p325, @p326, @p327, @p328, @p329, @p330, @p331, @p332, @p333, @p334, @p335, 5), (@p336, @p337, @p338, @p339, @p340, @p341, @p342, @p343, @p344, @p345, @p346, @p347, @p348, @p349, @p350, @p351, @p352, @p353, @p354, @p355, @p356, @p357, @p358, @p359, @p360, @p361, @p362, @p363, @p364, @p365, @p366, @p367, @p368, @p369, @p370, @p371, @p372, @p373, @p374, @p375, @p376, @p377, @p378, @p379, @p380, @p381, @p382, @p383, @p384, @p385, @p386, @p387, @p388, @p389, @p390, @p391, 6), (@p392, @p393, @p394, @p395, @p396, @p397, @p398, @p399, @p400, @p401, @p402, @p403, @p404, @p405, @p406, @p407, @p408, @p409, @p410, @p411, @p412, @p413, @p414, @p415, @p416, @p417, @p418, @p419, @p420, @p421, @p422, @p423, @p424, @p425, @p426, @p427, @p428, @p429, @p430, @p431, @p432, @p433, @p434, @p435, @p436, @p437, @p438, @p439, @p440, @p441, @p442, @p443, @p444, @p445, @p446, @p447, 7), (@p448, @p449, @p450, @p451, @p452, @p453, @p454, @p455, @p456, @p457, @p458, @p459, @p460, @p461, @p462, @p463, @p464, @p465, @p466, @p467, @p468, @p469, @p470, @p471, @p472, @p473, @p474, @p475, @p476, @p477, @p478, @p479, @p480, @p481, @p482, @p483, @p484, @p485, @p486, @p487, @p488, @p489, @p490, @p491, @p492, @p493, @p494, @p495, @p496, @p497, @p498, @p499, @p500, @p501, @p502, @p503, 8), (@p504, @p505, @p506, @p507, @p508, @p509, @p510, @p511, @p512, @p513, @p514, @p515, @p516, @p517, @p518, @p519, @p520, @p521, @p522, @p523, @p524, @p525, @p526, @p527, @p528, @p529, @p530, @p531, @p532, @p533, @p534, @p535, @p536, @p537, @p538, @p539, @p540, @p541, @p542, @p543, @p544, @p545, @p546, @p547, @p548, @p549, @p550, @p551, @p552, @p553, @p554, @p555, @p556, @p557, @p558, @p559, 9), (@p560, @p561, @p562, @p563, @p564, @p565, @p566, @p567, @p568, @p569, @p570, @p571, @p572, @p573, @p574, @p575, @p576, @p577, @p578, @p579, @p580, @p581, @p582, @p583, @p584, @p585, @p586, @p587, @p588, @p589, @p590, @p591, @p592, @p593, @p594, @p595, @p596, @p597, @p598, @p599, @p600, @p601, @p602, @p603, @p604, @p605, @p606, @p607, @p608, @p609, @p610, @p611, @p612, @p613, @p614, @p615, 10), (@p616, @p617, @p618, @p619, @p620, @p621, @p622, @p623, @p624, @p625, @p626, @p627, @p628, @p629, @p630, @p631, @p632, @p633, @p634, @p635, @p636, @p637, @p638, @p639, @p640, @p641, @p642, @p643, @p644, @p645, @p646, @p647, @p648, @p649, @p650, @p651, @p652, @p653, @p654, @p655, @p656, @p657, @p658, @p659, @p660, @p661, @p662, @p663, @p664, @p665, @p666, @p667, @p668, @p669, @p670, @p671, 11), (@p672, @p673, @p674, @p675, @p676, @p677, @p678, @p679, @p680, @p681, @p682, @p683, @p684, @p685, @p686, @p687, @p688, @p689, @p690, @p691, @p692, @p693, @p694, @p695, @p696, @p697, @p698, @p699, @p700, @p701, @p702, @p703, @p704, @p705, @p706, @p707, @p708, @p709, @p710, @p711, @p712, @p713, @p714, @p715, @p716, @p717, @p718, @p719, @p720, @p721, @p722, @p723, @p724, @p725, @p726, @p727, 12), (@p728, @p729, @p730, @p731, @p732, @p733, @p734, @p735, @p736, @p737, @p738, @p739, @p740, @p741, @p742, @p743, @p744, @p745, @p746, @p747, @p748, @p749, @p750, @p751, @p752, @p753, @p754, @p755, @p756, @p757, @p758, @p759, @p760, @p761, @p762, @p763, @p764, @p765, @p766, @p767, @p768, @p769, @p770, @p771, @p772, @p773, @p774, @p775, @p776, @p777, @p778, @p779, @p780, @p781, @p782, @p783, 13), (@p784, @p785, @p786, @p787, @p788, @p789, @p790, @p791, @p792, @p793, @p794, @p795, @p796, @p797, @p798, @p799, @p800, @p801, @p802, @p803, @p804, @p805, @p806, @p807, @p808, @p809, @p810, @p811, @p812, @p813, @p814, @p815, @p816, @p817, @p818, @p819, @p820, @p821, @p822, @p823, @p824, @p825, @p826, @p827, @p828, @p829, @p830, @p831, @p832, @p833, @p834, @p835, @p836, @p837, @p838, @p839, 14), (@p840, @p841, @p842, @p843, @p844, @p845, @p846, @p847, @p848, @p849, @p850, @p851, @p852, @p853, @p854, @p855, @p856, @p857, @p858, @p859, @p860, @p861, @p862, @p863, @p864, @p865, @p866, @p867, @p868, @p869, @p870, @p871, @p872, @p873, @p874, @p875, @p876, @p877, @p878, @p879, @p880, @p881, @p882, @p883, @p884, @p885, @p886, @p887, @p888, @p889, @p890, @p891, @p892, @p893, @p894, @p895, 15), (@p896, @p897, @p898, @p899, @p900, @p901, @p902, @p903, @p904, @p905, @p906, @p907, @p908, @p909, @p910, @p911, @p912, @p913, @p914, @p915, @p916, @p917, @p918, @p919, @p920, @p921, @p922, @p923, @p924, @p925, @p926, @p927, @p928, @p929, @p930, @p931, @p932, @p933, @p934, @p935, @p936, @p937, @p938, @p939, @p940, @p941, @p942, @p943, @p944, @p945, @p946, @p947, @p948, @p949, @p950, @p951, 16), (@p952, @p953, @p954, @p955, @p956, @p957, @p958, @p959, @p960, @p961, @p962, @p963, @p964, @p965, @p966, @p967, @p968, @p969, @p970, @p971, @p972, @p973, @p974, @p975, @p976, @p977, @p978, @p979, @p980, @p981, @p982, @p983, @p984, @p985, @p986, @p987, @p988, @p989, @p990, @p991, @p992, @p993, @p994, @p995, @p996, @p997, @p998, @p999, @p1000, @p1001, @p1002, @p1003, @p1004, @p1005, @p1006, @p1007, 17), (@p1008, @p1009, @p1010, @p1011, @p1012, @p1013, @p1014, @p1015, @p1016, @p1017, @p1018, @p1019, @p1020, @p1021, @p1022, @p1023, @p1024, @p1025, @p1026, @p1027, @p1028, @p1029, @p1030, @p1031, @p1032, @p1033, @p1034, @p1035, @p1036, @p1037, @p1038, @p1039, @p1040, @p1041, @p1042, @p1043, @p1044, @p1045, @p1046, @p1047, @p1048, @p1049, @p1050, @p1051, @p1052, @p1053, @p1054, @p1055, @p1056, @p1057, @p1058, @p1059, @p1060, @p1061, @p1062, @p1063, 18), (@p1064, @p1065, @p1066, @p1067, @p1068, @p1069, @p1070, @p1071, @p1072, @p1073, @p1074, @p1075, @p1076, @p1077, @p1078, @p1079, @p1080, @p1081, @p1082, @p1083, @p1084, @p1085, @p1086, @p1087, @p1088, @p1089, @p1090, @p1091, @p1092, @p1093, @p1094, @p1095, @p1096, @p1097, @p1098, @p1099, @p1100, @p1101, @p1102, @p1103, @p1104, @p1105, @p1106, @p1107, @p1108, @p1109, @p1110, @p1111, @p1112, @p1113, @p1114, @p1115, @p1116, @p1117, @p1118, @p1119, 19), (@p1120, @p1121, @p1122, @p1123, @p1124, @p1125, @p1126, @p1127, @p1128, @p1129, @p1130, @p1131, @p1132, @p1133, @p1134, @p1135, @p1136, @p1137, @p1138, @p1139, @p1140, @p1141, @p1142, @p1143, @p1144, @p1145, @p1146, @p1147, @p1148, @p1149, @p1150, @p1151, @p1152, @p1153, @p1154, @p1155, @p1156, @p1157, @p1158, @p1159, @p1160, @p1161, @p1162, @p1163, @p1164, @p1165, @p1166, @p1167, @p1168, @p1169, @p1170, @p1171, @p1172, @p1173, @p1174, @p1175, 20), (@p1176, @p1177, @p1178, @p1179, @p1180, @p1181, @p1182, @p1183, @p1184, @p1185, @p1186, @p1187, @p1188, @p1189, @p1190, @p1191, @p1192, @p1193, @p1194, @p1195, @p1196, @p1197, @p1198, @p1199, @p1200, @p1201, @p1202, @p1203, @p1204, @p1205, @p1206, @p1207, @p1208, @p1209, @p1210, @p1211, @p1212, @p1213, @p1214, @p1215, @p1216, @p1217, @p1218, @p1219, @p1220, @p1221, @p1222, @p1223, @p1224, @p1225, @p1226, @p1227, @p1228, @p1229, @p1230, @p1231, 21), (@p1232, @p1233, @p1234, @p1235, @p1236, @p1237, @p1238, @p1239, @p1240, @p1241, @p1242, @p1243, @p1244, @p1245, @p1246, @p1247, @p1248, @p1249, @p1250, @p1251, @p1252, @p1253, @p1254, @p1255, @p1256, @p1257, @p1258, @p1259, @p1260, @p1261, @p1262, @p1263, @p1264, @p1265, @p1266, @p1267, @p1268, @p1269, @p1270, @p1271, @p1272, @p1273, @p1274, @p1275, @p1276, @p1277, @p1278, @p1279, @p1280, @p1281, @p1282, @p1283, @p1284, @p1285, @p1286, @p1287, 22), (@p1288, @p1289, @p1290, @p1291, @p1292, @p1293, @p1294, @p1295, @p1296, @p1297, @p1298, @p1299, @p1300, @p1301, @p1302, @p1303, @p1304, @p1305, @p1306, @p1307, @p1308, @p1309, @p1310, @p1311, @p1312, @p1313, @p1314, @p1315, @p1316, @p1317, @p1318, @p1319, @p1320, @p1321, @p1322, @p1323, @p1324, @p1325, @p1326, @p1327, @p1328, @p1329, @p1330, @p1331, @p1332, @p1333, @p1334, @p1335, @p1336, @p1337, @p1338, @p1339, @p1340, @p1341, @p1342, @p1343, 23), (@p1344, @p1345, @p1346, @p1347, @p1348, @p1349, @p1350, @p1351, @p1352, @p1353, @p1354, @p1355, @p1356, @p1357, @p1358, @p1359, @p1360, @p1361, @p1362, @p1363, @p1364, @p1365, @p1366, @p1367, @p1368, @p1369, @p1370, @p1371, @p1372, @p1373, @p1374, @p1375, @p1376, @p1377, @p1378, @p1379, @p1380, @p1381, @p1382, @p1383, @p1384, @p1385, @p1386, @p1387, @p1388, @p1389, @p1390, @p1391, @p1392, @p1393, @p1394, @p1395, @p1396, @p1397, @p1398, @p1399, 24), (@p1400, @p1401, @p1402, @p1403, @p1404, @p1405, @p1406, @p1407, @p1408, @p1409, @p1410, @p1411, @p1412, @p1413, @p1414, @p1415, @p1416, @p1417, @p1418, @p1419, @p1420, @p1421, @p1422, @p1423, @p1424, @p1425, @p1426, @p1427, @p1428, @p1429, @p1430, @p1431, @p1432, @p1433, @p1434, @p1435, @p1436, @p1437, @p1438, @p1439, @p1440, @p1441, @p1442, @p1443, @p1444, @p1445, @p1446, @p1447, @p1448, @p1449, @p1450, @p1451, @p1452, @p1453, @p1454, @p1455, 25), (@p1456, @p1457, @p1458, @p1459, @p1460, @p1461, @p1462, @p1463, @p1464, @p1465, @p1466, @p1467, @p1468, @p1469, @p1470, @p1471, @p1472, @p1473, @p1474, @p1475, @p1476, @p1477, @p1478, @p1479, @p1480, @p1481, @p1482, @p1483, @p1484, @p1485, @p1486, @p1487, @p1488, @p1489, @p1490, @p1491, @p1492, @p1493, @p1494, @p1495, @p1496, @p1497, @p1498, @p1499, @p1500, @p1501, @p1502, @p1503, @p1504, @p1505, @p1506, @p1507, @p1508, @p1509, @p1510, @p1511, 26), (@p1512, @p1513, @p1514, @p1515, @p1516, @p1517, @p1518, @p1519, @p1520, @p1521, @p1522, @p1523, @p1524, @p1525, @p1526, @p1527, @p1528, @p1529, @p1530, @p1531, @p1532, @p1533, @p1534, @p1535, @p1536, @p1537, @p1538, @p1539, @p1540, @p1541, @p1542, @p1543, @p1544, @p1545, @p1546, @p1547, @p1548, @p1549, @p1550, @p1551, @p1552, @p1553, @p1554, @p1555, @p1556, @p1557, @p1558, @p1559, @p1560, @p1561, @p1562, @p1563, @p1564, @p1565, @p1566, @p1567, 27), (@p1568, @p1569, @p1570, @p1571, @p1572, @p1573, @p1574, @p1575, @p1576, @p1577, @p1578, @p1579, @p1580, @p1581, @p1582, @p1583, @p1584, @p1585, @p1586, @p1587, @p1588, @p1589, @p1590, @p1591, @p1592, @p1593, @p1594, @p1595, @p1596, @p1597, @p1598, @p1599, @p1600, @p1601, @p1602, @p1603, @p1604, @p1605, @p1606, @p1607, @p1608, @p1609, @p1610, @p1611, @p1612, @p1613, @p1614, @p1615, @p1616, @p1617, @p1618, @p1619, @p1620, @p1621, @p1622, @p1623, 28), (@p1624, @p1625, @p1626, @p1627, @p1628, @p1629, @p1630, @p1631, @p1632, @p1633, @p1634, @p1635, @p1636, @p1637, @p1638, @p1639, @p1640, @p1641, @p1642, @p1643, @p1644, @p1645, @p1646, @p1647, @p1648, @p1649, @p1650, @p1651, @p1652, @p1653, @p1654, @p1655, @p1656, @p1657, @p1658, @p1659, @p1660, @p1661, @p1662, @p1663, @p1664, @p1665, @p1666, @p1667, @p1668, @p1669, @p1670, @p1671, @p1672, @p1673, @p1674, @p1675, @p1676, @p1677, @p1678, @p1679, 29), (@p1680, @p1681, @p1682, @p1683, @p1684, @p1685, @p1686, @p1687, @p1688, @p1689, @p1690, @p1691, @p1692, @p1693, @p1694, @p1695, @p1696, @p1697, @p1698, @p1699, @p1700, @p1701, @p1702, @p1703, @p1704, @p1705, @p1706, @p1707, @p1708, @p1709, @p1710, @p1711, @p1712, @p1713, @p1714, @p1715, @p1716, @p1717, @p1718, @p1719, @p1720, @p1721, @p1722, @p1723, @p1724, @p1725, @p1726, @p1727, @p1728, @p1729, @p1730, @p1731, @p1732, @p1733, @p1734, @p1735, 30), (@p1736, @p1737, @p1738, @p1739, @p1740, @p1741, @p1742, @p1743, @p1744, @p1745, @p1746, @p1747, @p1748, @p1749, @p1750, @p1751, @p1752, @p1753, @p1754, @p1755, @p1756, @p1757, @p1758, @p1759, @p1760, @p1761, @p1762, @p1763, @p1764, @p1765, @p1766, @p1767, @p1768, @p1769, @p1770, @p1771, @p1772, @p1773, @p1774, @p1775, @p1776, @p1777, @p1778, @p1779, @p1780, @p1781, @p1782, @p1783, @p1784, @p1785, @p1786, @p1787, @p1788, @p1789, @p1790, @p1791, 31), (@p1792, @p1793, @p1794, @p1795, @p1796, @p1797, @p1798, @p1799, @p1800, @p1801, @p1802, @p1803, @p1804, @p1805, @p1806, @p1807, @p1808, @p1809, @p1810, @p1811, @p1812, @p1813, @p1814, @p1815, @p1816, @p1817, @p1818, @p1819, @p1820, @p1821, @p1822, @p1823, @p1824, @p1825, @p1826, @p1827, @p1828, @p1829, @p1830, @p1831, @p1832, @p1833, @p1834, @p1835, @p1836, @p1837, @p1838, @p1839, @p1840, @p1841, @p1842, @p1843, @p1844, @p1845, @p1846, @p1847, 32), (@p1848, @p1849, @p1850, @p1851, @p1852, @p1853, @p1854, @p1855, @p1856, @p1857, @p1858, @p1859, @p1860, @p1861, @p1862, @p1863, @p1864, @p1865, @p1866, @p1867, @p1868, @p1869, @p1870, @p1871, @p1872, @p1873, @p1874, @p1875, @p1876, @p1877, @p1878, @p1879, @p1880, @p1881, @p1882, @p1883, @p1884, @p1885, @p1886, @p1887, @p1888, @p1889, @p1890, @p1891, @p1892, @p1893, @p1894, @p1895, @p1896, @p1897, @p1898, @p1899, @p1900, @p1901, @p1902, @p1903, 33), (@p1904, @p1905, @p1906, @p1907, @p1908, @p1909, @p1910, @p1911, @p1912, @p1913, @p1914, @p1915, @p1916, @p1917, @p1918, @p1919, @p1920, @p1921, @p1922, @p1923, @p1924, @p1925, @p1926, @p1927, @p1928, @p1929, @p1930, @p1931, @p1932, @p1933, @p1934, @p1935, @p1936, @p1937, @p1938, @p1939, @p1940, @p1941, @p1942, @p1943, @p1944, @p1945, @p1946, @p1947, @p1948, @p1949, @p1950, @p1951, @p1952, @p1953, @p1954, @p1955, @p1956, @p1957, @p1958, @p1959, 34), (@p1960, @p1961, @p1962, @p1963, @p1964, @p1965, @p1966, @p1967, @p1968, @p1969, @p1970, @p1971, @p1972, @p1973, @p1974, @p1975, @p1976, @p1977, @p1978, @p1979, @p1980, @p1981, @p1982, @p1983, @p1984, @p1985, @p1986, @p1987, @p1988, @p1989, @p1990, @p1991, @p1992, @p1993, @p1994, @p1995, @p1996, @p1997, @p1998, @p1999, @p2000, @p2001, @p2002, @p2003, @p2004, @p2005, @p2006, @p2007, @p2008, @p2009, @p2010, @p2011, @p2012, @p2013, @p2014, @p2015, 35), (@p2016, @p2017, @p2018, @p2019, @p2020, @p2021, @p2022, @p2023, @p2024, @p2025, @p2026, @p2027, @p2028, @p2029, @p2030, @p2031, @p2032, @p2033, @p2034, @p2035, @p2036, @p2037, @p2038, @p2039, @p2040, @p2041, @p2042, @p2043, @p2044, @p2045, @p2046, @p2047, @p2048, @p2049, @p2050, @p2051, @p2052, @p2053, @p2054, @p2055, @p2056, @p2057, @p2058, @p2059, @p2060, @p2061, @p2062, @p2063, @p2064, @p2065, @p2066, @p2067, @p2068, @p2069, @p2070, @p2071, 36)) AS i ([addressee_cntry_cd], [addressee_city], [addressee_district], [addressee_email], [addressee_full_address], [addressee_home_address], [addressee_name], [addressee_postcode], [addressee_province], [addressee_subdistrict], [addressee_tel], [create_table], [delivery_code], [delivery_recipient_name], [delivery_relation_id], [delivery_status_id], [dest_outlet_id], [dest_outlet_port], [document_number], [item_barcode], [item_cod], [item_gross_weight], [item_height], [item_length], [item_price], [item_width], [lat], [log_id], [long], [outlet_id], [outlet_port], [podUrl], [remark], [scan_cntry_cd], [scan_cntry_postcode], [sender_cntry_cd], [sender_district], [sender_email], [sender_full_address], [sender_home_address], [member_id], [sender_name], [sender_postcode], [sender_province], [sender_subdistrict], [sender_tel], [server_id], [signatureUrl], [state], [status_code], [status_dtm], [timestamp], [transmit_dtm], [user_id], [wckt_id], [wkstn_no], _Position) ON 1=0 WHEN NOT MATCHED THEN INSERT ([addressee_cntry_cd], [addressee_city], [addressee_district], [addressee_email], [addressee_full_address], [addressee_home_address], [addressee_name], [addressee_postcode], [addressee_province], [addressee_subdistrict], [addressee_tel], [create_table], [delivery_code], [delivery_recipient_name], [delivery_relation_id], [delivery_status_id], [dest_outlet_id], [dest_outlet_port], [document_number], [item_barcode], [item_cod], [item_gross_weight], [item_height], [item_length], [item_price], [item_width], [lat], [log_id], [long], [outlet_id], [outlet_port], [podUrl], [remark], [scan_cntry_cd], [scan_cntry_postcode], [sender_cntry_cd], [sender_district], [sender_email], [sender_full_address], [sender_home_address], [member_id], [sender_name], [sender_postcode], [sender_province], [sender_subdistrict], [sender_tel], [server_id], [signatureUrl], [state], [status_code], [status_dtm], [timestamp], [transmit_dtm], [user_id], [wckt_id], [wkstn_no]) VALUES (i.[addressee_cntry_cd], i.[addressee_city], i.[addressee_district], i.[addressee_email], i.[addressee_full_address], i.[addressee_home_address], i.[addressee_name], i.[addressee_postcode], i.[addressee_province], i.[addressee_subdistrict], i.[addressee_tel], i.[create_table], i.[delivery_code], i.[delivery_recipient_name], i.[delivery_relation_id], i.[delivery_status_id], i.[dest_outlet_id], i.[dest_outlet_port], i.[document_number], i.[item_barcode], i.[item_cod], i.[item_gross_weight], i.[item_height], i.[item_length], i.[item_price], i.[item_width], i.[lat], i.[log_id], i.[long], i.[outlet_id], i.[outlet_port], i.[podUrl], i.[remark], i.[scan_cntry_cd], i.[scan_cntry_postcode], i.[sender_cntry_cd], i.[sender_district], i.[sender_email], i.[sender_full_address], i.[sender_home_address], i.[member_id], i.[sender_name], i.[sender_postcode], i.[sender_province], i.[sender_subdistrict], i.[sender_tel], i.[server_id], i.[signatureUrl], i.[state], i.[status_code], i.[status_dtm], i.[timestamp], i.[transmit_dtm], i.[user_id], i.[wckt_id], i.[wkstn_no]) OUTPUT INSERTED.[item_id], i._Position INTO @inserted0;  SELECT [t].[item_id] FROM [raw_data] t INNER JOIN @inserted0 i ON ([t].[item_id] = [i].[item_id]) ORDER BY [i].[_Position];  ",4,4,0,439,2,4
"(@p0 nvarchar(4000),@p1 nvarchar(4000),@p2 nvarchar(4000),@p3 nvarchar(4000),@p4 nvarchar(4000),@p5 nvarchar(4000),@p6 nvarchar(4000),@p7 nvarchar(4000),@p8 nvarchar(4000),@p9 nvarchar(4000),@p10 nvarchar(4000),@p11 datetime2(7),@p12 nvarchar(4000),@p13 nvarchar(4000),@p14 int,@p15 int,@p16 int,@p17 nvarchar(4000),@p18 nvarchar(4000),@p19 nvarchar(4000),@p20 decimal(18,2),@p21 decimal(18,2),@p22 nvarchar(4000),@p23 nvarchar(4000),@p24 decimal(18,2),@p25 nvarchar(4000),@p26 nvarchar(4000),@p27 nvarchar(4000),@p28 nvarchar(4000),@p29 int,@p30 nvarchar(4000),@p31 nvarchar(4000),@p32 nvarchar(4000),@p33 nvarchar(4000),@p34 nvarchar(4000),@p35 nvarchar(4000),@p36 nvarchar(4000),@p37 nvarchar(4000),@p38 nvarchar(4000),@p39 nvarchar(4000),@p40 int,@p41 nvarchar(4000),@p42 nvarchar(4000),@p43 nvarchar(4000),@p44 nvarchar(4000),@p45 nvarchar(4000),@p46 int,@p47 nvarchar(4000),@p48 int,@p49 int,@p50 datetime2(7),@p51 datetime2(7),@p52 datetime2(7),@p53 nvarchar(4000),@p54 nvarchar(4000),@p55 nvarchar(4000),@p56 nvarchar(4000),@p57 nvarchar(4000),@p58 nvarchar(4000),@p59 nvarchar(4000),@p60 nvarchar(4000),@p61 nvarchar(4000),@p62 nvarchar(4000),@p63 nvarchar(4000),@p64 nvarchar(4000),@p65 nvarchar(4000),@p66 nvarchar(4000),@p67 datetime2(7),@p68 nvarchar(4000),@p69 nvarchar(4000),@p70 int,@p71 int,@p72 int,@p73 nvarchar(4000),@p74 nvarchar(4000),@p75 nvarchar(4000),@p76 decimal(18,2),@p77 decimal(18,2),@p78 nvarchar(4000),@p79 nvarchar(4000),@p80 decimal(18,2),@p81 nvarchar(4000),@p82 nvarchar(4000),@p83 nvarchar(4000),@p84 nvarchar(4000),@p85 int,@p86 nvarchar(4000),@p87 nvarchar(4000),@p88 nvarchar(4000),@p89 nvarchar(4000),@p90 nvarchar(4000),@p91 nvarchar(4000),@p92 nvarchar(4000),@p93 nvarchar(4000),@p94 nvarchar(4000),@p95 nvarchar(4000),@p96 int,@p97 nvarchar(4000),@p98 nvarchar(4000),@p99 nvarchar(4000),@p100 nvarchar(4000),@p101 nvarchar(4000),@p102 int,@p103 nvarchar(4000),@p104 int,@p105 int,@p106 datetime2(7),@p107 datetime2(7),@p108 datetime2(7),@p109 nvarchar(4000),@p110 nvarchar(4000),@p111 nvarchar(4000),@p112 nvarchar(4000),@p113 nvarchar(4000),@p114 nvarchar(4000),@p115 nvarchar(4000),@p116 nvarchar(4000),@p117 nvarchar(4000),@p118 nvarchar(4000),@p119 nvarchar(4000),@p120 nvarchar(4000),@p121 nvarchar(4000),@p122 nvarchar(4000),@p123 datetime2(7),@p124 nvarchar(4000),@p125 nvarchar(4000),@p126 int,@p127 int,@p128 int,@p129 nvarchar(4000),@p130 nvarchar(4000),@p131 nvarchar(4000),@p132 nvarchar(4000),@p133 decimal(18,2),@p134 nvarchar(4000),@p135 nvarchar(4000),@p136 decimal(18,2),@p137 nvarchar(4000),@p138 nvarchar(4000),@p139 nvarchar(4000),@p140 nvarchar(4000),@p141 int,@p142 nvarchar(4000),@p143 nvarchar(4000),@p144 nvarchar(4000),@p145 nvarchar(4000),@p146 nvarchar(4000),@p147 nvarchar(4000),@p148 nvarchar(4000),@p149 nvarchar(4000),@p150 nvarchar(4000),@p151 nvarchar(4000),@p152 int,@p153 nvarchar(4000),@p154 nvarchar(4000),@p155 nvarchar(4000),@p156 nvarchar(4000),@p157 nvarchar(4000),@p158 int,@p159 nvarchar(4000),@p160 int,@p161 int,@p162 datetime2(7),@p163 datetime2(7),@p164 datetime2(7),@p165 nvarchar(4000),@p166 nvarchar(4000),@p167 nvarchar(4000),@p168 nvarchar(4000),@p169 nvarchar(4000),@p170 nvarchar(4000),@p171 nvarchar(4000),@p172 nvarchar(4000),@p173 nvarchar(4000),@p174 nvarchar(4000),@p175 nvarchar(4000),@p176 nvarchar(4000),@p177 nvarchar(4000),@p178 nvarchar(4000),@p179 datetime2(7),@p180 nvarchar(4000),@p181 nvarchar(4000),@p182 int,@p183 int,@p184 int,@p185 nvarchar(4000),@p186 nvarchar(4000),@p187 nvarchar(4000),@p188 decimal(18,2),@p189 decimal(18,2),@p190 nvarchar(4000),@p191 nvarchar(4000),@p192 decimal(18,2),@p193 nvarchar(4000),@p194 nvarchar(4000),@p195 nvarchar(4000),@p196 nvarchar(4000),@p197 int,@p198 nvarchar(4000),@p199 nvarchar(4000),@p200 nvarchar(4000),@p201 nvarchar(4000),@p202 nvarchar(4000),@p203 nvarchar(4000),@p204 nvarchar(4000),@p205 nvarchar(4000),@p206 nvarchar(4000),@p207 nvarchar(4000),@p208 int,@p209 nvarchar(4000),@p210 nvarchar(4000),@p211 nvarchar(4000),@p212 nvarchar(4000),@p213 nvarchar(4000),@p214 int,@p215 nvarchar(4000),@p216 int,@p217 int,@p218 datetime2(7),@p219 datetime2(7),@p220 datetime2(7),@p221 nvarchar(4000),@p222 nvarchar(4000),@p223 nvarchar(4000),@p224 nvarchar(4000),@p225 nvarchar(4000),@p226 nvarchar(4000),@p227 nvarchar(4000),@p228 nvarchar(4000),@p229 nvarchar(4000),@p230 nvarchar(4000),@p231 nvarchar(4000),@p232 nvarchar(4000),@p233 nvarchar(4000),@p234 nvarchar(4000),@p235 datetime2(7),@p236 nvarchar(4000),@p237 nvarchar(4000),@p238 int,@p239 int,@p240 int,@p241 nvarchar(4000),@p242 nvarchar(4000),@p243 nvarchar(4000),@p244 decimal(18,2),@p245 decimal(18,2),@p246 nvarchar(4000),@p247 nvarchar(4000),@p248 decimal(18,2),@p249 nvarchar(4000),@p250 nvarchar(4000),@p251 nvarchar(4000),@p252 nvarchar(4000),@p253 int,@p254 nvarchar(4000),@p255 nvarchar(4000),@p256 nvarchar(4000),@p257 nvarchar(4000),@p258 nvarchar(4000),@p259 nvarchar(4000),@p260 nvarchar(4000),@p261 nvarchar(4000),@p262 nvarchar(4000),@p263 nvarchar(4000),@p264 int,@p265 nvarchar(4000),@p266 nvarchar(4000),@p267 nvarchar(4000),@p268 nvarchar(4000),@p269 nvarchar(4000),@p270 int,@p271 nvarchar(4000),@p272 int,@p273 int,@p274 datetime2(7),@p275 datetime2(7),@p276 datetime2(7),@p277 nvarchar(4000),@p278 nvarchar(4000),@p279 nvarchar(4000),@p280 nvarchar(4000),@p281 nvarchar(4000),@p282 nvarchar(4000),@p283 nvarchar(4000),@p284 nvarchar(4000),@p285 nvarchar(4000),@p286 nvarchar(4000),@p287 nvarchar(4000),@p288 nvarchar(4000),@p289 nvarchar(4000),@p290 nvarchar(4000),@p291 datetime2(7),@p292 nvarchar(4000),@p293 nvarchar(4000),@p294 int,@p295 int,@p296 int,@p297 nvarchar(4000),@p298 nvarchar(4000),@p299 nvarchar(4000),@p300 decimal(18,2),@p301 decimal(18,2),@p302 nvarchar(4000),@p303 nvarchar(4000),@p304 decimal(18,2),@p305 nvarchar(4000),@p306 nvarchar(4000),@p307 nvarchar(4000),@p308 nvarchar(4000),@p309 int,@p310 nvarchar(4000),@p311 nvarchar(4000),@p312 nvarchar(4000),@p313 nvarchar(4000),@p314 nvarchar(4000),@p315 nvarchar(4000),@p316 nvarchar(4000),@p317 nvarchar(4000),@p318 nvarchar(4000),@p319 nvarchar(4000),@p320 int,@p321 nvarchar(4000),@p322 nvarchar(4000),@p323 nvarchar(4000),@p324 nvarchar(4000),@p325 nvarchar(4000),@p326 int,@p327 nvarchar(4000),@p328 int,@p329 int,@p330 datetime2(7),@p331 datetime2(7),@p332 datetime2(7),@p333 nvarchar(4000),@p334 nvarchar(4000),@p335 nvarchar(4000),@p336 nvarchar(4000),@p337 nvarchar(4000),@p338 nvarchar(4000),@p339 nvarchar(4000),@p340 nvarchar(4000),@p341 nvarchar(4000),@p342 nvarchar(4000),@p343 nvarchar(4000),@p344 nvarchar(4000),@p345 nvarchar(4000),@p346 nvarchar(4000),@p347 datetime2(7),@p348 nvarchar(4000),@p349 nvarchar(4000),@p350 int,@p351 int,@p352 int,@p353 nvarchar(4000),@p354 nvarchar(4000),@p355 nvarchar(4000),@p356 decimal(18,2),@p357 decimal(18,2),@p358 nvarchar(4000),@p359 nvarchar(4000),@p360 decimal(18,2),@p361 nvarchar(4000),@p362 nvarchar(4000),@p363 nvarchar(4000),@p364 nvarchar(4000),@p365 int,@p366 nvarchar(4000),@p367 nvarchar(4000),@p368 nvarchar(4000),@p369 nvarchar(4000),@p370 nvarchar(4000),@p371 nvarchar(4000),@p372 nvarchar(4000),@p373 nvarchar(4000),@p374 nvarchar(4000),@p375 nvarchar(4000),@p376 int,@p377 nvarchar(4000),@p378 nvarchar(4000),@p379 nvarchar(4000),@p380 nvarchar(4000),@p381 nvarchar(4000),@p382 int,@p383 nvarchar(4000),@p384 int,@p385 int,@p386 datetime2(7),@p387 datetime2(7),@p388 datetime2(7),@p389 nvarchar(4000),@p390 nvarchar(4000),@p391 nvarchar(4000),@p392 nvarchar(4000),@p393 nvarchar(4000),@p394 nvarchar(4000),@p395 nvarchar(4000),@p396 nvarchar(4000),@p397 nvarchar(4000),@p398 nvarchar(4000),@p399 nvarchar(4000),@p400 nvarchar(4000),@p401 nvarchar(4000),@p402 nvarchar(4000),@p403 datetime2(7),@p404 nvarchar(4000),@p405 nvarchar(4000),@p406 int,@p407 int,@p408 int,@p409 nvarchar(4000),@p410 nvarchar(4000),@p411 nvarchar(4000),@p412 decimal(18,2),@p413 decimal(18,2),@p414 nvarchar(4000),@p415 nvarchar(4000),@p416 decimal(18,2),@p417 nvarchar(4000),@p418 nvarchar(4000),@p419 nvarchar(4000),@p420 nvarchar(4000),@p421 int,@p422 nvarchar(4000),@p423 nvarchar(4000),@p424 nvarchar(4000),@p425 nvarchar(4000),@p426 nvarchar(4000),@p427 nvarchar(4000),@p428 nvarchar(4000),@p429 nvarchar(4000),@p430 nvarchar(4000),@p431 nvarchar(4000),@p432 int,@p433 nvarchar(4000),@p434 nvarchar(4000),@p435 nvarchar(4000),@p436 nvarchar(4000),@p437 nvarchar(4000),@p438 int,@p439 nvarchar(4000),@p440 int,@p441 int,@p442 datetime2(7),@p443 datetime2(7),@p444 datetime2(7),@p445 nvarchar(4000),@p446 nvarchar(4000),@p447 nvarchar(4000),@p448 nvarchar(4000),@p449 nvarchar(4000),@p450 nvarchar(4000),@p451 nvarchar(4000),@p452 nvarchar(4000),@p453 nvarchar(4000),@p454 nvarchar(4000),@p455 nvarchar(4000),@p456 nvarchar(4000),@p457 nvarchar(4000),@p458 nvarchar(4000),@p459 datetime2(7),@p460 nvarchar(4000),@p461 nvarchar(4000),@p462 int,@p463 int,@p464 int,@p465 nvarchar(4000),@p466 nvarchar(4000),@p467 nvarchar(4000),@p468 nvarchar(4000),@p469 decimal(18,2),@p470 nvarchar(4000),@p471 nvarchar(4000),@p472 decimal(18,2),@p473 nvarchar(4000),@p474 nvarchar(4000),@p475 nvarchar(4000),@p476 nvarchar(4000),@p477 int,@p478 nvarchar(4000),@p479 nvarchar(4000),@p480 nvarchar(4000),@p481 nvarchar(4000),@p482 nvarchar(4000),@p483 nvarchar(4000),@p484 nvarchar(4000),@p485 nvarchar(4000),@p486 nvarchar(4000),@p487 nvarchar(4000),@p488 int,@p489 nvarchar(4000),@p490 nvarchar(4000),@p491 nvarchar(4000),@p492 nvarchar(4000),@p493 nvarchar(4000),@p494 int,@p495 nvarchar(4000),@p496 int,@p497 int,@p498 datetime2(7),@p499 datetime2(7),@p500 datetime2(7),@p501 nvarchar(4000),@p502 nvarchar(4000),@p503 nvarchar(4000),@p504 nvarchar(4000),@p505 nvarchar(4000),@p506 nvarchar(4000),@p507 nvarchar(4000),@p508 nvarchar(4000),@p509 nvarchar(4000),@p510 nvarchar(4000),@p511 nvarchar(4000),@p512 nvarchar(4000),@p513 nvarchar(4000),@p514 nvarchar(4000),@p515 datetime2(7),@p516 nvarchar(4000),@p517 nvarchar(4000),@p518 int,@p519 int,@p520 int,@p521 nvarchar(4000),@p522 nvarchar(4000),@p523 nvarchar(4000),@p524 decimal(18,2),@p525 decimal(18,2),@p526 nvarchar(4000),@p527 nvarchar(4000),@p528 decimal(18,2),@p529 nvarchar(4000),@p530 nvarchar(4000),@p531 nvarchar(4000),@p532 nvarchar(4000),@p533 int,@p534 nvarchar(4000),@p535 nvarchar(4000),@p536 nvarchar(4000),@p537 nvarchar(4000),@p538 nvarchar(4000),@p539 nvarchar(4000),@p540 nvarchar(4000),@p541 nvarchar(4000),@p542 nvarchar(4000),@p543 nvarchar(4000),@p544 int,@p545 nvarchar(4000),@p546 nvarchar(4000),@p547 nvarchar(4000),@p548 nvarchar(4000),@p549 nvarchar(4000),@p550 int,@p551 nvarchar(4000),@p552 int,@p553 int,@p554 datetime2(7),@p555 datetime2(7),@p556 datetime2(7),@p557 nvarchar(4000),@p558 nvarchar(4000),@p559 nvarchar(4000),@p560 nvarchar(4000),@p561 nvarchar(4000),@p562 nvarchar(4000),@p563 nvarchar(4000),@p564 nvarchar(4000),@p565 nvarchar(4000),@p566 nvarchar(4000),@p567 nvarchar(4000),@p568 nvarchar(4000),@p569 nvarchar(4000),@p570 nvarchar(4000),@p571 datetime2(7),@p572 nvarchar(4000),@p573 nvarchar(4000),@p574 int,@p575 int,@p576 int,@p577 nvarchar(4000),@p578 nvarchar(4000),@p579 nvarchar(4000),@p580 decimal(18,2),@p581 decimal(18,2),@p582 nvarchar(4000),@p583 nvarchar(4000),@p584 decimal(18,2),@p585 nvarchar(4000),@p586 nvarchar(4000),@p587 nvarchar(4000),@p588 nvarchar(4000),@p589 int,@p590 nvarchar(4000),@p591 nvarchar(4000),@p592 nvarchar(4000),@p593 nvarchar(4000),@p594 nvarchar(4000),@p595 nvarchar(4000),@p596 nvarchar(4000),@p597 nvarchar(4000),@p598 nvarchar(4000),@p599 nvarchar(4000),@p600 int,@p601 nvarchar(4000),@p602 nvarchar(4000),@p603 nvarchar(4000),@p604 nvarchar(4000),@p605 nvarchar(4000),@p606 int,@p607 nvarchar(4000),@p608 int,@p609 int,@p610 datetime2(7),@p611 datetime2(7),@p612 datetime2(7),@p613 nvarchar(4000),@p614 nvarchar(4000),@p615 nvarchar(4000),@p616 nvarchar(4000),@p617 nvarchar(4000),@p618 nvarchar(4000),@p619 nvarchar(4000),@p620 nvarchar(4000),@p621 nvarchar(4000),@p622 nvarchar(4000),@p623 nvarchar(4000),@p624 nvarchar(4000),@p625 nvarchar(4000),@p626 nvarchar(4000),@p627 datetime2(7),@p628 nvarchar(4000),@p629 nvarchar(4000),@p630 int,@p631 int,@p632 int,@p633 nvarchar(4000),@p634 nvarchar(4000),@p635 nvarchar(4000),@p636 nvarchar(4000),@p637 decimal(18,2),@p638 nvarchar(4000),@p639 nvarchar(4000),@p640 decimal(18,2),@p641 nvarchar(4000),@p642 nvarchar(4000),@p643 nvarchar(4000),@p644 nvarchar(4000),@p645 int,@p646 nvarchar(4000),@p647 nvarchar(4000),@p648 nvarchar(4000),@p649 nvarchar(4000),@p650 nvarchar(4000),@p651 nvarchar(4000),@p652 nvarchar(4000),@p653 nvarchar(4000),@p654 nvarchar(4000),@p655 nvarchar(4000),@p656 int,@p657 nvarchar(4000),@p658 nvarchar(4000),@p659 nvarchar(4000),@p660 nvarchar(4000),@p661 nvarchar(4000),@p662 int,@p663 nvarchar(4000),@p664 int,@p665 int,@p666 datetime2(7),@p667 datetime2(7),@p668 datetime2(7),@p669 nvarchar(4000),@p670 nvarchar(4000),@p671 nvarchar(4000),@p672 nvarchar(4000),@p673 nvarchar(4000),@p674 nvarchar(4000),@p675 nvarchar(4000),@p676 nvarchar(4000),@p677 nvarchar(4000),@p678 nvarchar(4000),@p679 nvarchar(4000),@p680 nvarchar(4000),@p681 nvarchar(4000),@p682 nvarchar(4000),@p683 datetime2(7),@p684 nvarchar(4000),@p685 nvarchar(4000),@p686 int,@p687 int,@p688 int,@p689 nvarchar(4000),@p690 nvarchar(4000),@p691 nvarchar(4000),@p692 decimal(18,2),@p693 decimal(18,2),@p694 nvarchar(4000),@p695 nvarchar(4000),@p696 decimal(18,2),@p697 nvarchar(4000),@p698 nvarchar(4000),@p699 nvarchar(4000),@p700 nvarchar(4000),@p701 int,@p702 nvarchar(4000),@p703 nvarchar(4000),@p704 nvarchar(4000),@p705 nvarchar(4000),@p706 nvarchar(4000),@p707 nvarchar(4000),@p708 nvarchar(4000),@p709 nvarchar(4000),@p710 nvarchar(4000),@p711 nvarchar(4000),@p712 int,@p713 nvarchar(4000),@p714 nvarchar(4000),@p715 nvarchar(4000),@p716 nvarchar(4000),@p717 nvarchar(4000),@p718 int,@p719 nvarchar(4000),@p720 int,@p721 int,@p722 datetime2(7),@p723 datetime2(7),@p724 datetime2(7),@p725 nvarchar(4000),@p726 nvarchar(4000),@p727 nvarchar(4000),@p728 nvarchar(4000),@p729 nvarchar(4000),@p730 nvarchar(4000),@p731 nvarchar(4000),@p732 nvarchar(4000),@p733 nvarchar(4000),@p734 nvarchar(4000),@p735 nvarchar(4000),@p736 nvarchar(4000),@p737 nvarchar(4000),@p738 nvarchar(4000),@p739 datetime2(7),@p740 nvarchar(4000),@p741 nvarchar(4000),@p742 int,@p743 int,@p744 int,@p745 nvarchar(4000),@p746 nvarchar(4000),@p747 nvarchar(4000),@p748 decimal(18,2),@p749 decimal(18,2),@p750 nvarchar(4000),@p751 nvarchar(4000),@p752 decimal(18,2),@p753 nvarchar(4000),@p754 nvarchar(4000),@p755 nvarchar(4000),@p756 nvarchar(4000),@p757 int,@p758 nvarchar(4000),@p759 nvarchar(4000),@p760 nvarchar(4000),@p761 nvarchar(4000),@p762 nvarchar(4000),@p763 nvarchar(4000),@p764 nvarchar(4000),@p765 nvarchar(4000),@p766 nvarchar(4000),@p767 nvarchar(4000),@p768 int,@p769 nvarchar(4000),@p770 nvarchar(4000),@p771 nvarchar(4000),@p772 nvarchar(4000),@p773 nvarchar(4000),@p774 int,@p775 nvarchar(4000),@p776 int,@p777 int,@p778 datetime2(7),@p779 datetime2(7),@p780 datetime2(7),@p781 nvarchar(4000),@p782 nvarchar(4000),@p783 nvarchar(4000),@p784 nvarchar(4000),@p785 nvarchar(4000),@p786 nvarchar(4000),@p787 nvarchar(4000),@p788 nvarchar(4000),@p789 nvarchar(4000),@p790 nvarchar(4000),@p791 nvarchar(4000),@p792 nvarchar(4000),@p793 nvarchar(4000),@p794 nvarchar(4000),@p795 datetime2(7),@p796 nvarchar(4000),@p797 nvarchar(4000),@p798 int,@p799 int,@p800 int,@p801 nvarchar(4000),@p802 nvarchar(4000),@p803 nvarchar(4000),@p804 decimal(18,2),@p805 decimal(18,2),@p806 nvarchar(4000),@p807 nvarchar(4000),@p808 decimal(18,2),@p809 nvarchar(4000),@p810 nvarchar(4000),@p811 nvarchar(4000),@p812 nvarchar(4000),@p813 int,@p814 nvarchar(4000),@p815 nvarchar(4000),@p816 nvarchar(4000),@p817 nvarchar(4000),@p818 nvarchar(4000),@p819 nvarchar(4000),@p820 nvarchar(4000),@p821 nvarchar(4000),@p822 nvarchar(4000),@p823 nvarchar(4000),@p824 int,@p825 nvarchar(4000),@p826 nvarchar(4000),@p827 nvarchar(4000),@p828 nvarchar(4000),@p829 nvarchar(4000),@p830 int,@p831 nvarchar(4000),@p832 int,@p833 int,@p834 datetime2(7),@p835 datetime2(7),@p836 datetime2(7),@p837 nvarchar(4000),@p838 nvarchar(4000),@p839 nvarchar(4000),@p840 nvarchar(4000),@p841 nvarchar(4000),@p842 nvarchar(4000),@p843 nvarchar(4000),@p844 nvarchar(4000),@p845 nvarchar(4000),@p846 nvarchar(4000),@p847 nvarchar(4000),@p848 nvarchar(4000),@p849 nvarchar(4000),@p850 nvarchar(4000),@p851 datetime2(7),@p852 nvarchar(4000),@p853 nvarchar(4000),@p854 int,@p855 int,@p856 int,@p857 nvarchar(4000),@p858 nvarchar(4000),@p859 nvarchar(4000),@p860 decimal(18,2),@p861 decimal(18,2),@p862 nvarchar(4000),@p863 nvarchar(4000),@p864 decimal(18,2),@p865 nvarchar(4000),@p866 nvarchar(4000),@p867 nvarchar(4000),@p868 nvarchar(4000),@p869 int,@p870 nvarchar(4000),@p871 nvarchar(4000),@p872 nvarchar(4000),@p873 nvarchar(4000),@p874 nvarchar(4000),@p875 nvarchar(4000),@p876 nvarchar(4000),@p877 nvarchar(4000),@p878 nvarchar(4000),@p879 nvarchar(4000),@p880 int,@p881 nvarchar(4000),@p882 nvarchar(4000),@p883 nvarchar(4000),@p884 nvarchar(4000),@p885 nvarchar(4000),@p886 int,@p887 nvarchar(4000),@p888 int,@p889 int,@p890 datetime2(7),@p891 datetime2(7),@p892 datetime2(7),@p893 nvarchar(4000),@p894 nvarchar(4000),@p895 nvarchar(4000),@p896 nvarchar(4000),@p897 nvarchar(4000),@p898 nvarchar(4000),@p899 nvarchar(4000),@p900 nvarchar(4000),@p901 nvarchar(4000),@p902 nvarchar(4000),@p903 nvarchar(4000),@p904 nvarchar(4000),@p905 nvarchar(4000),@p906 nvarchar(4000),@p907 datetime2(7),@p908 nvarchar(4000),@p909 nvarchar(4000),@p910 int,@p911 int,@p912 int,@p913 nvarchar(4000),@p914 nvarchar(4000),@p915 nvarchar(4000),@p916 nvarchar(4000),@p917 decimal(18,2),@p918 nvarchar(4000),@p919 nvarchar(4000),@p920 decimal(18,2),@p921 nvarchar(4000),@p922 nvarchar(4000),@p923 nvarchar(4000),@p924 nvarchar(4000),@p925 int,@p926 nvarchar(4000),@p927 nvarchar(4000),@p928 nvarchar(4000),@p929 nvarchar(4000),@p930 nvarchar(4000),@p931 nvarchar(4000),@p932 nvarchar(4000),@p933 nvarchar(4000),@p934 nvarchar(4000),@p935 nvarchar(4000),@p936 int,@p937 nvarchar(4000),@p938 nvarchar(4000),@p939 nvarchar(4000),@p940 nvarchar(4000),@p941 nvarchar(4000),@p942 int,@p943 nvarchar(4000),@p944 int,@p945 int,@p946 datetime2(7),@p947 datetime2(7),@p948 datetime2(7),@p949 nvarchar(4000),@p950 nvarchar(4000),@p951 nvarchar(4000),@p952 nvarchar(4000),@p953 nvarchar(4000),@p954 nvarchar(4000),@p955 nvarchar(4000),@p956 nvarchar(4000),@p957 nvarchar(4000),@p958 nvarchar(4000),@p959 nvarchar(4000),@p960 nvarchar(4000),@p961 nvarchar(4000),@p962 nvarchar(4000),@p963 datetime2(7),@p964 nvarchar(4000),@p965 nvarchar(4000),@p966 int,@p967 int,@p968 int,@p969 nvarchar(4000),@p970 nvarchar(4000),@p971 nvarchar(4000),@p972 nvarchar(4000),@p973 decimal(18,2),@p974 nvarchar(4000),@p975 nvarchar(4000),@p976 decimal(18,2),@p977 nvarchar(4000),@p978 nvarchar(4000),@p979 nvarchar(4000),@p980 nvarchar(4000),@p981 int,@p982 nvarchar(4000),@p983 nvarchar(4000),@p984 nvarchar(4000),@p985 nvarchar(4000),@p986 nvarchar(4000),@p987 nvarchar(4000),@p988 nvarchar(4000),@p989 nvarchar(4000),@p990 nvarchar(4000),@p991 nvarchar(4000),@p992 int,@p993 nvarchar(4000),@p994 nvarchar(4000),@p995 nvarchar(4000),@p996 nvarchar(4000),@p997 nvarchar(4000),@p998 int,@p999 nvarchar(4000),@p1000 int,@p1001 int,@p1002 datetime2(7),@p1003 datetime2(7),@p1004 datetime2(7),@p1005 nvarchar(4000),@p1006 nvarchar(4000),@p1007 nvarchar(4000),@p1008 nvarchar(4000),@p1009 nvarchar(4000),@p1010 nvarchar(4000),@p1011 nvarchar(4000),@p1012 nvarchar(4000),@p1013 nvarchar(4000),@p1014 nvarchar(4000),@p1015 nvarchar(4000),@p1016 nvarchar(4000),@p1017 nvarchar(4000),@p1018 nvarchar(4000),@p1019 datetime2(7),@p1020 nvarchar(4000),@p1021 nvarchar(4000),@p1022 int,@p1023 int,@p1024 int,@p1025 nvarchar(4000),@p1026 nvarchar(4000),@p1027 nvarchar(4000),@p1028 decimal(18,2),@p1029 decimal(18,2),@p1030 nvarchar(4000),@p1031 nvarchar(4000),@p1032 decimal(18,2),@p1033 nvarchar(4000),@p1034 nvarchar(4000),@p1035 nvarchar(4000),@p1036 nvarchar(4000),@p1037 int,@p1038 nvarchar(4000),@p1039 nvarchar(4000),@p1040 nvarchar(4000),@p1041 nvarchar(4000),@p1042 nvarchar(4000),@p1043 nvarchar(4000),@p1044 nvarchar(4000),@p1045 nvarchar(4000),@p1046 nvarchar(4000),@p1047 nvarchar(4000),@p1048 int,@p1049 nvarchar(4000),@p1050 nvarchar(4000),@p1051 nvarchar(4000),@p1052 nvarchar(4000),@p1053 nvarchar(4000),@p1054 int,@p1055 nvarchar(4000),@p1056 int,@p1057 int,@p1058 datetime2(7),@p1059 datetime2(7),@p1060 datetime2(7),@p1061 nvarchar(4000),@p1062 nvarchar(4000),@p1063 nvarchar(4000),@p1064 nvarchar(4000),@p1065 nvarchar(4000),@p1066 nvarchar(4000),@p1067 nvarchar(4000),@p1068 nvarchar(4000),@p1069 nvarchar(4000),@p1070 nvarchar(4000),@p1071 nvarchar(4000),@p1072 nvarchar(4000),@p1073 nvarchar(4000),@p1074 nvarchar(4000),@p1075 datetime2(7),@p1076 nvarchar(4000),@p1077 nvarchar(4000),@p1078 int,@p1079 int,@p1080 int,@p1081 nvarchar(4000),@p1082 nvarchar(4000),@p1083 nvarchar(4000),@p1084 decimal(18,2),@p1085 decimal(18,2),@p1086 nvarchar(4000),@p1087 nvarchar(4000),@p1088 decimal(18,2),@p1089 nvarchar(4000),@p1090 nvarchar(4000),@p1091 nvarchar(4000),@p1092 nvarchar(4000),@p1093 int,@p1094 nvarchar(4000),@p1095 nvarchar(4000),@p1096 nvarchar(4000),@p1097 nvarchar(4000),@p1098 nvarchar(4000),@p1099 nvarchar(4000),@p1100 nvarchar(4000),@p1101 nvarchar(4000),@p1102 nvarchar(4000),@p1103 nvarchar(4000),@p1104 int,@p1105 nvarchar(4000),@p1106 nvarchar(4000),@p1107 nvarchar(4000),@p1108 nvarchar(4000),@p1109 nvarchar(4000),@p1110 int,@p1111 nvarchar(4000),@p1112 int,@p1113 int,@p1114 datetime2(7),@p1115 datetime2(7),@p1116 datetime2(7),@p1117 nvarchar(4000),@p1118 nvarchar(4000),@p1119 nvarchar(4000),@p1120 nvarchar(4000),@p1121 nvarchar(4000),@p1122 nvarchar(4000),@p1123 nvarchar(4000),@p1124 nvarchar(4000),@p1125 nvarchar(4000),@p1126 nvarchar(4000),@p1127 nvarchar(4000),@p1128 nvarchar(4000),@p1129 nvarchar(4000),@p1130 nvarchar(4000),@p1131 datetime2(7),@p1132 nvarchar(4000),@p1133 nvarchar(4000),@p1134 int,@p1135 int,@p1136 int,@p1137 nvarchar(4000),@p1138 nvarchar(4000),@p1139 nvarchar(4000),@p1140 decimal(18,2),@p1141 decimal(18,2),@p1142 nvarchar(4000),@p1143 nvarchar(4000),@p1144 decimal(18,2),@p1145 nvarchar(4000),@p1146 nvarchar(4000),@p1147 nvarchar(4000),@p1148 nvarchar(4000),@p1149 int,@p1150 nvarchar(4000),@p1151 nvarchar(4000),@p1152 nvarchar(4000),@p1153 nvarchar(4000),@p1154 nvarchar(4000),@p1155 nvarchar(4000),@p1156 nvarchar(4000),@p1157 nvarchar(4000),@p1158 nvarchar(4000),@p1159 nvarchar(4000),@p1160 int,@p1161 nvarchar(4000),@p1162 nvarchar(4000),@p1163 nvarchar(4000),@p1164 nvarchar(4000),@p1165 nvarchar(4000),@p1166 int,@p1167 nvarchar(4000),@p1168 int,@p1169 int,@p1170 datetime2(7),@p1171 datetime2(7),@p1172 datetime2(7),@p1173 nvarchar(4000),@p1174 nvarchar(4000),@p1175 nvarchar(4000),@p1176 nvarchar(4000),@p1177 nvarchar(4000),@p1178 nvarchar(4000),@p1179 nvarchar(4000),@p1180 nvarchar(4000),@p1181 nvarchar(4000),@p1182 nvarchar(4000),@p1183 nvarchar(4000),@p1184 nvarchar(4000),@p1185 nvarchar(4000),@p1186 nvarchar(4000),@p1187 datetime2(7),@p1188 nvarchar(4000),@p1189 nvarchar(4000),@p1190 int,@p1191 int,@p1192 int,@p1193 nvarchar(4000),@p1194 nvarchar(4000),@p1195 nvarchar(4000),@p1196 decimal(18,2),@p1197 decimal(18,2),@p1198 nvarchar(4000),@p1199 nvarchar(4000),@p1200 decimal(18,2),@p1201 nvarchar(4000),@p1202 nvarchar(4000),@p1203 nvarchar(4000),@p1204 nvarchar(4000),@p1205 int,@p1206 nvarchar(4000),@p1207 nvarchar(4000),@p1208 nvarchar(4000),@p1209 nvarchar(4000),@p1210 nvarchar(4000),@p1211 nvarchar(4000),@p1212 nvarchar(4000),@p1213 nvarchar(4000),@p1214 nvarchar(4000),@p1215 nvarchar(4000),@p1216 int,@p1217 nvarchar(4000),@p1218 nvarchar(4000),@p1219 nvarchar(4000),@p1220 nvarchar(4000),@p1221 nvarchar(4000),@p1222 int,@p1223 nvarchar(4000),@p1224 int,@p1225 int,@p1226 datetime2(7),@p1227 datetime2(7),@p1228 datetime2(7),@p1229 nvarchar(4000),@p1230 nvarchar(4000),@p1231 nvarchar(4000),@p1232 nvarchar(4000),@p1233 nvarchar(4000),@p1234 nvarchar(4000),@p1235 nvarchar(4000),@p1236 nvarchar(4000),@p1237 nvarchar(4000),@p1238 nvarchar(4000),@p1239 nvarchar(4000),@p1240 nvarchar(4000),@p1241 nvarchar(4000),@p1242 nvarchar(4000),@p1243 datetime2(7),@p1244 nvarchar(4000),@p1245 nvarchar(4000),@p1246 int,@p1247 int,@p1248 int,@p1249 nvarchar(4000),@p1250 nvarchar(4000),@p1251 nvarchar(4000),@p1252 decimal(18,2),@p1253 decimal(18,2),@p1254 nvarchar(4000),@p1255 nvarchar(4000),@p1256 decimal(18,2),@p1257 nvarchar(4000),@p1258 nvarchar(4000),@p1259 nvarchar(4000),@p1260 nvarchar(4000),@p1261 int,@p1262 nvarchar(4000),@p1263 nvarchar(4000),@p1264 nvarchar(4000),@p1265 nvarchar(4000),@p1266 nvarchar(4000),@p1267 nvarchar(4000),@p1268 nvarchar(4000),@p1269 nvarchar(4000),@p1270 nvarchar(4000),@p1271 nvarchar(4000),@p1272 int,@p1273 nvarchar(4000),@p1274 nvarchar(4000),@p1275 nvarchar(4000),@p1276 nvarchar(4000),@p1277 nvarchar(4000),@p1278 int,@p1279 nvarchar(4000),@p1280 int,@p1281 int,@p1282 datetime2(7),@p1283 datetime2(7),@p1284 datetime2(7),@p1285 nvarchar(4000),@p1286 nvarchar(4000),@p1287 nvarchar(4000),@p1288 nvarchar(4000),@p1289 nvarchar(4000),@p1290 nvarchar(4000),@p1291 nvarchar(4000),@p1292 nvarchar(4000),@p1293 nvarchar(4000),@p1294 nvarchar(4000),@p1295 nvarchar(4000),@p1296 nvarchar(4000),@p1297 nvarchar(4000),@p1298 nvarchar(4000),@p1299 datetime2(7),@p1300 nvarchar(4000),@p1301 nvarchar(4000),@p1302 int,@p1303 int,@p1304 int,@p1305 nvarchar(4000),@p1306 nvarchar(4000),@p1307 nvarchar(4000),@p1308 decimal(18,2),@p1309 decimal(18,2),@p1310 nvarchar(4000),@p1311 nvarchar(4000),@p1312 decimal(18,2),@p1313 nvarchar(4000),@p1314 nvarchar(4000),@p1315 nvarchar(4000),@p1316 nvarchar(4000),@p1317 int,@p1318 nvarchar(4000),@p1319 nvarchar(4000),@p1320 nvarchar(4000),@p1321 nvarchar(4000),@p1322 nvarchar(4000),@p1323 nvarchar(4000),@p1324 nvarchar(4000),@p1325 nvarchar(4000),@p1326 nvarchar(4000),@p1327 nvarchar(4000),@p1328 int,@p1329 nvarchar(4000),@p1330 nvarchar(4000),@p1331 nvarchar(4000),@p1332 nvarchar(4000),@p1333 nvarchar(4000),@p1334 int,@p1335 nvarchar(4000),@p1336 int,@p1337 int,@p1338 datetime2(7),@p1339 datetime2(7),@p1340 datetime2(7),@p1341 nvarchar(4000),@p1342 nvarchar(4000),@p1343 nvarchar(4000),@p1344 nvarchar(4000),@p1345 nvarchar(4000),@p1346 nvarchar(4000),@p1347 nvarchar(4000),@p1348 nvarchar(4000),@p1349 nvarchar(4000),@p1350 nvarchar(4000),@p1351 nvarchar(4000),@p1352 nvarchar(4000),@p1353 nvarchar(4000),@p1354 nvarchar(4000),@p1355 datetime2(7),@p1356 nvarchar(4000),@p1357 nvarchar(4000),@p1358 int,@p1359 int,@p1360 int,@p1361 nvarchar(4000),@p1362 nvarchar(4000),@p1363 nvarchar(4000),@p1364 decimal(18,2),@p1365 decimal(18,2),@p1366 nvarchar(4000),@p1367 nvarchar(4000),@p1368 decimal(18,2),@p1369 nvarchar(4000),@p1370 nvarchar(4000),@p1371 nvarchar(4000),@p1372 nvarchar(4000),@p1373 int,@p1374 nvarchar(4000),@p1375 nvarchar(4000),@p1376 nvarchar(4000),@p1377 nvarchar(4000),@p1378 nvarchar(4000),@p1379 nvarchar(4000),@p1380 nvarchar(4000),@p1381 nvarchar(4000),@p1382 nvarchar(4000),@p1383 nvarchar(4000),@p1384 int,@p1385 nvarchar(4000),@p1386 nvarchar(4000),@p1387 nvarchar(4000),@p1388 nvarchar(4000),@p1389 nvarchar(4000),@p1390 int,@p1391 nvarchar(4000),@p1392 int,@p1393 int,@p1394 datetime2(7),@p1395 datetime2(7),@p1396 datetime2(7),@p1397 nvarchar(4000),@p1398 nvarchar(4000),@p1399 nvarchar(4000),@p1400 nvarchar(4000),@p1401 nvarchar(4000),@p1402 nvarchar(4000),@p1403 nvarchar(4000),@p1404 nvarchar(4000),@p1405 nvarchar(4000),@p1406 nvarchar(4000),@p1407 nvarchar(4000),@p1408 nvarchar(4000),@p1409 nvarchar(4000),@p1410 nvarchar(4000),@p1411 datetime2(7),@p1412 nvarchar(4000),@p1413 nvarchar(4000),@p1414 int,@p1415 int,@p1416 int,@p1417 nvarchar(4000),@p1418 nvarchar(4000),@p1419 nvarchar(4000),@p1420 decimal(18,2),@p1421 decimal(18,2),@p1422 nvarchar(4000),@p1423 nvarchar(4000),@p1424 decimal(18,2),@p1425 nvarchar(4000),@p1426 nvarchar(4000),@p1427 nvarchar(4000),@p1428 nvarchar(4000),@p1429 int,@p1430 nvarchar(4000),@p1431 nvarchar(4000),@p1432 nvarchar(4000),@p1433 nvarchar(4000),@p1434 nvarchar(4000),@p1435 nvarchar(4000),@p1436 nvarchar(4000),@p1437 nvarchar(4000),@p1438 nvarchar(4000),@p1439 nvarchar(4000),@p1440 int,@p1441 nvarchar(4000),@p1442 nvarchar(4000),@p1443 nvarchar(4000),@p1444 nvarchar(4000),@p1445 nvarchar(4000),@p1446 int,@p1447 nvarchar(4000),@p1448 int,@p1449 int,@p1450 datetime2(7),@p1451 datetime2(7),@p1452 datetime2(7),@p1453 nvarchar(4000),@p1454 nvarchar(4000),@p1455 nvarchar(4000),@p1456 nvarchar(4000),@p1457 nvarchar(4000),@p1458 nvarchar(4000),@p1459 nvarchar(4000),@p1460 nvarchar(4000),@p1461 nvarchar(4000),@p1462 nvarchar(4000),@p1463 nvarchar(4000),@p1464 nvarchar(4000),@p1465 nvarchar(4000),@p1466 nvarchar(4000),@p1467 datetime2(7),@p1468 nvarchar(4000),@p1469 nvarchar(4000),@p1470 int,@p1471 int,@p1472 int,@p1473 nvarchar(4000),@p1474 nvarchar(4000),@p1475 nvarchar(4000),@p1476 nvarchar(4000),@p1477 decimal(18,2),@p1478 nvarchar(4000),@p1479 nvarchar(4000),@p1480 decimal(18,2),@p1481 nvarchar(4000),@p1482 nvarchar(4000),@p1483 nvarchar(4000),@p1484 nvarchar(4000),@p1485 int,@p1486 nvarchar(4000),@p1487 nvarchar(4000),@p1488 nvarchar(4000),@p1489 nvarchar(4000),@p1490 nvarchar(4000),@p1491 nvarchar(4000),@p1492 nvarchar(4000),@p1493 nvarchar(4000),@p1494 nvarchar(4000),@p1495 nvarchar(4000),@p1496 int,@p1497 nvarchar(4000),@p1498 nvarchar(4000),@p1499 nvarchar(4000),@p1500 nvarchar(4000),@p1501 nvarchar(4000),@p1502 int,@p1503 nvarchar(4000),@p1504 int,@p1505 int,@p1506 datetime2(7),@p1507 datetime2(7),@p1508 datetime2(7),@p1509 nvarchar(4000),@p1510 nvarchar(4000),@p1511 nvarchar(4000),@p1512 nvarchar(4000),@p1513 nvarchar(4000),@p1514 nvarchar(4000),@p1515 nvarchar(4000),@p1516 nvarchar(4000),@p1517 nvarchar(4000),@p1518 nvarchar(4000),@p1519 nvarchar(4000),@p1520 nvarchar(4000),@p1521 nvarchar(4000),@p1522 nvarchar(4000),@p1523 datetime2(7),@p1524 nvarchar(4000),@p1525 nvarchar(4000),@p1526 int,@p1527 int,@p1528 int,@p1529 nvarchar(4000),@p1530 nvarchar(4000),@p1531 nvarchar(4000),@p1532 decimal(18,2),@p1533 decimal(18,2),@p1534 nvarchar(4000),@p1535 nvarchar(4000),@p1536 decimal(18,2),@p1537 nvarchar(4000),@p1538 nvarchar(4000),@p1539 nvarchar(4000),@p1540 nvarchar(4000),@p1541 int,@p1542 nvarchar(4000),@p1543 nvarchar(4000),@p1544 nvarchar(4000),@p1545 nvarchar(4000),@p1546 nvarchar(4000),@p1547 nvarchar(4000),@p1548 nvarchar(4000),@p1549 nvarchar(4000),@p1550 nvarchar(4000),@p1551 nvarchar(4000),@p1552 int,@p1553 nvarchar(4000),@p1554 nvarchar(4000),@p1555 nvarchar(4000),@p1556 nvarchar(4000),@p1557 nvarchar(4000),@p1558 int,@p1559 nvarchar(4000),@p1560 int,@p1561 int,@p1562 datetime2(7),@p1563 datetime2(7),@p1564 datetime2(7),@p1565 nvarchar(4000),@p1566 nvarchar(4000),@p1567 nvarchar(4000),@p1568 nvarchar(4000),@p1569 nvarchar(4000),@p1570 nvarchar(4000),@p1571 nvarchar(4000),@p1572 nvarchar(4000),@p1573 nvarchar(4000),@p1574 nvarchar(4000),@p1575 nvarchar(4000),@p1576 nvarchar(4000),@p1577 nvarchar(4000),@p1578 nvarchar(4000),@p1579 datetime2(7),@p1580 nvarchar(4000),@p1581 nvarchar(4000),@p1582 int,@p1583 int,@p1584 int,@p1585 nvarchar(4000),@p1586 nvarchar(4000),@p1587 nvarchar(4000),@p1588 decimal(18,2),@p1589 decimal(18,2),@p1590 nvarchar(4000),@p1591 nvarchar(4000),@p1592 decimal(18,2),@p1593 nvarchar(4000),@p1594 nvarchar(4000),@p1595 nvarchar(4000),@p1596 nvarchar(4000),@p1597 int,@p1598 nvarchar(4000),@p1599 nvarchar(4000),@p1600 nvarchar(4000),@p1601 nvarchar(4000),@p1602 nvarchar(4000),@p1603 nvarchar(4000),@p1604 nvarchar(4000),@p1605 nvarchar(4000),@p1606 nvarchar(4000),@p1607 nvarchar(4000),@p1608 int,@p1609 nvarchar(4000),@p1610 nvarchar(4000),@p1611 nvarchar(4000),@p1612 nvarchar(4000),@p1613 nvarchar(4000),@p1614 int,@p1615 nvarchar(4000),@p1616 int,@p1617 int,@p1618 datetime2(7),@p1619 datetime2(7),@p1620 datetime2(7),@p1621 nvarchar(4000),@p1622 nvarchar(4000),@p1623 nvarchar(4000),@p1624 nvarchar(4000),@p1625 nvarchar(4000),@p1626 nvarchar(4000),@p1627 nvarchar(4000),@p1628 nvarchar(4000),@p1629 nvarchar(4000),@p1630 nvarchar(4000),@p1631 nvarchar(4000),@p1632 nvarchar(4000),@p1633 nvarchar(4000),@p1634 nvarchar(4000),@p1635 datetime2(7),@p1636 nvarchar(4000),@p1637 nvarchar(4000),@p1638 int,@p1639 int,@p1640 int,@p1641 nvarchar(4000),@p1642 nvarchar(4000),@p1643 nvarchar(4000),@p1644 decimal(18,2),@p1645 decimal(18,2),@p1646 nvarchar(4000),@p1647 nvarchar(4000),@p1648 decimal(18,2),@p1649 nvarchar(4000),@p1650 nvarchar(4000),@p1651 nvarchar(4000),@p1652 nvarchar(4000),@p1653 int,@p1654 nvarchar(4000),@p1655 nvarchar(4000),@p1656 nvarchar(4000),@p1657 nvarchar(4000),@p1658 nvarchar(4000),@p1659 nvarchar(4000),@p1660 nvarchar(4000),@p1661 nvarchar(4000),@p1662 nvarchar(4000),@p1663 nvarchar(4000),@p1664 int,@p1665 nvarchar(4000),@p1666 nvarchar(4000),@p1667 nvarchar(4000),@p1668 nvarchar(4000),@p1669 nvarchar(4000),@p1670 int,@p1671 nvarchar(4000),@p1672 int,@p1673 int,@p1674 datetime2(7),@p1675 datetime2(7),@p1676 datetime2(7),@p1677 nvarchar(4000),@p1678 nvarchar(4000),@p1679 nvarchar(4000),@p1680 nvarchar(4000),@p1681 nvarchar(4000),@p1682 nvarchar(4000),@p1683 nvarchar(4000),@p1684 nvarchar(4000),@p1685 nvarchar(4000),@p1686 nvarchar(4000),@p1687 nvarchar(4000),@p1688 nvarchar(4000),@p1689 nvarchar(4000),@p1690 nvarchar(4000),@p1691 datetime2(7),@p1692 nvarchar(4000),@p1693 nvarchar(4000),@p1694 int,@p1695 int,@p1696 int,@p1697 nvarchar(4000),@p1698 nvarchar(4000),@p1699 nvarchar(4000),@p1700 decimal(18,2),@p1701 decimal(18,2),@p1702 nvarchar(4000),@p1703 nvarchar(4000),@p1704 decimal(18,2),@p1705 nvarchar(4000),@p1706 nvarchar(4000),@p1707 nvarchar(4000),@p1708 nvarchar(4000),@p1709 int,@p1710 nvarchar(4000),@p1711 nvarchar(4000),@p1712 nvarchar(4000),@p1713 nvarchar(4000),@p1714 nvarchar(4000),@p1715 nvarchar(4000),@p1716 nvarchar(4000),@p1717 nvarchar(4000),@p1718 nvarchar(4000),@p1719 nvarchar(4000),@p1720 int,@p1721 nvarchar(4000),@p1722 nvarchar(4000),@p1723 nvarchar(4000),@p1724 nvarchar(4000),@p1725 nvarchar(4000),@p1726 int,@p1727 nvarchar(4000),@p1728 int,@p1729 int,@p1730 datetime2(7),@p1731 datetime2(7),@p1732 datetime2(7),@p1733 nvarchar(4000),@p1734 nvarchar(4000),@p1735 nvarchar(4000),@p1736 nvarchar(4000),@p1737 nvarchar(4000),@p1738 nvarchar(4000),@p1739 nvarchar(4000),@p1740 nvarchar(4000),@p1741 nvarchar(4000),@p1742 nvarchar(4000),@p1743 nvarchar(4000),@p1744 nvarchar(4000),@p1745 nvarchar(4000),@p1746 nvarchar(4000),@p1747 datetime2(7),@p1748 nvarchar(4000),@p1749 nvarchar(4000),@p1750 int,@p1751 int,@p1752 int,@p1753 nvarchar(4000),@p1754 nvarchar(4000),@p1755 nvarchar(4000),@p1756 decimal(18,2),@p1757 decimal(18,2),@p1758 nvarchar(4000),@p1759 nvarchar(4000),@p1760 decimal(18,2),@p1761 nvarchar(4000),@p1762 nvarchar(4000),@p1763 nvarchar(4000),@p1764 nvarchar(4000),@p1765 int,@p1766 nvarchar(4000),@p1767 nvarchar(4000),@p1768 nvarchar(4000),@p1769 nvarchar(4000),@p1770 nvarchar(4000),@p1771 nvarchar(4000),@p1772 nvarchar(4000),@p1773 nvarchar(4000),@p1774 nvarchar(4000),@p1775 nvarchar(4000),@p1776 int,@p1777 nvarchar(4000),@p1778 nvarchar(4000),@p1779 nvarchar(4000),@p1780 nvarchar(4000),@p1781 nvarchar(4000),@p1782 int,@p1783 nvarchar(4000),@p1784 int,@p1785 int,@p1786 datetime2(7),@p1787 datetime2(7),@p1788 datetime2(7),@p1789 nvarchar(4000),@p1790 nvarchar(4000),@p1791 nvarchar(4000),@p1792 nvarchar(4000),@p1793 nvarchar(4000),@p1794 nvarchar(4000),@p1795 nvarchar(4000),@p1796 nvarchar(4000),@p1797 nvarchar(4000),@p1798 nvarchar(4000),@p1799 nvarchar(4000),@p1800 nvarchar(4000),@p1801 nvarchar(4000),@p1802 nvarchar(4000),@p1803 datetime2(7),@p1804 nvarchar(4000),@p1805 nvarchar(4000),@p1806 int,@p1807 int,@p1808 int,@p1809 nvarchar(4000),@p1810 nvarchar(4000),@p1811 nvarchar(4000),@p1812 decimal(18,2),@p1813 decimal(18,2),@p1814 nvarchar(4000),@p1815 nvarchar(4000),@p1816 decimal(18,2),@p1817 nvarchar(4000),@p1818 nvarchar(4000),@p1819 nvarchar(4000),@p1820 nvarchar(4000),@p1821 int,@p1822 nvarchar(4000),@p1823 nvarchar(4000),@p1824 nvarchar(4000),@p1825 nvarchar(4000),@p1826 nvarchar(4000),@p1827 nvarchar(4000),@p1828 nvarchar(4000),@p1829 nvarchar(4000),@p1830 nvarchar(4000),@p1831 nvarchar(4000),@p1832 int,@p1833 nvarchar(4000),@p1834 nvarchar(4000),@p1835 nvarchar(4000),@p1836 nvarchar(4000),@p1837 nvarchar(4000),@p1838 int,@p1839 nvarchar(4000),@p1840 int,@p1841 int,@p1842 datetime2(7),@p1843 datetime2(7),@p1844 datetime2(7),@p1845 nvarchar(4000),@p1846 nvarchar(4000),@p1847 nvarchar(4000),@p1848 nvarchar(4000),@p1849 nvarchar(4000),@p1850 nvarchar(4000),@p1851 nvarchar(4000),@p1852 nvarchar(4000),@p1853 nvarchar(4000),@p1854 nvarchar(4000),@p1855 nvarchar(4000),@p1856 nvarchar(4000),@p1857 nvarchar(4000),@p1858 nvarchar(4000),@p1859 datetime2(7),@p1860 nvarchar(4000),@p1861 nvarchar(4000),@p1862 int,@p1863 int,@p1864 int,@p1865 nvarchar(4000),@p1866 nvarchar(4000),@p1867 nvarchar(4000),@p1868 decimal(18,2),@p1869 decimal(18,2),@p1870 nvarchar(4000),@p1871 nvarchar(4000),@p1872 decimal(18,2),@p1873 nvarchar(4000),@p1874 nvarchar(4000),@p1875 nvarchar(4000),@p1876 nvarchar(4000),@p1877 int,@p1878 nvarchar(4000),@p1879 nvarchar(4000),@p1880 nvarchar(4000),@p1881 nvarchar(4000),@p1882 nvarchar(4000),@p1883 nvarchar(4000),@p1884 nvarchar(4000),@p1885 nvarchar(4000),@p1886 nvarchar(4000),@p1887 nvarchar(4000),@p1888 int,@p1889 nvarchar(4000),@p1890 nvarchar(4000),@p1891 nvarchar(4000),@p1892 nvarchar(4000),@p1893 nvarchar(4000),@p1894 int,@p1895 nvarchar(4000),@p1896 int,@p1897 int,@p1898 datetime2(7),@p1899 datetime2(7),@p1900 datetime2(7),@p1901 nvarchar(4000),@p1902 nvarchar(4000),@p1903 nvarchar(4000),@p1904 nvarchar(4000),@p1905 nvarchar(4000),@p1906 nvarchar(4000),@p1907 nvarchar(4000),@p1908 nvarchar(4000),@p1909 nvarchar(4000),@p1910 nvarchar(4000),@p1911 nvarchar(4000),@p1912 nvarchar(4000),@p1913 nvarchar(4000),@p1914 nvarchar(4000),@p1915 datetime2(7),@p1916 nvarchar(4000),@p1917 nvarchar(4000),@p1918 int,@p1919 int,@p1920 int,@p1921 nvarchar(4000),@p1922 nvarchar(4000),@p1923 nvarchar(4000),@p1924 decimal(18,2),@p1925 decimal(18,2),@p1926 nvarchar(4000),@p1927 nvarchar(4000),@p1928 decimal(18,2),@p1929 nvarchar(4000),@p1930 nvarchar(4000),@p1931 nvarchar(4000),@p1932 nvarchar(4000),@p1933 int,@p1934 nvarchar(4000),@p1935 nvarchar(4000),@p1936 nvarchar(4000),@p1937 nvarchar(4000),@p1938 nvarchar(4000),@p1939 nvarchar(4000),@p1940 nvarchar(4000),@p1941 nvarchar(4000),@p1942 nvarchar(4000),@p1943 nvarchar(4000),@p1944 int,@p1945 nvarchar(4000),@p1946 nvarchar(4000),@p1947 nvarchar(4000),@p1948 nvarchar(4000),@p1949 nvarchar(4000),@p1950 int,@p1951 nvarchar(4000),@p1952 int,@p1953 int,@p1954 datetime2(7),@p1955 datetime2(7),@p1956 datetime2(7),@p1957 nvarchar(4000),@p1958 nvarchar(4000),@p1959 nvarchar(4000),@p1960 nvarchar(4000),@p1961 nvarchar(4000),@p1962 nvarchar(4000),@p1963 nvarchar(4000),@p1964 nvarchar(4000),@p1965 nvarchar(4000),@p1966 nvarchar(4000),@p1967 nvarchar(4000),@p1968 nvarchar(4000),@p1969 nvarchar(4000),@p1970 nvarchar(4000),@p1971 datetime2(7),@p1972 nvarchar(4000),@p1973 nvarchar(4000),@p1974 int,@p1975 int,@p1976 int,@p1977 nvarchar(4000),@p1978 nvarchar(4000),@p1979 nvarchar(4000),@p1980 decimal(18,2),@p1981 decimal(18,2),@p1982 nvarchar(4000),@p1983 nvarchar(4000),@p1984 decimal(18,2),@p1985 nvarchar(4000),@p1986 nvarchar(4000),@p1987 nvarchar(4000),@p1988 nvarchar(4000),@p1989 int,@p1990 nvarchar(4000),@p1991 nvarchar(4000),@p1992 nvarchar(4000),@p1993 nvarchar(4000),@p1994 nvarchar(4000),@p1995 nvarchar(4000),@p1996 nvarchar(4000),@p1997 nvarchar(4000),@p1998 nvarchar(4000),@p1999 nvarchar(4000),@p2000 int,@p2001 nvarchar(4000),@p2002 nvarchar(4000),@p2003 nvarchar(4000),@p2004 nvarchar(4000),@p2005 nvarchar(4000),@p2006 int,@p2007 nvarchar(4000),@p2008 int,@p2009 int,@p2010 datetime2(7),@p2011 datetime2(7),@p2012 datetime2(7),@p2013 nvarchar(4000),@p2014 nvarchar(4000),@p2015 nvarchar(4000),@p2016 nvarchar(4000),@p2017 nvarchar(4000),@p2018 nvarchar(4000),@p2019 nvarchar(4000),@p2020 nvarchar(4000),@p2021 nvarchar(4000),@p2022 nvarchar(4000),@p2023 nvarchar(4000),@p2024 nvarchar(4000),@p2025 nvarchar(4000),@p2026 nvarchar(4000),@p2027 datetime2(7),@p2028 nvarchar(4000),@p2029 nvarchar(4000),@p2030 int,@p2031 int,@p2032 int,@p2033 nvarchar(4000),@p2034 nvarchar(4000),@p2035 nvarchar(4000),@p2036 decimal(18,2),@p2037 decimal(18,2),@p2038 nvarchar(4000),@p2039 nvarchar(4000),@p2040 decimal(18,2),@p2041 nvarchar(4000),@p2042 nvarchar(4000),@p2043 nvarchar(4000),@p2044 nvarchar(4000),@p2045 int,@p2046 nvarchar(4000),@p2047 nvarchar(4000),@p2048 nvarchar(4000),@p2049 nvarchar(4000),@p2050 nvarchar(4000),@p2051 nvarchar(4000),@p2052 nvarchar(4000),@p2053 nvarchar(4000),@p2054 nvarchar(4000),@p2055 nvarchar(4000),@p2056 int,@p2057 nvarchar(4000),@p2058 nvarchar(4000),@p2059 nvarchar(4000),@p2060 nvarchar(4000),@p2061 nvarchar(4000),@p2062 int,@p2063 nvarchar(4000),@p2064 int,@p2065 int,@p2066 datetime2(7),@p2067 datetime2(7),@p2068 datetime2(7),@p2069 nvarchar(4000),@p2070 nvarchar(4000),@p2071 nvarchar(4000))SET NOCOUNT ON; DECLARE @inserted0 TABLE ([item_id] int, [_Position] [int]); MERGE [raw_data] USING ( VALUES (@p0, @p1, @p2, @p3, @p4, @p5, @p6, @p7, @p8, @p9, @p10, @p11, @p12, @p13, @p14, @p15, @p16, @p17, @p18, @p19, @p20, @p21, @p22, @p23, @p24, @p25, @p26, @p27, @p28, @p29, @p30, @p31, @p32, @p33, @p34, @p35, @p36, @p37, @p38, @p39, @p40, @p41, @p42, @p43, @p44, @p45, @p46, @p47, @p48, @p49, @p50, @p51, @p52, @p53, @p54, @p55, 0), (@p56, @p57, @p58, @p59, @p60, @p61, @p62, @p63, @p64, @p65, @p66, @p67, @p68, @p69, @p70, @p71, @p72, @p73, @p74, @p75, @p76, @p77, @p78, @p79, @p80, @p81, @p82, @p83, @p84, @p85, @p86, @p87, @p88, @p89, @p90, @p91, @p92, @p93, @p94, @p95, @p96, @p97, @p98, @p99, @p100, @p101, @p102, @p103, @p104, @p105, @p106, @p107, @p108, @p109, @p110, @p111, 1), (@p112, @p113, @p114, @p115, @p116, @p117, @p118, @p119, @p120, @p121, @p122, @p123, @p124, @p125, @p126, @p127, @p128, @p129, @p130, @p131, @p132, @p133, @p134, @p135, @p136, @p137, @p138, @p139, @p140, @p141, @p142, @p143, @p144, @p145, @p146, @p147, @p148, @p149, @p150, @p151, @p152, @p153, @p154, @p155, @p156, @p157, @p158, @p159, @p160, @p161, @p162, @p163, @p164, @p165, @p166, @p167, 2), (@p168, @p169, @p170, @p171, @p172, @p173, @p174, @p175, @p176, @p177, @p178, @p179, @p180, @p181, @p182, @p183, @p184, @p185, @p186, @p187, @p188, @p189, @p190, @p191, @p192, @p193, @p194, @p195, @p196, @p197, @p198, @p199, @p200, @p201, @p202, @p203, @p204, @p205, @p206, @p207, @p208, @p209, @p210, @p211, @p212, @p213, @p214, @p215, @p216, @p217, @p218, @p219, @p220, @p221, @p222, @p223, 3), (@p224, @p225, @p226, @p227, @p228, @p229, @p230, @p231, @p232, @p233, @p234, @p235, @p236, @p237, @p238, @p239, @p240, @p241, @p242, @p243, @p244, @p245, @p246, @p247, @p248, @p249, @p250, @p251, @p252, @p253, @p254, @p255, @p256, @p257, @p258, @p259, @p260, @p261, @p262, @p263, @p264, @p265, @p266, @p267, @p268, @p269, @p270, @p271, @p272, @p273, @p274, @p275, @p276, @p277, @p278, @p279, 4), (@p280, @p281, @p282, @p283, @p284, @p285, @p286, @p287, @p288, @p289, @p290, @p291, @p292, @p293, @p294, @p295, @p296, @p297, @p298, @p299, @p300, @p301, @p302, @p303, @p304, @p305, @p306, @p307, @p308, @p309, @p310, @p311, @p312, @p313, @p314, @p315, @p316, @p317, @p318, @p319, @p320, @p321, @p322, @p323, @p324, @p325, @p326, @p327, @p328, @p329, @p330, @p331, @p332, @p333, @p334, @p335, 5), (@p336, @p337, @p338, @p339, @p340, @p341, @p342, @p343, @p344, @p345, @p346, @p347, @p348, @p349, @p350, @p351, @p352, @p353, @p354, @p355, @p356, @p357, @p358, @p359, @p360, @p361, @p362, @p363, @p364, @p365, @p366, @p367, @p368, @p369, @p370, @p371, @p372, @p373, @p374, @p375, @p376, @p377, @p378, @p379, @p380, @p381, @p382, @p383, @p384, @p385, @p386, @p387, @p388, @p389, @p390, @p391, 6), (@p392, @p393, @p394, @p395, @p396, @p397, @p398, @p399, @p400, @p401, @p402, @p403, @p404, @p405, @p406, @p407, @p408, @p409, @p410, @p411, @p412, @p413, @p414, @p415, @p416, @p417, @p418, @p419, @p420, @p421, @p422, @p423, @p424, @p425, @p426, @p427, @p428, @p429, @p430, @p431, @p432, @p433, @p434, @p435, @p436, @p437, @p438, @p439, @p440, @p441, @p442, @p443, @p444, @p445, @p446, @p447, 7), (@p448, @p449, @p450, @p451, @p452, @p453, @p454, @p455, @p456, @p457, @p458, @p459, @p460, @p461, @p462, @p463, @p464, @p465, @p466, @p467, @p468, @p469, @p470, @p471, @p472, @p473, @p474, @p475, @p476, @p477, @p478, @p479, @p480, @p481, @p482, @p483, @p484, @p485, @p486, @p487, @p488, @p489, @p490, @p491, @p492, @p493, @p494, @p495, @p496, @p497, @p498, @p499, @p500, @p501, @p502, @p503, 8), (@p504, @p505, @p506, @p507, @p508, @p509, @p510, @p511, @p512, @p513, @p514, @p515, @p516, @p517, @p518, @p519, @p520, @p521, @p522, @p523, @p524, @p525, @p526, @p527, @p528, @p529, @p530, @p531, @p532, @p533, @p534, @p535, @p536, @p537, @p538, @p539, @p540, @p541, @p542, @p543, @p544, @p545, @p546, @p547, @p548, @p549, @p550, @p551, @p552, @p553, @p554, @p555, @p556, @p557, @p558, @p559, 9), (@p560, @p561, @p562, @p563, @p564, @p565, @p566, @p567, @p568, @p569, @p570, @p571, @p572, @p573, @p574, @p575, @p576, @p577, @p578, @p579, @p580, @p581, @p582, @p583, @p584, @p585, @p586, @p587, @p588, @p589, @p590, @p591, @p592, @p593, @p594, @p595, @p596, @p597, @p598, @p599, @p600, @p601, @p602, @p603, @p604, @p605, @p606, @p607, @p608, @p609, @p610, @p611, @p612, @p613, @p614, @p615, 10), (@p616, @p617, @p618, @p619, @p620, @p621, @p622, @p623, @p624, @p625, @p626, @p627, @p628, @p629, @p630, @p631, @p632, @p633, @p634, @p635, @p636, @p637, @p638, @p639, @p640, @p641, @p642, @p643, @p644, @p645, @p646, @p647, @p648, @p649, @p650, @p651, @p652, @p653, @p654, @p655, @p656, @p657, @p658, @p659, @p660, @p661, @p662, @p663, @p664, @p665, @p666, @p667, @p668, @p669, @p670, @p671, 11), (@p672, @p673, @p674, @p675, @p676, @p677, @p678, @p679, @p680, @p681, @p682, @p683, @p684, @p685, @p686, @p687, @p688, @p689, @p690, @p691, @p692, @p693, @p694, @p695, @p696, @p697, @p698, @p699, @p700, @p701, @p702, @p703, @p704, @p705, @p706, @p707, @p708, @p709, @p710, @p711, @p712, @p713, @p714, @p715, @p716, @p717, @p718, @p719, @p720, @p721, @p722, @p723, @p724, @p725, @p726, @p727, 12), (@p728, @p729, @p730, @p731, @p732, @p733, @p734, @p735, @p736, @p737, @p738, @p739, @p740, @p741, @p742, @p743, @p744, @p745, @p746, @p747, @p748, @p749, @p750, @p751, @p752, @p753, @p754, @p755, @p756, @p757, @p758, @p759, @p760, @p761, @p762, @p763, @p764, @p765, @p766, @p767, @p768, @p769, @p770, @p771, @p772, @p773, @p774, @p775, @p776, @p777, @p778, @p779, @p780, @p781, @p782, @p783, 13), (@p784, @p785, @p786, @p787, @p788, @p789, @p790, @p791, @p792, @p793, @p794, @p795, @p796, @p797, @p798, @p799, @p800, @p801, @p802, @p803, @p804, @p805, @p806, @p807, @p808, @p809, @p810, @p811, @p812, @p813, @p814, @p815, @p816, @p817, @p818, @p819, @p820, @p821, @p822, @p823, @p824, @p825, @p826, @p827, @p828, @p829, @p830, @p831, @p832, @p833, @p834, @p835, @p836, @p837, @p838, @p839, 14), (@p840, @p841, @p842, @p843, @p844, @p845, @p846, @p847, @p848, @p849, @p850, @p851, @p852, @p853, @p854, @p855, @p856, @p857, @p858, @p859, @p860, @p861, @p862, @p863, @p864, @p865, @p866, @p867, @p868, @p869, @p870, @p871, @p872, @p873, @p874, @p875, @p876, @p877, @p878, @p879, @p880, @p881, @p882, @p883, @p884, @p885, @p886, @p887, @p888, @p889, @p890, @p891, @p892, @p893, @p894, @p895, 15), (@p896, @p897, @p898, @p899, @p900, @p901, @p902, @p903, @p904, @p905, @p906, @p907, @p908, @p909, @p910, @p911, @p912, @p913, @p914, @p915, @p916, @p917, @p918, @p919, @p920, @p921, @p922, @p923, @p924, @p925, @p926, @p927, @p928, @p929, @p930, @p931, @p932, @p933, @p934, @p935, @p936, @p937, @p938, @p939, @p940, @p941, @p942, @p943, @p944, @p945, @p946, @p947, @p948, @p949, @p950, @p951, 16), (@p952, @p953, @p954, @p955, @p956, @p957, @p958, @p959, @p960, @p961, @p962, @p963, @p964, @p965, @p966, @p967, @p968, @p969, @p970, @p971, @p972, @p973, @p974, @p975, @p976, @p977, @p978, @p979, @p980, @p981, @p982, @p983, @p984, @p985, @p986, @p987, @p988, @p989, @p990, @p991, @p992, @p993, @p994, @p995, @p996, @p997, @p998, @p999, @p1000, @p1001, @p1002, @p1003, @p1004, @p1005, @p1006, @p1007, 17), (@p1008, @p1009, @p1010, @p1011, @p1012, @p1013, @p1014, @p1015, @p1016, @p1017, @p1018, @p1019, @p1020, @p1021, @p1022, @p1023, @p1024, @p1025, @p1026, @p1027, @p1028, @p1029, @p1030, @p1031, @p1032, @p1033, @p1034, @p1035, @p1036, @p1037, @p1038, @p1039, @p1040, @p1041, @p1042, @p1043, @p1044, @p1045, @p1046, @p1047, @p1048, @p1049, @p1050, @p1051, @p1052, @p1053, @p1054, @p1055, @p1056, @p1057, @p1058, @p1059, @p1060, @p1061, @p1062, @p1063, 18), (@p1064, @p1065, @p1066, @p1067, @p1068, @p1069, @p1070, @p1071, @p1072, @p1073, @p1074, @p1075, @p1076, @p1077, @p1078, @p1079, @p1080, @p1081, @p1082, @p1083, @p1084, @p1085, @p1086, @p1087, @p1088, @p1089, @p1090, @p1091, @p1092, @p1093, @p1094, @p1095, @p1096, @p1097, @p1098, @p1099, @p1100, @p1101, @p1102, @p1103, @p1104, @p1105, @p1106, @p1107, @p1108, @p1109, @p1110, @p1111, @p1112, @p1113, @p1114, @p1115, @p1116, @p1117, @p1118, @p1119, 19), (@p1120, @p1121, @p1122, @p1123, @p1124, @p1125, @p1126, @p1127, @p1128, @p1129, @p1130, @p1131, @p1132, @p1133, @p1134, @p1135, @p1136, @p1137, @p1138, @p1139, @p1140, @p1141, @p1142, @p1143, @p1144, @p1145, @p1146, @p1147, @p1148, @p1149, @p1150, @p1151, @p1152, @p1153, @p1154, @p1155, @p1156, @p1157, @p1158, @p1159, @p1160, @p1161, @p1162, @p1163, @p1164, @p1165, @p1166, @p1167, @p1168, @p1169, @p1170, @p1171, @p1172, @p1173, @p1174, @p1175, 20), (@p1176, @p1177, @p1178, @p1179, @p1180, @p1181, @p1182, @p1183, @p1184, @p1185, @p1186, @p1187, @p1188, @p1189, @p1190, @p1191, @p1192, @p1193, @p1194, @p1195, @p1196, @p1197, @p1198, @p1199, @p1200, @p1201, @p1202, @p1203, @p1204, @p1205, @p1206, @p1207, @p1208, @p1209, @p1210, @p1211, @p1212, @p1213, @p1214, @p1215, @p1216, @p1217, @p1218, @p1219, @p1220, @p1221, @p1222, @p1223, @p1224, @p1225, @p1226, @p1227, @p1228, @p1229, @p1230, @p1231, 21), (@p1232, @p1233, @p1234, @p1235, @p1236, @p1237, @p1238, @p1239, @p1240, @p1241, @p1242, @p1243, @p1244, @p1245, @p1246, @p1247, @p1248, @p1249, @p1250, @p1251, @p1252, @p1253, @p1254, @p1255, @p1256, @p1257, @p1258, @p1259, @p1260, @p1261, @p1262, @p1263, @p1264, @p1265, @p1266, @p1267, @p1268, @p1269, @p1270, @p1271, @p1272, @p1273, @p1274, @p1275, @p1276, @p1277, @p1278, @p1279, @p1280, @p1281, @p1282, @p1283, @p1284, @p1285, @p1286, @p1287, 22), (@p1288, @p1289, @p1290, @p1291, @p1292, @p1293, @p1294, @p1295, @p1296, @p1297, @p1298, @p1299, @p1300, @p1301, @p1302, @p1303, @p1304, @p1305, @p1306, @p1307, @p1308, @p1309, @p1310, @p1311, @p1312, @p1313, @p1314, @p1315, @p1316, @p1317, @p1318, @p1319, @p1320, @p1321, @p1322, @p1323, @p1324, @p1325, @p1326, @p1327, @p1328, @p1329, @p1330, @p1331, @p1332, @p1333, @p1334, @p1335, @p1336, @p1337, @p1338, @p1339, @p1340, @p1341, @p1342, @p1343, 23), (@p1344, @p1345, @p1346, @p1347, @p1348, @p1349, @p1350, @p1351, @p1352, @p1353, @p1354, @p1355, @p1356, @p1357, @p1358, @p1359, @p1360, @p1361, @p1362, @p1363, @p1364, @p1365, @p1366, @p1367, @p1368, @p1369, @p1370, @p1371, @p1372, @p1373, @p1374, @p1375, @p1376, @p1377, @p1378, @p1379, @p1380, @p1381, @p1382, @p1383, @p1384, @p1385, @p1386, @p1387, @p1388, @p1389, @p1390, @p1391, @p1392, @p1393, @p1394, @p1395, @p1396, @p1397, @p1398, @p1399, 24), (@p1400, @p1401, @p1402, @p1403, @p1404, @p1405, @p1406, @p1407, @p1408, @p1409, @p1410, @p1411, @p1412, @p1413, @p1414, @p1415, @p1416, @p1417, @p1418, @p1419, @p1420, @p1421, @p1422, @p1423, @p1424, @p1425, @p1426, @p1427, @p1428, @p1429, @p1430, @p1431, @p1432, @p1433, @p1434, @p1435, @p1436, @p1437, @p1438, @p1439, @p1440, @p1441, @p1442, @p1443, @p1444, @p1445, @p1446, @p1447, @p1448, @p1449, @p1450, @p1451, @p1452, @p1453, @p1454, @p1455, 25), (@p1456, @p1457, @p1458, @p1459, @p1460, @p1461, @p1462, @p1463, @p1464, @p1465, @p1466, @p1467, @p1468, @p1469, @p1470, @p1471, @p1472, @p1473, @p1474, @p1475, @p1476, @p1477, @p1478, @p1479, @p1480, @p1481, @p1482, @p1483, @p1484, @p1485, @p1486, @p1487, @p1488, @p1489, @p1490, @p1491, @p1492, @p1493, @p1494, @p1495, @p1496, @p1497, @p1498, @p1499, @p1500, @p1501, @p1502, @p1503, @p1504, @p1505, @p1506, @p1507, @p1508, @p1509, @p1510, @p1511, 26), (@p1512, @p1513, @p1514, @p1515, @p1516, @p1517, @p1518, @p1519, @p1520, @p1521, @p1522, @p1523, @p1524, @p1525, @p1526, @p1527, @p1528, @p1529, @p1530, @p1531, @p1532, @p1533, @p1534, @p1535, @p1536, @p1537, @p1538, @p1539, @p1540, @p1541, @p1542, @p1543, @p1544, @p1545, @p1546, @p1547, @p1548, @p1549, @p1550, @p1551, @p1552, @p1553, @p1554, @p1555, @p1556, @p1557, @p1558, @p1559, @p1560, @p1561, @p1562, @p1563, @p1564, @p1565, @p1566, @p1567, 27), (@p1568, @p1569, @p1570, @p1571, @p1572, @p1573, @p1574, @p1575, @p1576, @p1577, @p1578, @p1579, @p1580, @p1581, @p1582, @p1583, @p1584, @p1585, @p1586, @p1587, @p1588, @p1589, @p1590, @p1591, @p1592, @p1593, @p1594, @p1595, @p1596, @p1597, @p1598, @p1599, @p1600, @p1601, @p1602, @p1603, @p1604, @p1605, @p1606, @p1607, @p1608, @p1609, @p1610, @p1611, @p1612, @p1613, @p1614, @p1615, @p1616, @p1617, @p1618, @p1619, @p1620, @p1621, @p1622, @p1623, 28), (@p1624, @p1625, @p1626, @p1627, @p1628, @p1629, @p1630, @p1631, @p1632, @p1633, @p1634, @p1635, @p1636, @p1637, @p1638, @p1639, @p1640, @p1641, @p1642, @p1643, @p1644, @p1645, @p1646, @p1647, @p1648, @p1649, @p1650, @p1651, @p1652, @p1653, @p1654, @p1655, @p1656, @p1657, @p1658, @p1659, @p1660, @p1661, @p1662, @p1663, @p1664, @p1665, @p1666, @p1667, @p1668, @p1669, @p1670, @p1671, @p1672, @p1673, @p1674, @p1675, @p1676, @p1677, @p1678, @p1679, 29), (@p1680, @p1681, @p1682, @p1683, @p1684, @p1685, @p1686, @p1687, @p1688, @p1689, @p1690, @p1691, @p1692, @p1693, @p1694, @p1695, @p1696, @p1697, @p1698, @p1699, @p1700, @p1701, @p1702, @p1703, @p1704, @p1705, @p1706, @p1707, @p1708, @p1709, @p1710, @p1711, @p1712, @p1713, @p1714, @p1715, @p1716, @p1717, @p1718, @p1719, @p1720, @p1721, @p1722, @p1723, @p1724, @p1725, @p1726, @p1727, @p1728, @p1729, @p1730, @p1731, @p1732, @p1733, @p1734, @p1735, 30), (@p1736, @p1737, @p1738, @p1739, @p1740, @p1741, @p1742, @p1743, @p1744, @p1745, @p1746, @p1747, @p1748, @p1749, @p1750, @p1751, @p1752, @p1753, @p1754, @p1755, @p1756, @p1757, @p1758, @p1759, @p1760, @p1761, @p1762, @p1763, @p1764, @p1765, @p1766, @p1767, @p1768, @p1769, @p1770, @p1771, @p1772, @p1773, @p1774, @p1775, @p1776, @p1777, @p1778, @p1779, @p1780, @p1781, @p1782, @p1783, @p1784, @p1785, @p1786, @p1787, @p1788, @p1789, @p1790, @p1791, 31), (@p1792, @p1793, @p1794, @p1795, @p1796, @p1797, @p1798, @p1799, @p1800, @p1801, @p1802, @p1803, @p1804, @p1805, @p1806, @p1807, @p1808, @p1809, @p1810, @p1811, @p1812, @p1813, @p1814, @p1815, @p1816, @p1817, @p1818, @p1819, @p1820, @p1821, @p1822, @p1823, @p1824, @p1825, @p1826, @p1827, @p1828, @p1829, @p1830, @p1831, @p1832, @p1833, @p1834, @p1835, @p1836, @p1837, @p1838, @p1839, @p1840, @p1841, @p1842, @p1843, @p1844, @p1845, @p1846, @p1847, 32), (@p1848, @p1849, @p1850, @p1851, @p1852, @p1853, @p1854, @p1855, @p1856, @p1857, @p1858, @p1859, @p1860, @p1861, @p1862, @p1863, @p1864, @p1865, @p1866, @p1867, @p1868, @p1869, @p1870, @p1871, @p1872, @p1873, @p1874, @p1875, @p1876, @p1877, @p1878, @p1879, @p1880, @p1881, @p1882, @p1883, @p1884, @p1885, @p1886, @p1887, @p1888, @p1889, @p1890, @p1891, @p1892, @p1893, @p1894, @p1895, @p1896, @p1897, @p1898, @p1899, @p1900, @p1901, @p1902, @p1903, 33), (@p1904, @p1905, @p1906, @p1907, @p1908, @p1909, @p1910, @p1911, @p1912, @p1913, @p1914, @p1915, @p1916, @p1917, @p1918, @p1919, @p1920, @p1921, @p1922, @p1923, @p1924, @p1925, @p1926, @p1927, @p1928, @p1929, @p1930, @p1931, @p1932, @p1933, @p1934, @p1935, @p1936, @p1937, @p1938, @p1939, @p1940, @p1941, @p1942, @p1943, @p1944, @p1945, @p1946, @p1947, @p1948, @p1949, @p1950, @p1951, @p1952, @p1953, @p1954, @p1955, @p1956, @p1957, @p1958, @p1959, 34), (@p1960, @p1961, @p1962, @p1963, @p1964, @p1965, @p1966, @p1967, @p1968, @p1969, @p1970, @p1971, @p1972, @p1973, @p1974, @p1975, @p1976, @p1977, @p1978, @p1979, @p1980, @p1981, @p1982, @p1983, @p1984, @p1985, @p1986, @p1987, @p1988, @p1989, @p1990, @p1991, @p1992, @p1993, @p1994, @p1995, @p1996, @p1997, @p1998, @p1999, @p2000, @p2001, @p2002, @p2003, @p2004, @p2005, @p2006, @p2007, @p2008, @p2009, @p2010, @p2011, @p2012, @p2013, @p2014, @p2015, 35), (@p2016, @p2017, @p2018, @p2019, @p2020, @p2021, @p2022, @p2023, @p2024, @p2025, @p2026, @p2027, @p2028, @p2029, @p2030, @p2031, @p2032, @p2033, @p2034, @p2035, @p2036, @p2037, @p2038, @p2039, @p2040, @p2041, @p2042, @p2043, @p2044, @p2045, @p2046, @p2047, @p2048, @p2049, @p2050, @p2051, @p2052, @p2053, @p2054, @p2055, @p2056, @p2057, @p2058, @p2059, @p2060, @p2061, @p2062, @p2063, @p2064, @p2065, @p2066, @p2067, @p2068, @p2069, @p2070, @p2071, 36)) AS i ([addressee_cntry_cd], [addressee_city], [addressee_district], [addressee_email], [addressee_full_address], [addressee_home_address], [addressee_name], [addressee_postcode], [addressee_province], [addressee_subdistrict], [addressee_tel], [create_table], [delivery_code], [delivery_recipient_name], [delivery_relation_id], [delivery_status_id], [dest_outlet_id], [dest_outlet_port], [document_number], [item_barcode], [item_cod], [item_gross_weight], [item_height], [item_length], [item_price], [item_width], [lat], [log_id], [long], [outlet_id], [outlet_port], [podUrl], [remark], [scan_cntry_cd], [scan_cntry_postcode], [sender_cntry_cd], [sender_district], [sender_email], [sender_full_address], [sender_home_address], [member_id], [sender_name], [sender_postcode], [sender_province], [sender_subdistrict], [sender_tel], [server_id], [signatureUrl], [state], [status_code], [status_dtm], [timestamp], [transmit_dtm], [user_id], [wckt_id], [wkstn_no], _Position) ON 1=0 WHEN NOT MATCHED THEN INSERT ([addressee_cntry_cd], [addressee_city], [addressee_district], [addressee_email], [addressee_full_address], [addressee_home_address], [addressee_name], [addressee_postcode], [addressee_province], [addressee_subdistrict], [addressee_tel], [create_table], [delivery_code], [delivery_recipient_name], [delivery_relation_id], [delivery_status_id], [dest_outlet_id], [dest_outlet_port], [document_number], [item_barcode], [item_cod], [item_gross_weight], [item_height], [item_length], [item_price], [item_width], [lat], [log_id], [long], [outlet_id], [outlet_port], [podUrl], [remark], [scan_cntry_cd], [scan_cntry_postcode], [sender_cntry_cd], [sender_district], [sender_email], [sender_full_address], [sender_home_address], [member_id], [sender_name], [sender_postcode], [sender_province], [sender_subdistrict], [sender_tel], [server_id], [signatureUrl], [state], [status_code], [status_dtm], [timestamp], [transmit_dtm], [user_id], [wckt_id], [wkstn_no]) VALUES (i.[addressee_cntry_cd], i.[addressee_city], i.[addressee_district], i.[addressee_email], i.[addressee_full_address], i.[addressee_home_address], i.[addressee_name], i.[addressee_postcode], i.[addressee_province], i.[addressee_subdistrict], i.[addressee_tel], i.[create_table], i.[delivery_code], i.[delivery_recipient_name], i.[delivery_relation_id], i.[delivery_status_id], i.[dest_outlet_id], i.[dest_outlet_port], i.[document_number], i.[item_barcode], i.[item_cod], i.[item_gross_weight], i.[item_height], i.[item_length], i.[item_price], i.[item_width], i.[lat], i.[log_id], i.[long], i.[outlet_id], i.[outlet_port], i.[podUrl], i.[remark], i.[scan_cntry_cd], i.[scan_cntry_postcode], i.[sender_cntry_cd], i.[sender_district], i.[sender_email], i.[sender_full_address], i.[sender_home_address], i.[member_id], i.[sender_name], i.[sender_postcode], i.[sender_province], i.[sender_subdistrict], i.[sender_tel], i.[server_id], i.[signatureUrl], i.[state], i.[status_code], i.[status_dtm], i.[timestamp], i.[transmit_dtm], i.[user_id], i.[wckt_id], i.[wkstn_no]) OUTPUT INSERTED.[item_id], i._Position INTO @inserted0;  SELECT [t].[item_id] FROM [raw_data] t INNER JOIN @inserted0 i ON ([t].[item_id] = [i].[item_id]) ORDER BY [i].[_Position];  ",4,4,0,438,2,4
"SELECT     DB_NAME (database_id) as [Database Name],     name as [Database File Name],     [Type] = CASE WHEN Type_Desc = 'ROWS' THEN 'Data File(s)'             WHEN Type_Desc = 'LOG'  THEN 'Log File(s)'             ELSE Type_Desc END,     size*8/1024 as 'Size (MB)',     physical_name as [Database_File_Location] FROM sys.master_files ORDER BY 1,3  IF OBJECT_ID('tempdb.dbo.#space') IS NOT NULL     DROP TABLE #space  CREATE TABLE #space (       database_id INT PRIMARY KEY     , data_used_size DECIMAL(18,2)     , log_used_size DECIMAL(18,2) )  DECLARE @SQL NVARCHAR(MAX)  SELECT @SQL = STUFF((     SELECT '     USE [' + d.name + ']     INSERT INTO #space (database_id, data_used_size, log_used_size)     SELECT           DB_ID()         , SUM(CASE WHEN [type] = 0 THEN space_used END)         , SUM(CASE WHEN [type] = 1 THEN space_used END)     FROM (         SELECT s.[type], space_used = SUM(FILEPROPERTY(s.name, ''SpaceUsed'') * 8. / 1024)         FROM sys.database_files s         GROUP BY s.[type]     ) t;'     FROM sys.databases d     WHERE d.[state] = 0     FOR XML PATH(''), TYPE).value('.', 'NVARCHAR(MAX)'), 1, 2, '')  EXEC sys.sp_executesql @SQL  SELECT       d.database_id     , d.name     , d.state_desc     , d.recovery_model_desc     , t.total_size     , t.data_size     , s.data_used_size     , t.log_size     , s.log_used_size     , bu.full_last_date     , bu.full_size     , bu.log_last_date     , bu.log_size FROM (     SELECT           database_id         , log_size = CAST(SUM(CASE WHEN [type] = 1 THEN size END) * 8. / 1024 AS DECIMAL(18,2))         , data_size = CAST(SUM(CASE WHEN [type] = 0 THEN size END) * 8. / 1024 AS DECIMAL(18,2))         , total_size = CAST(SUM(size) * 8. / 1024 AS DECIMAL(18,2))     FROM sys.master_files     GROUP BY database_id ) t JOIN sys.databases d ON d.database_id = t.database_id LEFT JOIN #space s ON d.database_id = s.database_id LEFT JOIN (     SELECT           database_name         , full_last_date = MAX(CASE WHEN [type] = 'D' THEN backup_finish_date END)         , full_size = MAX(CASE WHEN [type] = 'D' THEN backup_size END)         , log_last_date = MAX(CASE WHEN [type] = 'L' THEN backup_finish_date END)         , log_size = MAX(CASE WHEN [type] = 'L' THEN backup_size END)     FROM (         SELECT               s.database_name             , s.[type]             , s.backup_finish_date             , backup_size =                         CAST(CASE WHEN s.backup_size = s.compressed_backup_size                                     THEN s.backup_size                                     ELSE s.compressed_backup_size                         END / 1048576.0 AS DECIMAL(18,2))             , RowNum = ROW_NUMBER() OVER (PARTITION BY s.database_name, s.[type] ORDER BY s.backup_finish_date DESC)         FROM msdb.dbo.backupset s         WHERE s.[type] IN ('D', 'L')     ) f     WHERE f.RowNum = 1     GROUP BY f.database_name ) bu ON d.name = bu.database_name ORDER BY t.total_size DESC  SELECT      req.session_id     , req.total_elapsed_time AS duration_ms     , req.cpu_time AS cpu_time_ms     , req.total_elapsed_time - req.cpu_time AS wait_time     , req.logical_reads     , SUBSTRING (REPLACE (REPLACE (SUBSTRING (ST.text, (req.statement_start_offset/2) + 1,         ((CASE statement_end_offset            WHEN -1            THEN DATALENGTH(ST.text)              ELSE req.statement_end_offset          END - req.statement_start_offset)/2) + 1) , CHAR(10), ' '), CHAR(13), ' '),        1, 512)  AS statement_text   FROM sys.dm_exec_requests AS req     CROSS APPLY sys.dm_exec_sql_text(req.sql_handle) AS ST ORDER BY total_elapsed_time DESC;  SELECT top 100 t.text,      (qs.total_elapsed_time/1000) / qs.execution_count AS avg_elapsed_time,      (qs.total_worker_time/1000) / qs.execution_count AS avg_cpu_time,      ((qs.total_elapsed_time/1000) / qs.execution_count ) - ((qs.total_worker_time/1000) / qs.execution_count) AS avg_wait_time,      qs.total_logical_reads / qs.execution_count AS avg_logical_reads,      qs.total_logical_writes / qs.execution_count AS avg_writes,      (qs.total_elapsed_time/1000) AS cumulative_elapsed_time_all_executions FROM sys.dm_exec_query_stats qs      CROSS apply sys.Dm_exec_sql_text (sql_handle) t -- WHERE t.text like '<Your Query>%' -- Replace <Your Query> with your query or the beginning part of your query. The special chars like '[','_','%','^' in the query should be escaped. ORDER BY (qs.total_elapsed_time / qs.execution_count) DESC  --Deadlock sql check SELECT     session_id,     start_time,      [status],     command,     blocking_session_id,     wait_type,     wait_time,     open_transaction_count,     transaction_id,     total_elapsed_time,     Definition = CAST(text AS VARCHAR(MAX)) FROM     SYS.DM_EXEC_REQUESTS     CROSS APPLY sys.dm_exec_sql_text(sql_handle)  WHERE blocking_session_id != 0  SELECT sqlserver_start_time, (committed_kb/1024) AS Total_Server_Memory_MB, (committed_target_kb/1024)  AS Target_Server_Memory_MB FROM sys.dm_os_sys_info;",4,4,0,38,0,4
"(@p0 nvarchar(4000),@p1 nvarchar(4000),@p2 nvarchar(4000),@p3 nvarchar(4000),@p4 nvarchar(4000),@p5 nvarchar(4000),@p6 nvarchar(4000),@p7 nvarchar(4000),@p8 nvarchar(4000),@p9 nvarchar(4000),@p10 nvarchar(4000),@p11 datetime2(7),@p12 nvarchar(4000),@p13 nvarchar(4000),@p14 int,@p15 int,@p16 int,@p17 nvarchar(4000),@p18 nvarchar(4000),@p19 nvarchar(4000),@p20 nvarchar(4000),@p21 decimal(18,2),@p22 nvarchar(4000),@p23 nvarchar(4000),@p24 decimal(18,2),@p25 nvarchar(4000),@p26 nvarchar(4000),@p27 nvarchar(4000),@p28 nvarchar(4000),@p29 int,@p30 nvarchar(4000),@p31 nvarchar(4000),@p32 nvarchar(4000),@p33 nvarchar(4000),@p34 nvarchar(4000),@p35 nvarchar(4000),@p36 nvarchar(4000),@p37 nvarchar(4000),@p38 nvarchar(4000),@p39 nvarchar(4000),@p40 int,@p41 nvarchar(4000),@p42 nvarchar(4000),@p43 nvarchar(4000),@p44 nvarchar(4000),@p45 nvarchar(4000),@p46 int,@p47 nvarchar(4000),@p48 int,@p49 int,@p50 datetime2(7),@p51 datetime2(7),@p52 datetime2(7),@p53 nvarchar(4000),@p54 nvarchar(4000),@p55 nvarchar(4000),@p56 nvarchar(4000),@p57 nvarchar(4000),@p58 nvarchar(4000),@p59 nvarchar(4000),@p60 nvarchar(4000),@p61 nvarchar(4000),@p62 nvarchar(4000),@p63 nvarchar(4000),@p64 nvarchar(4000),@p65 nvarchar(4000),@p66 nvarchar(4000),@p67 datetime2(7),@p68 nvarchar(4000),@p69 nvarchar(4000),@p70 int,@p71 int,@p72 int,@p73 nvarchar(4000),@p74 nvarchar(4000),@p75 nvarchar(4000),@p76 nvarchar(4000),@p77 decimal(18,2),@p78 nvarchar(4000),@p79 nvarchar(4000),@p80 decimal(18,2),@p81 nvarchar(4000),@p82 nvarchar(4000),@p83 nvarchar(4000),@p84 nvarchar(4000),@p85 int,@p86 nvarchar(4000),@p87 nvarchar(4000),@p88 nvarchar(4000),@p89 nvarchar(4000),@p90 nvarchar(4000),@p91 nvarchar(4000),@p92 nvarchar(4000),@p93 nvarchar(4000),@p94 nvarchar(4000),@p95 nvarchar(4000),@p96 int,@p97 nvarchar(4000),@p98 nvarchar(4000),@p99 nvarchar(4000),@p100 nvarchar(4000),@p101 nvarchar(4000),@p102 int,@p103 nvarchar(4000),@p104 int,@p105 int,@p106 datetime2(7),@p107 datetime2(7),@p108 datetime2(7),@p109 nvarchar(4000),@p110 nvarchar(4000),@p111 nvarchar(4000),@p112 nvarchar(4000),@p113 nvarchar(4000),@p114 nvarchar(4000),@p115 nvarchar(4000),@p116 nvarchar(4000),@p117 nvarchar(4000),@p118 nvarchar(4000),@p119 nvarchar(4000),@p120 nvarchar(4000),@p121 nvarchar(4000),@p122 nvarchar(4000),@p123 datetime2(7),@p124 nvarchar(4000),@p125 nvarchar(4000),@p126 int,@p127 int,@p128 int,@p129 nvarchar(4000),@p130 nvarchar(4000),@p131 nvarchar(4000),@p132 nvarchar(4000),@p133 decimal(18,2),@p134 nvarchar(4000),@p135 nvarchar(4000),@p136 decimal(18,2),@p137 nvarchar(4000),@p138 nvarchar(4000),@p139 nvarchar(4000),@p140 nvarchar(4000),@p141 int,@p142 nvarchar(4000),@p143 nvarchar(4000),@p144 nvarchar(4000),@p145 nvarchar(4000),@p146 nvarchar(4000),@p147 nvarchar(4000),@p148 nvarchar(4000),@p149 nvarchar(4000),@p150 nvarchar(4000),@p151 nvarchar(4000),@p152 int,@p153 nvarchar(4000),@p154 nvarchar(4000),@p155 nvarchar(4000),@p156 nvarchar(4000),@p157 nvarchar(4000),@p158 int,@p159 nvarchar(4000),@p160 int,@p161 int,@p162 datetime2(7),@p163 datetime2(7),@p164 datetime2(7),@p165 nvarchar(4000),@p166 nvarchar(4000),@p167 nvarchar(4000),@p168 nvarchar(4000),@p169 nvarchar(4000),@p170 nvarchar(4000),@p171 nvarchar(4000),@p172 nvarchar(4000),@p173 nvarchar(4000),@p174 nvarchar(4000),@p175 nvarchar(4000),@p176 nvarchar(4000),@p177 nvarchar(4000),@p178 nvarchar(4000),@p179 datetime2(7),@p180 nvarchar(4000),@p181 nvarchar(4000),@p182 int,@p183 int,@p184 int,@p185 nvarchar(4000),@p186 nvarchar(4000),@p187 nvarchar(4000),@p188 nvarchar(4000),@p189 decimal(18,2),@p190 nvarchar(4000),@p191 nvarchar(4000),@p192 decimal(18,2),@p193 nvarchar(4000),@p194 nvarchar(4000),@p195 nvarchar(4000),@p196 nvarchar(4000),@p197 int,@p198 nvarchar(4000),@p199 nvarchar(4000),@p200 nvarchar(4000),@p201 nvarchar(4000),@p202 nvarchar(4000),@p203 nvarchar(4000),@p204 nvarchar(4000),@p205 nvarchar(4000),@p206 nvarchar(4000),@p207 nvarchar(4000),@p208 int,@p209 nvarchar(4000),@p210 nvarchar(4000),@p211 nvarchar(4000),@p212 nvarchar(4000),@p213 nvarchar(4000),@p214 int,@p215 nvarchar(4000),@p216 int,@p217 int,@p218 datetime2(7),@p219 datetime2(7),@p220 datetime2(7),@p221 nvarchar(4000),@p222 nvarchar(4000),@p223 nvarchar(4000),@p224 nvarchar(4000),@p225 nvarchar(4000),@p226 nvarchar(4000),@p227 nvarchar(4000),@p228 nvarchar(4000),@p229 nvarchar(4000),@p230 nvarchar(4000),@p231 nvarchar(4000),@p232 nvarchar(4000),@p233 nvarchar(4000),@p234 nvarchar(4000),@p235 datetime2(7),@p236 nvarchar(4000),@p237 nvarchar(4000),@p238 int,@p239 int,@p240 int,@p241 nvarchar(4000),@p242 nvarchar(4000),@p243 nvarchar(4000),@p244 nvarchar(4000),@p245 decimal(18,2),@p246 nvarchar(4000),@p247 nvarchar(4000),@p248 decimal(18,2),@p249 nvarchar(4000),@p250 nvarchar(4000),@p251 nvarchar(4000),@p252 nvarchar(4000),@p253 int,@p254 nvarchar(4000),@p255 nvarchar(4000),@p256 nvarchar(4000),@p257 nvarchar(4000),@p258 nvarchar(4000),@p259 nvarchar(4000),@p260 nvarchar(4000),@p261 nvarchar(4000),@p262 nvarchar(4000),@p263 nvarchar(4000),@p264 int,@p265 nvarchar(4000),@p266 nvarchar(4000),@p267 nvarchar(4000),@p268 nvarchar(4000),@p269 nvarchar(4000),@p270 int,@p271 nvarchar(4000),@p272 int,@p273 int,@p274 datetime2(7),@p275 datetime2(7),@p276 datetime2(7),@p277 nvarchar(4000),@p278 nvarchar(4000),@p279 nvarchar(4000),@p280 nvarchar(4000),@p281 nvarchar(4000),@p282 nvarchar(4000),@p283 nvarchar(4000),@p284 nvarchar(4000),@p285 nvarchar(4000),@p286 nvarchar(4000),@p287 nvarchar(4000),@p288 nvarchar(4000),@p289 nvarchar(4000),@p290 nvarchar(4000),@p291 datetime2(7),@p292 nvarchar(4000),@p293 nvarchar(4000),@p294 int,@p295 int,@p296 int,@p297 nvarchar(4000),@p298 nvarchar(4000),@p299 nvarchar(4000),@p300 nvarchar(4000),@p301 decimal(18,2),@p302 nvarchar(4000),@p303 nvarchar(4000),@p304 decimal(18,2),@p305 nvarchar(4000),@p306 nvarchar(4000),@p307 nvarchar(4000),@p308 nvarchar(4000),@p309 int,@p310 nvarchar(4000),@p311 nvarchar(4000),@p312 nvarchar(4000),@p313 nvarchar(4000),@p314 nvarchar(4000),@p315 nvarchar(4000),@p316 nvarchar(4000),@p317 nvarchar(4000),@p318 nvarchar(4000),@p319 nvarchar(4000),@p320 int,@p321 nvarchar(4000),@p322 nvarchar(4000),@p323 nvarchar(4000),@p324 nvarchar(4000),@p325 nvarchar(4000),@p326 int,@p327 nvarchar(4000),@p328 int,@p329 int,@p330 datetime2(7),@p331 datetime2(7),@p332 datetime2(7),@p333 nvarchar(4000),@p334 nvarchar(4000),@p335 nvarchar(4000),@p336 nvarchar(4000),@p337 nvarchar(4000),@p338 nvarchar(4000),@p339 nvarchar(4000),@p340 nvarchar(4000),@p341 nvarchar(4000),@p342 nvarchar(4000),@p343 nvarchar(4000),@p344 nvarchar(4000),@p345 nvarchar(4000),@p346 nvarchar(4000),@p347 datetime2(7),@p348 nvarchar(4000),@p349 nvarchar(4000),@p350 int,@p351 int,@p352 int,@p353 nvarchar(4000),@p354 nvarchar(4000),@p355 nvarchar(4000),@p356 nvarchar(4000),@p357 decimal(18,2),@p358 nvarchar(4000),@p359 nvarchar(4000),@p360 decimal(18,2),@p361 nvarchar(4000),@p362 nvarchar(4000),@p363 nvarchar(4000),@p364 nvarchar(4000),@p365 int,@p366 nvarchar(4000),@p367 nvarchar(4000),@p368 nvarchar(4000),@p369 nvarchar(4000),@p370 nvarchar(4000),@p371 nvarchar(4000),@p372 nvarchar(4000),@p373 nvarchar(4000),@p374 nvarchar(4000),@p375 nvarchar(4000),@p376 int,@p377 nvarchar(4000),@p378 nvarchar(4000),@p379 nvarchar(4000),@p380 nvarchar(4000),@p381 nvarchar(4000),@p382 int,@p383 nvarchar(4000),@p384 int,@p385 int,@p386 datetime2(7),@p387 datetime2(7),@p388 datetime2(7),@p389 nvarchar(4000),@p390 nvarchar(4000),@p391 nvarchar(4000),@p392 nvarchar(4000),@p393 nvarchar(4000),@p394 nvarchar(4000),@p395 nvarchar(4000),@p396 nvarchar(4000),@p397 nvarchar(4000),@p398 nvarchar(4000),@p399 nvarchar(4000),@p400 nvarchar(4000),@p401 nvarchar(4000),@p402 nvarchar(4000),@p403 datetime2(7),@p404 nvarchar(4000),@p405 nvarchar(4000),@p406 int,@p407 int,@p408 int,@p409 nvarchar(4000),@p410 nvarchar(4000),@p411 nvarchar(4000),@p412 nvarchar(4000),@p413 decimal(18,2),@p414 nvarchar(4000),@p415 nvarchar(4000),@p416 decimal(18,2),@p417 nvarchar(4000),@p418 nvarchar(4000),@p419 nvarchar(4000),@p420 nvarchar(4000),@p421 int,@p422 nvarchar(4000),@p423 nvarchar(4000),@p424 nvarchar(4000),@p425 nvarchar(4000),@p426 nvarchar(4000),@p427 nvarchar(4000),@p428 nvarchar(4000),@p429 nvarchar(4000),@p430 nvarchar(4000),@p431 nvarchar(4000),@p432 int,@p433 nvarchar(4000),@p434 nvarchar(4000),@p435 nvarchar(4000),@p436 nvarchar(4000),@p437 nvarchar(4000),@p438 int,@p439 nvarchar(4000),@p440 int,@p441 int,@p442 datetime2(7),@p443 datetime2(7),@p444 datetime2(7),@p445 nvarchar(4000),@p446 nvarchar(4000),@p447 nvarchar(4000),@p448 nvarchar(4000),@p449 nvarchar(4000),@p450 nvarchar(4000),@p451 nvarchar(4000),@p452 nvarchar(4000),@p453 nvarchar(4000),@p454 nvarchar(4000),@p455 nvarchar(4000),@p456 nvarchar(4000),@p457 nvarchar(4000),@p458 nvarchar(4000),@p459 datetime2(7),@p460 nvarchar(4000),@p461 nvarchar(4000),@p462 int,@p463 int,@p464 int,@p465 nvarchar(4000),@p466 nvarchar(4000),@p467 nvarchar(4000),@p468 nvarchar(4000),@p469 decimal(18,2),@p470 nvarchar(4000),@p471 nvarchar(4000),@p472 decimal(18,2),@p473 nvarchar(4000),@p474 nvarchar(4000),@p475 nvarchar(4000),@p476 nvarchar(4000),@p477 int,@p478 nvarchar(4000),@p479 nvarchar(4000),@p480 nvarchar(4000),@p481 nvarchar(4000),@p482 nvarchar(4000),@p483 nvarchar(4000),@p484 nvarchar(4000),@p485 nvarchar(4000),@p486 nvarchar(4000),@p487 nvarchar(4000),@p488 int,@p489 nvarchar(4000),@p490 nvarchar(4000),@p491 nvarchar(4000),@p492 nvarchar(4000),@p493 nvarchar(4000),@p494 int,@p495 nvarchar(4000),@p496 int,@p497 int,@p498 datetime2(7),@p499 datetime2(7),@p500 datetime2(7),@p501 nvarchar(4000),@p502 nvarchar(4000),@p503 nvarchar(4000),@p504 nvarchar(4000),@p505 nvarchar(4000),@p506 nvarchar(4000),@p507 nvarchar(4000),@p508 nvarchar(4000),@p509 nvarchar(4000),@p510 nvarchar(4000),@p511 nvarchar(4000),@p512 nvarchar(4000),@p513 nvarchar(4000),@p514 nvarchar(4000),@p515 datetime2(7),@p516 nvarchar(4000),@p517 nvarchar(4000),@p518 int,@p519 int,@p520 int,@p521 nvarchar(4000),@p522 nvarchar(4000),@p523 nvarchar(4000),@p524 nvarchar(4000),@p525 decimal(18,2),@p526 nvarchar(4000),@p527 nvarchar(4000),@p528 decimal(18,2),@p529 nvarchar(4000),@p530 nvarchar(4000),@p531 nvarchar(4000),@p532 nvarchar(4000),@p533 int,@p534 nvarchar(4000),@p535 nvarchar(4000),@p536 nvarchar(4000),@p537 nvarchar(4000),@p538 nvarchar(4000),@p539 nvarchar(4000),@p540 nvarchar(4000),@p541 nvarchar(4000),@p542 nvarchar(4000),@p543 nvarchar(4000),@p544 int,@p545 nvarchar(4000),@p546 nvarchar(4000),@p547 nvarchar(4000),@p548 nvarchar(4000),@p549 nvarchar(4000),@p550 int,@p551 nvarchar(4000),@p552 int,@p553 int,@p554 datetime2(7),@p555 datetime2(7),@p556 datetime2(7),@p557 nvarchar(4000),@p558 nvarchar(4000),@p559 nvarchar(4000),@p560 nvarchar(4000),@p561 nvarchar(4000),@p562 nvarchar(4000),@p563 nvarchar(4000),@p564 nvarchar(4000),@p565 nvarchar(4000),@p566 nvarchar(4000),@p567 nvarchar(4000),@p568 nvarchar(4000),@p569 nvarchar(4000),@p570 nvarchar(4000),@p571 datetime2(7),@p572 nvarchar(4000),@p573 nvarchar(4000),@p574 int,@p575 int,@p576 int,@p577 nvarchar(4000),@p578 nvarchar(4000),@p579 nvarchar(4000),@p580 nvarchar(4000),@p581 decimal(18,2),@p582 nvarchar(4000),@p583 nvarchar(4000),@p584 decimal(18,2),@p585 nvarchar(4000),@p586 nvarchar(4000),@p587 nvarchar(4000),@p588 nvarchar(4000),@p589 int,@p590 nvarchar(4000),@p591 nvarchar(4000),@p592 nvarchar(4000),@p593 nvarchar(4000),@p594 nvarchar(4000),@p595 nvarchar(4000),@p596 nvarchar(4000),@p597 nvarchar(4000),@p598 nvarchar(4000),@p599 nvarchar(4000),@p600 int,@p601 nvarchar(4000),@p602 nvarchar(4000),@p603 nvarchar(4000),@p604 nvarchar(4000),@p605 nvarchar(4000),@p606 int,@p607 nvarchar(4000),@p608 int,@p609 int,@p610 datetime2(7),@p611 datetime2(7),@p612 datetime2(7),@p613 nvarchar(4000),@p614 nvarchar(4000),@p615 nvarchar(4000),@p616 nvarchar(4000),@p617 nvarchar(4000),@p618 nvarchar(4000),@p619 nvarchar(4000),@p620 nvarchar(4000),@p621 nvarchar(4000),@p622 nvarchar(4000),@p623 nvarchar(4000),@p624 nvarchar(4000),@p625 nvarchar(4000),@p626 nvarchar(4000),@p627 datetime2(7),@p628 nvarchar(4000),@p629 nvarchar(4000),@p630 int,@p631 int,@p632 int,@p633 nvarchar(4000),@p634 nvarchar(4000),@p635 nvarchar(4000),@p636 nvarchar(4000),@p637 decimal(18,2),@p638 nvarchar(4000),@p639 nvarchar(4000),@p640 decimal(18,2),@p641 nvarchar(4000),@p642 nvarchar(4000),@p643 nvarchar(4000),@p644 nvarchar(4000),@p645 int,@p646 nvarchar(4000),@p647 nvarchar(4000),@p648 nvarchar(4000),@p649 nvarchar(4000),@p650 nvarchar(4000),@p651 nvarchar(4000),@p652 nvarchar(4000),@p653 nvarchar(4000),@p654 nvarchar(4000),@p655 nvarchar(4000),@p656 int,@p657 nvarchar(4000),@p658 nvarchar(4000),@p659 nvarchar(4000),@p660 nvarchar(4000),@p661 nvarchar(4000),@p662 int,@p663 nvarchar(4000),@p664 int,@p665 int,@p666 datetime2(7),@p667 datetime2(7),@p668 datetime2(7),@p669 nvarchar(4000),@p670 nvarchar(4000),@p671 nvarchar(4000),@p672 nvarchar(4000),@p673 nvarchar(4000),@p674 nvarchar(4000),@p675 nvarchar(4000),@p676 nvarchar(4000),@p677 nvarchar(4000),@p678 nvarchar(4000),@p679 nvarchar(4000),@p680 nvarchar(4000),@p681 nvarchar(4000),@p682 nvarchar(4000),@p683 datetime2(7),@p684 nvarchar(4000),@p685 nvarchar(4000),@p686 int,@p687 int,@p688 int,@p689 nvarchar(4000),@p690 nvarchar(4000),@p691 nvarchar(4000),@p692 nvarchar(4000),@p693 decimal(18,2),@p694 nvarchar(4000),@p695 nvarchar(4000),@p696 decimal(18,2),@p697 nvarchar(4000),@p698 nvarchar(4000),@p699 nvarchar(4000),@p700 nvarchar(4000),@p701 int,@p702 nvarchar(4000),@p703 nvarchar(4000),@p704 nvarchar(4000),@p705 nvarchar(4000),@p706 nvarchar(4000),@p707 nvarchar(4000),@p708 nvarchar(4000),@p709 nvarchar(4000),@p710 nvarchar(4000),@p711 nvarchar(4000),@p712 int,@p713 nvarchar(4000),@p714 nvarchar(4000),@p715 nvarchar(4000),@p716 nvarchar(4000),@p717 nvarchar(4000),@p718 int,@p719 nvarchar(4000),@p720 int,@p721 int,@p722 datetime2(7),@p723 datetime2(7),@p724 datetime2(7),@p725 nvarchar(4000),@p726 nvarchar(4000),@p727 nvarchar(4000),@p728 nvarchar(4000),@p729 nvarchar(4000),@p730 nvarchar(4000),@p731 nvarchar(4000),@p732 nvarchar(4000),@p733 nvarchar(4000),@p734 nvarchar(4000),@p735 nvarchar(4000),@p736 nvarchar(4000),@p737 nvarchar(4000),@p738 nvarchar(4000),@p739 datetime2(7),@p740 nvarchar(4000),@p741 nvarchar(4000),@p742 int,@p743 int,@p744 int,@p745 nvarchar(4000),@p746 nvarchar(4000),@p747 nvarchar(4000),@p748 nvarchar(4000),@p749 decimal(18,2),@p750 nvarchar(4000),@p751 nvarchar(4000),@p752 decimal(18,2),@p753 nvarchar(4000),@p754 nvarchar(4000),@p755 nvarchar(4000),@p756 nvarchar(4000),@p757 int,@p758 nvarchar(4000),@p759 nvarchar(4000),@p760 nvarchar(4000),@p761 nvarchar(4000),@p762 nvarchar(4000),@p763 nvarchar(4000),@p764 nvarchar(4000),@p765 nvarchar(4000),@p766 nvarchar(4000),@p767 nvarchar(4000),@p768 int,@p769 nvarchar(4000),@p770 nvarchar(4000),@p771 nvarchar(4000),@p772 nvarchar(4000),@p773 nvarchar(4000),@p774 int,@p775 nvarchar(4000),@p776 int,@p777 int,@p778 datetime2(7),@p779 datetime2(7),@p780 datetime2(7),@p781 nvarchar(4000),@p782 nvarchar(4000),@p783 nvarchar(4000),@p784 nvarchar(4000),@p785 nvarchar(4000),@p786 nvarchar(4000),@p787 nvarchar(4000),@p788 nvarchar(4000),@p789 nvarchar(4000),@p790 nvarchar(4000),@p791 nvarchar(4000),@p792 nvarchar(4000),@p793 nvarchar(4000),@p794 nvarchar(4000),@p795 datetime2(7),@p796 nvarchar(4000),@p797 nvarchar(4000),@p798 int,@p799 int,@p800 int,@p801 nvarchar(4000),@p802 nvarchar(4000),@p803 nvarchar(4000),@p804 nvarchar(4000),@p805 decimal(18,2),@p806 nvarchar(4000),@p807 nvarchar(4000),@p808 decimal(18,2),@p809 nvarchar(4000),@p810 nvarchar(4000),@p811 nvarchar(4000),@p812 nvarchar(4000),@p813 int,@p814 nvarchar(4000),@p815 nvarchar(4000),@p816 nvarchar(4000),@p817 nvarchar(4000),@p818 nvarchar(4000),@p819 nvarchar(4000),@p820 nvarchar(4000),@p821 nvarchar(4000),@p822 nvarchar(4000),@p823 nvarchar(4000),@p824 int,@p825 nvarchar(4000),@p826 nvarchar(4000),@p827 nvarchar(4000),@p828 nvarchar(4000),@p829 nvarchar(4000),@p830 int,@p831 nvarchar(4000),@p832 int,@p833 int,@p834 datetime2(7),@p835 datetime2(7),@p836 datetime2(7),@p837 nvarchar(4000),@p838 nvarchar(4000),@p839 nvarchar(4000),@p840 nvarchar(4000),@p841 nvarchar(4000),@p842 nvarchar(4000),@p843 nvarchar(4000),@p844 nvarchar(4000),@p845 nvarchar(4000),@p846 nvarchar(4000),@p847 nvarchar(4000),@p848 nvarchar(4000),@p849 nvarchar(4000),@p850 nvarchar(4000),@p851 datetime2(7),@p852 nvarchar(4000),@p853 nvarchar(4000),@p854 int,@p855 int,@p856 int,@p857 nvarchar(4000),@p858 nvarchar(4000),@p859 nvarchar(4000),@p860 nvarchar(4000),@p861 decimal(18,2),@p862 nvarchar(4000),@p863 nvarchar(4000),@p864 decimal(18,2),@p865 nvarchar(4000),@p866 nvarchar(4000),@p867 nvarchar(4000),@p868 nvarchar(4000),@p869 int,@p870 nvarchar(4000),@p871 nvarchar(4000),@p872 nvarchar(4000),@p873 nvarchar(4000),@p874 nvarchar(4000),@p875 nvarchar(4000),@p876 nvarchar(4000),@p877 nvarchar(4000),@p878 nvarchar(4000),@p879 nvarchar(4000),@p880 int,@p881 nvarchar(4000),@p882 nvarchar(4000),@p883 nvarchar(4000),@p884 nvarchar(4000),@p885 nvarchar(4000),@p886 int,@p887 nvarchar(4000),@p888 int,@p889 int,@p890 datetime2(7),@p891 datetime2(7),@p892 datetime2(7),@p893 nvarchar(4000),@p894 nvarchar(4000),@p895 nvarchar(4000),@p896 nvarchar(4000),@p897 nvarchar(4000),@p898 nvarchar(4000),@p899 nvarchar(4000),@p900 nvarchar(4000),@p901 nvarchar(4000),@p902 nvarchar(4000),@p903 nvarchar(4000),@p904 nvarchar(4000),@p905 nvarchar(4000),@p906 nvarchar(4000),@p907 datetime2(7),@p908 nvarchar(4000),@p909 nvarchar(4000),@p910 int,@p911 int,@p912 int,@p913 nvarchar(4000),@p914 nvarchar(4000),@p915 nvarchar(4000),@p916 nvarchar(4000),@p917 decimal(18,2),@p918 nvarchar(4000),@p919 nvarchar(4000),@p920 decimal(18,2),@p921 nvarchar(4000),@p922 nvarchar(4000),@p923 nvarchar(4000),@p924 nvarchar(4000),@p925 int,@p926 nvarchar(4000),@p927 nvarchar(4000),@p928 nvarchar(4000),@p929 nvarchar(4000),@p930 nvarchar(4000),@p931 nvarchar(4000),@p932 nvarchar(4000),@p933 nvarchar(4000),@p934 nvarchar(4000),@p935 nvarchar(4000),@p936 int,@p937 nvarchar(4000),@p938 nvarchar(4000),@p939 nvarchar(4000),@p940 nvarchar(4000),@p941 nvarchar(4000),@p942 int,@p943 nvarchar(4000),@p944 int,@p945 int,@p946 datetime2(7),@p947 datetime2(7),@p948 datetime2(7),@p949 nvarchar(4000),@p950 nvarchar(4000),@p951 nvarchar(4000),@p952 nvarchar(4000),@p953 nvarchar(4000),@p954 nvarchar(4000),@p955 nvarchar(4000),@p956 nvarchar(4000),@p957 nvarchar(4000),@p958 nvarchar(4000),@p959 nvarchar(4000),@p960 nvarchar(4000),@p961 nvarchar(4000),@p962 nvarchar(4000),@p963 datetime2(7),@p964 nvarchar(4000),@p965 nvarchar(4000),@p966 int,@p967 int,@p968 int,@p969 nvarchar(4000),@p970 nvarchar(4000),@p971 nvarchar(4000),@p972 nvarchar(4000),@p973 decimal(18,2),@p974 nvarchar(4000),@p975 nvarchar(4000),@p976 decimal(18,2),@p977 nvarchar(4000),@p978 nvarchar(4000),@p979 nvarchar(4000),@p980 nvarchar(4000),@p981 int,@p982 nvarchar(4000),@p983 nvarchar(4000),@p984 nvarchar(4000),@p985 nvarchar(4000),@p986 nvarchar(4000),@p987 nvarchar(4000),@p988 nvarchar(4000),@p989 nvarchar(4000),@p990 nvarchar(4000),@p991 nvarchar(4000),@p992 int,@p993 nvarchar(4000),@p994 nvarchar(4000),@p995 nvarchar(4000),@p996 nvarchar(4000),@p997 nvarchar(4000),@p998 int,@p999 nvarchar(4000),@p1000 int,@p1001 int,@p1002 datetime2(7),@p1003 datetime2(7),@p1004 datetime2(7),@p1005 nvarchar(4000),@p1006 nvarchar(4000),@p1007 nvarchar(4000),@p1008 nvarchar(4000),@p1009 nvarchar(4000),@p1010 nvarchar(4000),@p1011 nvarchar(4000),@p1012 nvarchar(4000),@p1013 nvarchar(4000),@p1014 nvarchar(4000),@p1015 nvarchar(4000),@p1016 nvarchar(4000),@p1017 nvarchar(4000),@p1018 nvarchar(4000),@p1019 datetime2(7),@p1020 nvarchar(4000),@p1021 nvarchar(4000),@p1022 int,@p1023 int,@p1024 int,@p1025 nvarchar(4000),@p1026 nvarchar(4000),@p1027 nvarchar(4000),@p1028 nvarchar(4000),@p1029 decimal(18,2),@p1030 nvarchar(4000),@p1031 nvarchar(4000),@p1032 decimal(18,2),@p1033 nvarchar(4000),@p1034 nvarchar(4000),@p1035 nvarchar(4000),@p1036 nvarchar(4000),@p1037 int,@p1038 nvarchar(4000),@p1039 nvarchar(4000),@p1040 nvarchar(4000),@p1041 nvarchar(4000),@p1042 nvarchar(4000),@p1043 nvarchar(4000),@p1044 nvarchar(4000),@p1045 nvarchar(4000),@p1046 nvarchar(4000),@p1047 nvarchar(4000),@p1048 int,@p1049 nvarchar(4000),@p1050 nvarchar(4000),@p1051 nvarchar(4000),@p1052 nvarchar(4000),@p1053 nvarchar(4000),@p1054 int,@p1055 nvarchar(4000),@p1056 int,@p1057 int,@p1058 datetime2(7),@p1059 datetime2(7),@p1060 datetime2(7),@p1061 nvarchar(4000),@p1062 nvarchar(4000),@p1063 nvarchar(4000),@p1064 nvarchar(4000),@p1065 nvarchar(4000),@p1066 nvarchar(4000),@p1067 nvarchar(4000),@p1068 nvarchar(4000),@p1069 nvarchar(4000),@p1070 nvarchar(4000),@p1071 nvarchar(4000),@p1072 nvarchar(4000),@p1073 nvarchar(4000),@p1074 nvarchar(4000),@p1075 datetime2(7),@p1076 nvarchar(4000),@p1077 nvarchar(4000),@p1078 int,@p1079 int,@p1080 int,@p1081 nvarchar(4000),@p1082 nvarchar(4000),@p1083 nvarchar(4000),@p1084 nvarchar(4000),@p1085 decimal(18,2),@p1086 nvarchar(4000),@p1087 nvarchar(4000),@p1088 decimal(18,2),@p1089 nvarchar(4000),@p1090 nvarchar(4000),@p1091 nvarchar(4000),@p1092 nvarchar(4000),@p1093 int,@p1094 nvarchar(4000),@p1095 nvarchar(4000),@p1096 nvarchar(4000),@p1097 nvarchar(4000),@p1098 nvarchar(4000),@p1099 nvarchar(4000),@p1100 nvarchar(4000),@p1101 nvarchar(4000),@p1102 nvarchar(4000),@p1103 nvarchar(4000),@p1104 int,@p1105 nvarchar(4000),@p1106 nvarchar(4000),@p1107 nvarchar(4000),@p1108 nvarchar(4000),@p1109 nvarchar(4000),@p1110 int,@p1111 nvarchar(4000),@p1112 int,@p1113 int,@p1114 datetime2(7),@p1115 datetime2(7),@p1116 datetime2(7),@p1117 nvarchar(4000),@p1118 nvarchar(4000),@p1119 nvarchar(4000),@p1120 nvarchar(4000),@p1121 nvarchar(4000),@p1122 nvarchar(4000),@p1123 nvarchar(4000),@p1124 nvarchar(4000),@p1125 nvarchar(4000),@p1126 nvarchar(4000),@p1127 nvarchar(4000),@p1128 nvarchar(4000),@p1129 nvarchar(4000),@p1130 nvarchar(4000),@p1131 datetime2(7),@p1132 nvarchar(4000),@p1133 nvarchar(4000),@p1134 int,@p1135 int,@p1136 int,@p1137 nvarchar(4000),@p1138 nvarchar(4000),@p1139 nvarchar(4000),@p1140 nvarchar(4000),@p1141 decimal(18,2),@p1142 nvarchar(4000),@p1143 nvarchar(4000),@p1144 decimal(18,2),@p1145 nvarchar(4000),@p1146 nvarchar(4000),@p1147 nvarchar(4000),@p1148 nvarchar(4000),@p1149 int,@p1150 nvarchar(4000),@p1151 nvarchar(4000),@p1152 nvarchar(4000),@p1153 nvarchar(4000),@p1154 nvarchar(4000),@p1155 nvarchar(4000),@p1156 nvarchar(4000),@p1157 nvarchar(4000),@p1158 nvarchar(4000),@p1159 nvarchar(4000),@p1160 int,@p1161 nvarchar(4000),@p1162 nvarchar(4000),@p1163 nvarchar(4000),@p1164 nvarchar(4000),@p1165 nvarchar(4000),@p1166 int,@p1167 nvarchar(4000),@p1168 int,@p1169 int,@p1170 datetime2(7),@p1171 datetime2(7),@p1172 datetime2(7),@p1173 nvarchar(4000),@p1174 nvarchar(4000),@p1175 nvarchar(4000),@p1176 nvarchar(4000),@p1177 nvarchar(4000),@p1178 nvarchar(4000),@p1179 nvarchar(4000),@p1180 nvarchar(4000),@p1181 nvarchar(4000),@p1182 nvarchar(4000),@p1183 nvarchar(4000),@p1184 nvarchar(4000),@p1185 nvarchar(4000),@p1186 nvarchar(4000),@p1187 datetime2(7),@p1188 nvarchar(4000),@p1189 nvarchar(4000),@p1190 int,@p1191 int,@p1192 int,@p1193 nvarchar(4000),@p1194 nvarchar(4000),@p1195 nvarchar(4000),@p1196 nvarchar(4000),@p1197 decimal(18,2),@p1198 nvarchar(4000),@p1199 nvarchar(4000),@p1200 decimal(18,2),@p1201 nvarchar(4000),@p1202 nvarchar(4000),@p1203 nvarchar(4000),@p1204 nvarchar(4000),@p1205 int,@p1206 nvarchar(4000),@p1207 nvarchar(4000),@p1208 nvarchar(4000),@p1209 nvarchar(4000),@p1210 nvarchar(4000),@p1211 nvarchar(4000),@p1212 nvarchar(4000),@p1213 nvarchar(4000),@p1214 nvarchar(4000),@p1215 nvarchar(4000),@p1216 int,@p1217 nvarchar(4000),@p1218 nvarchar(4000),@p1219 nvarchar(4000),@p1220 nvarchar(4000),@p1221 nvarchar(4000),@p1222 int,@p1223 nvarchar(4000),@p1224 int,@p1225 int,@p1226 datetime2(7),@p1227 datetime2(7),@p1228 datetime2(7),@p1229 nvarchar(4000),@p1230 nvarchar(4000),@p1231 nvarchar(4000),@p1232 nvarchar(4000),@p1233 nvarchar(4000),@p1234 nvarchar(4000),@p1235 nvarchar(4000),@p1236 nvarchar(4000),@p1237 nvarchar(4000),@p1238 nvarchar(4000),@p1239 nvarchar(4000),@p1240 nvarchar(4000),@p1241 nvarchar(4000),@p1242 nvarchar(4000),@p1243 datetime2(7),@p1244 nvarchar(4000),@p1245 nvarchar(4000),@p1246 int,@p1247 int,@p1248 int,@p1249 nvarchar(4000),@p1250 nvarchar(4000),@p1251 nvarchar(4000),@p1252 nvarchar(4000),@p1253 decimal(18,2),@p1254 nvarchar(4000),@p1255 nvarchar(4000),@p1256 decimal(18,2),@p1257 nvarchar(4000),@p1258 nvarchar(4000),@p1259 nvarchar(4000),@p1260 nvarchar(4000),@p1261 int,@p1262 nvarchar(4000),@p1263 nvarchar(4000),@p1264 nvarchar(4000),@p1265 nvarchar(4000),@p1266 nvarchar(4000),@p1267 nvarchar(4000),@p1268 nvarchar(4000),@p1269 nvarchar(4000),@p1270 nvarchar(4000),@p1271 nvarchar(4000),@p1272 int,@p1273 nvarchar(4000),@p1274 nvarchar(4000),@p1275 nvarchar(4000),@p1276 nvarchar(4000),@p1277 nvarchar(4000),@p1278 int,@p1279 nvarchar(4000),@p1280 int,@p1281 int,@p1282 datetime2(7),@p1283 datetime2(7),@p1284 datetime2(7),@p1285 nvarchar(4000),@p1286 nvarchar(4000),@p1287 nvarchar(4000),@p1288 nvarchar(4000),@p1289 nvarchar(4000),@p1290 nvarchar(4000),@p1291 nvarchar(4000),@p1292 nvarchar(4000),@p1293 nvarchar(4000),@p1294 nvarchar(4000),@p1295 nvarchar(4000),@p1296 nvarchar(4000),@p1297 nvarchar(4000),@p1298 nvarchar(4000),@p1299 datetime2(7),@p1300 nvarchar(4000),@p1301 nvarchar(4000),@p1302 int,@p1303 int,@p1304 int,@p1305 nvarchar(4000),@p1306 nvarchar(4000),@p1307 nvarchar(4000),@p1308 nvarchar(4000),@p1309 decimal(18,2),@p1310 nvarchar(4000),@p1311 nvarchar(4000),@p1312 decimal(18,2),@p1313 nvarchar(4000),@p1314 nvarchar(4000),@p1315 nvarchar(4000),@p1316 nvarchar(4000),@p1317 int,@p1318 nvarchar(4000),@p1319 nvarchar(4000),@p1320 nvarchar(4000),@p1321 nvarchar(4000),@p1322 nvarchar(4000),@p1323 nvarchar(4000),@p1324 nvarchar(4000),@p1325 nvarchar(4000),@p1326 nvarchar(4000),@p1327 nvarchar(4000),@p1328 int,@p1329 nvarchar(4000),@p1330 nvarchar(4000),@p1331 nvarchar(4000),@p1332 nvarchar(4000),@p1333 nvarchar(4000),@p1334 int,@p1335 nvarchar(4000),@p1336 int,@p1337 int,@p1338 datetime2(7),@p1339 datetime2(7),@p1340 datetime2(7),@p1341 nvarchar(4000),@p1342 nvarchar(4000),@p1343 nvarchar(4000),@p1344 nvarchar(4000),@p1345 nvarchar(4000),@p1346 nvarchar(4000),@p1347 nvarchar(4000),@p1348 nvarchar(4000),@p1349 nvarchar(4000),@p1350 nvarchar(4000),@p1351 nvarchar(4000),@p1352 nvarchar(4000),@p1353 nvarchar(4000),@p1354 nvarchar(4000),@p1355 datetime2(7),@p1356 nvarchar(4000),@p1357 nvarchar(4000),@p1358 int,@p1359 int,@p1360 int,@p1361 nvarchar(4000),@p1362 nvarchar(4000),@p1363 nvarchar(4000),@p1364 nvarchar(4000),@p1365 decimal(18,2),@p1366 nvarchar(4000),@p1367 nvarchar(4000),@p1368 decimal(18,2),@p1369 nvarchar(4000),@p1370 nvarchar(4000),@p1371 nvarchar(4000),@p1372 nvarchar(4000),@p1373 int,@p1374 nvarchar(4000),@p1375 nvarchar(4000),@p1376 nvarchar(4000),@p1377 nvarchar(4000),@p1378 nvarchar(4000),@p1379 nvarchar(4000),@p1380 nvarchar(4000),@p1381 nvarchar(4000),@p1382 nvarchar(4000),@p1383 nvarchar(4000),@p1384 int,@p1385 nvarchar(4000),@p1386 nvarchar(4000),@p1387 nvarchar(4000),@p1388 nvarchar(4000),@p1389 nvarchar(4000),@p1390 int,@p1391 nvarchar(4000),@p1392 int,@p1393 int,@p1394 datetime2(7),@p1395 datetime2(7),@p1396 datetime2(7),@p1397 nvarchar(4000),@p1398 nvarchar(4000),@p1399 nvarchar(4000),@p1400 nvarchar(4000),@p1401 nvarchar(4000),@p1402 nvarchar(4000),@p1403 nvarchar(4000),@p1404 nvarchar(4000),@p1405 nvarchar(4000),@p1406 nvarchar(4000),@p1407 nvarchar(4000),@p1408 nvarchar(4000),@p1409 nvarchar(4000),@p1410 nvarchar(4000),@p1411 datetime2(7),@p1412 nvarchar(4000),@p1413 nvarchar(4000),@p1414 int,@p1415 int,@p1416 int,@p1417 nvarchar(4000),@p1418 nvarchar(4000),@p1419 nvarchar(4000),@p1420 decimal(18,2),@p1421 decimal(18,2),@p1422 nvarchar(4000),@p1423 nvarchar(4000),@p1424 decimal(18,2),@p1425 nvarchar(4000),@p1426 nvarchar(4000),@p1427 nvarchar(4000),@p1428 nvarchar(4000),@p1429 int,@p1430 nvarchar(4000),@p1431 nvarchar(4000),@p1432 nvarchar(4000),@p1433 nvarchar(4000),@p1434 nvarchar(4000),@p1435 nvarchar(4000),@p1436 nvarchar(4000),@p1437 nvarchar(4000),@p1438 nvarchar(4000),@p1439 nvarchar(4000),@p1440 int,@p1441 nvarchar(4000),@p1442 nvarchar(4000),@p1443 nvarchar(4000),@p1444 nvarchar(4000),@p1445 nvarchar(4000),@p1446 int,@p1447 nvarchar(4000),@p1448 int,@p1449 int,@p1450 datetime2(7),@p1451 datetime2(7),@p1452 datetime2(7),@p1453 nvarchar(4000),@p1454 nvarchar(4000),@p1455 nvarchar(4000),@p1456 nvarchar(4000),@p1457 nvarchar(4000),@p1458 nvarchar(4000),@p1459 nvarchar(4000),@p1460 nvarchar(4000),@p1461 nvarchar(4000),@p1462 nvarchar(4000),@p1463 nvarchar(4000),@p1464 nvarchar(4000),@p1465 nvarchar(4000),@p1466 nvarchar(4000),@p1467 datetime2(7),@p1468 nvarchar(4000),@p1469 nvarchar(4000),@p1470 int,@p1471 int,@p1472 int,@p1473 nvarchar(4000),@p1474 nvarchar(4000),@p1475 nvarchar(4000),@p1476 nvarchar(4000),@p1477 decimal(18,2),@p1478 nvarchar(4000),@p1479 nvarchar(4000),@p1480 decimal(18,2),@p1481 nvarchar(4000),@p1482 nvarchar(4000),@p1483 nvarchar(4000),@p1484 nvarchar(4000),@p1485 int,@p1486 nvarchar(4000),@p1487 nvarchar(4000),@p1488 nvarchar(4000),@p1489 nvarchar(4000),@p1490 nvarchar(4000),@p1491 nvarchar(4000),@p1492 nvarchar(4000),@p1493 nvarchar(4000),@p1494 nvarchar(4000),@p1495 nvarchar(4000),@p1496 int,@p1497 nvarchar(4000),@p1498 nvarchar(4000),@p1499 nvarchar(4000),@p1500 nvarchar(4000),@p1501 nvarchar(4000),@p1502 int,@p1503 nvarchar(4000),@p1504 int,@p1505 int,@p1506 datetime2(7),@p1507 datetime2(7),@p1508 datetime2(7),@p1509 nvarchar(4000),@p1510 nvarchar(4000),@p1511 nvarchar(4000),@p1512 nvarchar(4000),@p1513 nvarchar(4000),@p1514 nvarchar(4000),@p1515 nvarchar(4000),@p1516 nvarchar(4000),@p1517 nvarchar(4000),@p1518 nvarchar(4000),@p1519 nvarchar(4000),@p1520 nvarchar(4000),@p1521 nvarchar(4000),@p1522 nvarchar(4000),@p1523 datetime2(7),@p1524 nvarchar(4000),@p1525 nvarchar(4000),@p1526 int,@p1527 int,@p1528 int,@p1529 nvarchar(4000),@p1530 nvarchar(4000),@p1531 nvarchar(4000),@p1532 nvarchar(4000),@p1533 decimal(18,2),@p1534 nvarchar(4000),@p1535 nvarchar(4000),@p1536 decimal(18,2),@p1537 nvarchar(4000),@p1538 nvarchar(4000),@p1539 nvarchar(4000),@p1540 nvarchar(4000),@p1541 int,@p1542 nvarchar(4000),@p1543 nvarchar(4000),@p1544 nvarchar(4000),@p1545 nvarchar(4000),@p1546 nvarchar(4000),@p1547 nvarchar(4000),@p1548 nvarchar(4000),@p1549 nvarchar(4000),@p1550 nvarchar(4000),@p1551 nvarchar(4000),@p1552 int,@p1553 nvarchar(4000),@p1554 nvarchar(4000),@p1555 nvarchar(4000),@p1556 nvarchar(4000),@p1557 nvarchar(4000),@p1558 int,@p1559 nvarchar(4000),@p1560 int,@p1561 int,@p1562 datetime2(7),@p1563 datetime2(7),@p1564 datetime2(7),@p1565 nvarchar(4000),@p1566 nvarchar(4000),@p1567 nvarchar(4000),@p1568 nvarchar(4000),@p1569 nvarchar(4000),@p1570 nvarchar(4000),@p1571 nvarchar(4000),@p1572 nvarchar(4000),@p1573 nvarchar(4000),@p1574 nvarchar(4000),@p1575 nvarchar(4000),@p1576 nvarchar(4000),@p1577 nvarchar(4000),@p1578 nvarchar(4000),@p1579 datetime2(7),@p1580 nvarchar(4000),@p1581 nvarchar(4000),@p1582 int,@p1583 int,@p1584 int,@p1585 nvarchar(4000),@p1586 nvarchar(4000),@p1587 nvarchar(4000),@p1588 nvarchar(4000),@p1589 decimal(18,2),@p1590 nvarchar(4000),@p1591 nvarchar(4000),@p1592 decimal(18,2),@p1593 nvarchar(4000),@p1594 nvarchar(4000),@p1595 nvarchar(4000),@p1596 nvarchar(4000),@p1597 int,@p1598 nvarchar(4000),@p1599 nvarchar(4000),@p1600 nvarchar(4000),@p1601 nvarchar(4000),@p1602 nvarchar(4000),@p1603 nvarchar(4000),@p1604 nvarchar(4000),@p1605 nvarchar(4000),@p1606 nvarchar(4000),@p1607 nvarchar(4000),@p1608 int,@p1609 nvarchar(4000),@p1610 nvarchar(4000),@p1611 nvarchar(4000),@p1612 nvarchar(4000),@p1613 nvarchar(4000),@p1614 int,@p1615 nvarchar(4000),@p1616 int,@p1617 int,@p1618 datetime2(7),@p1619 datetime2(7),@p1620 datetime2(7),@p1621 nvarchar(4000),@p1622 nvarchar(4000),@p1623 nvarchar(4000),@p1624 nvarchar(4000),@p1625 nvarchar(4000),@p1626 nvarchar(4000),@p1627 nvarchar(4000),@p1628 nvarchar(4000),@p1629 nvarchar(4000),@p1630 nvarchar(4000),@p1631 nvarchar(4000),@p1632 nvarchar(4000),@p1633 nvarchar(4000),@p1634 nvarchar(4000),@p1635 datetime2(7),@p1636 nvarchar(4000),@p1637 nvarchar(4000),@p1638 int,@p1639 int,@p1640 int,@p1641 nvarchar(4000),@p1642 nvarchar(4000),@p1643 nvarchar(4000),@p1644 nvarchar(4000),@p1645 decimal(18,2),@p1646 nvarchar(4000),@p1647 nvarchar(4000),@p1648 decimal(18,2),@p1649 nvarchar(4000),@p1650 nvarchar(4000),@p1651 nvarchar(4000),@p1652 nvarchar(4000),@p1653 int,@p1654 nvarchar(4000),@p1655 nvarchar(4000),@p1656 nvarchar(4000),@p1657 nvarchar(4000),@p1658 nvarchar(4000),@p1659 nvarchar(4000),@p1660 nvarchar(4000),@p1661 nvarchar(4000),@p1662 nvarchar(4000),@p1663 nvarchar(4000),@p1664 int,@p1665 nvarchar(4000),@p1666 nvarchar(4000),@p1667 nvarchar(4000),@p1668 nvarchar(4000),@p1669 nvarchar(4000),@p1670 int,@p1671 nvarchar(4000),@p1672 int,@p1673 int,@p1674 datetime2(7),@p1675 datetime2(7),@p1676 datetime2(7),@p1677 nvarchar(4000),@p1678 nvarchar(4000),@p1679 nvarchar(4000),@p1680 nvarchar(4000),@p1681 nvarchar(4000),@p1682 nvarchar(4000),@p1683 nvarchar(4000),@p1684 nvarchar(4000),@p1685 nvarchar(4000),@p1686 nvarchar(4000),@p1687 nvarchar(4000),@p1688 nvarchar(4000),@p1689 nvarchar(4000),@p1690 nvarchar(4000),@p1691 datetime2(7),@p1692 nvarchar(4000),@p1693 nvarchar(4000),@p1694 int,@p1695 int,@p1696 int,@p1697 nvarchar(4000),@p1698 nvarchar(4000),@p1699 nvarchar(4000),@p1700 nvarchar(4000),@p1701 decimal(18,2),@p1702 nvarchar(4000),@p1703 nvarchar(4000),@p1704 decimal(18,2),@p1705 nvarchar(4000),@p1706 nvarchar(4000),@p1707 nvarchar(4000),@p1708 nvarchar(4000),@p1709 int,@p1710 nvarchar(4000),@p1711 nvarchar(4000),@p1712 nvarchar(4000),@p1713 nvarchar(4000),@p1714 nvarchar(4000),@p1715 nvarchar(4000),@p1716 nvarchar(4000),@p1717 nvarchar(4000),@p1718 nvarchar(4000),@p1719 nvarchar(4000),@p1720 int,@p1721 nvarchar(4000),@p1722 nvarchar(4000),@p1723 nvarchar(4000),@p1724 nvarchar(4000),@p1725 nvarchar(4000),@p1726 int,@p1727 nvarchar(4000),@p1728 int,@p1729 int,@p1730 datetime2(7),@p1731 datetime2(7),@p1732 datetime2(7),@p1733 nvarchar(4000),@p1734 nvarchar(4000),@p1735 nvarchar(4000),@p1736 nvarchar(4000),@p1737 nvarchar(4000),@p1738 nvarchar(4000),@p1739 nvarchar(4000),@p1740 nvarchar(4000),@p1741 nvarchar(4000),@p1742 nvarchar(4000),@p1743 nvarchar(4000),@p1744 nvarchar(4000),@p1745 nvarchar(4000),@p1746 nvarchar(4000),@p1747 datetime2(7),@p1748 nvarchar(4000),@p1749 nvarchar(4000),@p1750 int,@p1751 int,@p1752 int,@p1753 nvarchar(4000),@p1754 nvarchar(4000),@p1755 nvarchar(4000),@p1756 nvarchar(4000),@p1757 decimal(18,2),@p1758 nvarchar(4000),@p1759 nvarchar(4000),@p1760 decimal(18,2),@p1761 nvarchar(4000),@p1762 nvarchar(4000),@p1763 nvarchar(4000),@p1764 nvarchar(4000),@p1765 int,@p1766 nvarchar(4000),@p1767 nvarchar(4000),@p1768 nvarchar(4000),@p1769 nvarchar(4000),@p1770 nvarchar(4000),@p1771 nvarchar(4000),@p1772 nvarchar(4000),@p1773 nvarchar(4000),@p1774 nvarchar(4000),@p1775 nvarchar(4000),@p1776 int,@p1777 nvarchar(4000),@p1778 nvarchar(4000),@p1779 nvarchar(4000),@p1780 nvarchar(4000),@p1781 nvarchar(4000),@p1782 int,@p1783 nvarchar(4000),@p1784 int,@p1785 int,@p1786 datetime2(7),@p1787 datetime2(7),@p1788 datetime2(7),@p1789 nvarchar(4000),@p1790 nvarchar(4000),@p1791 nvarchar(4000),@p1792 nvarchar(4000),@p1793 nvarchar(4000),@p1794 nvarchar(4000),@p1795 nvarchar(4000),@p1796 nvarchar(4000),@p1797 nvarchar(4000),@p1798 nvarchar(4000),@p1799 nvarchar(4000),@p1800 nvarchar(4000),@p1801 nvarchar(4000),@p1802 nvarchar(4000),@p1803 datetime2(7),@p1804 nvarchar(4000),@p1805 nvarchar(4000),@p1806 int,@p1807 int,@p1808 int,@p1809 nvarchar(4000),@p1810 nvarchar(4000),@p1811 nvarchar(4000),@p1812 nvarchar(4000),@p1813 decimal(18,2),@p1814 nvarchar(4000),@p1815 nvarchar(4000),@p1816 decimal(18,2),@p1817 nvarchar(4000),@p1818 nvarchar(4000),@p1819 nvarchar(4000),@p1820 nvarchar(4000),@p1821 int,@p1822 nvarchar(4000),@p1823 nvarchar(4000),@p1824 nvarchar(4000),@p1825 nvarchar(4000),@p1826 nvarchar(4000),@p1827 nvarchar(4000),@p1828 nvarchar(4000),@p1829 nvarchar(4000),@p1830 nvarchar(4000),@p1831 nvarchar(4000),@p1832 int,@p1833 nvarchar(4000),@p1834 nvarchar(4000),@p1835 nvarchar(4000),@p1836 nvarchar(4000),@p1837 nvarchar(4000),@p1838 int,@p1839 nvarchar(4000),@p1840 int,@p1841 int,@p1842 datetime2(7),@p1843 datetime2(7),@p1844 datetime2(7),@p1845 nvarchar(4000),@p1846 nvarchar(4000),@p1847 nvarchar(4000),@p1848 nvarchar(4000),@p1849 nvarchar(4000),@p1850 nvarchar(4000),@p1851 nvarchar(4000),@p1852 nvarchar(4000),@p1853 nvarchar(4000),@p1854 nvarchar(4000),@p1855 nvarchar(4000),@p1856 nvarchar(4000),@p1857 nvarchar(4000),@p1858 nvarchar(4000),@p1859 datetime2(7),@p1860 nvarchar(4000),@p1861 nvarchar(4000),@p1862 int,@p1863 int,@p1864 int,@p1865 nvarchar(4000),@p1866 nvarchar(4000),@p1867 nvarchar(4000),@p1868 nvarchar(4000),@p1869 decimal(18,2),@p1870 nvarchar(4000),@p1871 nvarchar(4000),@p1872 decimal(18,2),@p1873 nvarchar(4000),@p1874 nvarchar(4000),@p1875 nvarchar(4000),@p1876 nvarchar(4000),@p1877 int,@p1878 nvarchar(4000),@p1879 nvarchar(4000),@p1880 nvarchar(4000),@p1881 nvarchar(4000),@p1882 nvarchar(4000),@p1883 nvarchar(4000),@p1884 nvarchar(4000),@p1885 nvarchar(4000),@p1886 nvarchar(4000),@p1887 nvarchar(4000),@p1888 int,@p1889 nvarchar(4000),@p1890 nvarchar(4000),@p1891 nvarchar(4000),@p1892 nvarchar(4000),@p1893 nvarchar(4000),@p1894 int,@p1895 nvarchar(4000),@p1896 int,@p1897 int,@p1898 datetime2(7),@p1899 datetime2(7),@p1900 datetime2(7),@p1901 nvarchar(4000),@p1902 nvarchar(4000),@p1903 nvarchar(4000),@p1904 nvarchar(4000),@p1905 nvarchar(4000),@p1906 nvarchar(4000),@p1907 nvarchar(4000),@p1908 nvarchar(4000),@p1909 nvarchar(4000),@p1910 nvarchar(4000),@p1911 nvarchar(4000),@p1912 nvarchar(4000),@p1913 nvarchar(4000),@p1914 nvarchar(4000),@p1915 datetime2(7),@p1916 nvarchar(4000),@p1917 nvarchar(4000),@p1918 int,@p1919 int,@p1920 int,@p1921 nvarchar(4000),@p1922 nvarchar(4000),@p1923 nvarchar(4000),@p1924 nvarchar(4000),@p1925 decimal(18,2),@p1926 nvarchar(4000),@p1927 nvarchar(4000),@p1928 decimal(18,2),@p1929 nvarchar(4000),@p1930 nvarchar(4000),@p1931 nvarchar(4000),@p1932 nvarchar(4000),@p1933 int,@p1934 nvarchar(4000),@p1935 nvarchar(4000),@p1936 nvarchar(4000),@p1937 nvarchar(4000),@p1938 nvarchar(4000),@p1939 nvarchar(4000),@p1940 nvarchar(4000),@p1941 nvarchar(4000),@p1942 nvarchar(4000),@p1943 nvarchar(4000),@p1944 int,@p1945 nvarchar(4000),@p1946 nvarchar(4000),@p1947 nvarchar(4000),@p1948 nvarchar(4000),@p1949 nvarchar(4000),@p1950 int,@p1951 nvarchar(4000),@p1952 int,@p1953 int,@p1954 datetime2(7),@p1955 datetime2(7),@p1956 datetime2(7),@p1957 nvarchar(4000),@p1958 nvarchar(4000),@p1959 nvarchar(4000),@p1960 nvarchar(4000),@p1961 nvarchar(4000),@p1962 nvarchar(4000),@p1963 nvarchar(4000),@p1964 nvarchar(4000),@p1965 nvarchar(4000),@p1966 nvarchar(4000),@p1967 nvarchar(4000),@p1968 nvarchar(4000),@p1969 nvarchar(4000),@p1970 nvarchar(4000),@p1971 datetime2(7),@p1972 nvarchar(4000),@p1973 nvarchar(4000),@p1974 int,@p1975 int,@p1976 int,@p1977 nvarchar(4000),@p1978 nvarchar(4000),@p1979 nvarchar(4000),@p1980 nvarchar(4000),@p1981 decimal(18,2),@p1982 nvarchar(4000),@p1983 nvarchar(4000),@p1984 decimal(18,2),@p1985 nvarchar(4000),@p1986 nvarchar(4000),@p1987 nvarchar(4000),@p1988 nvarchar(4000),@p1989 int,@p1990 nvarchar(4000),@p1991 nvarchar(4000),@p1992 nvarchar(4000),@p1993 nvarchar(4000),@p1994 nvarchar(4000),@p1995 nvarchar(4000),@p1996 nvarchar(4000),@p1997 nvarchar(4000),@p1998 nvarchar(4000),@p1999 nvarchar(4000),@p2000 int,@p2001 nvarchar(4000),@p2002 nvarchar(4000),@p2003 nvarchar(4000),@p2004 nvarchar(4000),@p2005 nvarchar(4000),@p2006 int,@p2007 nvarchar(4000),@p2008 int,@p2009 int,@p2010 datetime2(7),@p2011 datetime2(7),@p2012 datetime2(7),@p2013 nvarchar(4000),@p2014 nvarchar(4000),@p2015 nvarchar(4000),@p2016 nvarchar(4000),@p2017 nvarchar(4000),@p2018 nvarchar(4000),@p2019 nvarchar(4000),@p2020 nvarchar(4000),@p2021 nvarchar(4000),@p2022 nvarchar(4000),@p2023 nvarchar(4000),@p2024 nvarchar(4000),@p2025 nvarchar(4000),@p2026 nvarchar(4000),@p2027 datetime2(7),@p2028 nvarchar(4000),@p2029 nvarchar(4000),@p2030 int,@p2031 int,@p2032 int,@p2033 nvarchar(4000),@p2034 nvarchar(4000),@p2035 nvarchar(4000),@p2036 decimal(18,2),@p2037 decimal(18,2),@p2038 nvarchar(4000),@p2039 nvarchar(4000),@p2040 decimal(18,2),@p2041 nvarchar(4000),@p2042 nvarchar(4000),@p2043 nvarchar(4000),@p2044 nvarchar(4000),@p2045 int,@p2046 nvarchar(4000),@p2047 nvarchar(4000),@p2048 nvarchar(4000),@p2049 nvarchar(4000),@p2050 nvarchar(4000),@p2051 nvarchar(4000),@p2052 nvarchar(4000),@p2053 nvarchar(4000),@p2054 nvarchar(4000),@p2055 nvarchar(4000),@p2056 int,@p2057 nvarchar(4000),@p2058 nvarchar(4000),@p2059 nvarchar(4000),@p2060 nvarchar(4000),@p2061 nvarchar(4000),@p2062 int,@p2063 nvarchar(4000),@p2064 int,@p2065 int,@p2066 datetime2(7),@p2067 datetime2(7),@p2068 datetime2(7),@p2069 nvarchar(4000),@p2070 nvarchar(4000),@p2071 nvarchar(4000))SET NOCOUNT ON; DECLARE @inserted0 TABLE ([item_id] int, [_Position] [int]); MERGE [raw_data] USING ( VALUES (@p0, @p1, @p2, @p3, @p4, @p5, @p6, @p7, @p8, @p9, @p10, @p11, @p12, @p13, @p14, @p15, @p16, @p17, @p18, @p19, @p20, @p21, @p22, @p23, @p24, @p25, @p26, @p27, @p28, @p29, @p30, @p31, @p32, @p33, @p34, @p35, @p36, @p37, @p38, @p39, @p40, @p41, @p42, @p43, @p44, @p45, @p46, @p47, @p48, @p49, @p50, @p51, @p52, @p53, @p54, @p55, 0), (@p56, @p57, @p58, @p59, @p60, @p61, @p62, @p63, @p64, @p65, @p66, @p67, @p68, @p69, @p70, @p71, @p72, @p73, @p74, @p75, @p76, @p77, @p78, @p79, @p80, @p81, @p82, @p83, @p84, @p85, @p86, @p87, @p88, @p89, @p90, @p91, @p92, @p93, @p94, @p95, @p96, @p97, @p98, @p99, @p100, @p101, @p102, @p103, @p104, @p105, @p106, @p107, @p108, @p109, @p110, @p111, 1), (@p112, @p113, @p114, @p115, @p116, @p117, @p118, @p119, @p120, @p121, @p122, @p123, @p124, @p125, @p126, @p127, @p128, @p129, @p130, @p131, @p132, @p133, @p134, @p135, @p136, @p137, @p138, @p139, @p140, @p141, @p142, @p143, @p144, @p145, @p146, @p147, @p148, @p149, @p150, @p151, @p152, @p153, @p154, @p155, @p156, @p157, @p158, @p159, @p160, @p161, @p162, @p163, @p164, @p165, @p166, @p167, 2), (@p168, @p169, @p170, @p171, @p172, @p173, @p174, @p175, @p176, @p177, @p178, @p179, @p180, @p181, @p182, @p183, @p184, @p185, @p186, @p187, @p188, @p189, @p190, @p191, @p192, @p193, @p194, @p195, @p196, @p197, @p198, @p199, @p200, @p201, @p202, @p203, @p204, @p205, @p206, @p207, @p208, @p209, @p210, @p211, @p212, @p213, @p214, @p215, @p216, @p217, @p218, @p219, @p220, @p221, @p222, @p223, 3), (@p224, @p225, @p226, @p227, @p228, @p229, @p230, @p231, @p232, @p233, @p234, @p235, @p236, @p237, @p238, @p239, @p240, @p241, @p242, @p243, @p244, @p245, @p246, @p247, @p248, @p249, @p250, @p251, @p252, @p253, @p254, @p255, @p256, @p257, @p258, @p259, @p260, @p261, @p262, @p263, @p264, @p265, @p266, @p267, @p268, @p269, @p270, @p271, @p272, @p273, @p274, @p275, @p276, @p277, @p278, @p279, 4), (@p280, @p281, @p282, @p283, @p284, @p285, @p286, @p287, @p288, @p289, @p290, @p291, @p292, @p293, @p294, @p295, @p296, @p297, @p298, @p299, @p300, @p301, @p302, @p303, @p304, @p305, @p306, @p307, @p308, @p309, @p310, @p311, @p312, @p313, @p314, @p315, @p316, @p317, @p318, @p319, @p320, @p321, @p322, @p323, @p324, @p325, @p326, @p327, @p328, @p329, @p330, @p331, @p332, @p333, @p334, @p335, 5), (@p336, @p337, @p338, @p339, @p340, @p341, @p342, @p343, @p344, @p345, @p346, @p347, @p348, @p349, @p350, @p351, @p352, @p353, @p354, @p355, @p356, @p357, @p358, @p359, @p360, @p361, @p362, @p363, @p364, @p365, @p366, @p367, @p368, @p369, @p370, @p371, @p372, @p373, @p374, @p375, @p376, @p377, @p378, @p379, @p380, @p381, @p382, @p383, @p384, @p385, @p386, @p387, @p388, @p389, @p390, @p391, 6), (@p392, @p393, @p394, @p395, @p396, @p397, @p398, @p399, @p400, @p401, @p402, @p403, @p404, @p405, @p406, @p407, @p408, @p409, @p410, @p411, @p412, @p413, @p414, @p415, @p416, @p417, @p418, @p419, @p420, @p421, @p422, @p423, @p424, @p425, @p426, @p427, @p428, @p429, @p430, @p431, @p432, @p433, @p434, @p435, @p436, @p437, @p438, @p439, @p440, @p441, @p442, @p443, @p444, @p445, @p446, @p447, 7), (@p448, @p449, @p450, @p451, @p452, @p453, @p454, @p455, @p456, @p457, @p458, @p459, @p460, @p461, @p462, @p463, @p464, @p465, @p466, @p467, @p468, @p469, @p470, @p471, @p472, @p473, @p474, @p475, @p476, @p477, @p478, @p479, @p480, @p481, @p482, @p483, @p484, @p485, @p486, @p487, @p488, @p489, @p490, @p491, @p492, @p493, @p494, @p495, @p496, @p497, @p498, @p499, @p500, @p501, @p502, @p503, 8), (@p504, @p505, @p506, @p507, @p508, @p509, @p510, @p511, @p512, @p513, @p514, @p515, @p516, @p517, @p518, @p519, @p520, @p521, @p522, @p523, @p524, @p525, @p526, @p527, @p528, @p529, @p530, @p531, @p532, @p533, @p534, @p535, @p536, @p537, @p538, @p539, @p540, @p541, @p542, @p543, @p544, @p545, @p546, @p547, @p548, @p549, @p550, @p551, @p552, @p553, @p554, @p555, @p556, @p557, @p558, @p559, 9), (@p560, @p561, @p562, @p563, @p564, @p565, @p566, @p567, @p568, @p569, @p570, @p571, @p572, @p573, @p574, @p575, @p576, @p577, @p578, @p579, @p580, @p581, @p582, @p583, @p584, @p585, @p586, @p587, @p588, @p589, @p590, @p591, @p592, @p593, @p594, @p595, @p596, @p597, @p598, @p599, @p600, @p601, @p602, @p603, @p604, @p605, @p606, @p607, @p608, @p609, @p610, @p611, @p612, @p613, @p614, @p615, 10), (@p616, @p617, @p618, @p619, @p620, @p621, @p622, @p623, @p624, @p625, @p626, @p627, @p628, @p629, @p630, @p631, @p632, @p633, @p634, @p635, @p636, @p637, @p638, @p639, @p640, @p641, @p642, @p643, @p644, @p645, @p646, @p647, @p648, @p649, @p650, @p651, @p652, @p653, @p654, @p655, @p656, @p657, @p658, @p659, @p660, @p661, @p662, @p663, @p664, @p665, @p666, @p667, @p668, @p669, @p670, @p671, 11), (@p672, @p673, @p674, @p675, @p676, @p677, @p678, @p679, @p680, @p681, @p682, @p683, @p684, @p685, @p686, @p687, @p688, @p689, @p690, @p691, @p692, @p693, @p694, @p695, @p696, @p697, @p698, @p699, @p700, @p701, @p702, @p703, @p704, @p705, @p706, @p707, @p708, @p709, @p710, @p711, @p712, @p713, @p714, @p715, @p716, @p717, @p718, @p719, @p720, @p721, @p722, @p723, @p724, @p725, @p726, @p727, 12), (@p728, @p729, @p730, @p731, @p732, @p733, @p734, @p735, @p736, @p737, @p738, @p739, @p740, @p741, @p742, @p743, @p744, @p745, @p746, @p747, @p748, @p749, @p750, @p751, @p752, @p753, @p754, @p755, @p756, @p757, @p758, @p759, @p760, @p761, @p762, @p763, @p764, @p765, @p766, @p767, @p768, @p769, @p770, @p771, @p772, @p773, @p774, @p775, @p776, @p777, @p778, @p779, @p780, @p781, @p782, @p783, 13), (@p784, @p785, @p786, @p787, @p788, @p789, @p790, @p791, @p792, @p793, @p794, @p795, @p796, @p797, @p798, @p799, @p800, @p801, @p802, @p803, @p804, @p805, @p806, @p807, @p808, @p809, @p810, @p811, @p812, @p813, @p814, @p815, @p816, @p817, @p818, @p819, @p820, @p821, @p822, @p823, @p824, @p825, @p826, @p827, @p828, @p829, @p830, @p831, @p832, @p833, @p834, @p835, @p836, @p837, @p838, @p839, 14), (@p840, @p841, @p842, @p843, @p844, @p845, @p846, @p847, @p848, @p849, @p850, @p851, @p852, @p853, @p854, @p855, @p856, @p857, @p858, @p859, @p860, @p861, @p862, @p863, @p864, @p865, @p866, @p867, @p868, @p869, @p870, @p871, @p872, @p873, @p874, @p875, @p876, @p877, @p878, @p879, @p880, @p881, @p882, @p883, @p884, @p885, @p886, @p887, @p888, @p889, @p890, @p891, @p892, @p893, @p894, @p895, 15), (@p896, @p897, @p898, @p899, @p900, @p901, @p902, @p903, @p904, @p905, @p906, @p907, @p908, @p909, @p910, @p911, @p912, @p913, @p914, @p915, @p916, @p917, @p918, @p919, @p920, @p921, @p922, @p923, @p924, @p925, @p926, @p927, @p928, @p929, @p930, @p931, @p932, @p933, @p934, @p935, @p936, @p937, @p938, @p939, @p940, @p941, @p942, @p943, @p944, @p945, @p946, @p947, @p948, @p949, @p950, @p951, 16), (@p952, @p953, @p954, @p955, @p956, @p957, @p958, @p959, @p960, @p961, @p962, @p963, @p964, @p965, @p966, @p967, @p968, @p969, @p970, @p971, @p972, @p973, @p974, @p975, @p976, @p977, @p978, @p979, @p980, @p981, @p982, @p983, @p984, @p985, @p986, @p987, @p988, @p989, @p990, @p991, @p992, @p993, @p994, @p995, @p996, @p997, @p998, @p999, @p1000, @p1001, @p1002, @p1003, @p1004, @p1005, @p1006, @p1007, 17), (@p1008, @p1009, @p1010, @p1011, @p1012, @p1013, @p1014, @p1015, @p1016, @p1017, @p1018, @p1019, @p1020, @p1021, @p1022, @p1023, @p1024, @p1025, @p1026, @p1027, @p1028, @p1029, @p1030, @p1031, @p1032, @p1033, @p1034, @p1035, @p1036, @p1037, @p1038, @p1039, @p1040, @p1041, @p1042, @p1043, @p1044, @p1045, @p1046, @p1047, @p1048, @p1049, @p1050, @p1051, @p1052, @p1053, @p1054, @p1055, @p1056, @p1057, @p1058, @p1059, @p1060, @p1061, @p1062, @p1063, 18), (@p1064, @p1065, @p1066, @p1067, @p1068, @p1069, @p1070, @p1071, @p1072, @p1073, @p1074, @p1075, @p1076, @p1077, @p1078, @p1079, @p1080, @p1081, @p1082, @p1083, @p1084, @p1085, @p1086, @p1087, @p1088, @p1089, @p1090, @p1091, @p1092, @p1093, @p1094, @p1095, @p1096, @p1097, @p1098, @p1099, @p1100, @p1101, @p1102, @p1103, @p1104, @p1105, @p1106, @p1107, @p1108, @p1109, @p1110, @p1111, @p1112, @p1113, @p1114, @p1115, @p1116, @p1117, @p1118, @p1119, 19), (@p1120, @p1121, @p1122, @p1123, @p1124, @p1125, @p1126, @p1127, @p1128, @p1129, @p1130, @p1131, @p1132, @p1133, @p1134, @p1135, @p1136, @p1137, @p1138, @p1139, @p1140, @p1141, @p1142, @p1143, @p1144, @p1145, @p1146, @p1147, @p1148, @p1149, @p1150, @p1151, @p1152, @p1153, @p1154, @p1155, @p1156, @p1157, @p1158, @p1159, @p1160, @p1161, @p1162, @p1163, @p1164, @p1165, @p1166, @p1167, @p1168, @p1169, @p1170, @p1171, @p1172, @p1173, @p1174, @p1175, 20), (@p1176, @p1177, @p1178, @p1179, @p1180, @p1181, @p1182, @p1183, @p1184, @p1185, @p1186, @p1187, @p1188, @p1189, @p1190, @p1191, @p1192, @p1193, @p1194, @p1195, @p1196, @p1197, @p1198, @p1199, @p1200, @p1201, @p1202, @p1203, @p1204, @p1205, @p1206, @p1207, @p1208, @p1209, @p1210, @p1211, @p1212, @p1213, @p1214, @p1215, @p1216, @p1217, @p1218, @p1219, @p1220, @p1221, @p1222, @p1223, @p1224, @p1225, @p1226, @p1227, @p1228, @p1229, @p1230, @p1231, 21), (@p1232, @p1233, @p1234, @p1235, @p1236, @p1237, @p1238, @p1239, @p1240, @p1241, @p1242, @p1243, @p1244, @p1245, @p1246, @p1247, @p1248, @p1249, @p1250, @p1251, @p1252, @p1253, @p1254, @p1255, @p1256, @p1257, @p1258, @p1259, @p1260, @p1261, @p1262, @p1263, @p1264, @p1265, @p1266, @p1267, @p1268, @p1269, @p1270, @p1271, @p1272, @p1273, @p1274, @p1275, @p1276, @p1277, @p1278, @p1279, @p1280, @p1281, @p1282, @p1283, @p1284, @p1285, @p1286, @p1287, 22), (@p1288, @p1289, @p1290, @p1291, @p1292, @p1293, @p1294, @p1295, @p1296, @p1297, @p1298, @p1299, @p1300, @p1301, @p1302, @p1303, @p1304, @p1305, @p1306, @p1307, @p1308, @p1309, @p1310, @p1311, @p1312, @p1313, @p1314, @p1315, @p1316, @p1317, @p1318, @p1319, @p1320, @p1321, @p1322, @p1323, @p1324, @p1325, @p1326, @p1327, @p1328, @p1329, @p1330, @p1331, @p1332, @p1333, @p1334, @p1335, @p1336, @p1337, @p1338, @p1339, @p1340, @p1341, @p1342, @p1343, 23), (@p1344, @p1345, @p1346, @p1347, @p1348, @p1349, @p1350, @p1351, @p1352, @p1353, @p1354, @p1355, @p1356, @p1357, @p1358, @p1359, @p1360, @p1361, @p1362, @p1363, @p1364, @p1365, @p1366, @p1367, @p1368, @p1369, @p1370, @p1371, @p1372, @p1373, @p1374, @p1375, @p1376, @p1377, @p1378, @p1379, @p1380, @p1381, @p1382, @p1383, @p1384, @p1385, @p1386, @p1387, @p1388, @p1389, @p1390, @p1391, @p1392, @p1393, @p1394, @p1395, @p1396, @p1397, @p1398, @p1399, 24), (@p1400, @p1401, @p1402, @p1403, @p1404, @p1405, @p1406, @p1407, @p1408, @p1409, @p1410, @p1411, @p1412, @p1413, @p1414, @p1415, @p1416, @p1417, @p1418, @p1419, @p1420, @p1421, @p1422, @p1423, @p1424, @p1425, @p1426, @p1427, @p1428, @p1429, @p1430, @p1431, @p1432, @p1433, @p1434, @p1435, @p1436, @p1437, @p1438, @p1439, @p1440, @p1441, @p1442, @p1443, @p1444, @p1445, @p1446, @p1447, @p1448, @p1449, @p1450, @p1451, @p1452, @p1453, @p1454, @p1455, 25), (@p1456, @p1457, @p1458, @p1459, @p1460, @p1461, @p1462, @p1463, @p1464, @p1465, @p1466, @p1467, @p1468, @p1469, @p1470, @p1471, @p1472, @p1473, @p1474, @p1475, @p1476, @p1477, @p1478, @p1479, @p1480, @p1481, @p1482, @p1483, @p1484, @p1485, @p1486, @p1487, @p1488, @p1489, @p1490, @p1491, @p1492, @p1493, @p1494, @p1495, @p1496, @p1497, @p1498, @p1499, @p1500, @p1501, @p1502, @p1503, @p1504, @p1505, @p1506, @p1507, @p1508, @p1509, @p1510, @p1511, 26), (@p1512, @p1513, @p1514, @p1515, @p1516, @p1517, @p1518, @p1519, @p1520, @p1521, @p1522, @p1523, @p1524, @p1525, @p1526, @p1527, @p1528, @p1529, @p1530, @p1531, @p1532, @p1533, @p1534, @p1535, @p1536, @p1537, @p1538, @p1539, @p1540, @p1541, @p1542, @p1543, @p1544, @p1545, @p1546, @p1547, @p1548, @p1549, @p1550, @p1551, @p1552, @p1553, @p1554, @p1555, @p1556, @p1557, @p1558, @p1559, @p1560, @p1561, @p1562, @p1563, @p1564, @p1565, @p1566, @p1567, 27), (@p1568, @p1569, @p1570, @p1571, @p1572, @p1573, @p1574, @p1575, @p1576, @p1577, @p1578, @p1579, @p1580, @p1581, @p1582, @p1583, @p1584, @p1585, @p1586, @p1587, @p1588, @p1589, @p1590, @p1591, @p1592, @p1593, @p1594, @p1595, @p1596, @p1597, @p1598, @p1599, @p1600, @p1601, @p1602, @p1603, @p1604, @p1605, @p1606, @p1607, @p1608, @p1609, @p1610, @p1611, @p1612, @p1613, @p1614, @p1615, @p1616, @p1617, @p1618, @p1619, @p1620, @p1621, @p1622, @p1623, 28), (@p1624, @p1625, @p1626, @p1627, @p1628, @p1629, @p1630, @p1631, @p1632, @p1633, @p1634, @p1635, @p1636, @p1637, @p1638, @p1639, @p1640, @p1641, @p1642, @p1643, @p1644, @p1645, @p1646, @p1647, @p1648, @p1649, @p1650, @p1651, @p1652, @p1653, @p1654, @p1655, @p1656, @p1657, @p1658, @p1659, @p1660, @p1661, @p1662, @p1663, @p1664, @p1665, @p1666, @p1667, @p1668, @p1669, @p1670, @p1671, @p1672, @p1673, @p1674, @p1675, @p1676, @p1677, @p1678, @p1679, 29), (@p1680, @p1681, @p1682, @p1683, @p1684, @p1685, @p1686, @p1687, @p1688, @p1689, @p1690, @p1691, @p1692, @p1693, @p1694, @p1695, @p1696, @p1697, @p1698, @p1699, @p1700, @p1701, @p1702, @p1703, @p1704, @p1705, @p1706, @p1707, @p1708, @p1709, @p1710, @p1711, @p1712, @p1713, @p1714, @p1715, @p1716, @p1717, @p1718, @p1719, @p1720, @p1721, @p1722, @p1723, @p1724, @p1725, @p1726, @p1727, @p1728, @p1729, @p1730, @p1731, @p1732, @p1733, @p1734, @p1735, 30), (@p1736, @p1737, @p1738, @p1739, @p1740, @p1741, @p1742, @p1743, @p1744, @p1745, @p1746, @p1747, @p1748, @p1749, @p1750, @p1751, @p1752, @p1753, @p1754, @p1755, @p1756, @p1757, @p1758, @p1759, @p1760, @p1761, @p1762, @p1763, @p1764, @p1765, @p1766, @p1767, @p1768, @p1769, @p1770, @p1771, @p1772, @p1773, @p1774, @p1775, @p1776, @p1777, @p1778, @p1779, @p1780, @p1781, @p1782, @p1783, @p1784, @p1785, @p1786, @p1787, @p1788, @p1789, @p1790, @p1791, 31), (@p1792, @p1793, @p1794, @p1795, @p1796, @p1797, @p1798, @p1799, @p1800, @p1801, @p1802, @p1803, @p1804, @p1805, @p1806, @p1807, @p1808, @p1809, @p1810, @p1811, @p1812, @p1813, @p1814, @p1815, @p1816, @p1817, @p1818, @p1819, @p1820, @p1821, @p1822, @p1823, @p1824, @p1825, @p1826, @p1827, @p1828, @p1829, @p1830, @p1831, @p1832, @p1833, @p1834, @p1835, @p1836, @p1837, @p1838, @p1839, @p1840, @p1841, @p1842, @p1843, @p1844, @p1845, @p1846, @p1847, 32), (@p1848, @p1849, @p1850, @p1851, @p1852, @p1853, @p1854, @p1855, @p1856, @p1857, @p1858, @p1859, @p1860, @p1861, @p1862, @p1863, @p1864, @p1865, @p1866, @p1867, @p1868, @p1869, @p1870, @p1871, @p1872, @p1873, @p1874, @p1875, @p1876, @p1877, @p1878, @p1879, @p1880, @p1881, @p1882, @p1883, @p1884, @p1885, @p1886, @p1887, @p1888, @p1889, @p1890, @p1891, @p1892, @p1893, @p1894, @p1895, @p1896, @p1897, @p1898, @p1899, @p1900, @p1901, @p1902, @p1903, 33), (@p1904, @p1905, @p1906, @p1907, @p1908, @p1909, @p1910, @p1911, @p1912, @p1913, @p1914, @p1915, @p1916, @p1917, @p1918, @p1919, @p1920, @p1921, @p1922, @p1923, @p1924, @p1925, @p1926, @p1927, @p1928, @p1929, @p1930, @p1931, @p1932, @p1933, @p1934, @p1935, @p1936, @p1937, @p1938, @p1939, @p1940, @p1941, @p1942, @p1943, @p1944, @p1945, @p1946, @p1947, @p1948, @p1949, @p1950, @p1951, @p1952, @p1953, @p1954, @p1955, @p1956, @p1957, @p1958, @p1959, 34), (@p1960, @p1961, @p1962, @p1963, @p1964, @p1965, @p1966, @p1967, @p1968, @p1969, @p1970, @p1971, @p1972, @p1973, @p1974, @p1975, @p1976, @p1977, @p1978, @p1979, @p1980, @p1981, @p1982, @p1983, @p1984, @p1985, @p1986, @p1987, @p1988, @p1989, @p1990, @p1991, @p1992, @p1993, @p1994, @p1995, @p1996, @p1997, @p1998, @p1999, @p2000, @p2001, @p2002, @p2003, @p2004, @p2005, @p2006, @p2007, @p2008, @p2009, @p2010, @p2011, @p2012, @p2013, @p2014, @p2015, 35), (@p2016, @p2017, @p2018, @p2019, @p2020, @p2021, @p2022, @p2023, @p2024, @p2025, @p2026, @p2027, @p2028, @p2029, @p2030, @p2031, @p2032, @p2033, @p2034, @p2035, @p2036, @p2037, @p2038, @p2039, @p2040, @p2041, @p2042, @p2043, @p2044, @p2045, @p2046, @p2047, @p2048, @p2049, @p2050, @p2051, @p2052, @p2053, @p2054, @p2055, @p2056, @p2057, @p2058, @p2059, @p2060, @p2061, @p2062, @p2063, @p2064, @p2065, @p2066, @p2067, @p2068, @p2069, @p2070, @p2071, 36)) AS i ([addressee_cntry_cd], [addressee_city], [addressee_district], [addressee_email], [addressee_full_address], [addressee_home_address], [addressee_name], [addressee_postcode], [addressee_province], [addressee_subdistrict], [addressee_tel], [create_table], [delivery_code], [delivery_recipient_name], [delivery_relation_id], [delivery_status_id], [dest_outlet_id], [dest_outlet_port], [document_number], [item_barcode], [item_cod], [item_gross_weight], [item_height], [item_length], [item_price], [item_width], [lat], [log_id], [long], [outlet_id], [outlet_port], [podUrl], [remark], [scan_cntry_cd], [scan_cntry_postcode], [sender_cntry_cd], [sender_district], [sender_email], [sender_full_address], [sender_home_address], [member_id], [sender_name], [sender_postcode], [sender_province], [sender_subdistrict], [sender_tel], [server_id], [signatureUrl], [state], [status_code], [status_dtm], [timestamp], [transmit_dtm], [user_id], [wckt_id], [wkstn_no], _Position) ON 1=0 WHEN NOT MATCHED THEN INSERT ([addressee_cntry_cd], [addressee_city], [addressee_district], [addressee_email], [addressee_full_address], [addressee_home_address], [addressee_name], [addressee_postcode], [addressee_province], [addressee_subdistrict], [addressee_tel], [create_table], [delivery_code], [delivery_recipient_name], [delivery_relation_id], [delivery_status_id], [dest_outlet_id], [dest_outlet_port], [document_number], [item_barcode], [item_cod], [item_gross_weight], [item_height], [item_length], [item_price], [item_width], [lat], [log_id], [long], [outlet_id], [outlet_port], [podUrl], [remark], [scan_cntry_cd], [scan_cntry_postcode], [sender_cntry_cd], [sender_district], [sender_email], [sender_full_address], [sender_home_address], [member_id], [sender_name], [sender_postcode], [sender_province], [sender_subdistrict], [sender_tel], [server_id], [signatureUrl], [state], [status_code], [status_dtm], [timestamp], [transmit_dtm], [user_id], [wckt_id], [wkstn_no]) VALUES (i.[addressee_cntry_cd], i.[addressee_city], i.[addressee_district], i.[addressee_email], i.[addressee_full_address], i.[addressee_home_address], i.[addressee_name], i.[addressee_postcode], i.[addressee_province], i.[addressee_subdistrict], i.[addressee_tel], i.[create_table], i.[delivery_code], i.[delivery_recipient_name], i.[delivery_relation_id], i.[delivery_status_id], i.[dest_outlet_id], i.[dest_outlet_port], i.[document_number], i.[item_barcode], i.[item_cod], i.[item_gross_weight], i.[item_height], i.[item_length], i.[item_price], i.[item_width], i.[lat], i.[log_id], i.[long], i.[outlet_id], i.[outlet_port], i.[podUrl], i.[remark], i.[scan_cntry_cd], i.[scan_cntry_postcode], i.[sender_cntry_cd], i.[sender_district], i.[sender_email], i.[sender_full_address], i.[sender_home_address], i.[member_id], i.[sender_name], i.[sender_postcode], i.[sender_province], i.[sender_subdistrict], i.[sender_tel], i.[server_id], i.[signatureUrl], i.[state], i.[status_code], i.[status_dtm], i.[timestamp], i.[transmit_dtm], i.[user_id], i.[wckt_id], i.[wkstn_no]) OUTPUT INSERTED.[item_id], i._Position INTO @inserted0;  SELECT [t].[item_id] FROM [raw_data] t INNER JOIN @inserted0 i ON ([t].[item_id] = [i].[item_id]) ORDER BY [i].[_Position];  ",4,4,0,443,5,4
"(@p0 nvarchar(4000),@p1 nvarchar(4000),@p2 nvarchar(4000),@p3 nvarchar(4000),@p4 nvarchar(4000),@p5 nvarchar(4000),@p6 nvarchar(4000),@p7 nvarchar(4000),@p8 nvarchar(4000),@p9 nvarchar(4000),@p10 nvarchar(4000),@p11 datetime2(7),@p12 nvarchar(4000),@p13 nvarchar(4000),@p14 int,@p15 int,@p16 int,@p17 nvarchar(4000),@p18 nvarchar(4000),@p19 nvarchar(4000),@p20 nvarchar(4000),@p21 decimal(18,2),@p22 nvarchar(4000),@p23 nvarchar(4000),@p24 decimal(18,2),@p25 nvarchar(4000),@p26 nvarchar(4000),@p27 nvarchar(4000),@p28 nvarchar(4000),@p29 int,@p30 nvarchar(4000),@p31 nvarchar(4000),@p32 nvarchar(4000),@p33 nvarchar(4000),@p34 nvarchar(4000),@p35 nvarchar(4000),@p36 nvarchar(4000),@p37 nvarchar(4000),@p38 nvarchar(4000),@p39 nvarchar(4000),@p40 int,@p41 nvarchar(4000),@p42 nvarchar(4000),@p43 nvarchar(4000),@p44 nvarchar(4000),@p45 nvarchar(4000),@p46 int,@p47 nvarchar(4000),@p48 int,@p49 int,@p50 datetime2(7),@p51 datetime2(7),@p52 datetime2(7),@p53 nvarchar(4000),@p54 nvarchar(4000),@p55 nvarchar(4000),@p56 nvarchar(4000),@p57 nvarchar(4000),@p58 nvarchar(4000),@p59 nvarchar(4000),@p60 nvarchar(4000),@p61 nvarchar(4000),@p62 nvarchar(4000),@p63 nvarchar(4000),@p64 nvarchar(4000),@p65 nvarchar(4000),@p66 nvarchar(4000),@p67 datetime2(7),@p68 nvarchar(4000),@p69 nvarchar(4000),@p70 int,@p71 int,@p72 int,@p73 nvarchar(4000),@p74 nvarchar(4000),@p75 nvarchar(4000),@p76 nvarchar(4000),@p77 decimal(18,2),@p78 nvarchar(4000),@p79 nvarchar(4000),@p80 decimal(18,2),@p81 nvarchar(4000),@p82 nvarchar(4000),@p83 nvarchar(4000),@p84 nvarchar(4000),@p85 int,@p86 nvarchar(4000),@p87 nvarchar(4000),@p88 nvarchar(4000),@p89 nvarchar(4000),@p90 nvarchar(4000),@p91 nvarchar(4000),@p92 nvarchar(4000),@p93 nvarchar(4000),@p94 nvarchar(4000),@p95 nvarchar(4000),@p96 int,@p97 nvarchar(4000),@p98 nvarchar(4000),@p99 nvarchar(4000),@p100 nvarchar(4000),@p101 nvarchar(4000),@p102 int,@p103 nvarchar(4000),@p104 int,@p105 int,@p106 datetime2(7),@p107 datetime2(7),@p108 datetime2(7),@p109 nvarchar(4000),@p110 nvarchar(4000),@p111 nvarchar(4000),@p112 nvarchar(4000),@p113 nvarchar(4000),@p114 nvarchar(4000),@p115 nvarchar(4000),@p116 nvarchar(4000),@p117 nvarchar(4000),@p118 nvarchar(4000),@p119 nvarchar(4000),@p120 nvarchar(4000),@p121 nvarchar(4000),@p122 nvarchar(4000),@p123 datetime2(7),@p124 nvarchar(4000),@p125 nvarchar(4000),@p126 int,@p127 int,@p128 int,@p129 nvarchar(4000),@p130 nvarchar(4000),@p131 nvarchar(4000),@p132 nvarchar(4000),@p133 decimal(18,2),@p134 nvarchar(4000),@p135 nvarchar(4000),@p136 decimal(18,2),@p137 nvarchar(4000),@p138 nvarchar(4000),@p139 nvarchar(4000),@p140 nvarchar(4000),@p141 int,@p142 nvarchar(4000),@p143 nvarchar(4000),@p144 nvarchar(4000),@p145 nvarchar(4000),@p146 nvarchar(4000),@p147 nvarchar(4000),@p148 nvarchar(4000),@p149 nvarchar(4000),@p150 nvarchar(4000),@p151 nvarchar(4000),@p152 int,@p153 nvarchar(4000),@p154 nvarchar(4000),@p155 nvarchar(4000),@p156 nvarchar(4000),@p157 nvarchar(4000),@p158 int,@p159 nvarchar(4000),@p160 int,@p161 int,@p162 datetime2(7),@p163 datetime2(7),@p164 datetime2(7),@p165 nvarchar(4000),@p166 nvarchar(4000),@p167 nvarchar(4000),@p168 nvarchar(4000),@p169 nvarchar(4000),@p170 nvarchar(4000),@p171 nvarchar(4000),@p172 nvarchar(4000),@p173 nvarchar(4000),@p174 nvarchar(4000),@p175 nvarchar(4000),@p176 nvarchar(4000),@p177 nvarchar(4000),@p178 nvarchar(4000),@p179 datetime2(7),@p180 nvarchar(4000),@p181 nvarchar(4000),@p182 int,@p183 int,@p184 int,@p185 nvarchar(4000),@p186 nvarchar(4000),@p187 nvarchar(4000),@p188 nvarchar(4000),@p189 decimal(18,2),@p190 nvarchar(4000),@p191 nvarchar(4000),@p192 decimal(18,2),@p193 nvarchar(4000),@p194 nvarchar(4000),@p195 nvarchar(4000),@p196 nvarchar(4000),@p197 int,@p198 nvarchar(4000),@p199 nvarchar(4000),@p200 nvarchar(4000),@p201 nvarchar(4000),@p202 nvarchar(4000),@p203 nvarchar(4000),@p204 nvarchar(4000),@p205 nvarchar(4000),@p206 nvarchar(4000),@p207 nvarchar(4000),@p208 int,@p209 nvarchar(4000),@p210 nvarchar(4000),@p211 nvarchar(4000),@p212 nvarchar(4000),@p213 nvarchar(4000),@p214 int,@p215 nvarchar(4000),@p216 int,@p217 int,@p218 datetime2(7),@p219 datetime2(7),@p220 datetime2(7),@p221 nvarchar(4000),@p222 nvarchar(4000),@p223 nvarchar(4000),@p224 nvarchar(4000),@p225 nvarchar(4000),@p226 nvarchar(4000),@p227 nvarchar(4000),@p228 nvarchar(4000),@p229 nvarchar(4000),@p230 nvarchar(4000),@p231 nvarchar(4000),@p232 nvarchar(4000),@p233 nvarchar(4000),@p234 nvarchar(4000),@p235 datetime2(7),@p236 nvarchar(4000),@p237 nvarchar(4000),@p238 int,@p239 int,@p240 int,@p241 nvarchar(4000),@p242 nvarchar(4000),@p243 nvarchar(4000),@p244 nvarchar(4000),@p245 decimal(18,2),@p246 nvarchar(4000),@p247 nvarchar(4000),@p248 decimal(18,2),@p249 nvarchar(4000),@p250 nvarchar(4000),@p251 nvarchar(4000),@p252 nvarchar(4000),@p253 int,@p254 nvarchar(4000),@p255 nvarchar(4000),@p256 nvarchar(4000),@p257 nvarchar(4000),@p258 nvarchar(4000),@p259 nvarchar(4000),@p260 nvarchar(4000),@p261 nvarchar(4000),@p262 nvarchar(4000),@p263 nvarchar(4000),@p264 int,@p265 nvarchar(4000),@p266 nvarchar(4000),@p267 nvarchar(4000),@p268 nvarchar(4000),@p269 nvarchar(4000),@p270 int,@p271 nvarchar(4000),@p272 int,@p273 int,@p274 datetime2(7),@p275 datetime2(7),@p276 datetime2(7),@p277 nvarchar(4000),@p278 nvarchar(4000),@p279 nvarchar(4000),@p280 nvarchar(4000),@p281 nvarchar(4000),@p282 nvarchar(4000),@p283 nvarchar(4000),@p284 nvarchar(4000),@p285 nvarchar(4000),@p286 nvarchar(4000),@p287 nvarchar(4000),@p288 nvarchar(4000),@p289 nvarchar(4000),@p290 nvarchar(4000),@p291 datetime2(7),@p292 nvarchar(4000),@p293 nvarchar(4000),@p294 int,@p295 int,@p296 int,@p297 nvarchar(4000),@p298 nvarchar(4000),@p299 nvarchar(4000),@p300 nvarchar(4000),@p301 decimal(18,2),@p302 nvarchar(4000),@p303 nvarchar(4000),@p304 decimal(18,2),@p305 nvarchar(4000),@p306 nvarchar(4000),@p307 nvarchar(4000),@p308 nvarchar(4000),@p309 int,@p310 nvarchar(4000),@p311 nvarchar(4000),@p312 nvarchar(4000),@p313 nvarchar(4000),@p314 nvarchar(4000),@p315 nvarchar(4000),@p316 nvarchar(4000),@p317 nvarchar(4000),@p318 nvarchar(4000),@p319 nvarchar(4000),@p320 int,@p321 nvarchar(4000),@p322 nvarchar(4000),@p323 nvarchar(4000),@p324 nvarchar(4000),@p325 nvarchar(4000),@p326 int,@p327 nvarchar(4000),@p328 int,@p329 int,@p330 datetime2(7),@p331 datetime2(7),@p332 datetime2(7),@p333 nvarchar(4000),@p334 nvarchar(4000),@p335 nvarchar(4000),@p336 nvarchar(4000),@p337 nvarchar(4000),@p338 nvarchar(4000),@p339 nvarchar(4000),@p340 nvarchar(4000),@p341 nvarchar(4000),@p342 nvarchar(4000),@p343 nvarchar(4000),@p344 nvarchar(4000),@p345 nvarchar(4000),@p346 nvarchar(4000),@p347 datetime2(7),@p348 nvarchar(4000),@p349 nvarchar(4000),@p350 int,@p351 int,@p352 int,@p353 nvarchar(4000),@p354 nvarchar(4000),@p355 nvarchar(4000),@p356 nvarchar(4000),@p357 decimal(18,2),@p358 nvarchar(4000),@p359 nvarchar(4000),@p360 decimal(18,2),@p361 nvarchar(4000),@p362 nvarchar(4000),@p363 nvarchar(4000),@p364 nvarchar(4000),@p365 int,@p366 nvarchar(4000),@p367 nvarchar(4000),@p368 nvarchar(4000),@p369 nvarchar(4000),@p370 nvarchar(4000),@p371 nvarchar(4000),@p372 nvarchar(4000),@p373 nvarchar(4000),@p374 nvarchar(4000),@p375 nvarchar(4000),@p376 int,@p377 nvarchar(4000),@p378 nvarchar(4000),@p379 nvarchar(4000),@p380 nvarchar(4000),@p381 nvarchar(4000),@p382 int,@p383 nvarchar(4000),@p384 int,@p385 int,@p386 datetime2(7),@p387 datetime2(7),@p388 datetime2(7),@p389 nvarchar(4000),@p390 nvarchar(4000),@p391 nvarchar(4000),@p392 nvarchar(4000),@p393 nvarchar(4000),@p394 nvarchar(4000),@p395 nvarchar(4000),@p396 nvarchar(4000),@p397 nvarchar(4000),@p398 nvarchar(4000),@p399 nvarchar(4000),@p400 nvarchar(4000),@p401 nvarchar(4000),@p402 nvarchar(4000),@p403 datetime2(7),@p404 nvarchar(4000),@p405 nvarchar(4000),@p406 int,@p407 int,@p408 int,@p409 nvarchar(4000),@p410 nvarchar(4000),@p411 nvarchar(4000),@p412 nvarchar(4000),@p413 decimal(18,2),@p414 nvarchar(4000),@p415 nvarchar(4000),@p416 decimal(18,2),@p417 nvarchar(4000),@p418 nvarchar(4000),@p419 nvarchar(4000),@p420 nvarchar(4000),@p421 int,@p422 nvarchar(4000),@p423 nvarchar(4000),@p424 nvarchar(4000),@p425 nvarchar(4000),@p426 nvarchar(4000),@p427 nvarchar(4000),@p428 nvarchar(4000),@p429 nvarchar(4000),@p430 nvarchar(4000),@p431 nvarchar(4000),@p432 int,@p433 nvarchar(4000),@p434 nvarchar(4000),@p435 nvarchar(4000),@p436 nvarchar(4000),@p437 nvarchar(4000),@p438 int,@p439 nvarchar(4000),@p440 int,@p441 int,@p442 datetime2(7),@p443 datetime2(7),@p444 datetime2(7),@p445 nvarchar(4000),@p446 nvarchar(4000),@p447 nvarchar(4000),@p448 nvarchar(4000),@p449 nvarchar(4000),@p450 nvarchar(4000),@p451 nvarchar(4000),@p452 nvarchar(4000),@p453 nvarchar(4000),@p454 nvarchar(4000),@p455 nvarchar(4000),@p456 nvarchar(4000),@p457 nvarchar(4000),@p458 nvarchar(4000),@p459 datetime2(7),@p460 nvarchar(4000),@p461 nvarchar(4000),@p462 int,@p463 int,@p464 int,@p465 nvarchar(4000),@p466 nvarchar(4000),@p467 nvarchar(4000),@p468 decimal(18,2),@p469 decimal(18,2),@p470 nvarchar(4000),@p471 nvarchar(4000),@p472 decimal(18,2),@p473 nvarchar(4000),@p474 nvarchar(4000),@p475 nvarchar(4000),@p476 nvarchar(4000),@p477 int,@p478 nvarchar(4000),@p479 nvarchar(4000),@p480 nvarchar(4000),@p481 nvarchar(4000),@p482 nvarchar(4000),@p483 nvarchar(4000),@p484 nvarchar(4000),@p485 nvarchar(4000),@p486 nvarchar(4000),@p487 nvarchar(4000),@p488 int,@p489 nvarchar(4000),@p490 nvarchar(4000),@p491 nvarchar(4000),@p492 nvarchar(4000),@p493 nvarchar(4000),@p494 int,@p495 nvarchar(4000),@p496 int,@p497 int,@p498 datetime2(7),@p499 datetime2(7),@p500 datetime2(7),@p501 nvarchar(4000),@p502 nvarchar(4000),@p503 nvarchar(4000),@p504 nvarchar(4000),@p505 nvarchar(4000),@p506 nvarchar(4000),@p507 nvarchar(4000),@p508 nvarchar(4000),@p509 nvarchar(4000),@p510 nvarchar(4000),@p511 nvarchar(4000),@p512 nvarchar(4000),@p513 nvarchar(4000),@p514 nvarchar(4000),@p515 datetime2(7),@p516 nvarchar(4000),@p517 nvarchar(4000),@p518 int,@p519 int,@p520 int,@p521 nvarchar(4000),@p522 nvarchar(4000),@p523 nvarchar(4000),@p524 decimal(18,2),@p525 decimal(18,2),@p526 nvarchar(4000),@p527 nvarchar(4000),@p528 decimal(18,2),@p529 nvarchar(4000),@p530 nvarchar(4000),@p531 nvarchar(4000),@p532 nvarchar(4000),@p533 int,@p534 nvarchar(4000),@p535 nvarchar(4000),@p536 nvarchar(4000),@p537 nvarchar(4000),@p538 nvarchar(4000),@p539 nvarchar(4000),@p540 nvarchar(4000),@p541 nvarchar(4000),@p542 nvarchar(4000),@p543 nvarchar(4000),@p544 int,@p545 nvarchar(4000),@p546 nvarchar(4000),@p547 nvarchar(4000),@p548 nvarchar(4000),@p549 nvarchar(4000),@p550 int,@p551 nvarchar(4000),@p552 int,@p553 int,@p554 datetime2(7),@p555 datetime2(7),@p556 datetime2(7),@p557 nvarchar(4000),@p558 nvarchar(4000),@p559 nvarchar(4000),@p560 nvarchar(4000),@p561 nvarchar(4000),@p562 nvarchar(4000),@p563 nvarchar(4000),@p564 nvarchar(4000),@p565 nvarchar(4000),@p566 nvarchar(4000),@p567 nvarchar(4000),@p568 nvarchar(4000),@p569 nvarchar(4000),@p570 nvarchar(4000),@p571 datetime2(7),@p572 nvarchar(4000),@p573 nvarchar(4000),@p574 int,@p575 int,@p576 int,@p577 nvarchar(4000),@p578 nvarchar(4000),@p579 nvarchar(4000),@p580 decimal(18,2),@p581 decimal(18,2),@p582 nvarchar(4000),@p583 nvarchar(4000),@p584 decimal(18,2),@p585 nvarchar(4000),@p586 nvarchar(4000),@p587 nvarchar(4000),@p588 nvarchar(4000),@p589 int,@p590 nvarchar(4000),@p591 nvarchar(4000),@p592 nvarchar(4000),@p593 nvarchar(4000),@p594 nvarchar(4000),@p595 nvarchar(4000),@p596 nvarchar(4000),@p597 nvarchar(4000),@p598 nvarchar(4000),@p599 nvarchar(4000),@p600 int,@p601 nvarchar(4000),@p602 nvarchar(4000),@p603 nvarchar(4000),@p604 nvarchar(4000),@p605 nvarchar(4000),@p606 int,@p607 nvarchar(4000),@p608 int,@p609 int,@p610 datetime2(7),@p611 datetime2(7),@p612 datetime2(7),@p613 nvarchar(4000),@p614 nvarchar(4000),@p615 nvarchar(4000),@p616 nvarchar(4000),@p617 nvarchar(4000),@p618 nvarchar(4000),@p619 nvarchar(4000),@p620 nvarchar(4000),@p621 nvarchar(4000),@p622 nvarchar(4000),@p623 nvarchar(4000),@p624 nvarchar(4000),@p625 nvarchar(4000),@p626 nvarchar(4000),@p627 datetime2(7),@p628 nvarchar(4000),@p629 nvarchar(4000),@p630 int,@p631 int,@p632 int,@p633 nvarchar(4000),@p634 nvarchar(4000),@p635 nvarchar(4000),@p636 decimal(18,2),@p637 decimal(18,2),@p638 nvarchar(4000),@p639 nvarchar(4000),@p640 decimal(18,2),@p641 nvarchar(4000),@p642 nvarchar(4000),@p643 nvarchar(4000),@p644 nvarchar(4000),@p645 int,@p646 nvarchar(4000),@p647 nvarchar(4000),@p648 nvarchar(4000),@p649 nvarchar(4000),@p650 nvarchar(4000),@p651 nvarchar(4000),@p652 nvarchar(4000),@p653 nvarchar(4000),@p654 nvarchar(4000),@p655 nvarchar(4000),@p656 int,@p657 nvarchar(4000),@p658 nvarchar(4000),@p659 nvarchar(4000),@p660 nvarchar(4000),@p661 nvarchar(4000),@p662 int,@p663 nvarchar(4000),@p664 int,@p665 int,@p666 datetime2(7),@p667 datetime2(7),@p668 datetime2(7),@p669 nvarchar(4000),@p670 nvarchar(4000),@p671 nvarchar(4000),@p672 nvarchar(4000),@p673 nvarchar(4000),@p674 nvarchar(4000),@p675 nvarchar(4000),@p676 nvarchar(4000),@p677 nvarchar(4000),@p678 nvarchar(4000),@p679 nvarchar(4000),@p680 nvarchar(4000),@p681 nvarchar(4000),@p682 nvarchar(4000),@p683 datetime2(7),@p684 nvarchar(4000),@p685 nvarchar(4000),@p686 int,@p687 int,@p688 int,@p689 nvarchar(4000),@p690 nvarchar(4000),@p691 nvarchar(4000),@p692 decimal(18,2),@p693 decimal(18,2),@p694 nvarchar(4000),@p695 nvarchar(4000),@p696 decimal(18,2),@p697 nvarchar(4000),@p698 nvarchar(4000),@p699 nvarchar(4000),@p700 nvarchar(4000),@p701 int,@p702 nvarchar(4000),@p703 nvarchar(4000),@p704 nvarchar(4000),@p705 nvarchar(4000),@p706 nvarchar(4000),@p707 nvarchar(4000),@p708 nvarchar(4000),@p709 nvarchar(4000),@p710 nvarchar(4000),@p711 nvarchar(4000),@p712 int,@p713 nvarchar(4000),@p714 nvarchar(4000),@p715 nvarchar(4000),@p716 nvarchar(4000),@p717 nvarchar(4000),@p718 int,@p719 nvarchar(4000),@p720 int,@p721 int,@p722 datetime2(7),@p723 datetime2(7),@p724 datetime2(7),@p725 nvarchar(4000),@p726 nvarchar(4000),@p727 nvarchar(4000),@p728 nvarchar(4000),@p729 nvarchar(4000),@p730 nvarchar(4000),@p731 nvarchar(4000),@p732 nvarchar(4000),@p733 nvarchar(4000),@p734 nvarchar(4000),@p735 nvarchar(4000),@p736 nvarchar(4000),@p737 nvarchar(4000),@p738 nvarchar(4000),@p739 datetime2(7),@p740 nvarchar(4000),@p741 nvarchar(4000),@p742 int,@p743 int,@p744 int,@p745 nvarchar(4000),@p746 nvarchar(4000),@p747 nvarchar(4000),@p748 decimal(18,2),@p749 decimal(18,2),@p750 nvarchar(4000),@p751 nvarchar(4000),@p752 decimal(18,2),@p753 nvarchar(4000),@p754 nvarchar(4000),@p755 nvarchar(4000),@p756 nvarchar(4000),@p757 int,@p758 nvarchar(4000),@p759 nvarchar(4000),@p760 nvarchar(4000),@p761 nvarchar(4000),@p762 nvarchar(4000),@p763 nvarchar(4000),@p764 nvarchar(4000),@p765 nvarchar(4000),@p766 nvarchar(4000),@p767 nvarchar(4000),@p768 int,@p769 nvarchar(4000),@p770 nvarchar(4000),@p771 nvarchar(4000),@p772 nvarchar(4000),@p773 nvarchar(4000),@p774 int,@p775 nvarchar(4000),@p776 int,@p777 int,@p778 datetime2(7),@p779 datetime2(7),@p780 datetime2(7),@p781 nvarchar(4000),@p782 nvarchar(4000),@p783 nvarchar(4000),@p784 nvarchar(4000),@p785 nvarchar(4000),@p786 nvarchar(4000),@p787 nvarchar(4000),@p788 nvarchar(4000),@p789 nvarchar(4000),@p790 nvarchar(4000),@p791 nvarchar(4000),@p792 nvarchar(4000),@p793 nvarchar(4000),@p794 nvarchar(4000),@p795 datetime2(7),@p796 nvarchar(4000),@p797 nvarchar(4000),@p798 int,@p799 int,@p800 int,@p801 nvarchar(4000),@p802 nvarchar(4000),@p803 nvarchar(4000),@p804 decimal(18,2),@p805 decimal(18,2),@p806 nvarchar(4000),@p807 nvarchar(4000),@p808 decimal(18,2),@p809 nvarchar(4000),@p810 nvarchar(4000),@p811 nvarchar(4000),@p812 nvarchar(4000),@p813 int,@p814 nvarchar(4000),@p815 nvarchar(4000),@p816 nvarchar(4000),@p817 nvarchar(4000),@p818 nvarchar(4000),@p819 nvarchar(4000),@p820 nvarchar(4000),@p821 nvarchar(4000),@p822 nvarchar(4000),@p823 nvarchar(4000),@p824 int,@p825 nvarchar(4000),@p826 nvarchar(4000),@p827 nvarchar(4000),@p828 nvarchar(4000),@p829 nvarchar(4000),@p830 int,@p831 nvarchar(4000),@p832 int,@p833 int,@p834 datetime2(7),@p835 datetime2(7),@p836 datetime2(7),@p837 nvarchar(4000),@p838 nvarchar(4000),@p839 nvarchar(4000),@p840 nvarchar(4000),@p841 nvarchar(4000),@p842 nvarchar(4000),@p843 nvarchar(4000),@p844 nvarchar(4000),@p845 nvarchar(4000),@p846 nvarchar(4000),@p847 nvarchar(4000),@p848 nvarchar(4000),@p849 nvarchar(4000),@p850 nvarchar(4000),@p851 datetime2(7),@p852 nvarchar(4000),@p853 nvarchar(4000),@p854 int,@p855 int,@p856 int,@p857 nvarchar(4000),@p858 nvarchar(4000),@p859 nvarchar(4000),@p860 decimal(18,2),@p861 decimal(18,2),@p862 nvarchar(4000),@p863 nvarchar(4000),@p864 decimal(18,2),@p865 nvarchar(4000),@p866 nvarchar(4000),@p867 nvarchar(4000),@p868 nvarchar(4000),@p869 int,@p870 nvarchar(4000),@p871 nvarchar(4000),@p872 nvarchar(4000),@p873 nvarchar(4000),@p874 nvarchar(4000),@p875 nvarchar(4000),@p876 nvarchar(4000),@p877 nvarchar(4000),@p878 nvarchar(4000),@p879 nvarchar(4000),@p880 int,@p881 nvarchar(4000),@p882 nvarchar(4000),@p883 nvarchar(4000),@p884 nvarchar(4000),@p885 nvarchar(4000),@p886 int,@p887 nvarchar(4000),@p888 int,@p889 int,@p890 datetime2(7),@p891 datetime2(7),@p892 datetime2(7),@p893 nvarchar(4000),@p894 nvarchar(4000),@p895 nvarchar(4000),@p896 nvarchar(4000),@p897 nvarchar(4000),@p898 nvarchar(4000),@p899 nvarchar(4000),@p900 nvarchar(4000),@p901 nvarchar(4000),@p902 nvarchar(4000),@p903 nvarchar(4000),@p904 nvarchar(4000),@p905 nvarchar(4000),@p906 nvarchar(4000),@p907 datetime2(7),@p908 nvarchar(4000),@p909 nvarchar(4000),@p910 int,@p911 int,@p912 int,@p913 nvarchar(4000),@p914 nvarchar(4000),@p915 nvarchar(4000),@p916 nvarchar(4000),@p917 decimal(18,2),@p918 nvarchar(4000),@p919 nvarchar(4000),@p920 decimal(18,2),@p921 nvarchar(4000),@p922 nvarchar(4000),@p923 nvarchar(4000),@p924 nvarchar(4000),@p925 int,@p926 nvarchar(4000),@p927 nvarchar(4000),@p928 nvarchar(4000),@p929 nvarchar(4000),@p930 nvarchar(4000),@p931 nvarchar(4000),@p932 nvarchar(4000),@p933 nvarchar(4000),@p934 nvarchar(4000),@p935 nvarchar(4000),@p936 int,@p937 nvarchar(4000),@p938 nvarchar(4000),@p939 nvarchar(4000),@p940 nvarchar(4000),@p941 nvarchar(4000),@p942 int,@p943 nvarchar(4000),@p944 int,@p945 int,@p946 datetime2(7),@p947 datetime2(7),@p948 datetime2(7),@p949 nvarchar(4000),@p950 nvarchar(4000),@p951 nvarchar(4000),@p952 nvarchar(4000),@p953 nvarchar(4000),@p954 nvarchar(4000),@p955 nvarchar(4000),@p956 nvarchar(4000),@p957 nvarchar(4000),@p958 nvarchar(4000),@p959 nvarchar(4000),@p960 nvarchar(4000),@p961 nvarchar(4000),@p962 nvarchar(4000),@p963 datetime2(7),@p964 nvarchar(4000),@p965 nvarchar(4000),@p966 int,@p967 int,@p968 int,@p969 nvarchar(4000),@p970 nvarchar(4000),@p971 nvarchar(4000),@p972 decimal(18,2),@p973 decimal(18,2),@p974 nvarchar(4000),@p975 nvarchar(4000),@p976 decimal(18,2),@p977 nvarchar(4000),@p978 nvarchar(4000),@p979 nvarchar(4000),@p980 nvarchar(4000),@p981 int,@p982 nvarchar(4000),@p983 nvarchar(4000),@p984 nvarchar(4000),@p985 nvarchar(4000),@p986 nvarchar(4000),@p987 nvarchar(4000),@p988 nvarchar(4000),@p989 nvarchar(4000),@p990 nvarchar(4000),@p991 nvarchar(4000),@p992 int,@p993 nvarchar(4000),@p994 nvarchar(4000),@p995 nvarchar(4000),@p996 nvarchar(4000),@p997 nvarchar(4000),@p998 int,@p999 nvarchar(4000),@p1000 int,@p1001 int,@p1002 datetime2(7),@p1003 datetime2(7),@p1004 datetime2(7),@p1005 nvarchar(4000),@p1006 nvarchar(4000),@p1007 nvarchar(4000),@p1008 nvarchar(4000),@p1009 nvarchar(4000),@p1010 nvarchar(4000),@p1011 nvarchar(4000),@p1012 nvarchar(4000),@p1013 nvarchar(4000),@p1014 nvarchar(4000),@p1015 nvarchar(4000),@p1016 nvarchar(4000),@p1017 nvarchar(4000),@p1018 nvarchar(4000),@p1019 datetime2(7),@p1020 nvarchar(4000),@p1021 nvarchar(4000),@p1022 int,@p1023 int,@p1024 int,@p1025 nvarchar(4000),@p1026 nvarchar(4000),@p1027 nvarchar(4000),@p1028 nvarchar(4000),@p1029 decimal(18,2),@p1030 nvarchar(4000),@p1031 nvarchar(4000),@p1032 decimal(18,2),@p1033 nvarchar(4000),@p1034 nvarchar(4000),@p1035 nvarchar(4000),@p1036 nvarchar(4000),@p1037 int,@p1038 nvarchar(4000),@p1039 nvarchar(4000),@p1040 nvarchar(4000),@p1041 nvarchar(4000),@p1042 nvarchar(4000),@p1043 nvarchar(4000),@p1044 nvarchar(4000),@p1045 nvarchar(4000),@p1046 nvarchar(4000),@p1047 nvarchar(4000),@p1048 int,@p1049 nvarchar(4000),@p1050 nvarchar(4000),@p1051 nvarchar(4000),@p1052 nvarchar(4000),@p1053 nvarchar(4000),@p1054 int,@p1055 nvarchar(4000),@p1056 int,@p1057 int,@p1058 datetime2(7),@p1059 datetime2(7),@p1060 datetime2(7),@p1061 nvarchar(4000),@p1062 nvarchar(4000),@p1063 nvarchar(4000),@p1064 nvarchar(4000),@p1065 nvarchar(4000),@p1066 nvarchar(4000),@p1067 nvarchar(4000),@p1068 nvarchar(4000),@p1069 nvarchar(4000),@p1070 nvarchar(4000),@p1071 nvarchar(4000),@p1072 nvarchar(4000),@p1073 nvarchar(4000),@p1074 nvarchar(4000),@p1075 datetime2(7),@p1076 nvarchar(4000),@p1077 nvarchar(4000),@p1078 int,@p1079 int,@p1080 int,@p1081 nvarchar(4000),@p1082 nvarchar(4000),@p1083 nvarchar(4000),@p1084 nvarchar(4000),@p1085 decimal(18,2),@p1086 nvarchar(4000),@p1087 nvarchar(4000),@p1088 decimal(18,2),@p1089 nvarchar(4000),@p1090 nvarchar(4000),@p1091 nvarchar(4000),@p1092 nvarchar(4000),@p1093 int,@p1094 nvarchar(4000),@p1095 nvarchar(4000),@p1096 nvarchar(4000),@p1097 nvarchar(4000),@p1098 nvarchar(4000),@p1099 nvarchar(4000),@p1100 nvarchar(4000),@p1101 nvarchar(4000),@p1102 nvarchar(4000),@p1103 nvarchar(4000),@p1104 int,@p1105 nvarchar(4000),@p1106 nvarchar(4000),@p1107 nvarchar(4000),@p1108 nvarchar(4000),@p1109 nvarchar(4000),@p1110 int,@p1111 nvarchar(4000),@p1112 int,@p1113 int,@p1114 datetime2(7),@p1115 datetime2(7),@p1116 datetime2(7),@p1117 nvarchar(4000),@p1118 nvarchar(4000),@p1119 nvarchar(4000),@p1120 nvarchar(4000),@p1121 nvarchar(4000),@p1122 nvarchar(4000),@p1123 nvarchar(4000),@p1124 nvarchar(4000),@p1125 nvarchar(4000),@p1126 nvarchar(4000),@p1127 nvarchar(4000),@p1128 nvarchar(4000),@p1129 nvarchar(4000),@p1130 nvarchar(4000),@p1131 datetime2(7),@p1132 nvarchar(4000),@p1133 nvarchar(4000),@p1134 int,@p1135 int,@p1136 int,@p1137 nvarchar(4000),@p1138 nvarchar(4000),@p1139 nvarchar(4000),@p1140 nvarchar(4000),@p1141 decimal(18,2),@p1142 nvarchar(4000),@p1143 nvarchar(4000),@p1144 decimal(18,2),@p1145 nvarchar(4000),@p1146 nvarchar(4000),@p1147 nvarchar(4000),@p1148 nvarchar(4000),@p1149 int,@p1150 nvarchar(4000),@p1151 nvarchar(4000),@p1152 nvarchar(4000),@p1153 nvarchar(4000),@p1154 nvarchar(4000),@p1155 nvarchar(4000),@p1156 nvarchar(4000),@p1157 nvarchar(4000),@p1158 nvarchar(4000),@p1159 nvarchar(4000),@p1160 int,@p1161 nvarchar(4000),@p1162 nvarchar(4000),@p1163 nvarchar(4000),@p1164 nvarchar(4000),@p1165 nvarchar(4000),@p1166 int,@p1167 nvarchar(4000),@p1168 int,@p1169 int,@p1170 datetime2(7),@p1171 datetime2(7),@p1172 datetime2(7),@p1173 nvarchar(4000),@p1174 nvarchar(4000),@p1175 nvarchar(4000),@p1176 nvarchar(4000),@p1177 nvarchar(4000),@p1178 nvarchar(4000),@p1179 nvarchar(4000),@p1180 nvarchar(4000),@p1181 nvarchar(4000),@p1182 nvarchar(4000),@p1183 nvarchar(4000),@p1184 nvarchar(4000),@p1185 nvarchar(4000),@p1186 nvarchar(4000),@p1187 datetime2(7),@p1188 nvarchar(4000),@p1189 nvarchar(4000),@p1190 int,@p1191 int,@p1192 int,@p1193 nvarchar(4000),@p1194 nvarchar(4000),@p1195 nvarchar(4000),@p1196 nvarchar(4000),@p1197 decimal(18,2),@p1198 nvarchar(4000),@p1199 nvarchar(4000),@p1200 decimal(18,2),@p1201 nvarchar(4000),@p1202 nvarchar(4000),@p1203 nvarchar(4000),@p1204 nvarchar(4000),@p1205 int,@p1206 nvarchar(4000),@p1207 nvarchar(4000),@p1208 nvarchar(4000),@p1209 nvarchar(4000),@p1210 nvarchar(4000),@p1211 nvarchar(4000),@p1212 nvarchar(4000),@p1213 nvarchar(4000),@p1214 nvarchar(4000),@p1215 nvarchar(4000),@p1216 int,@p1217 nvarchar(4000),@p1218 nvarchar(4000),@p1219 nvarchar(4000),@p1220 nvarchar(4000),@p1221 nvarchar(4000),@p1222 int,@p1223 nvarchar(4000),@p1224 int,@p1225 int,@p1226 datetime2(7),@p1227 datetime2(7),@p1228 datetime2(7),@p1229 nvarchar(4000),@p1230 nvarchar(4000),@p1231 nvarchar(4000),@p1232 nvarchar(4000),@p1233 nvarchar(4000),@p1234 nvarchar(4000),@p1235 nvarchar(4000),@p1236 nvarchar(4000),@p1237 nvarchar(4000),@p1238 nvarchar(4000),@p1239 nvarchar(4000),@p1240 nvarchar(4000),@p1241 nvarchar(4000),@p1242 nvarchar(4000),@p1243 datetime2(7),@p1244 nvarchar(4000),@p1245 nvarchar(4000),@p1246 int,@p1247 int,@p1248 int,@p1249 nvarchar(4000),@p1250 nvarchar(4000),@p1251 nvarchar(4000),@p1252 nvarchar(4000),@p1253 decimal(18,2),@p1254 nvarchar(4000),@p1255 nvarchar(4000),@p1256 decimal(18,2),@p1257 nvarchar(4000),@p1258 nvarchar(4000),@p1259 nvarchar(4000),@p1260 nvarchar(4000),@p1261 int,@p1262 nvarchar(4000),@p1263 nvarchar(4000),@p1264 nvarchar(4000),@p1265 nvarchar(4000),@p1266 nvarchar(4000),@p1267 nvarchar(4000),@p1268 nvarchar(4000),@p1269 nvarchar(4000),@p1270 nvarchar(4000),@p1271 nvarchar(4000),@p1272 int,@p1273 nvarchar(4000),@p1274 nvarchar(4000),@p1275 nvarchar(4000),@p1276 nvarchar(4000),@p1277 nvarchar(4000),@p1278 int,@p1279 nvarchar(4000),@p1280 int,@p1281 int,@p1282 datetime2(7),@p1283 datetime2(7),@p1284 datetime2(7),@p1285 nvarchar(4000),@p1286 nvarchar(4000),@p1287 nvarchar(4000),@p1288 nvarchar(4000),@p1289 nvarchar(4000),@p1290 nvarchar(4000),@p1291 nvarchar(4000),@p1292 nvarchar(4000),@p1293 nvarchar(4000),@p1294 nvarchar(4000),@p1295 nvarchar(4000),@p1296 nvarchar(4000),@p1297 nvarchar(4000),@p1298 nvarchar(4000),@p1299 datetime2(7),@p1300 nvarchar(4000),@p1301 nvarchar(4000),@p1302 int,@p1303 int,@p1304 int,@p1305 nvarchar(4000),@p1306 nvarchar(4000),@p1307 nvarchar(4000),@p1308 nvarchar(4000),@p1309 decimal(18,2),@p1310 nvarchar(4000),@p1311 nvarchar(4000),@p1312 decimal(18,2),@p1313 nvarchar(4000),@p1314 nvarchar(4000),@p1315 nvarchar(4000),@p1316 nvarchar(4000),@p1317 int,@p1318 nvarchar(4000),@p1319 nvarchar(4000),@p1320 nvarchar(4000),@p1321 nvarchar(4000),@p1322 nvarchar(4000),@p1323 nvarchar(4000),@p1324 nvarchar(4000),@p1325 nvarchar(4000),@p1326 nvarchar(4000),@p1327 nvarchar(4000),@p1328 int,@p1329 nvarchar(4000),@p1330 nvarchar(4000),@p1331 nvarchar(4000),@p1332 nvarchar(4000),@p1333 nvarchar(4000),@p1334 int,@p1335 nvarchar(4000),@p1336 int,@p1337 int,@p1338 datetime2(7),@p1339 datetime2(7),@p1340 datetime2(7),@p1341 nvarchar(4000),@p1342 nvarchar(4000),@p1343 nvarchar(4000),@p1344 nvarchar(4000),@p1345 nvarchar(4000),@p1346 nvarchar(4000),@p1347 nvarchar(4000),@p1348 nvarchar(4000),@p1349 nvarchar(4000),@p1350 nvarchar(4000),@p1351 nvarchar(4000),@p1352 nvarchar(4000),@p1353 nvarchar(4000),@p1354 nvarchar(4000),@p1355 datetime2(7),@p1356 nvarchar(4000),@p1357 nvarchar(4000),@p1358 int,@p1359 int,@p1360 int,@p1361 nvarchar(4000),@p1362 nvarchar(4000),@p1363 nvarchar(4000),@p1364 nvarchar(4000),@p1365 decimal(18,2),@p1366 nvarchar(4000),@p1367 nvarchar(4000),@p1368 decimal(18,2),@p1369 nvarchar(4000),@p1370 nvarchar(4000),@p1371 nvarchar(4000),@p1372 nvarchar(4000),@p1373 int,@p1374 nvarchar(4000),@p1375 nvarchar(4000),@p1376 nvarchar(4000),@p1377 nvarchar(4000),@p1378 nvarchar(4000),@p1379 nvarchar(4000),@p1380 nvarchar(4000),@p1381 nvarchar(4000),@p1382 nvarchar(4000),@p1383 nvarchar(4000),@p1384 int,@p1385 nvarchar(4000),@p1386 nvarchar(4000),@p1387 nvarchar(4000),@p1388 nvarchar(4000),@p1389 nvarchar(4000),@p1390 int,@p1391 nvarchar(4000),@p1392 int,@p1393 int,@p1394 datetime2(7),@p1395 datetime2(7),@p1396 datetime2(7),@p1397 nvarchar(4000),@p1398 nvarchar(4000),@p1399 nvarchar(4000),@p1400 nvarchar(4000),@p1401 nvarchar(4000),@p1402 nvarchar(4000),@p1403 nvarchar(4000),@p1404 nvarchar(4000),@p1405 nvarchar(4000),@p1406 nvarchar(4000),@p1407 nvarchar(4000),@p1408 nvarchar(4000),@p1409 nvarchar(4000),@p1410 nvarchar(4000),@p1411 datetime2(7),@p1412 nvarchar(4000),@p1413 nvarchar(4000),@p1414 int,@p1415 int,@p1416 int,@p1417 nvarchar(4000),@p1418 nvarchar(4000),@p1419 nvarchar(4000),@p1420 nvarchar(4000),@p1421 decimal(18,2),@p1422 nvarchar(4000),@p1423 nvarchar(4000),@p1424 decimal(18,2),@p1425 nvarchar(4000),@p1426 nvarchar(4000),@p1427 nvarchar(4000),@p1428 nvarchar(4000),@p1429 int,@p1430 nvarchar(4000),@p1431 nvarchar(4000),@p1432 nvarchar(4000),@p1433 nvarchar(4000),@p1434 nvarchar(4000),@p1435 nvarchar(4000),@p1436 nvarchar(4000),@p1437 nvarchar(4000),@p1438 nvarchar(4000),@p1439 nvarchar(4000),@p1440 int,@p1441 nvarchar(4000),@p1442 nvarchar(4000),@p1443 nvarchar(4000),@p1444 nvarchar(4000),@p1445 nvarchar(4000),@p1446 int,@p1447 nvarchar(4000),@p1448 int,@p1449 int,@p1450 datetime2(7),@p1451 datetime2(7),@p1452 datetime2(7),@p1453 nvarchar(4000),@p1454 nvarchar(4000),@p1455 nvarchar(4000),@p1456 nvarchar(4000),@p1457 nvarchar(4000),@p1458 nvarchar(4000),@p1459 nvarchar(4000),@p1460 nvarchar(4000),@p1461 nvarchar(4000),@p1462 nvarchar(4000),@p1463 nvarchar(4000),@p1464 nvarchar(4000),@p1465 nvarchar(4000),@p1466 nvarchar(4000),@p1467 datetime2(7),@p1468 nvarchar(4000),@p1469 nvarchar(4000),@p1470 int,@p1471 int,@p1472 int,@p1473 nvarchar(4000),@p1474 nvarchar(4000),@p1475 nvarchar(4000),@p1476 nvarchar(4000),@p1477 decimal(18,2),@p1478 nvarchar(4000),@p1479 nvarchar(4000),@p1480 decimal(18,2),@p1481 nvarchar(4000),@p1482 nvarchar(4000),@p1483 nvarchar(4000),@p1484 nvarchar(4000),@p1485 int,@p1486 nvarchar(4000),@p1487 nvarchar(4000),@p1488 nvarchar(4000),@p1489 nvarchar(4000),@p1490 nvarchar(4000),@p1491 nvarchar(4000),@p1492 nvarchar(4000),@p1493 nvarchar(4000),@p1494 nvarchar(4000),@p1495 nvarchar(4000),@p1496 int,@p1497 nvarchar(4000),@p1498 nvarchar(4000),@p1499 nvarchar(4000),@p1500 nvarchar(4000),@p1501 nvarchar(4000),@p1502 int,@p1503 nvarchar(4000),@p1504 int,@p1505 int,@p1506 datetime2(7),@p1507 datetime2(7),@p1508 datetime2(7),@p1509 nvarchar(4000),@p1510 nvarchar(4000),@p1511 nvarchar(4000),@p1512 nvarchar(4000),@p1513 nvarchar(4000),@p1514 nvarchar(4000),@p1515 nvarchar(4000),@p1516 nvarchar(4000),@p1517 nvarchar(4000),@p1518 nvarchar(4000),@p1519 nvarchar(4000),@p1520 nvarchar(4000),@p1521 nvarchar(4000),@p1522 nvarchar(4000),@p1523 datetime2(7),@p1524 nvarchar(4000),@p1525 nvarchar(4000),@p1526 int,@p1527 int,@p1528 int,@p1529 nvarchar(4000),@p1530 nvarchar(4000),@p1531 nvarchar(4000),@p1532 nvarchar(4000),@p1533 decimal(18,2),@p1534 nvarchar(4000),@p1535 nvarchar(4000),@p1536 decimal(18,2),@p1537 nvarchar(4000),@p1538 nvarchar(4000),@p1539 nvarchar(4000),@p1540 nvarchar(4000),@p1541 int,@p1542 nvarchar(4000),@p1543 nvarchar(4000),@p1544 nvarchar(4000),@p1545 nvarchar(4000),@p1546 nvarchar(4000),@p1547 nvarchar(4000),@p1548 nvarchar(4000),@p1549 nvarchar(4000),@p1550 nvarchar(4000),@p1551 nvarchar(4000),@p1552 int,@p1553 nvarchar(4000),@p1554 nvarchar(4000),@p1555 nvarchar(4000),@p1556 nvarchar(4000),@p1557 nvarchar(4000),@p1558 int,@p1559 nvarchar(4000),@p1560 int,@p1561 int,@p1562 datetime2(7),@p1563 datetime2(7),@p1564 datetime2(7),@p1565 nvarchar(4000),@p1566 nvarchar(4000),@p1567 nvarchar(4000),@p1568 nvarchar(4000),@p1569 nvarchar(4000),@p1570 nvarchar(4000),@p1571 nvarchar(4000),@p1572 nvarchar(4000),@p1573 nvarchar(4000),@p1574 nvarchar(4000),@p1575 nvarchar(4000),@p1576 nvarchar(4000),@p1577 nvarchar(4000),@p1578 nvarchar(4000),@p1579 datetime2(7),@p1580 nvarchar(4000),@p1581 nvarchar(4000),@p1582 int,@p1583 int,@p1584 int,@p1585 nvarchar(4000),@p1586 nvarchar(4000),@p1587 nvarchar(4000),@p1588 nvarchar(4000),@p1589 decimal(18,2),@p1590 nvarchar(4000),@p1591 nvarchar(4000),@p1592 decimal(18,2),@p1593 nvarchar(4000),@p1594 nvarchar(4000),@p1595 nvarchar(4000),@p1596 nvarchar(4000),@p1597 int,@p1598 nvarchar(4000),@p1599 nvarchar(4000),@p1600 nvarchar(4000),@p1601 nvarchar(4000),@p1602 nvarchar(4000),@p1603 nvarchar(4000),@p1604 nvarchar(4000),@p1605 nvarchar(4000),@p1606 nvarchar(4000),@p1607 nvarchar(4000),@p1608 int,@p1609 nvarchar(4000),@p1610 nvarchar(4000),@p1611 nvarchar(4000),@p1612 nvarchar(4000),@p1613 nvarchar(4000),@p1614 int,@p1615 nvarchar(4000),@p1616 int,@p1617 int,@p1618 datetime2(7),@p1619 datetime2(7),@p1620 datetime2(7),@p1621 nvarchar(4000),@p1622 nvarchar(4000),@p1623 nvarchar(4000),@p1624 nvarchar(4000),@p1625 nvarchar(4000),@p1626 nvarchar(4000),@p1627 nvarchar(4000),@p1628 nvarchar(4000),@p1629 nvarchar(4000),@p1630 nvarchar(4000),@p1631 nvarchar(4000),@p1632 nvarchar(4000),@p1633 nvarchar(4000),@p1634 nvarchar(4000),@p1635 datetime2(7),@p1636 nvarchar(4000),@p1637 nvarchar(4000),@p1638 int,@p1639 int,@p1640 int,@p1641 nvarchar(4000),@p1642 nvarchar(4000),@p1643 nvarchar(4000),@p1644 nvarchar(4000),@p1645 decimal(18,2),@p1646 nvarchar(4000),@p1647 nvarchar(4000),@p1648 decimal(18,2),@p1649 nvarchar(4000),@p1650 nvarchar(4000),@p1651 nvarchar(4000),@p1652 nvarchar(4000),@p1653 int,@p1654 nvarchar(4000),@p1655 nvarchar(4000),@p1656 nvarchar(4000),@p1657 nvarchar(4000),@p1658 nvarchar(4000),@p1659 nvarchar(4000),@p1660 nvarchar(4000),@p1661 nvarchar(4000),@p1662 nvarchar(4000),@p1663 nvarchar(4000),@p1664 int,@p1665 nvarchar(4000),@p1666 nvarchar(4000),@p1667 nvarchar(4000),@p1668 nvarchar(4000),@p1669 nvarchar(4000),@p1670 int,@p1671 nvarchar(4000),@p1672 int,@p1673 int,@p1674 datetime2(7),@p1675 datetime2(7),@p1676 datetime2(7),@p1677 nvarchar(4000),@p1678 nvarchar(4000),@p1679 nvarchar(4000),@p1680 nvarchar(4000),@p1681 nvarchar(4000),@p1682 nvarchar(4000),@p1683 nvarchar(4000),@p1684 nvarchar(4000),@p1685 nvarchar(4000),@p1686 nvarchar(4000),@p1687 nvarchar(4000),@p1688 nvarchar(4000),@p1689 nvarchar(4000),@p1690 nvarchar(4000),@p1691 datetime2(7),@p1692 nvarchar(4000),@p1693 nvarchar(4000),@p1694 int,@p1695 int,@p1696 int,@p1697 nvarchar(4000),@p1698 nvarchar(4000),@p1699 nvarchar(4000),@p1700 nvarchar(4000),@p1701 decimal(18,2),@p1702 nvarchar(4000),@p1703 nvarchar(4000),@p1704 decimal(18,2),@p1705 nvarchar(4000),@p1706 nvarchar(4000),@p1707 nvarchar(4000),@p1708 nvarchar(4000),@p1709 int,@p1710 nvarchar(4000),@p1711 nvarchar(4000),@p1712 nvarchar(4000),@p1713 nvarchar(4000),@p1714 nvarchar(4000),@p1715 nvarchar(4000),@p1716 nvarchar(4000),@p1717 nvarchar(4000),@p1718 nvarchar(4000),@p1719 nvarchar(4000),@p1720 int,@p1721 nvarchar(4000),@p1722 nvarchar(4000),@p1723 nvarchar(4000),@p1724 nvarchar(4000),@p1725 nvarchar(4000),@p1726 int,@p1727 nvarchar(4000),@p1728 int,@p1729 int,@p1730 datetime2(7),@p1731 datetime2(7),@p1732 datetime2(7),@p1733 nvarchar(4000),@p1734 nvarchar(4000),@p1735 nvarchar(4000),@p1736 nvarchar(4000),@p1737 nvarchar(4000),@p1738 nvarchar(4000),@p1739 nvarchar(4000),@p1740 nvarchar(4000),@p1741 nvarchar(4000),@p1742 nvarchar(4000),@p1743 nvarchar(4000),@p1744 nvarchar(4000),@p1745 nvarchar(4000),@p1746 nvarchar(4000),@p1747 datetime2(7),@p1748 nvarchar(4000),@p1749 nvarchar(4000),@p1750 int,@p1751 int,@p1752 int,@p1753 nvarchar(4000),@p1754 nvarchar(4000),@p1755 nvarchar(4000),@p1756 nvarchar(4000),@p1757 decimal(18,2),@p1758 nvarchar(4000),@p1759 nvarchar(4000),@p1760 decimal(18,2),@p1761 nvarchar(4000),@p1762 nvarchar(4000),@p1763 nvarchar(4000),@p1764 nvarchar(4000),@p1765 int,@p1766 nvarchar(4000),@p1767 nvarchar(4000),@p1768 nvarchar(4000),@p1769 nvarchar(4000),@p1770 nvarchar(4000),@p1771 nvarchar(4000),@p1772 nvarchar(4000),@p1773 nvarchar(4000),@p1774 nvarchar(4000),@p1775 nvarchar(4000),@p1776 int,@p1777 nvarchar(4000),@p1778 nvarchar(4000),@p1779 nvarchar(4000),@p1780 nvarchar(4000),@p1781 nvarchar(4000),@p1782 int,@p1783 nvarchar(4000),@p1784 int,@p1785 int,@p1786 datetime2(7),@p1787 datetime2(7),@p1788 datetime2(7),@p1789 nvarchar(4000),@p1790 nvarchar(4000),@p1791 nvarchar(4000),@p1792 nvarchar(4000),@p1793 nvarchar(4000),@p1794 nvarchar(4000),@p1795 nvarchar(4000),@p1796 nvarchar(4000),@p1797 nvarchar(4000),@p1798 nvarchar(4000),@p1799 nvarchar(4000),@p1800 nvarchar(4000),@p1801 nvarchar(4000),@p1802 nvarchar(4000),@p1803 datetime2(7),@p1804 nvarchar(4000),@p1805 nvarchar(4000),@p1806 int,@p1807 int,@p1808 int,@p1809 nvarchar(4000),@p1810 nvarchar(4000),@p1811 nvarchar(4000),@p1812 nvarchar(4000),@p1813 decimal(18,2),@p1814 nvarchar(4000),@p1815 nvarchar(4000),@p1816 decimal(18,2),@p1817 nvarchar(4000),@p1818 nvarchar(4000),@p1819 nvarchar(4000),@p1820 nvarchar(4000),@p1821 int,@p1822 nvarchar(4000),@p1823 nvarchar(4000),@p1824 nvarchar(4000),@p1825 nvarchar(4000),@p1826 nvarchar(4000),@p1827 nvarchar(4000),@p1828 nvarchar(4000),@p1829 nvarchar(4000),@p1830 nvarchar(4000),@p1831 nvarchar(4000),@p1832 int,@p1833 nvarchar(4000),@p1834 nvarchar(4000),@p1835 nvarchar(4000),@p1836 nvarchar(4000),@p1837 nvarchar(4000),@p1838 int,@p1839 nvarchar(4000),@p1840 int,@p1841 int,@p1842 datetime2(7),@p1843 datetime2(7),@p1844 datetime2(7),@p1845 nvarchar(4000),@p1846 nvarchar(4000),@p1847 nvarchar(4000),@p1848 nvarchar(4000),@p1849 nvarchar(4000),@p1850 nvarchar(4000),@p1851 nvarchar(4000),@p1852 nvarchar(4000),@p1853 nvarchar(4000),@p1854 nvarchar(4000),@p1855 nvarchar(4000),@p1856 nvarchar(4000),@p1857 nvarchar(4000),@p1858 nvarchar(4000),@p1859 datetime2(7),@p1860 nvarchar(4000),@p1861 nvarchar(4000),@p1862 int,@p1863 int,@p1864 int,@p1865 nvarchar(4000),@p1866 nvarchar(4000),@p1867 nvarchar(4000),@p1868 nvarchar(4000),@p1869 decimal(18,2),@p1870 nvarchar(4000),@p1871 nvarchar(4000),@p1872 decimal(18,2),@p1873 nvarchar(4000),@p1874 nvarchar(4000),@p1875 nvarchar(4000),@p1876 nvarchar(4000),@p1877 int,@p1878 nvarchar(4000),@p1879 nvarchar(4000),@p1880 nvarchar(4000),@p1881 nvarchar(4000),@p1882 nvarchar(4000),@p1883 nvarchar(4000),@p1884 nvarchar(4000),@p1885 nvarchar(4000),@p1886 nvarchar(4000),@p1887 nvarchar(4000),@p1888 int,@p1889 nvarchar(4000),@p1890 nvarchar(4000),@p1891 nvarchar(4000),@p1892 nvarchar(4000),@p1893 nvarchar(4000),@p1894 int,@p1895 nvarchar(4000),@p1896 int,@p1897 int,@p1898 datetime2(7),@p1899 datetime2(7),@p1900 datetime2(7),@p1901 nvarchar(4000),@p1902 nvarchar(4000),@p1903 nvarchar(4000),@p1904 nvarchar(4000),@p1905 nvarchar(4000),@p1906 nvarchar(4000),@p1907 nvarchar(4000),@p1908 nvarchar(4000),@p1909 nvarchar(4000),@p1910 nvarchar(4000),@p1911 nvarchar(4000),@p1912 nvarchar(4000),@p1913 nvarchar(4000),@p1914 nvarchar(4000),@p1915 datetime2(7),@p1916 nvarchar(4000),@p1917 nvarchar(4000),@p1918 int,@p1919 int,@p1920 int,@p1921 nvarchar(4000),@p1922 nvarchar(4000),@p1923 nvarchar(4000),@p1924 nvarchar(4000),@p1925 decimal(18,2),@p1926 nvarchar(4000),@p1927 nvarchar(4000),@p1928 decimal(18,2),@p1929 nvarchar(4000),@p1930 nvarchar(4000),@p1931 nvarchar(4000),@p1932 nvarchar(4000),@p1933 int,@p1934 nvarchar(4000),@p1935 nvarchar(4000),@p1936 nvarchar(4000),@p1937 nvarchar(4000),@p1938 nvarchar(4000),@p1939 nvarchar(4000),@p1940 nvarchar(4000),@p1941 nvarchar(4000),@p1942 nvarchar(4000),@p1943 nvarchar(4000),@p1944 int,@p1945 nvarchar(4000),@p1946 nvarchar(4000),@p1947 nvarchar(4000),@p1948 nvarchar(4000),@p1949 nvarchar(4000),@p1950 int,@p1951 nvarchar(4000),@p1952 int,@p1953 int,@p1954 datetime2(7),@p1955 datetime2(7),@p1956 datetime2(7),@p1957 nvarchar(4000),@p1958 nvarchar(4000),@p1959 nvarchar(4000),@p1960 nvarchar(4000),@p1961 nvarchar(4000),@p1962 nvarchar(4000),@p1963 nvarchar(4000),@p1964 nvarchar(4000),@p1965 nvarchar(4000),@p1966 nvarchar(4000),@p1967 nvarchar(4000),@p1968 nvarchar(4000),@p1969 nvarchar(4000),@p1970 nvarchar(4000),@p1971 datetime2(7),@p1972 nvarchar(4000),@p1973 nvarchar(4000),@p1974 int,@p1975 int,@p1976 int,@p1977 nvarchar(4000),@p1978 nvarchar(4000),@p1979 nvarchar(4000),@p1980 nvarchar(4000),@p1981 decimal(18,2),@p1982 nvarchar(4000),@p1983 nvarchar(4000),@p1984 decimal(18,2),@p1985 nvarchar(4000),@p1986 nvarchar(4000),@p1987 nvarchar(4000),@p1988 nvarchar(4000),@p1989 int,@p1990 nvarchar(4000),@p1991 nvarchar(4000),@p1992 nvarchar(4000),@p1993 nvarchar(4000),@p1994 nvarchar(4000),@p1995 nvarchar(4000),@p1996 nvarchar(4000),@p1997 nvarchar(4000),@p1998 nvarchar(4000),@p1999 nvarchar(4000),@p2000 int,@p2001 nvarchar(4000),@p2002 nvarchar(4000),@p2003 nvarchar(4000),@p2004 nvarchar(4000),@p2005 nvarchar(4000),@p2006 int,@p2007 nvarchar(4000),@p2008 int,@p2009 int,@p2010 datetime2(7),@p2011 datetime2(7),@p2012 datetime2(7),@p2013 nvarchar(4000),@p2014 nvarchar(4000),@p2015 nvarchar(4000),@p2016 nvarchar(4000),@p2017 nvarchar(4000),@p2018 nvarchar(4000),@p2019 nvarchar(4000),@p2020 nvarchar(4000),@p2021 nvarchar(4000),@p2022 nvarchar(4000),@p2023 nvarchar(4000),@p2024 nvarchar(4000),@p2025 nvarchar(4000),@p2026 nvarchar(4000),@p2027 datetime2(7),@p2028 nvarchar(4000),@p2029 nvarchar(4000),@p2030 int,@p2031 int,@p2032 int,@p2033 nvarchar(4000),@p2034 nvarchar(4000),@p2035 nvarchar(4000),@p2036 decimal(18,2),@p2037 decimal(18,2),@p2038 nvarchar(4000),@p2039 nvarchar(4000),@p2040 decimal(18,2),@p2041 nvarchar(4000),@p2042 nvarchar(4000),@p2043 nvarchar(4000),@p2044 nvarchar(4000),@p2045 int,@p2046 nvarchar(4000),@p2047 nvarchar(4000),@p2048 nvarchar(4000),@p2049 nvarchar(4000),@p2050 nvarchar(4000),@p2051 nvarchar(4000),@p2052 nvarchar(4000),@p2053 nvarchar(4000),@p2054 nvarchar(4000),@p2055 nvarchar(4000),@p2056 int,@p2057 nvarchar(4000),@p2058 nvarchar(4000),@p2059 nvarchar(4000),@p2060 nvarchar(4000),@p2061 nvarchar(4000),@p2062 int,@p2063 nvarchar(4000),@p2064 int,@p2065 int,@p2066 datetime2(7),@p2067 datetime2(7),@p2068 datetime2(7),@p2069 nvarchar(4000),@p2070 nvarchar(4000),@p2071 nvarchar(4000))SET NOCOUNT ON; DECLARE @inserted0 TABLE ([item_id] int, [_Position] [int]); MERGE [raw_data] USING ( VALUES (@p0, @p1, @p2, @p3, @p4, @p5, @p6, @p7, @p8, @p9, @p10, @p11, @p12, @p13, @p14, @p15, @p16, @p17, @p18, @p19, @p20, @p21, @p22, @p23, @p24, @p25, @p26, @p27, @p28, @p29, @p30, @p31, @p32, @p33, @p34, @p35, @p36, @p37, @p38, @p39, @p40, @p41, @p42, @p43, @p44, @p45, @p46, @p47, @p48, @p49, @p50, @p51, @p52, @p53, @p54, @p55, 0), (@p56, @p57, @p58, @p59, @p60, @p61, @p62, @p63, @p64, @p65, @p66, @p67, @p68, @p69, @p70, @p71, @p72, @p73, @p74, @p75, @p76, @p77, @p78, @p79, @p80, @p81, @p82, @p83, @p84, @p85, @p86, @p87, @p88, @p89, @p90, @p91, @p92, @p93, @p94, @p95, @p96, @p97, @p98, @p99, @p100, @p101, @p102, @p103, @p104, @p105, @p106, @p107, @p108, @p109, @p110, @p111, 1), (@p112, @p113, @p114, @p115, @p116, @p117, @p118, @p119, @p120, @p121, @p122, @p123, @p124, @p125, @p126, @p127, @p128, @p129, @p130, @p131, @p132, @p133, @p134, @p135, @p136, @p137, @p138, @p139, @p140, @p141, @p142, @p143, @p144, @p145, @p146, @p147, @p148, @p149, @p150, @p151, @p152, @p153, @p154, @p155, @p156, @p157, @p158, @p159, @p160, @p161, @p162, @p163, @p164, @p165, @p166, @p167, 2), (@p168, @p169, @p170, @p171, @p172, @p173, @p174, @p175, @p176, @p177, @p178, @p179, @p180, @p181, @p182, @p183, @p184, @p185, @p186, @p187, @p188, @p189, @p190, @p191, @p192, @p193, @p194, @p195, @p196, @p197, @p198, @p199, @p200, @p201, @p202, @p203, @p204, @p205, @p206, @p207, @p208, @p209, @p210, @p211, @p212, @p213, @p214, @p215, @p216, @p217, @p218, @p219, @p220, @p221, @p222, @p223, 3), (@p224, @p225, @p226, @p227, @p228, @p229, @p230, @p231, @p232, @p233, @p234, @p235, @p236, @p237, @p238, @p239, @p240, @p241, @p242, @p243, @p244, @p245, @p246, @p247, @p248, @p249, @p250, @p251, @p252, @p253, @p254, @p255, @p256, @p257, @p258, @p259, @p260, @p261, @p262, @p263, @p264, @p265, @p266, @p267, @p268, @p269, @p270, @p271, @p272, @p273, @p274, @p275, @p276, @p277, @p278, @p279, 4), (@p280, @p281, @p282, @p283, @p284, @p285, @p286, @p287, @p288, @p289, @p290, @p291, @p292, @p293, @p294, @p295, @p296, @p297, @p298, @p299, @p300, @p301, @p302, @p303, @p304, @p305, @p306, @p307, @p308, @p309, @p310, @p311, @p312, @p313, @p314, @p315, @p316, @p317, @p318, @p319, @p320, @p321, @p322, @p323, @p324, @p325, @p326, @p327, @p328, @p329, @p330, @p331, @p332, @p333, @p334, @p335, 5), (@p336, @p337, @p338, @p339, @p340, @p341, @p342, @p343, @p344, @p345, @p346, @p347, @p348, @p349, @p350, @p351, @p352, @p353, @p354, @p355, @p356, @p357, @p358, @p359, @p360, @p361, @p362, @p363, @p364, @p365, @p366, @p367, @p368, @p369, @p370, @p371, @p372, @p373, @p374, @p375, @p376, @p377, @p378, @p379, @p380, @p381, @p382, @p383, @p384, @p385, @p386, @p387, @p388, @p389, @p390, @p391, 6), (@p392, @p393, @p394, @p395, @p396, @p397, @p398, @p399, @p400, @p401, @p402, @p403, @p404, @p405, @p406, @p407, @p408, @p409, @p410, @p411, @p412, @p413, @p414, @p415, @p416, @p417, @p418, @p419, @p420, @p421, @p422, @p423, @p424, @p425, @p426, @p427, @p428, @p429, @p430, @p431, @p432, @p433, @p434, @p435, @p436, @p437, @p438, @p439, @p440, @p441, @p442, @p443, @p444, @p445, @p446, @p447, 7), (@p448, @p449, @p450, @p451, @p452, @p453, @p454, @p455, @p456, @p457, @p458, @p459, @p460, @p461, @p462, @p463, @p464, @p465, @p466, @p467, @p468, @p469, @p470, @p471, @p472, @p473, @p474, @p475, @p476, @p477, @p478, @p479, @p480, @p481, @p482, @p483, @p484, @p485, @p486, @p487, @p488, @p489, @p490, @p491, @p492, @p493, @p494, @p495, @p496, @p497, @p498, @p499, @p500, @p501, @p502, @p503, 8), (@p504, @p505, @p506, @p507, @p508, @p509, @p510, @p511, @p512, @p513, @p514, @p515, @p516, @p517, @p518, @p519, @p520, @p521, @p522, @p523, @p524, @p525, @p526, @p527, @p528, @p529, @p530, @p531, @p532, @p533, @p534, @p535, @p536, @p537, @p538, @p539, @p540, @p541, @p542, @p543, @p544, @p545, @p546, @p547, @p548, @p549, @p550, @p551, @p552, @p553, @p554, @p555, @p556, @p557, @p558, @p559, 9), (@p560, @p561, @p562, @p563, @p564, @p565, @p566, @p567, @p568, @p569, @p570, @p571, @p572, @p573, @p574, @p575, @p576, @p577, @p578, @p579, @p580, @p581, @p582, @p583, @p584, @p585, @p586, @p587, @p588, @p589, @p590, @p591, @p592, @p593, @p594, @p595, @p596, @p597, @p598, @p599, @p600, @p601, @p602, @p603, @p604, @p605, @p606, @p607, @p608, @p609, @p610, @p611, @p612, @p613, @p614, @p615, 10), (@p616, @p617, @p618, @p619, @p620, @p621, @p622, @p623, @p624, @p625, @p626, @p627, @p628, @p629, @p630, @p631, @p632, @p633, @p634, @p635, @p636, @p637, @p638, @p639, @p640, @p641, @p642, @p643, @p644, @p645, @p646, @p647, @p648, @p649, @p650, @p651, @p652, @p653, @p654, @p655, @p656, @p657, @p658, @p659, @p660, @p661, @p662, @p663, @p664, @p665, @p666, @p667, @p668, @p669, @p670, @p671, 11), (@p672, @p673, @p674, @p675, @p676, @p677, @p678, @p679, @p680, @p681, @p682, @p683, @p684, @p685, @p686, @p687, @p688, @p689, @p690, @p691, @p692, @p693, @p694, @p695, @p696, @p697, @p698, @p699, @p700, @p701, @p702, @p703, @p704, @p705, @p706, @p707, @p708, @p709, @p710, @p711, @p712, @p713, @p714, @p715, @p716, @p717, @p718, @p719, @p720, @p721, @p722, @p723, @p724, @p725, @p726, @p727, 12), (@p728, @p729, @p730, @p731, @p732, @p733, @p734, @p735, @p736, @p737, @p738, @p739, @p740, @p741, @p742, @p743, @p744, @p745, @p746, @p747, @p748, @p749, @p750, @p751, @p752, @p753, @p754, @p755, @p756, @p757, @p758, @p759, @p760, @p761, @p762, @p763, @p764, @p765, @p766, @p767, @p768, @p769, @p770, @p771, @p772, @p773, @p774, @p775, @p776, @p777, @p778, @p779, @p780, @p781, @p782, @p783, 13), (@p784, @p785, @p786, @p787, @p788, @p789, @p790, @p791, @p792, @p793, @p794, @p795, @p796, @p797, @p798, @p799, @p800, @p801, @p802, @p803, @p804, @p805, @p806, @p807, @p808, @p809, @p810, @p811, @p812, @p813, @p814, @p815, @p816, @p817, @p818, @p819, @p820, @p821, @p822, @p823, @p824, @p825, @p826, @p827, @p828, @p829, @p830, @p831, @p832, @p833, @p834, @p835, @p836, @p837, @p838, @p839, 14), (@p840, @p841, @p842, @p843, @p844, @p845, @p846, @p847, @p848, @p849, @p850, @p851, @p852, @p853, @p854, @p855, @p856, @p857, @p858, @p859, @p860, @p861, @p862, @p863, @p864, @p865, @p866, @p867, @p868, @p869, @p870, @p871, @p872, @p873, @p874, @p875, @p876, @p877, @p878, @p879, @p880, @p881, @p882, @p883, @p884, @p885, @p886, @p887, @p888, @p889, @p890, @p891, @p892, @p893, @p894, @p895, 15), (@p896, @p897, @p898, @p899, @p900, @p901, @p902, @p903, @p904, @p905, @p906, @p907, @p908, @p909, @p910, @p911, @p912, @p913, @p914, @p915, @p916, @p917, @p918, @p919, @p920, @p921, @p922, @p923, @p924, @p925, @p926, @p927, @p928, @p929, @p930, @p931, @p932, @p933, @p934, @p935, @p936, @p937, @p938, @p939, @p940, @p941, @p942, @p943, @p944, @p945, @p946, @p947, @p948, @p949, @p950, @p951, 16), (@p952, @p953, @p954, @p955, @p956, @p957, @p958, @p959, @p960, @p961, @p962, @p963, @p964, @p965, @p966, @p967, @p968, @p969, @p970, @p971, @p972, @p973, @p974, @p975, @p976, @p977, @p978, @p979, @p980, @p981, @p982, @p983, @p984, @p985, @p986, @p987, @p988, @p989, @p990, @p991, @p992, @p993, @p994, @p995, @p996, @p997, @p998, @p999, @p1000, @p1001, @p1002, @p1003, @p1004, @p1005, @p1006, @p1007, 17), (@p1008, @p1009, @p1010, @p1011, @p1012, @p1013, @p1014, @p1015, @p1016, @p1017, @p1018, @p1019, @p1020, @p1021, @p1022, @p1023, @p1024, @p1025, @p1026, @p1027, @p1028, @p1029, @p1030, @p1031, @p1032, @p1033, @p1034, @p1035, @p1036, @p1037, @p1038, @p1039, @p1040, @p1041, @p1042, @p1043, @p1044, @p1045, @p1046, @p1047, @p1048, @p1049, @p1050, @p1051, @p1052, @p1053, @p1054, @p1055, @p1056, @p1057, @p1058, @p1059, @p1060, @p1061, @p1062, @p1063, 18), (@p1064, @p1065, @p1066, @p1067, @p1068, @p1069, @p1070, @p1071, @p1072, @p1073, @p1074, @p1075, @p1076, @p1077, @p1078, @p1079, @p1080, @p1081, @p1082, @p1083, @p1084, @p1085, @p1086, @p1087, @p1088, @p1089, @p1090, @p1091, @p1092, @p1093, @p1094, @p1095, @p1096, @p1097, @p1098, @p1099, @p1100, @p1101, @p1102, @p1103, @p1104, @p1105, @p1106, @p1107, @p1108, @p1109, @p1110, @p1111, @p1112, @p1113, @p1114, @p1115, @p1116, @p1117, @p1118, @p1119, 19), (@p1120, @p1121, @p1122, @p1123, @p1124, @p1125, @p1126, @p1127, @p1128, @p1129, @p1130, @p1131, @p1132, @p1133, @p1134, @p1135, @p1136, @p1137, @p1138, @p1139, @p1140, @p1141, @p1142, @p1143, @p1144, @p1145, @p1146, @p1147, @p1148, @p1149, @p1150, @p1151, @p1152, @p1153, @p1154, @p1155, @p1156, @p1157, @p1158, @p1159, @p1160, @p1161, @p1162, @p1163, @p1164, @p1165, @p1166, @p1167, @p1168, @p1169, @p1170, @p1171, @p1172, @p1173, @p1174, @p1175, 20), (@p1176, @p1177, @p1178, @p1179, @p1180, @p1181, @p1182, @p1183, @p1184, @p1185, @p1186, @p1187, @p1188, @p1189, @p1190, @p1191, @p1192, @p1193, @p1194, @p1195, @p1196, @p1197, @p1198, @p1199, @p1200, @p1201, @p1202, @p1203, @p1204, @p1205, @p1206, @p1207, @p1208, @p1209, @p1210, @p1211, @p1212, @p1213, @p1214, @p1215, @p1216, @p1217, @p1218, @p1219, @p1220, @p1221, @p1222, @p1223, @p1224, @p1225, @p1226, @p1227, @p1228, @p1229, @p1230, @p1231, 21), (@p1232, @p1233, @p1234, @p1235, @p1236, @p1237, @p1238, @p1239, @p1240, @p1241, @p1242, @p1243, @p1244, @p1245, @p1246, @p1247, @p1248, @p1249, @p1250, @p1251, @p1252, @p1253, @p1254, @p1255, @p1256, @p1257, @p1258, @p1259, @p1260, @p1261, @p1262, @p1263, @p1264, @p1265, @p1266, @p1267, @p1268, @p1269, @p1270, @p1271, @p1272, @p1273, @p1274, @p1275, @p1276, @p1277, @p1278, @p1279, @p1280, @p1281, @p1282, @p1283, @p1284, @p1285, @p1286, @p1287, 22), (@p1288, @p1289, @p1290, @p1291, @p1292, @p1293, @p1294, @p1295, @p1296, @p1297, @p1298, @p1299, @p1300, @p1301, @p1302, @p1303, @p1304, @p1305, @p1306, @p1307, @p1308, @p1309, @p1310, @p1311, @p1312, @p1313, @p1314, @p1315, @p1316, @p1317, @p1318, @p1319, @p1320, @p1321, @p1322, @p1323, @p1324, @p1325, @p1326, @p1327, @p1328, @p1329, @p1330, @p1331, @p1332, @p1333, @p1334, @p1335, @p1336, @p1337, @p1338, @p1339, @p1340, @p1341, @p1342, @p1343, 23), (@p1344, @p1345, @p1346, @p1347, @p1348, @p1349, @p1350, @p1351, @p1352, @p1353, @p1354, @p1355, @p1356, @p1357, @p1358, @p1359, @p1360, @p1361, @p1362, @p1363, @p1364, @p1365, @p1366, @p1367, @p1368, @p1369, @p1370, @p1371, @p1372, @p1373, @p1374, @p1375, @p1376, @p1377, @p1378, @p1379, @p1380, @p1381, @p1382, @p1383, @p1384, @p1385, @p1386, @p1387, @p1388, @p1389, @p1390, @p1391, @p1392, @p1393, @p1394, @p1395, @p1396, @p1397, @p1398, @p1399, 24), (@p1400, @p1401, @p1402, @p1403, @p1404, @p1405, @p1406, @p1407, @p1408, @p1409, @p1410, @p1411, @p1412, @p1413, @p1414, @p1415, @p1416, @p1417, @p1418, @p1419, @p1420, @p1421, @p1422, @p1423, @p1424, @p1425, @p1426, @p1427, @p1428, @p1429, @p1430, @p1431, @p1432, @p1433, @p1434, @p1435, @p1436, @p1437, @p1438, @p1439, @p1440, @p1441, @p1442, @p1443, @p1444, @p1445, @p1446, @p1447, @p1448, @p1449, @p1450, @p1451, @p1452, @p1453, @p1454, @p1455, 25), (@p1456, @p1457, @p1458, @p1459, @p1460, @p1461, @p1462, @p1463, @p1464, @p1465, @p1466, @p1467, @p1468, @p1469, @p1470, @p1471, @p1472, @p1473, @p1474, @p1475, @p1476, @p1477, @p1478, @p1479, @p1480, @p1481, @p1482, @p1483, @p1484, @p1485, @p1486, @p1487, @p1488, @p1489, @p1490, @p1491, @p1492, @p1493, @p1494, @p1495, @p1496, @p1497, @p1498, @p1499, @p1500, @p1501, @p1502, @p1503, @p1504, @p1505, @p1506, @p1507, @p1508, @p1509, @p1510, @p1511, 26), (@p1512, @p1513, @p1514, @p1515, @p1516, @p1517, @p1518, @p1519, @p1520, @p1521, @p1522, @p1523, @p1524, @p1525, @p1526, @p1527, @p1528, @p1529, @p1530, @p1531, @p1532, @p1533, @p1534, @p1535, @p1536, @p1537, @p1538, @p1539, @p1540, @p1541, @p1542, @p1543, @p1544, @p1545, @p1546, @p1547, @p1548, @p1549, @p1550, @p1551, @p1552, @p1553, @p1554, @p1555, @p1556, @p1557, @p1558, @p1559, @p1560, @p1561, @p1562, @p1563, @p1564, @p1565, @p1566, @p1567, 27), (@p1568, @p1569, @p1570, @p1571, @p1572, @p1573, @p1574, @p1575, @p1576, @p1577, @p1578, @p1579, @p1580, @p1581, @p1582, @p1583, @p1584, @p1585, @p1586, @p1587, @p1588, @p1589, @p1590, @p1591, @p1592, @p1593, @p1594, @p1595, @p1596, @p1597, @p1598, @p1599, @p1600, @p1601, @p1602, @p1603, @p1604, @p1605, @p1606, @p1607, @p1608, @p1609, @p1610, @p1611, @p1612, @p1613, @p1614, @p1615, @p1616, @p1617, @p1618, @p1619, @p1620, @p1621, @p1622, @p1623, 28), (@p1624, @p1625, @p1626, @p1627, @p1628, @p1629, @p1630, @p1631, @p1632, @p1633, @p1634, @p1635, @p1636, @p1637, @p1638, @p1639, @p1640, @p1641, @p1642, @p1643, @p1644, @p1645, @p1646, @p1647, @p1648, @p1649, @p1650, @p1651, @p1652, @p1653, @p1654, @p1655, @p1656, @p1657, @p1658, @p1659, @p1660, @p1661, @p1662, @p1663, @p1664, @p1665, @p1666, @p1667, @p1668, @p1669, @p1670, @p1671, @p1672, @p1673, @p1674, @p1675, @p1676, @p1677, @p1678, @p1679, 29), (@p1680, @p1681, @p1682, @p1683, @p1684, @p1685, @p1686, @p1687, @p1688, @p1689, @p1690, @p1691, @p1692, @p1693, @p1694, @p1695, @p1696, @p1697, @p1698, @p1699, @p1700, @p1701, @p1702, @p1703, @p1704, @p1705, @p1706, @p1707, @p1708, @p1709, @p1710, @p1711, @p1712, @p1713, @p1714, @p1715, @p1716, @p1717, @p1718, @p1719, @p1720, @p1721, @p1722, @p1723, @p1724, @p1725, @p1726, @p1727, @p1728, @p1729, @p1730, @p1731, @p1732, @p1733, @p1734, @p1735, 30), (@p1736, @p1737, @p1738, @p1739, @p1740, @p1741, @p1742, @p1743, @p1744, @p1745, @p1746, @p1747, @p1748, @p1749, @p1750, @p1751, @p1752, @p1753, @p1754, @p1755, @p1756, @p1757, @p1758, @p1759, @p1760, @p1761, @p1762, @p1763, @p1764, @p1765, @p1766, @p1767, @p1768, @p1769, @p1770, @p1771, @p1772, @p1773, @p1774, @p1775, @p1776, @p1777, @p1778, @p1779, @p1780, @p1781, @p1782, @p1783, @p1784, @p1785, @p1786, @p1787, @p1788, @p1789, @p1790, @p1791, 31), (@p1792, @p1793, @p1794, @p1795, @p1796, @p1797, @p1798, @p1799, @p1800, @p1801, @p1802, @p1803, @p1804, @p1805, @p1806, @p1807, @p1808, @p1809, @p1810, @p1811, @p1812, @p1813, @p1814, @p1815, @p1816, @p1817, @p1818, @p1819, @p1820, @p1821, @p1822, @p1823, @p1824, @p1825, @p1826, @p1827, @p1828, @p1829, @p1830, @p1831, @p1832, @p1833, @p1834, @p1835, @p1836, @p1837, @p1838, @p1839, @p1840, @p1841, @p1842, @p1843, @p1844, @p1845, @p1846, @p1847, 32), (@p1848, @p1849, @p1850, @p1851, @p1852, @p1853, @p1854, @p1855, @p1856, @p1857, @p1858, @p1859, @p1860, @p1861, @p1862, @p1863, @p1864, @p1865, @p1866, @p1867, @p1868, @p1869, @p1870, @p1871, @p1872, @p1873, @p1874, @p1875, @p1876, @p1877, @p1878, @p1879, @p1880, @p1881, @p1882, @p1883, @p1884, @p1885, @p1886, @p1887, @p1888, @p1889, @p1890, @p1891, @p1892, @p1893, @p1894, @p1895, @p1896, @p1897, @p1898, @p1899, @p1900, @p1901, @p1902, @p1903, 33), (@p1904, @p1905, @p1906, @p1907, @p1908, @p1909, @p1910, @p1911, @p1912, @p1913, @p1914, @p1915, @p1916, @p1917, @p1918, @p1919, @p1920, @p1921, @p1922, @p1923, @p1924, @p1925, @p1926, @p1927, @p1928, @p1929, @p1930, @p1931, @p1932, @p1933, @p1934, @p1935, @p1936, @p1937, @p1938, @p1939, @p1940, @p1941, @p1942, @p1943, @p1944, @p1945, @p1946, @p1947, @p1948, @p1949, @p1950, @p1951, @p1952, @p1953, @p1954, @p1955, @p1956, @p1957, @p1958, @p1959, 34), (@p1960, @p1961, @p1962, @p1963, @p1964, @p1965, @p1966, @p1967, @p1968, @p1969, @p1970, @p1971, @p1972, @p1973, @p1974, @p1975, @p1976, @p1977, @p1978, @p1979, @p1980, @p1981, @p1982, @p1983, @p1984, @p1985, @p1986, @p1987, @p1988, @p1989, @p1990, @p1991, @p1992, @p1993, @p1994, @p1995, @p1996, @p1997, @p1998, @p1999, @p2000, @p2001, @p2002, @p2003, @p2004, @p2005, @p2006, @p2007, @p2008, @p2009, @p2010, @p2011, @p2012, @p2013, @p2014, @p2015, 35), (@p2016, @p2017, @p2018, @p2019, @p2020, @p2021, @p2022, @p2023, @p2024, @p2025, @p2026, @p2027, @p2028, @p2029, @p2030, @p2031, @p2032, @p2033, @p2034, @p2035, @p2036, @p2037, @p2038, @p2039, @p2040, @p2041, @p2042, @p2043, @p2044, @p2045, @p2046, @p2047, @p2048, @p2049, @p2050, @p2051, @p2052, @p2053, @p2054, @p2055, @p2056, @p2057, @p2058, @p2059, @p2060, @p2061, @p2062, @p2063, @p2064, @p2065, @p2066, @p2067, @p2068, @p2069, @p2070, @p2071, 36)) AS i ([addressee_cntry_cd], [addressee_city], [addressee_district], [addressee_email], [addressee_full_address], [addressee_home_address], [addressee_name], [addressee_postcode], [addressee_province], [addressee_subdistrict], [addressee_tel], [create_table], [delivery_code], [delivery_recipient_name], [delivery_relation_id], [delivery_status_id], [dest_outlet_id], [dest_outlet_port], [document_number], [item_barcode], [item_cod], [item_gross_weight], [item_height], [item_length], [item_price], [item_width], [lat], [log_id], [long], [outlet_id], [outlet_port], [podUrl], [remark], [scan_cntry_cd], [scan_cntry_postcode], [sender_cntry_cd], [sender_district], [sender_email], [sender_full_address], [sender_home_address], [member_id], [sender_name], [sender_postcode], [sender_province], [sender_subdistrict], [sender_tel], [server_id], [signatureUrl], [state], [status_code], [status_dtm], [timestamp], [transmit_dtm], [user_id], [wckt_id], [wkstn_no], _Position) ON 1=0 WHEN NOT MATCHED THEN INSERT ([addressee_cntry_cd], [addressee_city], [addressee_district], [addressee_email], [addressee_full_address], [addressee_home_address], [addressee_name], [addressee_postcode], [addressee_province], [addressee_subdistrict], [addressee_tel], [create_table], [delivery_code], [delivery_recipient_name], [delivery_relation_id], [delivery_status_id], [dest_outlet_id], [dest_outlet_port], [document_number], [item_barcode], [item_cod], [item_gross_weight], [item_height], [item_length], [item_price], [item_width], [lat], [log_id], [long], [outlet_id], [outlet_port], [podUrl], [remark], [scan_cntry_cd], [scan_cntry_postcode], [sender_cntry_cd], [sender_district], [sender_email], [sender_full_address], [sender_home_address], [member_id], [sender_name], [sender_postcode], [sender_province], [sender_subdistrict], [sender_tel], [server_id], [signatureUrl], [state], [status_code], [status_dtm], [timestamp], [transmit_dtm], [user_id], [wckt_id], [wkstn_no]) VALUES (i.[addressee_cntry_cd], i.[addressee_city], i.[addressee_district], i.[addressee_email], i.[addressee_full_address], i.[addressee_home_address], i.[addressee_name], i.[addressee_postcode], i.[addressee_province], i.[addressee_subdistrict], i.[addressee_tel], i.[create_table], i.[delivery_code], i.[delivery_recipient_name], i.[delivery_relation_id], i.[delivery_status_id], i.[dest_outlet_id], i.[dest_outlet_port], i.[document_number], i.[item_barcode], i.[item_cod], i.[item_gross_weight], i.[item_height], i.[item_length], i.[item_price], i.[item_width], i.[lat], i.[log_id], i.[long], i.[outlet_id], i.[outlet_port], i.[podUrl], i.[remark], i.[scan_cntry_cd], i.[scan_cntry_postcode], i.[sender_cntry_cd], i.[sender_district], i.[sender_email], i.[sender_full_address], i.[sender_home_address], i.[member_id], i.[sender_name], i.[sender_postcode], i.[sender_province], i.[sender_subdistrict], i.[sender_tel], i.[server_id], i.[signatureUrl], i.[state], i.[status_code], i.[status_dtm], i.[timestamp], i.[transmit_dtm], i.[user_id], i.[wckt_id], i.[wkstn_no]) OUTPUT INSERTED.[item_id], i._Position INTO @inserted0;  SELECT [t].[item_id] FROM [raw_data] t INNER JOIN @inserted0 i ON ([t].[item_id] = [i].[item_id]) ORDER BY [i].[_Position];  ",4,4,0,438,9,4
"(@p0 nvarchar(4000),@p1 nvarchar(4000),@p2 nvarchar(4000),@p3 nvarchar(4000),@p4 nvarchar(4000),@p5 nvarchar(4000),@p6 nvarchar(4000),@p7 nvarchar(4000),@p8 nvarchar(4000),@p9 nvarchar(4000),@p10 nvarchar(4000),@p11 datetime2(7),@p12 nvarchar(4000),@p13 nvarchar(4000),@p14 int,@p15 int,@p16 int,@p17 nvarchar(4000),@p18 nvarchar(4000),@p19 nvarchar(4000),@p20 nvarchar(4000),@p21 decimal(18,2),@p22 nvarchar(4000),@p23 nvarchar(4000),@p24 decimal(18,2),@p25 nvarchar(4000),@p26 nvarchar(4000),@p27 nvarchar(4000),@p28 nvarchar(4000),@p29 int,@p30 nvarchar(4000),@p31 nvarchar(4000),@p32 nvarchar(4000),@p33 nvarchar(4000),@p34 nvarchar(4000),@p35 nvarchar(4000),@p36 nvarchar(4000),@p37 nvarchar(4000),@p38 nvarchar(4000),@p39 nvarchar(4000),@p40 int,@p41 nvarchar(4000),@p42 nvarchar(4000),@p43 nvarchar(4000),@p44 nvarchar(4000),@p45 nvarchar(4000),@p46 int,@p47 nvarchar(4000),@p48 int,@p49 int,@p50 datetime2(7),@p51 datetime2(7),@p52 datetime2(7),@p53 nvarchar(4000),@p54 nvarchar(4000),@p55 nvarchar(4000),@p56 nvarchar(4000),@p57 nvarchar(4000),@p58 nvarchar(4000),@p59 nvarchar(4000),@p60 nvarchar(4000),@p61 nvarchar(4000),@p62 nvarchar(4000),@p63 nvarchar(4000),@p64 nvarchar(4000),@p65 nvarchar(4000),@p66 nvarchar(4000),@p67 datetime2(7),@p68 nvarchar(4000),@p69 nvarchar(4000),@p70 int,@p71 int,@p72 int,@p73 nvarchar(4000),@p74 nvarchar(4000),@p75 nvarchar(4000),@p76 nvarchar(4000),@p77 decimal(18,2),@p78 nvarchar(4000),@p79 nvarchar(4000),@p80 decimal(18,2),@p81 nvarchar(4000),@p82 nvarchar(4000),@p83 nvarchar(4000),@p84 nvarchar(4000),@p85 int,@p86 nvarchar(4000),@p87 nvarchar(4000),@p88 nvarchar(4000),@p89 nvarchar(4000),@p90 nvarchar(4000),@p91 nvarchar(4000),@p92 nvarchar(4000),@p93 nvarchar(4000),@p94 nvarchar(4000),@p95 nvarchar(4000),@p96 int,@p97 nvarchar(4000),@p98 nvarchar(4000),@p99 nvarchar(4000),@p100 nvarchar(4000),@p101 nvarchar(4000),@p102 int,@p103 nvarchar(4000),@p104 int,@p105 int,@p106 datetime2(7),@p107 datetime2(7),@p108 datetime2(7),@p109 nvarchar(4000),@p110 nvarchar(4000),@p111 nvarchar(4000),@p112 nvarchar(4000),@p113 nvarchar(4000),@p114 nvarchar(4000),@p115 nvarchar(4000),@p116 nvarchar(4000),@p117 nvarchar(4000),@p118 nvarchar(4000),@p119 nvarchar(4000),@p120 nvarchar(4000),@p121 nvarchar(4000),@p122 nvarchar(4000),@p123 datetime2(7),@p124 nvarchar(4000),@p125 nvarchar(4000),@p126 int,@p127 int,@p128 int,@p129 nvarchar(4000),@p130 nvarchar(4000),@p131 nvarchar(4000),@p132 nvarchar(4000),@p133 decimal(18,2),@p134 nvarchar(4000),@p135 nvarchar(4000),@p136 decimal(18,2),@p137 nvarchar(4000),@p138 nvarchar(4000),@p139 nvarchar(4000),@p140 nvarchar(4000),@p141 int,@p142 nvarchar(4000),@p143 nvarchar(4000),@p144 nvarchar(4000),@p145 nvarchar(4000),@p146 nvarchar(4000),@p147 nvarchar(4000),@p148 nvarchar(4000),@p149 nvarchar(4000),@p150 nvarchar(4000),@p151 nvarchar(4000),@p152 int,@p153 nvarchar(4000),@p154 nvarchar(4000),@p155 nvarchar(4000),@p156 nvarchar(4000),@p157 nvarchar(4000),@p158 int,@p159 nvarchar(4000),@p160 int,@p161 int,@p162 datetime2(7),@p163 datetime2(7),@p164 datetime2(7),@p165 nvarchar(4000),@p166 nvarchar(4000),@p167 nvarchar(4000),@p168 nvarchar(4000),@p169 nvarchar(4000),@p170 nvarchar(4000),@p171 nvarchar(4000),@p172 nvarchar(4000),@p173 nvarchar(4000),@p174 nvarchar(4000),@p175 nvarchar(4000),@p176 nvarchar(4000),@p177 nvarchar(4000),@p178 nvarchar(4000),@p179 datetime2(7),@p180 nvarchar(4000),@p181 nvarchar(4000),@p182 int,@p183 int,@p184 int,@p185 nvarchar(4000),@p186 nvarchar(4000),@p187 nvarchar(4000),@p188 nvarchar(4000),@p189 decimal(18,2),@p190 nvarchar(4000),@p191 nvarchar(4000),@p192 decimal(18,2),@p193 nvarchar(4000),@p194 nvarchar(4000),@p195 nvarchar(4000),@p196 nvarchar(4000),@p197 int,@p198 nvarchar(4000),@p199 nvarchar(4000),@p200 nvarchar(4000),@p201 nvarchar(4000),@p202 nvarchar(4000),@p203 nvarchar(4000),@p204 nvarchar(4000),@p205 nvarchar(4000),@p206 nvarchar(4000),@p207 nvarchar(4000),@p208 int,@p209 nvarchar(4000),@p210 nvarchar(4000),@p211 nvarchar(4000),@p212 nvarchar(4000),@p213 nvarchar(4000),@p214 int,@p215 nvarchar(4000),@p216 int,@p217 int,@p218 datetime2(7),@p219 datetime2(7),@p220 datetime2(7),@p221 nvarchar(4000),@p222 nvarchar(4000),@p223 nvarchar(4000),@p224 nvarchar(4000),@p225 nvarchar(4000),@p226 nvarchar(4000),@p227 nvarchar(4000),@p228 nvarchar(4000),@p229 nvarchar(4000),@p230 nvarchar(4000),@p231 nvarchar(4000),@p232 nvarchar(4000),@p233 nvarchar(4000),@p234 nvarchar(4000),@p235 datetime2(7),@p236 nvarchar(4000),@p237 nvarchar(4000),@p238 int,@p239 int,@p240 int,@p241 nvarchar(4000),@p242 nvarchar(4000),@p243 nvarchar(4000),@p244 decimal(18,2),@p245 decimal(18,2),@p246 nvarchar(4000),@p247 nvarchar(4000),@p248 decimal(18,2),@p249 nvarchar(4000),@p250 nvarchar(4000),@p251 nvarchar(4000),@p252 nvarchar(4000),@p253 int,@p254 nvarchar(4000),@p255 nvarchar(4000),@p256 nvarchar(4000),@p257 nvarchar(4000),@p258 nvarchar(4000),@p259 nvarchar(4000),@p260 nvarchar(4000),@p261 nvarchar(4000),@p262 nvarchar(4000),@p263 nvarchar(4000),@p264 int,@p265 nvarchar(4000),@p266 nvarchar(4000),@p267 nvarchar(4000),@p268 nvarchar(4000),@p269 nvarchar(4000),@p270 int,@p271 nvarchar(4000),@p272 int,@p273 int,@p274 datetime2(7),@p275 datetime2(7),@p276 datetime2(7),@p277 nvarchar(4000),@p278 nvarchar(4000),@p279 nvarchar(4000),@p280 nvarchar(4000),@p281 nvarchar(4000),@p282 nvarchar(4000),@p283 nvarchar(4000),@p284 nvarchar(4000),@p285 nvarchar(4000),@p286 nvarchar(4000),@p287 nvarchar(4000),@p288 nvarchar(4000),@p289 nvarchar(4000),@p290 nvarchar(4000),@p291 datetime2(7),@p292 nvarchar(4000),@p293 nvarchar(4000),@p294 int,@p295 int,@p296 int,@p297 nvarchar(4000),@p298 nvarchar(4000),@p299 nvarchar(4000),@p300 decimal(18,2),@p301 decimal(18,2),@p302 nvarchar(4000),@p303 nvarchar(4000),@p304 decimal(18,2),@p305 nvarchar(4000),@p306 nvarchar(4000),@p307 nvarchar(4000),@p308 nvarchar(4000),@p309 int,@p310 nvarchar(4000),@p311 nvarchar(4000),@p312 nvarchar(4000),@p313 nvarchar(4000),@p314 nvarchar(4000),@p315 nvarchar(4000),@p316 nvarchar(4000),@p317 nvarchar(4000),@p318 nvarchar(4000),@p319 nvarchar(4000),@p320 int,@p321 nvarchar(4000),@p322 nvarchar(4000),@p323 nvarchar(4000),@p324 nvarchar(4000),@p325 nvarchar(4000),@p326 int,@p327 nvarchar(4000),@p328 int,@p329 int,@p330 datetime2(7),@p331 datetime2(7),@p332 datetime2(7),@p333 nvarchar(4000),@p334 nvarchar(4000),@p335 nvarchar(4000),@p336 nvarchar(4000),@p337 nvarchar(4000),@p338 nvarchar(4000),@p339 nvarchar(4000),@p340 nvarchar(4000),@p341 nvarchar(4000),@p342 nvarchar(4000),@p343 nvarchar(4000),@p344 nvarchar(4000),@p345 nvarchar(4000),@p346 nvarchar(4000),@p347 datetime2(7),@p348 nvarchar(4000),@p349 nvarchar(4000),@p350 int,@p351 int,@p352 int,@p353 nvarchar(4000),@p354 nvarchar(4000),@p355 nvarchar(4000),@p356 decimal(18,2),@p357 decimal(18,2),@p358 nvarchar(4000),@p359 nvarchar(4000),@p360 decimal(18,2),@p361 nvarchar(4000),@p362 nvarchar(4000),@p363 nvarchar(4000),@p364 nvarchar(4000),@p365 int,@p366 nvarchar(4000),@p367 nvarchar(4000),@p368 nvarchar(4000),@p369 nvarchar(4000),@p370 nvarchar(4000),@p371 nvarchar(4000),@p372 nvarchar(4000),@p373 nvarchar(4000),@p374 nvarchar(4000),@p375 nvarchar(4000),@p376 int,@p377 nvarchar(4000),@p378 nvarchar(4000),@p379 nvarchar(4000),@p380 nvarchar(4000),@p381 nvarchar(4000),@p382 int,@p383 nvarchar(4000),@p384 int,@p385 int,@p386 datetime2(7),@p387 datetime2(7),@p388 datetime2(7),@p389 nvarchar(4000),@p390 nvarchar(4000),@p391 nvarchar(4000),@p392 nvarchar(4000),@p393 nvarchar(4000),@p394 nvarchar(4000),@p395 nvarchar(4000),@p396 nvarchar(4000),@p397 nvarchar(4000),@p398 nvarchar(4000),@p399 nvarchar(4000),@p400 nvarchar(4000),@p401 nvarchar(4000),@p402 nvarchar(4000),@p403 datetime2(7),@p404 nvarchar(4000),@p405 nvarchar(4000),@p406 int,@p407 int,@p408 int,@p409 nvarchar(4000),@p410 nvarchar(4000),@p411 nvarchar(4000),@p412 nvarchar(4000),@p413 decimal(18,2),@p414 nvarchar(4000),@p415 nvarchar(4000),@p416 decimal(18,2),@p417 nvarchar(4000),@p418 nvarchar(4000),@p419 nvarchar(4000),@p420 nvarchar(4000),@p421 int,@p422 nvarchar(4000),@p423 nvarchar(4000),@p424 nvarchar(4000),@p425 nvarchar(4000),@p426 nvarchar(4000),@p427 nvarchar(4000),@p428 nvarchar(4000),@p429 nvarchar(4000),@p430 nvarchar(4000),@p431 nvarchar(4000),@p432 int,@p433 nvarchar(4000),@p434 nvarchar(4000),@p435 nvarchar(4000),@p436 nvarchar(4000),@p437 nvarchar(4000),@p438 int,@p439 nvarchar(4000),@p440 int,@p441 int,@p442 datetime2(7),@p443 datetime2(7),@p444 datetime2(7),@p445 nvarchar(4000),@p446 nvarchar(4000),@p447 nvarchar(4000),@p448 nvarchar(4000),@p449 nvarchar(4000),@p450 nvarchar(4000),@p451 nvarchar(4000),@p452 nvarchar(4000),@p453 nvarchar(4000),@p454 nvarchar(4000),@p455 nvarchar(4000),@p456 nvarchar(4000),@p457 nvarchar(4000),@p458 nvarchar(4000),@p459 datetime2(7),@p460 nvarchar(4000),@p461 nvarchar(4000),@p462 int,@p463 int,@p464 int,@p465 nvarchar(4000),@p466 nvarchar(4000),@p467 nvarchar(4000),@p468 nvarchar(4000),@p469 decimal(18,2),@p470 nvarchar(4000),@p471 nvarchar(4000),@p472 decimal(18,2),@p473 nvarchar(4000),@p474 nvarchar(4000),@p475 nvarchar(4000),@p476 nvarchar(4000),@p477 int,@p478 nvarchar(4000),@p479 nvarchar(4000),@p480 nvarchar(4000),@p481 nvarchar(4000),@p482 nvarchar(4000),@p483 nvarchar(4000),@p484 nvarchar(4000),@p485 nvarchar(4000),@p486 nvarchar(4000),@p487 nvarchar(4000),@p488 int,@p489 nvarchar(4000),@p490 nvarchar(4000),@p491 nvarchar(4000),@p492 nvarchar(4000),@p493 nvarchar(4000),@p494 int,@p495 nvarchar(4000),@p496 int,@p497 int,@p498 datetime2(7),@p499 datetime2(7),@p500 datetime2(7),@p501 nvarchar(4000),@p502 nvarchar(4000),@p503 nvarchar(4000),@p504 nvarchar(4000),@p505 nvarchar(4000),@p506 nvarchar(4000),@p507 nvarchar(4000),@p508 nvarchar(4000),@p509 nvarchar(4000),@p510 nvarchar(4000),@p511 nvarchar(4000),@p512 nvarchar(4000),@p513 nvarchar(4000),@p514 nvarchar(4000),@p515 datetime2(7),@p516 nvarchar(4000),@p517 nvarchar(4000),@p518 int,@p519 int,@p520 int,@p521 nvarchar(4000),@p522 nvarchar(4000),@p523 nvarchar(4000),@p524 nvarchar(4000),@p525 decimal(18,2),@p526 nvarchar(4000),@p527 nvarchar(4000),@p528 decimal(18,2),@p529 nvarchar(4000),@p530 nvarchar(4000),@p531 nvarchar(4000),@p532 nvarchar(4000),@p533 int,@p534 nvarchar(4000),@p535 nvarchar(4000),@p536 nvarchar(4000),@p537 nvarchar(4000),@p538 nvarchar(4000),@p539 nvarchar(4000),@p540 nvarchar(4000),@p541 nvarchar(4000),@p542 nvarchar(4000),@p543 nvarchar(4000),@p544 int,@p545 nvarchar(4000),@p546 nvarchar(4000),@p547 nvarchar(4000),@p548 nvarchar(4000),@p549 nvarchar(4000),@p550 int,@p551 nvarchar(4000),@p552 int,@p553 int,@p554 datetime2(7),@p555 datetime2(7),@p556 datetime2(7),@p557 nvarchar(4000),@p558 nvarchar(4000),@p559 nvarchar(4000),@p560 nvarchar(4000),@p561 nvarchar(4000),@p562 nvarchar(4000),@p563 nvarchar(4000),@p564 nvarchar(4000),@p565 nvarchar(4000),@p566 nvarchar(4000),@p567 nvarchar(4000),@p568 nvarchar(4000),@p569 nvarchar(4000),@p570 nvarchar(4000),@p571 datetime2(7),@p572 nvarchar(4000),@p573 nvarchar(4000),@p574 int,@p575 int,@p576 int,@p577 nvarchar(4000),@p578 nvarchar(4000),@p579 nvarchar(4000),@p580 nvarchar(4000),@p581 decimal(18,2),@p582 nvarchar(4000),@p583 nvarchar(4000),@p584 decimal(18,2),@p585 nvarchar(4000),@p586 nvarchar(4000),@p587 nvarchar(4000),@p588 nvarchar(4000),@p589 int,@p590 nvarchar(4000),@p591 nvarchar(4000),@p592 nvarchar(4000),@p593 nvarchar(4000),@p594 nvarchar(4000),@p595 nvarchar(4000),@p596 nvarchar(4000),@p597 nvarchar(4000),@p598 nvarchar(4000),@p599 nvarchar(4000),@p600 int,@p601 nvarchar(4000),@p602 nvarchar(4000),@p603 nvarchar(4000),@p604 nvarchar(4000),@p605 nvarchar(4000),@p606 int,@p607 nvarchar(4000),@p608 int,@p609 int,@p610 datetime2(7),@p611 datetime2(7),@p612 datetime2(7),@p613 nvarchar(4000),@p614 nvarchar(4000),@p615 nvarchar(4000),@p616 nvarchar(4000),@p617 nvarchar(4000),@p618 nvarchar(4000),@p619 nvarchar(4000),@p620 nvarchar(4000),@p621 nvarchar(4000),@p622 nvarchar(4000),@p623 nvarchar(4000),@p624 nvarchar(4000),@p625 nvarchar(4000),@p626 nvarchar(4000),@p627 datetime2(7),@p628 nvarchar(4000),@p629 nvarchar(4000),@p630 int,@p631 int,@p632 int,@p633 nvarchar(4000),@p634 nvarchar(4000),@p635 nvarchar(4000),@p636 nvarchar(4000),@p637 decimal(18,2),@p638 nvarchar(4000),@p639 nvarchar(4000),@p640 decimal(18,2),@p641 nvarchar(4000),@p642 nvarchar(4000),@p643 nvarchar(4000),@p644 nvarchar(4000),@p645 int,@p646 nvarchar(4000),@p647 nvarchar(4000),@p648 nvarchar(4000),@p649 nvarchar(4000),@p650 nvarchar(4000),@p651 nvarchar(4000),@p652 nvarchar(4000),@p653 nvarchar(4000),@p654 nvarchar(4000),@p655 nvarchar(4000),@p656 int,@p657 nvarchar(4000),@p658 nvarchar(4000),@p659 nvarchar(4000),@p660 nvarchar(4000),@p661 nvarchar(4000),@p662 int,@p663 nvarchar(4000),@p664 int,@p665 int,@p666 datetime2(7),@p667 datetime2(7),@p668 datetime2(7),@p669 nvarchar(4000),@p670 nvarchar(4000),@p671 nvarchar(4000),@p672 nvarchar(4000),@p673 nvarchar(4000),@p674 nvarchar(4000),@p675 nvarchar(4000),@p676 nvarchar(4000),@p677 nvarchar(4000),@p678 nvarchar(4000),@p679 nvarchar(4000),@p680 nvarchar(4000),@p681 nvarchar(4000),@p682 nvarchar(4000),@p683 datetime2(7),@p684 nvarchar(4000),@p685 nvarchar(4000),@p686 int,@p687 int,@p688 int,@p689 nvarchar(4000),@p690 nvarchar(4000),@p691 nvarchar(4000),@p692 nvarchar(4000),@p693 decimal(18,2),@p694 nvarchar(4000),@p695 nvarchar(4000),@p696 decimal(18,2),@p697 nvarchar(4000),@p698 nvarchar(4000),@p699 nvarchar(4000),@p700 nvarchar(4000),@p701 int,@p702 nvarchar(4000),@p703 nvarchar(4000),@p704 nvarchar(4000),@p705 nvarchar(4000),@p706 nvarchar(4000),@p707 nvarchar(4000),@p708 nvarchar(4000),@p709 nvarchar(4000),@p710 nvarchar(4000),@p711 nvarchar(4000),@p712 int,@p713 nvarchar(4000),@p714 nvarchar(4000),@p715 nvarchar(4000),@p716 nvarchar(4000),@p717 nvarchar(4000),@p718 int,@p719 nvarchar(4000),@p720 int,@p721 int,@p722 datetime2(7),@p723 datetime2(7),@p724 datetime2(7),@p725 nvarchar(4000),@p726 nvarchar(4000),@p727 nvarchar(4000),@p728 nvarchar(4000),@p729 nvarchar(4000),@p730 nvarchar(4000),@p731 nvarchar(4000),@p732 nvarchar(4000),@p733 nvarchar(4000),@p734 nvarchar(4000),@p735 nvarchar(4000),@p736 nvarchar(4000),@p737 nvarchar(4000),@p738 nvarchar(4000),@p739 datetime2(7),@p740 nvarchar(4000),@p741 nvarchar(4000),@p742 int,@p743 int,@p744 int,@p745 nvarchar(4000),@p746 nvarchar(4000),@p747 nvarchar(4000),@p748 nvarchar(4000),@p749 decimal(18,2),@p750 nvarchar(4000),@p751 nvarchar(4000),@p752 decimal(18,2),@p753 nvarchar(4000),@p754 nvarchar(4000),@p755 nvarchar(4000),@p756 nvarchar(4000),@p757 int,@p758 nvarchar(4000),@p759 nvarchar(4000),@p760 nvarchar(4000),@p761 nvarchar(4000),@p762 nvarchar(4000),@p763 nvarchar(4000),@p764 nvarchar(4000),@p765 nvarchar(4000),@p766 nvarchar(4000),@p767 nvarchar(4000),@p768 int,@p769 nvarchar(4000),@p770 nvarchar(4000),@p771 nvarchar(4000),@p772 nvarchar(4000),@p773 nvarchar(4000),@p774 int,@p775 nvarchar(4000),@p776 int,@p777 int,@p778 datetime2(7),@p779 datetime2(7),@p780 datetime2(7),@p781 nvarchar(4000),@p782 nvarchar(4000),@p783 nvarchar(4000),@p784 nvarchar(4000),@p785 nvarchar(4000),@p786 nvarchar(4000),@p787 nvarchar(4000),@p788 nvarchar(4000),@p789 nvarchar(4000),@p790 nvarchar(4000),@p791 nvarchar(4000),@p792 nvarchar(4000),@p793 nvarchar(4000),@p794 nvarchar(4000),@p795 datetime2(7),@p796 nvarchar(4000),@p797 nvarchar(4000),@p798 int,@p799 int,@p800 int,@p801 nvarchar(4000),@p802 nvarchar(4000),@p803 nvarchar(4000),@p804 nvarchar(4000),@p805 decimal(18,2),@p806 nvarchar(4000),@p807 nvarchar(4000),@p808 decimal(18,2),@p809 nvarchar(4000),@p810 nvarchar(4000),@p811 nvarchar(4000),@p812 nvarchar(4000),@p813 int,@p814 nvarchar(4000),@p815 nvarchar(4000),@p816 nvarchar(4000),@p817 nvarchar(4000),@p818 nvarchar(4000),@p819 nvarchar(4000),@p820 nvarchar(4000),@p821 nvarchar(4000),@p822 nvarchar(4000),@p823 nvarchar(4000),@p824 int,@p825 nvarchar(4000),@p826 nvarchar(4000),@p827 nvarchar(4000),@p828 nvarchar(4000),@p829 nvarchar(4000),@p830 int,@p831 nvarchar(4000),@p832 int,@p833 int,@p834 datetime2(7),@p835 datetime2(7),@p836 datetime2(7),@p837 nvarchar(4000),@p838 nvarchar(4000),@p839 nvarchar(4000),@p840 nvarchar(4000),@p841 nvarchar(4000),@p842 nvarchar(4000),@p843 nvarchar(4000),@p844 nvarchar(4000),@p845 nvarchar(4000),@p846 nvarchar(4000),@p847 nvarchar(4000),@p848 nvarchar(4000),@p849 nvarchar(4000),@p850 nvarchar(4000),@p851 datetime2(7),@p852 nvarchar(4000),@p853 nvarchar(4000),@p854 int,@p855 int,@p856 int,@p857 nvarchar(4000),@p858 nvarchar(4000),@p859 nvarchar(4000),@p860 nvarchar(4000),@p861 decimal(18,2),@p862 nvarchar(4000),@p863 nvarchar(4000),@p864 decimal(18,2),@p865 nvarchar(4000),@p866 nvarchar(4000),@p867 nvarchar(4000),@p868 nvarchar(4000),@p869 int,@p870 nvarchar(4000),@p871 nvarchar(4000),@p872 nvarchar(4000),@p873 nvarchar(4000),@p874 nvarchar(4000),@p875 nvarchar(4000),@p876 nvarchar(4000),@p877 nvarchar(4000),@p878 nvarchar(4000),@p879 nvarchar(4000),@p880 int,@p881 nvarchar(4000),@p882 nvarchar(4000),@p883 nvarchar(4000),@p884 nvarchar(4000),@p885 nvarchar(4000),@p886 int,@p887 nvarchar(4000),@p888 int,@p889 int,@p890 datetime2(7),@p891 datetime2(7),@p892 datetime2(7),@p893 nvarchar(4000),@p894 nvarchar(4000),@p895 nvarchar(4000),@p896 nvarchar(4000),@p897 nvarchar(4000),@p898 nvarchar(4000),@p899 nvarchar(4000),@p900 nvarchar(4000),@p901 nvarchar(4000),@p902 nvarchar(4000),@p903 nvarchar(4000),@p904 nvarchar(4000),@p905 nvarchar(4000),@p906 nvarchar(4000),@p907 datetime2(7),@p908 nvarchar(4000),@p909 nvarchar(4000),@p910 int,@p911 int,@p912 int,@p913 nvarchar(4000),@p914 nvarchar(4000),@p915 nvarchar(4000),@p916 nvarchar(4000),@p917 decimal(18,2),@p918 nvarchar(4000),@p919 nvarchar(4000),@p920 decimal(18,2),@p921 nvarchar(4000),@p922 nvarchar(4000),@p923 nvarchar(4000),@p924 nvarchar(4000),@p925 int,@p926 nvarchar(4000),@p927 nvarchar(4000),@p928 nvarchar(4000),@p929 nvarchar(4000),@p930 nvarchar(4000),@p931 nvarchar(4000),@p932 nvarchar(4000),@p933 nvarchar(4000),@p934 nvarchar(4000),@p935 nvarchar(4000),@p936 int,@p937 nvarchar(4000),@p938 nvarchar(4000),@p939 nvarchar(4000),@p940 nvarchar(4000),@p941 nvarchar(4000),@p942 int,@p943 nvarchar(4000),@p944 int,@p945 int,@p946 datetime2(7),@p947 datetime2(7),@p948 datetime2(7),@p949 nvarchar(4000),@p950 nvarchar(4000),@p951 nvarchar(4000),@p952 nvarchar(4000),@p953 nvarchar(4000),@p954 nvarchar(4000),@p955 nvarchar(4000),@p956 nvarchar(4000),@p957 nvarchar(4000),@p958 nvarchar(4000),@p959 nvarchar(4000),@p960 nvarchar(4000),@p961 nvarchar(4000),@p962 nvarchar(4000),@p963 datetime2(7),@p964 nvarchar(4000),@p965 nvarchar(4000),@p966 int,@p967 int,@p968 int,@p969 nvarchar(4000),@p970 nvarchar(4000),@p971 nvarchar(4000),@p972 nvarchar(4000),@p973 decimal(18,2),@p974 nvarchar(4000),@p975 nvarchar(4000),@p976 decimal(18,2),@p977 nvarchar(4000),@p978 nvarchar(4000),@p979 nvarchar(4000),@p980 nvarchar(4000),@p981 int,@p982 nvarchar(4000),@p983 nvarchar(4000),@p984 nvarchar(4000),@p985 nvarchar(4000),@p986 nvarchar(4000),@p987 nvarchar(4000),@p988 nvarchar(4000),@p989 nvarchar(4000),@p990 nvarchar(4000),@p991 nvarchar(4000),@p992 int,@p993 nvarchar(4000),@p994 nvarchar(4000),@p995 nvarchar(4000),@p996 nvarchar(4000),@p997 nvarchar(4000),@p998 int,@p999 nvarchar(4000),@p1000 int,@p1001 int,@p1002 datetime2(7),@p1003 datetime2(7),@p1004 datetime2(7),@p1005 nvarchar(4000),@p1006 nvarchar(4000),@p1007 nvarchar(4000),@p1008 nvarchar(4000),@p1009 nvarchar(4000),@p1010 nvarchar(4000),@p1011 nvarchar(4000),@p1012 nvarchar(4000),@p1013 nvarchar(4000),@p1014 nvarchar(4000),@p1015 nvarchar(4000),@p1016 nvarchar(4000),@p1017 nvarchar(4000),@p1018 nvarchar(4000),@p1019 datetime2(7),@p1020 nvarchar(4000),@p1021 nvarchar(4000),@p1022 int,@p1023 int,@p1024 int,@p1025 nvarchar(4000),@p1026 nvarchar(4000),@p1027 nvarchar(4000),@p1028 nvarchar(4000),@p1029 decimal(18,2),@p1030 nvarchar(4000),@p1031 nvarchar(4000),@p1032 decimal(18,2),@p1033 nvarchar(4000),@p1034 nvarchar(4000),@p1035 nvarchar(4000),@p1036 nvarchar(4000),@p1037 int,@p1038 nvarchar(4000),@p1039 nvarchar(4000),@p1040 nvarchar(4000),@p1041 nvarchar(4000),@p1042 nvarchar(4000),@p1043 nvarchar(4000),@p1044 nvarchar(4000),@p1045 nvarchar(4000),@p1046 nvarchar(4000),@p1047 nvarchar(4000),@p1048 int,@p1049 nvarchar(4000),@p1050 nvarchar(4000),@p1051 nvarchar(4000),@p1052 nvarchar(4000),@p1053 nvarchar(4000),@p1054 int,@p1055 nvarchar(4000),@p1056 int,@p1057 int,@p1058 datetime2(7),@p1059 datetime2(7),@p1060 datetime2(7),@p1061 nvarchar(4000),@p1062 nvarchar(4000),@p1063 nvarchar(4000),@p1064 nvarchar(4000),@p1065 nvarchar(4000),@p1066 nvarchar(4000),@p1067 nvarchar(4000),@p1068 nvarchar(4000),@p1069 nvarchar(4000),@p1070 nvarchar(4000),@p1071 nvarchar(4000),@p1072 nvarchar(4000),@p1073 nvarchar(4000),@p1074 nvarchar(4000),@p1075 datetime2(7),@p1076 nvarchar(4000),@p1077 nvarchar(4000),@p1078 int,@p1079 int,@p1080 int,@p1081 nvarchar(4000),@p1082 nvarchar(4000),@p1083 nvarchar(4000),@p1084 nvarchar(4000),@p1085 decimal(18,2),@p1086 nvarchar(4000),@p1087 nvarchar(4000),@p1088 decimal(18,2),@p1089 nvarchar(4000),@p1090 nvarchar(4000),@p1091 nvarchar(4000),@p1092 nvarchar(4000),@p1093 int,@p1094 nvarchar(4000),@p1095 nvarchar(4000),@p1096 nvarchar(4000),@p1097 nvarchar(4000),@p1098 nvarchar(4000),@p1099 nvarchar(4000),@p1100 nvarchar(4000),@p1101 nvarchar(4000),@p1102 nvarchar(4000),@p1103 nvarchar(4000),@p1104 int,@p1105 nvarchar(4000),@p1106 nvarchar(4000),@p1107 nvarchar(4000),@p1108 nvarchar(4000),@p1109 nvarchar(4000),@p1110 int,@p1111 nvarchar(4000),@p1112 int,@p1113 int,@p1114 datetime2(7),@p1115 datetime2(7),@p1116 datetime2(7),@p1117 nvarchar(4000),@p1118 nvarchar(4000),@p1119 nvarchar(4000),@p1120 nvarchar(4000),@p1121 nvarchar(4000),@p1122 nvarchar(4000),@p1123 nvarchar(4000),@p1124 nvarchar(4000),@p1125 nvarchar(4000),@p1126 nvarchar(4000),@p1127 nvarchar(4000),@p1128 nvarchar(4000),@p1129 nvarchar(4000),@p1130 nvarchar(4000),@p1131 datetime2(7),@p1132 nvarchar(4000),@p1133 nvarchar(4000),@p1134 int,@p1135 int,@p1136 int,@p1137 nvarchar(4000),@p1138 nvarchar(4000),@p1139 nvarchar(4000),@p1140 nvarchar(4000),@p1141 decimal(18,2),@p1142 nvarchar(4000),@p1143 nvarchar(4000),@p1144 decimal(18,2),@p1145 nvarchar(4000),@p1146 nvarchar(4000),@p1147 nvarchar(4000),@p1148 nvarchar(4000),@p1149 int,@p1150 nvarchar(4000),@p1151 nvarchar(4000),@p1152 nvarchar(4000),@p1153 nvarchar(4000),@p1154 nvarchar(4000),@p1155 nvarchar(4000),@p1156 nvarchar(4000),@p1157 nvarchar(4000),@p1158 nvarchar(4000),@p1159 nvarchar(4000),@p1160 int,@p1161 nvarchar(4000),@p1162 nvarchar(4000),@p1163 nvarchar(4000),@p1164 nvarchar(4000),@p1165 nvarchar(4000),@p1166 int,@p1167 nvarchar(4000),@p1168 int,@p1169 int,@p1170 datetime2(7),@p1171 datetime2(7),@p1172 datetime2(7),@p1173 nvarchar(4000),@p1174 nvarchar(4000),@p1175 nvarchar(4000),@p1176 nvarchar(4000),@p1177 nvarchar(4000),@p1178 nvarchar(4000),@p1179 nvarchar(4000),@p1180 nvarchar(4000),@p1181 nvarchar(4000),@p1182 nvarchar(4000),@p1183 nvarchar(4000),@p1184 nvarchar(4000),@p1185 nvarchar(4000),@p1186 nvarchar(4000),@p1187 datetime2(7),@p1188 nvarchar(4000),@p1189 nvarchar(4000),@p1190 int,@p1191 int,@p1192 int,@p1193 nvarchar(4000),@p1194 nvarchar(4000),@p1195 nvarchar(4000),@p1196 nvarchar(4000),@p1197 decimal(18,2),@p1198 nvarchar(4000),@p1199 nvarchar(4000),@p1200 decimal(18,2),@p1201 nvarchar(4000),@p1202 nvarchar(4000),@p1203 nvarchar(4000),@p1204 nvarchar(4000),@p1205 int,@p1206 nvarchar(4000),@p1207 nvarchar(4000),@p1208 nvarchar(4000),@p1209 nvarchar(4000),@p1210 nvarchar(4000),@p1211 nvarchar(4000),@p1212 nvarchar(4000),@p1213 nvarchar(4000),@p1214 nvarchar(4000),@p1215 nvarchar(4000),@p1216 int,@p1217 nvarchar(4000),@p1218 nvarchar(4000),@p1219 nvarchar(4000),@p1220 nvarchar(4000),@p1221 nvarchar(4000),@p1222 int,@p1223 nvarchar(4000),@p1224 int,@p1225 int,@p1226 datetime2(7),@p1227 datetime2(7),@p1228 datetime2(7),@p1229 nvarchar(4000),@p1230 nvarchar(4000),@p1231 nvarchar(4000),@p1232 nvarchar(4000),@p1233 nvarchar(4000),@p1234 nvarchar(4000),@p1235 nvarchar(4000),@p1236 nvarchar(4000),@p1237 nvarchar(4000),@p1238 nvarchar(4000),@p1239 nvarchar(4000),@p1240 nvarchar(4000),@p1241 nvarchar(4000),@p1242 nvarchar(4000),@p1243 datetime2(7),@p1244 nvarchar(4000),@p1245 nvarchar(4000),@p1246 int,@p1247 int,@p1248 int,@p1249 nvarchar(4000),@p1250 nvarchar(4000),@p1251 nvarchar(4000),@p1252 nvarchar(4000),@p1253 decimal(18,2),@p1254 nvarchar(4000),@p1255 nvarchar(4000),@p1256 decimal(18,2),@p1257 nvarchar(4000),@p1258 nvarchar(4000),@p1259 nvarchar(4000),@p1260 nvarchar(4000),@p1261 int,@p1262 nvarchar(4000),@p1263 nvarchar(4000),@p1264 nvarchar(4000),@p1265 nvarchar(4000),@p1266 nvarchar(4000),@p1267 nvarchar(4000),@p1268 nvarchar(4000),@p1269 nvarchar(4000),@p1270 nvarchar(4000),@p1271 nvarchar(4000),@p1272 int,@p1273 nvarchar(4000),@p1274 nvarchar(4000),@p1275 nvarchar(4000),@p1276 nvarchar(4000),@p1277 nvarchar(4000),@p1278 int,@p1279 nvarchar(4000),@p1280 int,@p1281 int,@p1282 datetime2(7),@p1283 datetime2(7),@p1284 datetime2(7),@p1285 nvarchar(4000),@p1286 nvarchar(4000),@p1287 nvarchar(4000),@p1288 nvarchar(4000),@p1289 nvarchar(4000),@p1290 nvarchar(4000),@p1291 nvarchar(4000),@p1292 nvarchar(4000),@p1293 nvarchar(4000),@p1294 nvarchar(4000),@p1295 nvarchar(4000),@p1296 nvarchar(4000),@p1297 nvarchar(4000),@p1298 nvarchar(4000),@p1299 datetime2(7),@p1300 nvarchar(4000),@p1301 nvarchar(4000),@p1302 int,@p1303 int,@p1304 int,@p1305 nvarchar(4000),@p1306 nvarchar(4000),@p1307 nvarchar(4000),@p1308 nvarchar(4000),@p1309 decimal(18,2),@p1310 nvarchar(4000),@p1311 nvarchar(4000),@p1312 decimal(18,2),@p1313 nvarchar(4000),@p1314 nvarchar(4000),@p1315 nvarchar(4000),@p1316 nvarchar(4000),@p1317 int,@p1318 nvarchar(4000),@p1319 nvarchar(4000),@p1320 nvarchar(4000),@p1321 nvarchar(4000),@p1322 nvarchar(4000),@p1323 nvarchar(4000),@p1324 nvarchar(4000),@p1325 nvarchar(4000),@p1326 nvarchar(4000),@p1327 nvarchar(4000),@p1328 int,@p1329 nvarchar(4000),@p1330 nvarchar(4000),@p1331 nvarchar(4000),@p1332 nvarchar(4000),@p1333 nvarchar(4000),@p1334 int,@p1335 nvarchar(4000),@p1336 int,@p1337 int,@p1338 datetime2(7),@p1339 datetime2(7),@p1340 datetime2(7),@p1341 nvarchar(4000),@p1342 nvarchar(4000),@p1343 nvarchar(4000),@p1344 nvarchar(4000),@p1345 nvarchar(4000),@p1346 nvarchar(4000),@p1347 nvarchar(4000),@p1348 nvarchar(4000),@p1349 nvarchar(4000),@p1350 nvarchar(4000),@p1351 nvarchar(4000),@p1352 nvarchar(4000),@p1353 nvarchar(4000),@p1354 nvarchar(4000),@p1355 datetime2(7),@p1356 nvarchar(4000),@p1357 nvarchar(4000),@p1358 int,@p1359 int,@p1360 int,@p1361 nvarchar(4000),@p1362 nvarchar(4000),@p1363 nvarchar(4000),@p1364 decimal(18,2),@p1365 decimal(18,2),@p1366 nvarchar(4000),@p1367 nvarchar(4000),@p1368 decimal(18,2),@p1369 nvarchar(4000),@p1370 nvarchar(4000),@p1371 nvarchar(4000),@p1372 nvarchar(4000),@p1373 int,@p1374 nvarchar(4000),@p1375 nvarchar(4000),@p1376 nvarchar(4000),@p1377 nvarchar(4000),@p1378 nvarchar(4000),@p1379 nvarchar(4000),@p1380 nvarchar(4000),@p1381 nvarchar(4000),@p1382 nvarchar(4000),@p1383 nvarchar(4000),@p1384 int,@p1385 nvarchar(4000),@p1386 nvarchar(4000),@p1387 nvarchar(4000),@p1388 nvarchar(4000),@p1389 nvarchar(4000),@p1390 int,@p1391 nvarchar(4000),@p1392 int,@p1393 int,@p1394 datetime2(7),@p1395 datetime2(7),@p1396 datetime2(7),@p1397 nvarchar(4000),@p1398 nvarchar(4000),@p1399 nvarchar(4000),@p1400 nvarchar(4000),@p1401 nvarchar(4000),@p1402 nvarchar(4000),@p1403 nvarchar(4000),@p1404 nvarchar(4000),@p1405 nvarchar(4000),@p1406 nvarchar(4000),@p1407 nvarchar(4000),@p1408 nvarchar(4000),@p1409 nvarchar(4000),@p1410 nvarchar(4000),@p1411 datetime2(7),@p1412 nvarchar(4000),@p1413 nvarchar(4000),@p1414 int,@p1415 int,@p1416 int,@p1417 nvarchar(4000),@p1418 nvarchar(4000),@p1419 nvarchar(4000),@p1420 nvarchar(4000),@p1421 decimal(18,2),@p1422 nvarchar(4000),@p1423 nvarchar(4000),@p1424 decimal(18,2),@p1425 nvarchar(4000),@p1426 nvarchar(4000),@p1427 nvarchar(4000),@p1428 nvarchar(4000),@p1429 int,@p1430 nvarchar(4000),@p1431 nvarchar(4000),@p1432 nvarchar(4000),@p1433 nvarchar(4000),@p1434 nvarchar(4000),@p1435 nvarchar(4000),@p1436 nvarchar(4000),@p1437 nvarchar(4000),@p1438 nvarchar(4000),@p1439 nvarchar(4000),@p1440 int,@p1441 nvarchar(4000),@p1442 nvarchar(4000),@p1443 nvarchar(4000),@p1444 nvarchar(4000),@p1445 nvarchar(4000),@p1446 int,@p1447 nvarchar(4000),@p1448 int,@p1449 int,@p1450 datetime2(7),@p1451 datetime2(7),@p1452 datetime2(7),@p1453 nvarchar(4000),@p1454 nvarchar(4000),@p1455 nvarchar(4000),@p1456 nvarchar(4000),@p1457 nvarchar(4000),@p1458 nvarchar(4000),@p1459 nvarchar(4000),@p1460 nvarchar(4000),@p1461 nvarchar(4000),@p1462 nvarchar(4000),@p1463 nvarchar(4000),@p1464 nvarchar(4000),@p1465 nvarchar(4000),@p1466 nvarchar(4000),@p1467 datetime2(7),@p1468 nvarchar(4000),@p1469 nvarchar(4000),@p1470 int,@p1471 int,@p1472 int,@p1473 nvarchar(4000),@p1474 nvarchar(4000),@p1475 nvarchar(4000),@p1476 nvarchar(4000),@p1477 decimal(18,2),@p1478 nvarchar(4000),@p1479 nvarchar(4000),@p1480 decimal(18,2),@p1481 nvarchar(4000),@p1482 nvarchar(4000),@p1483 nvarchar(4000),@p1484 nvarchar(4000),@p1485 int,@p1486 nvarchar(4000),@p1487 nvarchar(4000),@p1488 nvarchar(4000),@p1489 nvarchar(4000),@p1490 nvarchar(4000),@p1491 nvarchar(4000),@p1492 nvarchar(4000),@p1493 nvarchar(4000),@p1494 nvarchar(4000),@p1495 nvarchar(4000),@p1496 int,@p1497 nvarchar(4000),@p1498 nvarchar(4000),@p1499 nvarchar(4000),@p1500 nvarchar(4000),@p1501 nvarchar(4000),@p1502 int,@p1503 nvarchar(4000),@p1504 int,@p1505 int,@p1506 datetime2(7),@p1507 datetime2(7),@p1508 datetime2(7),@p1509 nvarchar(4000),@p1510 nvarchar(4000),@p1511 nvarchar(4000),@p1512 nvarchar(4000),@p1513 nvarchar(4000),@p1514 nvarchar(4000),@p1515 nvarchar(4000),@p1516 nvarchar(4000),@p1517 nvarchar(4000),@p1518 nvarchar(4000),@p1519 nvarchar(4000),@p1520 nvarchar(4000),@p1521 nvarchar(4000),@p1522 nvarchar(4000),@p1523 datetime2(7),@p1524 nvarchar(4000),@p1525 nvarchar(4000),@p1526 int,@p1527 int,@p1528 int,@p1529 nvarchar(4000),@p1530 nvarchar(4000),@p1531 nvarchar(4000),@p1532 decimal(18,2),@p1533 decimal(18,2),@p1534 nvarchar(4000),@p1535 nvarchar(4000),@p1536 decimal(18,2),@p1537 nvarchar(4000),@p1538 nvarchar(4000),@p1539 nvarchar(4000),@p1540 nvarchar(4000),@p1541 int,@p1542 nvarchar(4000),@p1543 nvarchar(4000),@p1544 nvarchar(4000),@p1545 nvarchar(4000),@p1546 nvarchar(4000),@p1547 nvarchar(4000),@p1548 nvarchar(4000),@p1549 nvarchar(4000),@p1550 nvarchar(4000),@p1551 nvarchar(4000),@p1552 int,@p1553 nvarchar(4000),@p1554 nvarchar(4000),@p1555 nvarchar(4000),@p1556 nvarchar(4000),@p1557 nvarchar(4000),@p1558 int,@p1559 nvarchar(4000),@p1560 int,@p1561 int,@p1562 datetime2(7),@p1563 datetime2(7),@p1564 datetime2(7),@p1565 nvarchar(4000),@p1566 nvarchar(4000),@p1567 nvarchar(4000),@p1568 nvarchar(4000),@p1569 nvarchar(4000),@p1570 nvarchar(4000),@p1571 nvarchar(4000),@p1572 nvarchar(4000),@p1573 nvarchar(4000),@p1574 nvarchar(4000),@p1575 nvarchar(4000),@p1576 nvarchar(4000),@p1577 nvarchar(4000),@p1578 nvarchar(4000),@p1579 datetime2(7),@p1580 nvarchar(4000),@p1581 nvarchar(4000),@p1582 int,@p1583 int,@p1584 int,@p1585 nvarchar(4000),@p1586 nvarchar(4000),@p1587 nvarchar(4000),@p1588 decimal(18,2),@p1589 decimal(18,2),@p1590 nvarchar(4000),@p1591 nvarchar(4000),@p1592 decimal(18,2),@p1593 nvarchar(4000),@p1594 nvarchar(4000),@p1595 nvarchar(4000),@p1596 nvarchar(4000),@p1597 int,@p1598 nvarchar(4000),@p1599 nvarchar(4000),@p1600 nvarchar(4000),@p1601 nvarchar(4000),@p1602 nvarchar(4000),@p1603 nvarchar(4000),@p1604 nvarchar(4000),@p1605 nvarchar(4000),@p1606 nvarchar(4000),@p1607 nvarchar(4000),@p1608 int,@p1609 nvarchar(4000),@p1610 nvarchar(4000),@p1611 nvarchar(4000),@p1612 nvarchar(4000),@p1613 nvarchar(4000),@p1614 int,@p1615 nvarchar(4000),@p1616 int,@p1617 int,@p1618 datetime2(7),@p1619 datetime2(7),@p1620 datetime2(7),@p1621 nvarchar(4000),@p1622 nvarchar(4000),@p1623 nvarchar(4000),@p1624 nvarchar(4000),@p1625 nvarchar(4000),@p1626 nvarchar(4000),@p1627 nvarchar(4000),@p1628 nvarchar(4000),@p1629 nvarchar(4000),@p1630 nvarchar(4000),@p1631 nvarchar(4000),@p1632 nvarchar(4000),@p1633 nvarchar(4000),@p1634 nvarchar(4000),@p1635 datetime2(7),@p1636 nvarchar(4000),@p1637 nvarchar(4000),@p1638 int,@p1639 int,@p1640 int,@p1641 nvarchar(4000),@p1642 nvarchar(4000),@p1643 nvarchar(4000),@p1644 decimal(18,2),@p1645 decimal(18,2),@p1646 nvarchar(4000),@p1647 nvarchar(4000),@p1648 decimal(18,2),@p1649 nvarchar(4000),@p1650 nvarchar(4000),@p1651 nvarchar(4000),@p1652 nvarchar(4000),@p1653 int,@p1654 nvarchar(4000),@p1655 nvarchar(4000),@p1656 nvarchar(4000),@p1657 nvarchar(4000),@p1658 nvarchar(4000),@p1659 nvarchar(4000),@p1660 nvarchar(4000),@p1661 nvarchar(4000),@p1662 nvarchar(4000),@p1663 nvarchar(4000),@p1664 int,@p1665 nvarchar(4000),@p1666 nvarchar(4000),@p1667 nvarchar(4000),@p1668 nvarchar(4000),@p1669 nvarchar(4000),@p1670 int,@p1671 nvarchar(4000),@p1672 int,@p1673 int,@p1674 datetime2(7),@p1675 datetime2(7),@p1676 datetime2(7),@p1677 nvarchar(4000),@p1678 nvarchar(4000),@p1679 nvarchar(4000),@p1680 nvarchar(4000),@p1681 nvarchar(4000),@p1682 nvarchar(4000),@p1683 nvarchar(4000),@p1684 nvarchar(4000),@p1685 nvarchar(4000),@p1686 nvarchar(4000),@p1687 nvarchar(4000),@p1688 nvarchar(4000),@p1689 nvarchar(4000),@p1690 nvarchar(4000),@p1691 datetime2(7),@p1692 nvarchar(4000),@p1693 nvarchar(4000),@p1694 int,@p1695 int,@p1696 int,@p1697 nvarchar(4000),@p1698 nvarchar(4000),@p1699 nvarchar(4000),@p1700 nvarchar(4000),@p1701 decimal(18,2),@p1702 nvarchar(4000),@p1703 nvarchar(4000),@p1704 decimal(18,2),@p1705 nvarchar(4000),@p1706 nvarchar(4000),@p1707 nvarchar(4000),@p1708 nvarchar(4000),@p1709 int,@p1710 nvarchar(4000),@p1711 nvarchar(4000),@p1712 nvarchar(4000),@p1713 nvarchar(4000),@p1714 nvarchar(4000),@p1715 nvarchar(4000),@p1716 nvarchar(4000),@p1717 nvarchar(4000),@p1718 nvarchar(4000),@p1719 nvarchar(4000),@p1720 int,@p1721 nvarchar(4000),@p1722 nvarchar(4000),@p1723 nvarchar(4000),@p1724 nvarchar(4000),@p1725 nvarchar(4000),@p1726 int,@p1727 nvarchar(4000),@p1728 int,@p1729 int,@p1730 datetime2(7),@p1731 datetime2(7),@p1732 datetime2(7),@p1733 nvarchar(4000),@p1734 nvarchar(4000),@p1735 nvarchar(4000),@p1736 nvarchar(4000),@p1737 nvarchar(4000),@p1738 nvarchar(4000),@p1739 nvarchar(4000),@p1740 nvarchar(4000),@p1741 nvarchar(4000),@p1742 nvarchar(4000),@p1743 nvarchar(4000),@p1744 nvarchar(4000),@p1745 nvarchar(4000),@p1746 nvarchar(4000),@p1747 datetime2(7),@p1748 nvarchar(4000),@p1749 nvarchar(4000),@p1750 int,@p1751 int,@p1752 int,@p1753 nvarchar(4000),@p1754 nvarchar(4000),@p1755 nvarchar(4000),@p1756 nvarchar(4000),@p1757 decimal(18,2),@p1758 nvarchar(4000),@p1759 nvarchar(4000),@p1760 decimal(18,2),@p1761 nvarchar(4000),@p1762 nvarchar(4000),@p1763 nvarchar(4000),@p1764 nvarchar(4000),@p1765 int,@p1766 nvarchar(4000),@p1767 nvarchar(4000),@p1768 nvarchar(4000),@p1769 nvarchar(4000),@p1770 nvarchar(4000),@p1771 nvarchar(4000),@p1772 nvarchar(4000),@p1773 nvarchar(4000),@p1774 nvarchar(4000),@p1775 nvarchar(4000),@p1776 int,@p1777 nvarchar(4000),@p1778 nvarchar(4000),@p1779 nvarchar(4000),@p1780 nvarchar(4000),@p1781 nvarchar(4000),@p1782 int,@p1783 nvarchar(4000),@p1784 int,@p1785 int,@p1786 datetime2(7),@p1787 datetime2(7),@p1788 datetime2(7),@p1789 nvarchar(4000),@p1790 nvarchar(4000),@p1791 nvarchar(4000),@p1792 nvarchar(4000),@p1793 nvarchar(4000),@p1794 nvarchar(4000),@p1795 nvarchar(4000),@p1796 nvarchar(4000),@p1797 nvarchar(4000),@p1798 nvarchar(4000),@p1799 nvarchar(4000),@p1800 nvarchar(4000),@p1801 nvarchar(4000),@p1802 nvarchar(4000),@p1803 datetime2(7),@p1804 nvarchar(4000),@p1805 nvarchar(4000),@p1806 int,@p1807 int,@p1808 int,@p1809 nvarchar(4000),@p1810 nvarchar(4000),@p1811 nvarchar(4000),@p1812 nvarchar(4000),@p1813 decimal(18,2),@p1814 nvarchar(4000),@p1815 nvarchar(4000),@p1816 decimal(18,2),@p1817 nvarchar(4000),@p1818 nvarchar(4000),@p1819 nvarchar(4000),@p1820 nvarchar(4000),@p1821 int,@p1822 nvarchar(4000),@p1823 nvarchar(4000),@p1824 nvarchar(4000),@p1825 nvarchar(4000),@p1826 nvarchar(4000),@p1827 nvarchar(4000),@p1828 nvarchar(4000),@p1829 nvarchar(4000),@p1830 nvarchar(4000),@p1831 nvarchar(4000),@p1832 int,@p1833 nvarchar(4000),@p1834 nvarchar(4000),@p1835 nvarchar(4000),@p1836 nvarchar(4000),@p1837 nvarchar(4000),@p1838 int,@p1839 nvarchar(4000),@p1840 int,@p1841 int,@p1842 datetime2(7),@p1843 datetime2(7),@p1844 datetime2(7),@p1845 nvarchar(4000),@p1846 nvarchar(4000),@p1847 nvarchar(4000),@p1848 nvarchar(4000),@p1849 nvarchar(4000),@p1850 nvarchar(4000),@p1851 nvarchar(4000),@p1852 nvarchar(4000),@p1853 nvarchar(4000),@p1854 nvarchar(4000),@p1855 nvarchar(4000),@p1856 nvarchar(4000),@p1857 nvarchar(4000),@p1858 nvarchar(4000),@p1859 datetime2(7),@p1860 nvarchar(4000),@p1861 nvarchar(4000),@p1862 int,@p1863 int,@p1864 int,@p1865 nvarchar(4000),@p1866 nvarchar(4000),@p1867 nvarchar(4000),@p1868 nvarchar(4000),@p1869 decimal(18,2),@p1870 nvarchar(4000),@p1871 nvarchar(4000),@p1872 decimal(18,2),@p1873 nvarchar(4000),@p1874 nvarchar(4000),@p1875 nvarchar(4000),@p1876 nvarchar(4000),@p1877 int,@p1878 nvarchar(4000),@p1879 nvarchar(4000),@p1880 nvarchar(4000),@p1881 nvarchar(4000),@p1882 nvarchar(4000),@p1883 nvarchar(4000),@p1884 nvarchar(4000),@p1885 nvarchar(4000),@p1886 nvarchar(4000),@p1887 nvarchar(4000),@p1888 int,@p1889 nvarchar(4000),@p1890 nvarchar(4000),@p1891 nvarchar(4000),@p1892 nvarchar(4000),@p1893 nvarchar(4000),@p1894 int,@p1895 nvarchar(4000),@p1896 int,@p1897 int,@p1898 datetime2(7),@p1899 datetime2(7),@p1900 datetime2(7),@p1901 nvarchar(4000),@p1902 nvarchar(4000),@p1903 nvarchar(4000),@p1904 nvarchar(4000),@p1905 nvarchar(4000),@p1906 nvarchar(4000),@p1907 nvarchar(4000),@p1908 nvarchar(4000),@p1909 nvarchar(4000),@p1910 nvarchar(4000),@p1911 nvarchar(4000),@p1912 nvarchar(4000),@p1913 nvarchar(4000),@p1914 nvarchar(4000),@p1915 datetime2(7),@p1916 nvarchar(4000),@p1917 nvarchar(4000),@p1918 int,@p1919 int,@p1920 int,@p1921 nvarchar(4000),@p1922 nvarchar(4000),@p1923 nvarchar(4000),@p1924 nvarchar(4000),@p1925 decimal(18,2),@p1926 nvarchar(4000),@p1927 nvarchar(4000),@p1928 decimal(18,2),@p1929 nvarchar(4000),@p1930 nvarchar(4000),@p1931 nvarchar(4000),@p1932 nvarchar(4000),@p1933 int,@p1934 nvarchar(4000),@p1935 nvarchar(4000),@p1936 nvarchar(4000),@p1937 nvarchar(4000),@p1938 nvarchar(4000),@p1939 nvarchar(4000),@p1940 nvarchar(4000),@p1941 nvarchar(4000),@p1942 nvarchar(4000),@p1943 nvarchar(4000),@p1944 int,@p1945 nvarchar(4000),@p1946 nvarchar(4000),@p1947 nvarchar(4000),@p1948 nvarchar(4000),@p1949 nvarchar(4000),@p1950 int,@p1951 nvarchar(4000),@p1952 int,@p1953 int,@p1954 datetime2(7),@p1955 datetime2(7),@p1956 datetime2(7),@p1957 nvarchar(4000),@p1958 nvarchar(4000),@p1959 nvarchar(4000),@p1960 nvarchar(4000),@p1961 nvarchar(4000),@p1962 nvarchar(4000),@p1963 nvarchar(4000),@p1964 nvarchar(4000),@p1965 nvarchar(4000),@p1966 nvarchar(4000),@p1967 nvarchar(4000),@p1968 nvarchar(4000),@p1969 nvarchar(4000),@p1970 nvarchar(4000),@p1971 datetime2(7),@p1972 nvarchar(4000),@p1973 nvarchar(4000),@p1974 int,@p1975 int,@p1976 int,@p1977 nvarchar(4000),@p1978 nvarchar(4000),@p1979 nvarchar(4000),@p1980 nvarchar(4000),@p1981 decimal(18,2),@p1982 nvarchar(4000),@p1983 nvarchar(4000),@p1984 decimal(18,2),@p1985 nvarchar(4000),@p1986 nvarchar(4000),@p1987 nvarchar(4000),@p1988 nvarchar(4000),@p1989 int,@p1990 nvarchar(4000),@p1991 nvarchar(4000),@p1992 nvarchar(4000),@p1993 nvarchar(4000),@p1994 nvarchar(4000),@p1995 nvarchar(4000),@p1996 nvarchar(4000),@p1997 nvarchar(4000),@p1998 nvarchar(4000),@p1999 nvarchar(4000),@p2000 int,@p2001 nvarchar(4000),@p2002 nvarchar(4000),@p2003 nvarchar(4000),@p2004 nvarchar(4000),@p2005 nvarchar(4000),@p2006 int,@p2007 nvarchar(4000),@p2008 int,@p2009 int,@p2010 datetime2(7),@p2011 datetime2(7),@p2012 datetime2(7),@p2013 nvarchar(4000),@p2014 nvarchar(4000),@p2015 nvarchar(4000),@p2016 nvarchar(4000),@p2017 nvarchar(4000),@p2018 nvarchar(4000),@p2019 nvarchar(4000),@p2020 nvarchar(4000),@p2021 nvarchar(4000),@p2022 nvarchar(4000),@p2023 nvarchar(4000),@p2024 nvarchar(4000),@p2025 nvarchar(4000),@p2026 nvarchar(4000),@p2027 datetime2(7),@p2028 nvarchar(4000),@p2029 nvarchar(4000),@p2030 int,@p2031 int,@p2032 int,@p2033 nvarchar(4000),@p2034 nvarchar(4000),@p2035 nvarchar(4000),@p2036 nvarchar(4000),@p2037 decimal(18,2),@p2038 nvarchar(4000),@p2039 nvarchar(4000),@p2040 decimal(18,2),@p2041 nvarchar(4000),@p2042 nvarchar(4000),@p2043 nvarchar(4000),@p2044 nvarchar(4000),@p2045 int,@p2046 nvarchar(4000),@p2047 nvarchar(4000),@p2048 nvarchar(4000),@p2049 nvarchar(4000),@p2050 nvarchar(4000),@p2051 nvarchar(4000),@p2052 nvarchar(4000),@p2053 nvarchar(4000),@p2054 nvarchar(4000),@p2055 nvarchar(4000),@p2056 int,@p2057 nvarchar(4000),@p2058 nvarchar(4000),@p2059 nvarchar(4000),@p2060 nvarchar(4000),@p2061 nvarchar(4000),@p2062 int,@p2063 nvarchar(4000),@p2064 int,@p2065 int,@p2066 datetime2(7),@p2067 datetime2(7),@p2068 datetime2(7),@p2069 nvarchar(4000),@p2070 nvarchar(4000),@p2071 nvarchar(4000))SET NOCOUNT ON; DECLARE @inserted0 TABLE ([item_id] int, [_Position] [int]); MERGE [raw_data] USING ( VALUES (@p0, @p1, @p2, @p3, @p4, @p5, @p6, @p7, @p8, @p9, @p10, @p11, @p12, @p13, @p14, @p15, @p16, @p17, @p18, @p19, @p20, @p21, @p22, @p23, @p24, @p25, @p26, @p27, @p28, @p29, @p30, @p31, @p32, @p33, @p34, @p35, @p36, @p37, @p38, @p39, @p40, @p41, @p42, @p43, @p44, @p45, @p46, @p47, @p48, @p49, @p50, @p51, @p52, @p53, @p54, @p55, 0), (@p56, @p57, @p58, @p59, @p60, @p61, @p62, @p63, @p64, @p65, @p66, @p67, @p68, @p69, @p70, @p71, @p72, @p73, @p74, @p75, @p76, @p77, @p78, @p79, @p80, @p81, @p82, @p83, @p84, @p85, @p86, @p87, @p88, @p89, @p90, @p91, @p92, @p93, @p94, @p95, @p96, @p97, @p98, @p99, @p100, @p101, @p102, @p103, @p104, @p105, @p106, @p107, @p108, @p109, @p110, @p111, 1), (@p112, @p113, @p114, @p115, @p116, @p117, @p118, @p119, @p120, @p121, @p122, @p123, @p124, @p125, @p126, @p127, @p128, @p129, @p130, @p131, @p132, @p133, @p134, @p135, @p136, @p137, @p138, @p139, @p140, @p141, @p142, @p143, @p144, @p145, @p146, @p147, @p148, @p149, @p150, @p151, @p152, @p153, @p154, @p155, @p156, @p157, @p158, @p159, @p160, @p161, @p162, @p163, @p164, @p165, @p166, @p167, 2), (@p168, @p169, @p170, @p171, @p172, @p173, @p174, @p175, @p176, @p177, @p178, @p179, @p180, @p181, @p182, @p183, @p184, @p185, @p186, @p187, @p188, @p189, @p190, @p191, @p192, @p193, @p194, @p195, @p196, @p197, @p198, @p199, @p200, @p201, @p202, @p203, @p204, @p205, @p206, @p207, @p208, @p209, @p210, @p211, @p212, @p213, @p214, @p215, @p216, @p217, @p218, @p219, @p220, @p221, @p222, @p223, 3), (@p224, @p225, @p226, @p227, @p228, @p229, @p230, @p231, @p232, @p233, @p234, @p235, @p236, @p237, @p238, @p239, @p240, @p241, @p242, @p243, @p244, @p245, @p246, @p247, @p248, @p249, @p250, @p251, @p252, @p253, @p254, @p255, @p256, @p257, @p258, @p259, @p260, @p261, @p262, @p263, @p264, @p265, @p266, @p267, @p268, @p269, @p270, @p271, @p272, @p273, @p274, @p275, @p276, @p277, @p278, @p279, 4), (@p280, @p281, @p282, @p283, @p284, @p285, @p286, @p287, @p288, @p289, @p290, @p291, @p292, @p293, @p294, @p295, @p296, @p297, @p298, @p299, @p300, @p301, @p302, @p303, @p304, @p305, @p306, @p307, @p308, @p309, @p310, @p311, @p312, @p313, @p314, @p315, @p316, @p317, @p318, @p319, @p320, @p321, @p322, @p323, @p324, @p325, @p326, @p327, @p328, @p329, @p330, @p331, @p332, @p333, @p334, @p335, 5), (@p336, @p337, @p338, @p339, @p340, @p341, @p342, @p343, @p344, @p345, @p346, @p347, @p348, @p349, @p350, @p351, @p352, @p353, @p354, @p355, @p356, @p357, @p358, @p359, @p360, @p361, @p362, @p363, @p364, @p365, @p366, @p367, @p368, @p369, @p370, @p371, @p372, @p373, @p374, @p375, @p376, @p377, @p378, @p379, @p380, @p381, @p382, @p383, @p384, @p385, @p386, @p387, @p388, @p389, @p390, @p391, 6), (@p392, @p393, @p394, @p395, @p396, @p397, @p398, @p399, @p400, @p401, @p402, @p403, @p404, @p405, @p406, @p407, @p408, @p409, @p410, @p411, @p412, @p413, @p414, @p415, @p416, @p417, @p418, @p419, @p420, @p421, @p422, @p423, @p424, @p425, @p426, @p427, @p428, @p429, @p430, @p431, @p432, @p433, @p434, @p435, @p436, @p437, @p438, @p439, @p440, @p441, @p442, @p443, @p444, @p445, @p446, @p447, 7), (@p448, @p449, @p450, @p451, @p452, @p453, @p454, @p455, @p456, @p457, @p458, @p459, @p460, @p461, @p462, @p463, @p464, @p465, @p466, @p467, @p468, @p469, @p470, @p471, @p472, @p473, @p474, @p475, @p476, @p477, @p478, @p479, @p480, @p481, @p482, @p483, @p484, @p485, @p486, @p487, @p488, @p489, @p490, @p491, @p492, @p493, @p494, @p495, @p496, @p497, @p498, @p499, @p500, @p501, @p502, @p503, 8), (@p504, @p505, @p506, @p507, @p508, @p509, @p510, @p511, @p512, @p513, @p514, @p515, @p516, @p517, @p518, @p519, @p520, @p521, @p522, @p523, @p524, @p525, @p526, @p527, @p528, @p529, @p530, @p531, @p532, @p533, @p534, @p535, @p536, @p537, @p538, @p539, @p540, @p541, @p542, @p543, @p544, @p545, @p546, @p547, @p548, @p549, @p550, @p551, @p552, @p553, @p554, @p555, @p556, @p557, @p558, @p559, 9), (@p560, @p561, @p562, @p563, @p564, @p565, @p566, @p567, @p568, @p569, @p570, @p571, @p572, @p573, @p574, @p575, @p576, @p577, @p578, @p579, @p580, @p581, @p582, @p583, @p584, @p585, @p586, @p587, @p588, @p589, @p590, @p591, @p592, @p593, @p594, @p595, @p596, @p597, @p598, @p599, @p600, @p601, @p602, @p603, @p604, @p605, @p606, @p607, @p608, @p609, @p610, @p611, @p612, @p613, @p614, @p615, 10), (@p616, @p617, @p618, @p619, @p620, @p621, @p622, @p623, @p624, @p625, @p626, @p627, @p628, @p629, @p630, @p631, @p632, @p633, @p634, @p635, @p636, @p637, @p638, @p639, @p640, @p641, @p642, @p643, @p644, @p645, @p646, @p647, @p648, @p649, @p650, @p651, @p652, @p653, @p654, @p655, @p656, @p657, @p658, @p659, @p660, @p661, @p662, @p663, @p664, @p665, @p666, @p667, @p668, @p669, @p670, @p671, 11), (@p672, @p673, @p674, @p675, @p676, @p677, @p678, @p679, @p680, @p681, @p682, @p683, @p684, @p685, @p686, @p687, @p688, @p689, @p690, @p691, @p692, @p693, @p694, @p695, @p696, @p697, @p698, @p699, @p700, @p701, @p702, @p703, @p704, @p705, @p706, @p707, @p708, @p709, @p710, @p711, @p712, @p713, @p714, @p715, @p716, @p717, @p718, @p719, @p720, @p721, @p722, @p723, @p724, @p725, @p726, @p727, 12), (@p728, @p729, @p730, @p731, @p732, @p733, @p734, @p735, @p736, @p737, @p738, @p739, @p740, @p741, @p742, @p743, @p744, @p745, @p746, @p747, @p748, @p749, @p750, @p751, @p752, @p753, @p754, @p755, @p756, @p757, @p758, @p759, @p760, @p761, @p762, @p763, @p764, @p765, @p766, @p767, @p768, @p769, @p770, @p771, @p772, @p773, @p774, @p775, @p776, @p777, @p778, @p779, @p780, @p781, @p782, @p783, 13), (@p784, @p785, @p786, @p787, @p788, @p789, @p790, @p791, @p792, @p793, @p794, @p795, @p796, @p797, @p798, @p799, @p800, @p801, @p802, @p803, @p804, @p805, @p806, @p807, @p808, @p809, @p810, @p811, @p812, @p813, @p814, @p815, @p816, @p817, @p818, @p819, @p820, @p821, @p822, @p823, @p824, @p825, @p826, @p827, @p828, @p829, @p830, @p831, @p832, @p833, @p834, @p835, @p836, @p837, @p838, @p839, 14), (@p840, @p841, @p842, @p843, @p844, @p845, @p846, @p847, @p848, @p849, @p850, @p851, @p852, @p853, @p854, @p855, @p856, @p857, @p858, @p859, @p860, @p861, @p862, @p863, @p864, @p865, @p866, @p867, @p868, @p869, @p870, @p871, @p872, @p873, @p874, @p875, @p876, @p877, @p878, @p879, @p880, @p881, @p882, @p883, @p884, @p885, @p886, @p887, @p888, @p889, @p890, @p891, @p892, @p893, @p894, @p895, 15), (@p896, @p897, @p898, @p899, @p900, @p901, @p902, @p903, @p904, @p905, @p906, @p907, @p908, @p909, @p910, @p911, @p912, @p913, @p914, @p915, @p916, @p917, @p918, @p919, @p920, @p921, @p922, @p923, @p924, @p925, @p926, @p927, @p928, @p929, @p930, @p931, @p932, @p933, @p934, @p935, @p936, @p937, @p938, @p939, @p940, @p941, @p942, @p943, @p944, @p945, @p946, @p947, @p948, @p949, @p950, @p951, 16), (@p952, @p953, @p954, @p955, @p956, @p957, @p958, @p959, @p960, @p961, @p962, @p963, @p964, @p965, @p966, @p967, @p968, @p969, @p970, @p971, @p972, @p973, @p974, @p975, @p976, @p977, @p978, @p979, @p980, @p981, @p982, @p983, @p984, @p985, @p986, @p987, @p988, @p989, @p990, @p991, @p992, @p993, @p994, @p995, @p996, @p997, @p998, @p999, @p1000, @p1001, @p1002, @p1003, @p1004, @p1005, @p1006, @p1007, 17), (@p1008, @p1009, @p1010, @p1011, @p1012, @p1013, @p1014, @p1015, @p1016, @p1017, @p1018, @p1019, @p1020, @p1021, @p1022, @p1023, @p1024, @p1025, @p1026, @p1027, @p1028, @p1029, @p1030, @p1031, @p1032, @p1033, @p1034, @p1035, @p1036, @p1037, @p1038, @p1039, @p1040, @p1041, @p1042, @p1043, @p1044, @p1045, @p1046, @p1047, @p1048, @p1049, @p1050, @p1051, @p1052, @p1053, @p1054, @p1055, @p1056, @p1057, @p1058, @p1059, @p1060, @p1061, @p1062, @p1063, 18), (@p1064, @p1065, @p1066, @p1067, @p1068, @p1069, @p1070, @p1071, @p1072, @p1073, @p1074, @p1075, @p1076, @p1077, @p1078, @p1079, @p1080, @p1081, @p1082, @p1083, @p1084, @p1085, @p1086, @p1087, @p1088, @p1089, @p1090, @p1091, @p1092, @p1093, @p1094, @p1095, @p1096, @p1097, @p1098, @p1099, @p1100, @p1101, @p1102, @p1103, @p1104, @p1105, @p1106, @p1107, @p1108, @p1109, @p1110, @p1111, @p1112, @p1113, @p1114, @p1115, @p1116, @p1117, @p1118, @p1119, 19), (@p1120, @p1121, @p1122, @p1123, @p1124, @p1125, @p1126, @p1127, @p1128, @p1129, @p1130, @p1131, @p1132, @p1133, @p1134, @p1135, @p1136, @p1137, @p1138, @p1139, @p1140, @p1141, @p1142, @p1143, @p1144, @p1145, @p1146, @p1147, @p1148, @p1149, @p1150, @p1151, @p1152, @p1153, @p1154, @p1155, @p1156, @p1157, @p1158, @p1159, @p1160, @p1161, @p1162, @p1163, @p1164, @p1165, @p1166, @p1167, @p1168, @p1169, @p1170, @p1171, @p1172, @p1173, @p1174, @p1175, 20), (@p1176, @p1177, @p1178, @p1179, @p1180, @p1181, @p1182, @p1183, @p1184, @p1185, @p1186, @p1187, @p1188, @p1189, @p1190, @p1191, @p1192, @p1193, @p1194, @p1195, @p1196, @p1197, @p1198, @p1199, @p1200, @p1201, @p1202, @p1203, @p1204, @p1205, @p1206, @p1207, @p1208, @p1209, @p1210, @p1211, @p1212, @p1213, @p1214, @p1215, @p1216, @p1217, @p1218, @p1219, @p1220, @p1221, @p1222, @p1223, @p1224, @p1225, @p1226, @p1227, @p1228, @p1229, @p1230, @p1231, 21), (@p1232, @p1233, @p1234, @p1235, @p1236, @p1237, @p1238, @p1239, @p1240, @p1241, @p1242, @p1243, @p1244, @p1245, @p1246, @p1247, @p1248, @p1249, @p1250, @p1251, @p1252, @p1253, @p1254, @p1255, @p1256, @p1257, @p1258, @p1259, @p1260, @p1261, @p1262, @p1263, @p1264, @p1265, @p1266, @p1267, @p1268, @p1269, @p1270, @p1271, @p1272, @p1273, @p1274, @p1275, @p1276, @p1277, @p1278, @p1279, @p1280, @p1281, @p1282, @p1283, @p1284, @p1285, @p1286, @p1287, 22), (@p1288, @p1289, @p1290, @p1291, @p1292, @p1293, @p1294, @p1295, @p1296, @p1297, @p1298, @p1299, @p1300, @p1301, @p1302, @p1303, @p1304, @p1305, @p1306, @p1307, @p1308, @p1309, @p1310, @p1311, @p1312, @p1313, @p1314, @p1315, @p1316, @p1317, @p1318, @p1319, @p1320, @p1321, @p1322, @p1323, @p1324, @p1325, @p1326, @p1327, @p1328, @p1329, @p1330, @p1331, @p1332, @p1333, @p1334, @p1335, @p1336, @p1337, @p1338, @p1339, @p1340, @p1341, @p1342, @p1343, 23), (@p1344, @p1345, @p1346, @p1347, @p1348, @p1349, @p1350, @p1351, @p1352, @p1353, @p1354, @p1355, @p1356, @p1357, @p1358, @p1359, @p1360, @p1361, @p1362, @p1363, @p1364, @p1365, @p1366, @p1367, @p1368, @p1369, @p1370, @p1371, @p1372, @p1373, @p1374, @p1375, @p1376, @p1377, @p1378, @p1379, @p1380, @p1381, @p1382, @p1383, @p1384, @p1385, @p1386, @p1387, @p1388, @p1389, @p1390, @p1391, @p1392, @p1393, @p1394, @p1395, @p1396, @p1397, @p1398, @p1399, 24), (@p1400, @p1401, @p1402, @p1403, @p1404, @p1405, @p1406, @p1407, @p1408, @p1409, @p1410, @p1411, @p1412, @p1413, @p1414, @p1415, @p1416, @p1417, @p1418, @p1419, @p1420, @p1421, @p1422, @p1423, @p1424, @p1425, @p1426, @p1427, @p1428, @p1429, @p1430, @p1431, @p1432, @p1433, @p1434, @p1435, @p1436, @p1437, @p1438, @p1439, @p1440, @p1441, @p1442, @p1443, @p1444, @p1445, @p1446, @p1447, @p1448, @p1449, @p1450, @p1451, @p1452, @p1453, @p1454, @p1455, 25), (@p1456, @p1457, @p1458, @p1459, @p1460, @p1461, @p1462, @p1463, @p1464, @p1465, @p1466, @p1467, @p1468, @p1469, @p1470, @p1471, @p1472, @p1473, @p1474, @p1475, @p1476, @p1477, @p1478, @p1479, @p1480, @p1481, @p1482, @p1483, @p1484, @p1485, @p1486, @p1487, @p1488, @p1489, @p1490, @p1491, @p1492, @p1493, @p1494, @p1495, @p1496, @p1497, @p1498, @p1499, @p1500, @p1501, @p1502, @p1503, @p1504, @p1505, @p1506, @p1507, @p1508, @p1509, @p1510, @p1511, 26), (@p1512, @p1513, @p1514, @p1515, @p1516, @p1517, @p1518, @p1519, @p1520, @p1521, @p1522, @p1523, @p1524, @p1525, @p1526, @p1527, @p1528, @p1529, @p1530, @p1531, @p1532, @p1533, @p1534, @p1535, @p1536, @p1537, @p1538, @p1539, @p1540, @p1541, @p1542, @p1543, @p1544, @p1545, @p1546, @p1547, @p1548, @p1549, @p1550, @p1551, @p1552, @p1553, @p1554, @p1555, @p1556, @p1557, @p1558, @p1559, @p1560, @p1561, @p1562, @p1563, @p1564, @p1565, @p1566, @p1567, 27), (@p1568, @p1569, @p1570, @p1571, @p1572, @p1573, @p1574, @p1575, @p1576, @p1577, @p1578, @p1579, @p1580, @p1581, @p1582, @p1583, @p1584, @p1585, @p1586, @p1587, @p1588, @p1589, @p1590, @p1591, @p1592, @p1593, @p1594, @p1595, @p1596, @p1597, @p1598, @p1599, @p1600, @p1601, @p1602, @p1603, @p1604, @p1605, @p1606, @p1607, @p1608, @p1609, @p1610, @p1611, @p1612, @p1613, @p1614, @p1615, @p1616, @p1617, @p1618, @p1619, @p1620, @p1621, @p1622, @p1623, 28), (@p1624, @p1625, @p1626, @p1627, @p1628, @p1629, @p1630, @p1631, @p1632, @p1633, @p1634, @p1635, @p1636, @p1637, @p1638, @p1639, @p1640, @p1641, @p1642, @p1643, @p1644, @p1645, @p1646, @p1647, @p1648, @p1649, @p1650, @p1651, @p1652, @p1653, @p1654, @p1655, @p1656, @p1657, @p1658, @p1659, @p1660, @p1661, @p1662, @p1663, @p1664, @p1665, @p1666, @p1667, @p1668, @p1669, @p1670, @p1671, @p1672, @p1673, @p1674, @p1675, @p1676, @p1677, @p1678, @p1679, 29), (@p1680, @p1681, @p1682, @p1683, @p1684, @p1685, @p1686, @p1687, @p1688, @p1689, @p1690, @p1691, @p1692, @p1693, @p1694, @p1695, @p1696, @p1697, @p1698, @p1699, @p1700, @p1701, @p1702, @p1703, @p1704, @p1705, @p1706, @p1707, @p1708, @p1709, @p1710, @p1711, @p1712, @p1713, @p1714, @p1715, @p1716, @p1717, @p1718, @p1719, @p1720, @p1721, @p1722, @p1723, @p1724, @p1725, @p1726, @p1727, @p1728, @p1729, @p1730, @p1731, @p1732, @p1733, @p1734, @p1735, 30), (@p1736, @p1737, @p1738, @p1739, @p1740, @p1741, @p1742, @p1743, @p1744, @p1745, @p1746, @p1747, @p1748, @p1749, @p1750, @p1751, @p1752, @p1753, @p1754, @p1755, @p1756, @p1757, @p1758, @p1759, @p1760, @p1761, @p1762, @p1763, @p1764, @p1765, @p1766, @p1767, @p1768, @p1769, @p1770, @p1771, @p1772, @p1773, @p1774, @p1775, @p1776, @p1777, @p1778, @p1779, @p1780, @p1781, @p1782, @p1783, @p1784, @p1785, @p1786, @p1787, @p1788, @p1789, @p1790, @p1791, 31), (@p1792, @p1793, @p1794, @p1795, @p1796, @p1797, @p1798, @p1799, @p1800, @p1801, @p1802, @p1803, @p1804, @p1805, @p1806, @p1807, @p1808, @p1809, @p1810, @p1811, @p1812, @p1813, @p1814, @p1815, @p1816, @p1817, @p1818, @p1819, @p1820, @p1821, @p1822, @p1823, @p1824, @p1825, @p1826, @p1827, @p1828, @p1829, @p1830, @p1831, @p1832, @p1833, @p1834, @p1835, @p1836, @p1837, @p1838, @p1839, @p1840, @p1841, @p1842, @p1843, @p1844, @p1845, @p1846, @p1847, 32), (@p1848, @p1849, @p1850, @p1851, @p1852, @p1853, @p1854, @p1855, @p1856, @p1857, @p1858, @p1859, @p1860, @p1861, @p1862, @p1863, @p1864, @p1865, @p1866, @p1867, @p1868, @p1869, @p1870, @p1871, @p1872, @p1873, @p1874, @p1875, @p1876, @p1877, @p1878, @p1879, @p1880, @p1881, @p1882, @p1883, @p1884, @p1885, @p1886, @p1887, @p1888, @p1889, @p1890, @p1891, @p1892, @p1893, @p1894, @p1895, @p1896, @p1897, @p1898, @p1899, @p1900, @p1901, @p1902, @p1903, 33), (@p1904, @p1905, @p1906, @p1907, @p1908, @p1909, @p1910, @p1911, @p1912, @p1913, @p1914, @p1915, @p1916, @p1917, @p1918, @p1919, @p1920, @p1921, @p1922, @p1923, @p1924, @p1925, @p1926, @p1927, @p1928, @p1929, @p1930, @p1931, @p1932, @p1933, @p1934, @p1935, @p1936, @p1937, @p1938, @p1939, @p1940, @p1941, @p1942, @p1943, @p1944, @p1945, @p1946, @p1947, @p1948, @p1949, @p1950, @p1951, @p1952, @p1953, @p1954, @p1955, @p1956, @p1957, @p1958, @p1959, 34), (@p1960, @p1961, @p1962, @p1963, @p1964, @p1965, @p1966, @p1967, @p1968, @p1969, @p1970, @p1971, @p1972, @p1973, @p1974, @p1975, @p1976, @p1977, @p1978, @p1979, @p1980, @p1981, @p1982, @p1983, @p1984, @p1985, @p1986, @p1987, @p1988, @p1989, @p1990, @p1991, @p1992, @p1993, @p1994, @p1995, @p1996, @p1997, @p1998, @p1999, @p2000, @p2001, @p2002, @p2003, @p2004, @p2005, @p2006, @p2007, @p2008, @p2009, @p2010, @p2011, @p2012, @p2013, @p2014, @p2015, 35), (@p2016, @p2017, @p2018, @p2019, @p2020, @p2021, @p2022, @p2023, @p2024, @p2025, @p2026, @p2027, @p2028, @p2029, @p2030, @p2031, @p2032, @p2033, @p2034, @p2035, @p2036, @p2037, @p2038, @p2039, @p2040, @p2041, @p2042, @p2043, @p2044, @p2045, @p2046, @p2047, @p2048, @p2049, @p2050, @p2051, @p2052, @p2053, @p2054, @p2055, @p2056, @p2057, @p2058, @p2059, @p2060, @p2061, @p2062, @p2063, @p2064, @p2065, @p2066, @p2067, @p2068, @p2069, @p2070, @p2071, 36)) AS i ([addressee_cntry_cd], [addressee_city], [addressee_district], [addressee_email], [addressee_full_address], [addressee_home_address], [addressee_name], [addressee_postcode], [addressee_province], [addressee_subdistrict], [addressee_tel], [create_table], [delivery_code], [delivery_recipient_name], [delivery_relation_id], [delivery_status_id], [dest_outlet_id], [dest_outlet_port], [document_number], [item_barcode], [item_cod], [item_gross_weight], [item_height], [item_length], [item_price], [item_width], [lat], [log_id], [long], [outlet_id], [outlet_port], [podUrl], [remark], [scan_cntry_cd], [scan_cntry_postcode], [sender_cntry_cd], [sender_district], [sender_email], [sender_full_address], [sender_home_address], [member_id], [sender_name], [sender_postcode], [sender_province], [sender_subdistrict], [sender_tel], [server_id], [signatureUrl], [state], [status_code], [status_dtm], [timestamp], [transmit_dtm], [user_id], [wckt_id], [wkstn_no], _Position) ON 1=0 WHEN NOT MATCHED THEN INSERT ([addressee_cntry_cd], [addressee_city], [addressee_district], [addressee_email], [addressee_full_address], [addressee_home_address], [addressee_name], [addressee_postcode], [addressee_province], [addressee_subdistrict], [addressee_tel], [create_table], [delivery_code], [delivery_recipient_name], [delivery_relation_id], [delivery_status_id], [dest_outlet_id], [dest_outlet_port], [document_number], [item_barcode], [item_cod], [item_gross_weight], [item_height], [item_length], [item_price], [item_width], [lat], [log_id], [long], [outlet_id], [outlet_port], [podUrl], [remark], [scan_cntry_cd], [scan_cntry_postcode], [sender_cntry_cd], [sender_district], [sender_email], [sender_full_address], [sender_home_address], [member_id], [sender_name], [sender_postcode], [sender_province], [sender_subdistrict], [sender_tel], [server_id], [signatureUrl], [state], [status_code], [status_dtm], [timestamp], [transmit_dtm], [user_id], [wckt_id], [wkstn_no]) VALUES (i.[addressee_cntry_cd], i.[addressee_city], i.[addressee_district], i.[addressee_email], i.[addressee_full_address], i.[addressee_home_address], i.[addressee_name], i.[addressee_postcode], i.[addressee_province], i.[addressee_subdistrict], i.[addressee_tel], i.[create_table], i.[delivery_code], i.[delivery_recipient_name], i.[delivery_relation_id], i.[delivery_status_id], i.[dest_outlet_id], i.[dest_outlet_port], i.[document_number], i.[item_barcode], i.[item_cod], i.[item_gross_weight], i.[item_height], i.[item_length], i.[item_price], i.[item_width], i.[lat], i.[log_id], i.[long], i.[outlet_id], i.[outlet_port], i.[podUrl], i.[remark], i.[scan_cntry_cd], i.[scan_cntry_postcode], i.[sender_cntry_cd], i.[sender_district], i.[sender_email], i.[sender_full_address], i.[sender_home_address], i.[member_id], i.[sender_name], i.[sender_postcode], i.[sender_province], i.[sender_subdistrict], i.[sender_tel], i.[server_id], i.[signatureUrl], i.[state], i.[status_code], i.[status_dtm], i.[timestamp], i.[transmit_dtm], i.[user_id], i.[wckt_id], i.[wkstn_no]) OUTPUT INSERTED.[item_id], i._Position INTO @inserted0;  SELECT [t].[item_id] FROM [raw_data] t INNER JOIN @inserted0 i ON ([t].[item_id] = [i].[item_id]) ORDER BY [i].[_Position];  ",4,4,0,447,11,4
"(@p0 nvarchar(4000),@p1 nvarchar(4000),@p2 nvarchar(4000),@p3 nvarchar(4000),@p4 nvarchar(4000),@p5 nvarchar(4000),@p6 nvarchar(4000),@p7 nvarchar(4000),@p8 nvarchar(4000),@p9 nvarchar(4000),@p10 nvarchar(4000),@p11 datetime2(7),@p12 nvarchar(4000),@p13 nvarchar(4000),@p14 int,@p15 int,@p16 int,@p17 nvarchar(4000),@p18 nvarchar(4000),@p19 nvarchar(4000),@p20 decimal(18,2),@p21 decimal(18,2),@p22 nvarchar(4000),@p23 nvarchar(4000),@p24 decimal(18,2),@p25 nvarchar(4000),@p26 nvarchar(4000),@p27 nvarchar(4000),@p28 nvarchar(4000),@p29 int,@p30 nvarchar(4000),@p31 nvarchar(4000),@p32 nvarchar(4000),@p33 nvarchar(4000),@p34 nvarchar(4000),@p35 nvarchar(4000),@p36 nvarchar(4000),@p37 nvarchar(4000),@p38 nvarchar(4000),@p39 nvarchar(4000),@p40 int,@p41 nvarchar(4000),@p42 nvarchar(4000),@p43 nvarchar(4000),@p44 nvarchar(4000),@p45 nvarchar(4000),@p46 int,@p47 nvarchar(4000),@p48 int,@p49 int,@p50 datetime2(7),@p51 datetime2(7),@p52 datetime2(7),@p53 nvarchar(4000),@p54 nvarchar(4000),@p55 nvarchar(4000),@p56 nvarchar(4000),@p57 nvarchar(4000),@p58 nvarchar(4000),@p59 nvarchar(4000),@p60 nvarchar(4000),@p61 nvarchar(4000),@p62 nvarchar(4000),@p63 nvarchar(4000),@p64 nvarchar(4000),@p65 nvarchar(4000),@p66 nvarchar(4000),@p67 datetime2(7),@p68 nvarchar(4000),@p69 nvarchar(4000),@p70 int,@p71 int,@p72 int,@p73 nvarchar(4000),@p74 nvarchar(4000),@p75 nvarchar(4000),@p76 decimal(18,2),@p77 decimal(18,2),@p78 nvarchar(4000),@p79 nvarchar(4000),@p80 decimal(18,2),@p81 nvarchar(4000),@p82 nvarchar(4000),@p83 nvarchar(4000),@p84 nvarchar(4000),@p85 int,@p86 nvarchar(4000),@p87 nvarchar(4000),@p88 nvarchar(4000),@p89 nvarchar(4000),@p90 nvarchar(4000),@p91 nvarchar(4000),@p92 nvarchar(4000),@p93 nvarchar(4000),@p94 nvarchar(4000),@p95 nvarchar(4000),@p96 int,@p97 nvarchar(4000),@p98 nvarchar(4000),@p99 nvarchar(4000),@p100 nvarchar(4000),@p101 nvarchar(4000),@p102 int,@p103 nvarchar(4000),@p104 int,@p105 int,@p106 datetime2(7),@p107 datetime2(7),@p108 datetime2(7),@p109 nvarchar(4000),@p110 nvarchar(4000),@p111 nvarchar(4000),@p112 nvarchar(4000),@p113 nvarchar(4000),@p114 nvarchar(4000),@p115 nvarchar(4000),@p116 nvarchar(4000),@p117 nvarchar(4000),@p118 nvarchar(4000),@p119 nvarchar(4000),@p120 nvarchar(4000),@p121 nvarchar(4000),@p122 nvarchar(4000),@p123 datetime2(7),@p124 nvarchar(4000),@p125 nvarchar(4000),@p126 int,@p127 int,@p128 int,@p129 nvarchar(4000),@p130 nvarchar(4000),@p131 nvarchar(4000),@p132 decimal(18,2),@p133 decimal(18,2),@p134 nvarchar(4000),@p135 nvarchar(4000),@p136 decimal(18,2),@p137 nvarchar(4000),@p138 nvarchar(4000),@p139 nvarchar(4000),@p140 nvarchar(4000),@p141 int,@p142 nvarchar(4000),@p143 nvarchar(4000),@p144 nvarchar(4000),@p145 nvarchar(4000),@p146 nvarchar(4000),@p147 nvarchar(4000),@p148 nvarchar(4000),@p149 nvarchar(4000),@p150 nvarchar(4000),@p151 nvarchar(4000),@p152 int,@p153 nvarchar(4000),@p154 nvarchar(4000),@p155 nvarchar(4000),@p156 nvarchar(4000),@p157 nvarchar(4000),@p158 int,@p159 nvarchar(4000),@p160 int,@p161 int,@p162 datetime2(7),@p163 datetime2(7),@p164 datetime2(7),@p165 nvarchar(4000),@p166 nvarchar(4000),@p167 nvarchar(4000),@p168 nvarchar(4000),@p169 nvarchar(4000),@p170 nvarchar(4000),@p171 nvarchar(4000),@p172 nvarchar(4000),@p173 nvarchar(4000),@p174 nvarchar(4000),@p175 nvarchar(4000),@p176 nvarchar(4000),@p177 nvarchar(4000),@p178 nvarchar(4000),@p179 datetime2(7),@p180 nvarchar(4000),@p181 nvarchar(4000),@p182 int,@p183 int,@p184 int,@p185 nvarchar(4000),@p186 nvarchar(4000),@p187 nvarchar(4000),@p188 decimal(18,2),@p189 decimal(18,2),@p190 nvarchar(4000),@p191 nvarchar(4000),@p192 decimal(18,2),@p193 nvarchar(4000),@p194 nvarchar(4000),@p195 nvarchar(4000),@p196 nvarchar(4000),@p197 int,@p198 nvarchar(4000),@p199 nvarchar(4000),@p200 nvarchar(4000),@p201 nvarchar(4000),@p202 nvarchar(4000),@p203 nvarchar(4000),@p204 nvarchar(4000),@p205 nvarchar(4000),@p206 nvarchar(4000),@p207 nvarchar(4000),@p208 int,@p209 nvarchar(4000),@p210 nvarchar(4000),@p211 nvarchar(4000),@p212 nvarchar(4000),@p213 nvarchar(4000),@p214 int,@p215 nvarchar(4000),@p216 int,@p217 int,@p218 datetime2(7),@p219 datetime2(7),@p220 datetime2(7),@p221 nvarchar(4000),@p222 nvarchar(4000),@p223 nvarchar(4000),@p224 nvarchar(4000),@p225 nvarchar(4000),@p226 nvarchar(4000),@p227 nvarchar(4000),@p228 nvarchar(4000),@p229 nvarchar(4000),@p230 nvarchar(4000),@p231 nvarchar(4000),@p232 nvarchar(4000),@p233 nvarchar(4000),@p234 nvarchar(4000),@p235 datetime2(7),@p236 nvarchar(4000),@p237 nvarchar(4000),@p238 int,@p239 int,@p240 int,@p241 nvarchar(4000),@p242 nvarchar(4000),@p243 nvarchar(4000),@p244 decimal(18,2),@p245 decimal(18,2),@p246 nvarchar(4000),@p247 nvarchar(4000),@p248 decimal(18,2),@p249 nvarchar(4000),@p250 nvarchar(4000),@p251 nvarchar(4000),@p252 nvarchar(4000),@p253 int,@p254 nvarchar(4000),@p255 nvarchar(4000),@p256 nvarchar(4000),@p257 nvarchar(4000),@p258 nvarchar(4000),@p259 nvarchar(4000),@p260 nvarchar(4000),@p261 nvarchar(4000),@p262 nvarchar(4000),@p263 nvarchar(4000),@p264 int,@p265 nvarchar(4000),@p266 nvarchar(4000),@p267 nvarchar(4000),@p268 nvarchar(4000),@p269 nvarchar(4000),@p270 int,@p271 nvarchar(4000),@p272 int,@p273 int,@p274 datetime2(7),@p275 datetime2(7),@p276 datetime2(7),@p277 nvarchar(4000),@p278 nvarchar(4000),@p279 nvarchar(4000),@p280 nvarchar(4000),@p281 nvarchar(4000),@p282 nvarchar(4000),@p283 nvarchar(4000),@p284 nvarchar(4000),@p285 nvarchar(4000),@p286 nvarchar(4000),@p287 nvarchar(4000),@p288 nvarchar(4000),@p289 nvarchar(4000),@p290 nvarchar(4000),@p291 datetime2(7),@p292 nvarchar(4000),@p293 nvarchar(4000),@p294 int,@p295 int,@p296 int,@p297 nvarchar(4000),@p298 nvarchar(4000),@p299 nvarchar(4000),@p300 decimal(18,2),@p301 decimal(18,2),@p302 nvarchar(4000),@p303 nvarchar(4000),@p304 decimal(18,2),@p305 nvarchar(4000),@p306 nvarchar(4000),@p307 nvarchar(4000),@p308 nvarchar(4000),@p309 int,@p310 nvarchar(4000),@p311 nvarchar(4000),@p312 nvarchar(4000),@p313 nvarchar(4000),@p314 nvarchar(4000),@p315 nvarchar(4000),@p316 nvarchar(4000),@p317 nvarchar(4000),@p318 nvarchar(4000),@p319 nvarchar(4000),@p320 int,@p321 nvarchar(4000),@p322 nvarchar(4000),@p323 nvarchar(4000),@p324 nvarchar(4000),@p325 nvarchar(4000),@p326 int,@p327 nvarchar(4000),@p328 int,@p329 int,@p330 datetime2(7),@p331 datetime2(7),@p332 datetime2(7),@p333 nvarchar(4000),@p334 nvarchar(4000),@p335 nvarchar(4000),@p336 nvarchar(4000),@p337 nvarchar(4000),@p338 nvarchar(4000),@p339 nvarchar(4000),@p340 nvarchar(4000),@p341 nvarchar(4000),@p342 nvarchar(4000),@p343 nvarchar(4000),@p344 nvarchar(4000),@p345 nvarchar(4000),@p346 nvarchar(4000),@p347 datetime2(7),@p348 nvarchar(4000),@p349 nvarchar(4000),@p350 int,@p351 int,@p352 int,@p353 nvarchar(4000),@p354 nvarchar(4000),@p355 nvarchar(4000),@p356 decimal(18,2),@p357 decimal(18,2),@p358 nvarchar(4000),@p359 nvarchar(4000),@p360 decimal(18,2),@p361 nvarchar(4000),@p362 nvarchar(4000),@p363 nvarchar(4000),@p364 nvarchar(4000),@p365 int,@p366 nvarchar(4000),@p367 nvarchar(4000),@p368 nvarchar(4000),@p369 nvarchar(4000),@p370 nvarchar(4000),@p371 nvarchar(4000),@p372 nvarchar(4000),@p373 nvarchar(4000),@p374 nvarchar(4000),@p375 nvarchar(4000),@p376 int,@p377 nvarchar(4000),@p378 nvarchar(4000),@p379 nvarchar(4000),@p380 nvarchar(4000),@p381 nvarchar(4000),@p382 int,@p383 nvarchar(4000),@p384 int,@p385 int,@p386 datetime2(7),@p387 datetime2(7),@p388 datetime2(7),@p389 nvarchar(4000),@p390 nvarchar(4000),@p391 nvarchar(4000),@p392 nvarchar(4000),@p393 nvarchar(4000),@p394 nvarchar(4000),@p395 nvarchar(4000),@p396 nvarchar(4000),@p397 nvarchar(4000),@p398 nvarchar(4000),@p399 nvarchar(4000),@p400 nvarchar(4000),@p401 nvarchar(4000),@p402 nvarchar(4000),@p403 datetime2(7),@p404 nvarchar(4000),@p405 nvarchar(4000),@p406 int,@p407 int,@p408 int,@p409 nvarchar(4000),@p410 nvarchar(4000),@p411 nvarchar(4000),@p412 decimal(18,2),@p413 decimal(18,2),@p414 nvarchar(4000),@p415 nvarchar(4000),@p416 decimal(18,2),@p417 nvarchar(4000),@p418 nvarchar(4000),@p419 nvarchar(4000),@p420 nvarchar(4000),@p421 int,@p422 nvarchar(4000),@p423 nvarchar(4000),@p424 nvarchar(4000),@p425 nvarchar(4000),@p426 nvarchar(4000),@p427 nvarchar(4000),@p428 nvarchar(4000),@p429 nvarchar(4000),@p430 nvarchar(4000),@p431 nvarchar(4000),@p432 int,@p433 nvarchar(4000),@p434 nvarchar(4000),@p435 nvarchar(4000),@p436 nvarchar(4000),@p437 nvarchar(4000),@p438 int,@p439 nvarchar(4000),@p440 int,@p441 int,@p442 datetime2(7),@p443 datetime2(7),@p444 datetime2(7),@p445 nvarchar(4000),@p446 nvarchar(4000),@p447 nvarchar(4000),@p448 nvarchar(4000),@p449 nvarchar(4000),@p450 nvarchar(4000),@p451 nvarchar(4000),@p452 nvarchar(4000),@p453 nvarchar(4000),@p454 nvarchar(4000),@p455 nvarchar(4000),@p456 nvarchar(4000),@p457 nvarchar(4000),@p458 nvarchar(4000),@p459 datetime2(7),@p460 nvarchar(4000),@p461 nvarchar(4000),@p462 int,@p463 int,@p464 int,@p465 nvarchar(4000),@p466 nvarchar(4000),@p467 nvarchar(4000),@p468 decimal(18,2),@p469 decimal(18,2),@p470 nvarchar(4000),@p471 nvarchar(4000),@p472 decimal(18,2),@p473 nvarchar(4000),@p474 nvarchar(4000),@p475 nvarchar(4000),@p476 nvarchar(4000),@p477 int,@p478 nvarchar(4000),@p479 nvarchar(4000),@p480 nvarchar(4000),@p481 nvarchar(4000),@p482 nvarchar(4000),@p483 nvarchar(4000),@p484 nvarchar(4000),@p485 nvarchar(4000),@p486 nvarchar(4000),@p487 nvarchar(4000),@p488 int,@p489 nvarchar(4000),@p490 nvarchar(4000),@p491 nvarchar(4000),@p492 nvarchar(4000),@p493 nvarchar(4000),@p494 int,@p495 nvarchar(4000),@p496 int,@p497 int,@p498 datetime2(7),@p499 datetime2(7),@p500 datetime2(7),@p501 nvarchar(4000),@p502 nvarchar(4000),@p503 nvarchar(4000),@p504 nvarchar(4000),@p505 nvarchar(4000),@p506 nvarchar(4000),@p507 nvarchar(4000),@p508 nvarchar(4000),@p509 nvarchar(4000),@p510 nvarchar(4000),@p511 nvarchar(4000),@p512 nvarchar(4000),@p513 nvarchar(4000),@p514 nvarchar(4000),@p515 datetime2(7),@p516 nvarchar(4000),@p517 nvarchar(4000),@p518 int,@p519 int,@p520 int,@p521 nvarchar(4000),@p522 nvarchar(4000),@p523 nvarchar(4000),@p524 decimal(18,2),@p525 decimal(18,2),@p526 nvarchar(4000),@p527 nvarchar(4000),@p528 decimal(18,2),@p529 nvarchar(4000),@p530 nvarchar(4000),@p531 nvarchar(4000),@p532 nvarchar(4000),@p533 int,@p534 nvarchar(4000),@p535 nvarchar(4000),@p536 nvarchar(4000),@p537 nvarchar(4000),@p538 nvarchar(4000),@p539 nvarchar(4000),@p540 nvarchar(4000),@p541 nvarchar(4000),@p542 nvarchar(4000),@p543 nvarchar(4000),@p544 int,@p545 nvarchar(4000),@p546 nvarchar(4000),@p547 nvarchar(4000),@p548 nvarchar(4000),@p549 nvarchar(4000),@p550 int,@p551 nvarchar(4000),@p552 int,@p553 int,@p554 datetime2(7),@p555 datetime2(7),@p556 datetime2(7),@p557 nvarchar(4000),@p558 nvarchar(4000),@p559 nvarchar(4000),@p560 nvarchar(4000),@p561 nvarchar(4000),@p562 nvarchar(4000),@p563 nvarchar(4000),@p564 nvarchar(4000),@p565 nvarchar(4000),@p566 nvarchar(4000),@p567 nvarchar(4000),@p568 nvarchar(4000),@p569 nvarchar(4000),@p570 nvarchar(4000),@p571 datetime2(7),@p572 nvarchar(4000),@p573 nvarchar(4000),@p574 int,@p575 int,@p576 int,@p577 nvarchar(4000),@p578 nvarchar(4000),@p579 nvarchar(4000),@p580 decimal(18,2),@p581 decimal(18,2),@p582 nvarchar(4000),@p583 nvarchar(4000),@p584 decimal(18,2),@p585 nvarchar(4000),@p586 nvarchar(4000),@p587 nvarchar(4000),@p588 nvarchar(4000),@p589 int,@p590 nvarchar(4000),@p591 nvarchar(4000),@p592 nvarchar(4000),@p593 nvarchar(4000),@p594 nvarchar(4000),@p595 nvarchar(4000),@p596 nvarchar(4000),@p597 nvarchar(4000),@p598 nvarchar(4000),@p599 nvarchar(4000),@p600 int,@p601 nvarchar(4000),@p602 nvarchar(4000),@p603 nvarchar(4000),@p604 nvarchar(4000),@p605 nvarchar(4000),@p606 int,@p607 nvarchar(4000),@p608 int,@p609 int,@p610 datetime2(7),@p611 datetime2(7),@p612 datetime2(7),@p613 nvarchar(4000),@p614 nvarchar(4000),@p615 nvarchar(4000),@p616 nvarchar(4000),@p617 nvarchar(4000),@p618 nvarchar(4000),@p619 nvarchar(4000),@p620 nvarchar(4000),@p621 nvarchar(4000),@p622 nvarchar(4000),@p623 nvarchar(4000),@p624 nvarchar(4000),@p625 nvarchar(4000),@p626 nvarchar(4000),@p627 datetime2(7),@p628 nvarchar(4000),@p629 nvarchar(4000),@p630 int,@p631 int,@p632 int,@p633 nvarchar(4000),@p634 nvarchar(4000),@p635 nvarchar(4000),@p636 decimal(18,2),@p637 decimal(18,2),@p638 nvarchar(4000),@p639 nvarchar(4000),@p640 decimal(18,2),@p641 nvarchar(4000),@p642 nvarchar(4000),@p643 nvarchar(4000),@p644 nvarchar(4000),@p645 int,@p646 nvarchar(4000),@p647 nvarchar(4000),@p648 nvarchar(4000),@p649 nvarchar(4000),@p650 nvarchar(4000),@p651 nvarchar(4000),@p652 nvarchar(4000),@p653 nvarchar(4000),@p654 nvarchar(4000),@p655 nvarchar(4000),@p656 int,@p657 nvarchar(4000),@p658 nvarchar(4000),@p659 nvarchar(4000),@p660 nvarchar(4000),@p661 nvarchar(4000),@p662 int,@p663 nvarchar(4000),@p664 int,@p665 int,@p666 datetime2(7),@p667 datetime2(7),@p668 datetime2(7),@p669 nvarchar(4000),@p670 nvarchar(4000),@p671 nvarchar(4000),@p672 nvarchar(4000),@p673 nvarchar(4000),@p674 nvarchar(4000),@p675 nvarchar(4000),@p676 nvarchar(4000),@p677 nvarchar(4000),@p678 nvarchar(4000),@p679 nvarchar(4000),@p680 nvarchar(4000),@p681 nvarchar(4000),@p682 nvarchar(4000),@p683 datetime2(7),@p684 nvarchar(4000),@p685 nvarchar(4000),@p686 int,@p687 int,@p688 int,@p689 nvarchar(4000),@p690 nvarchar(4000),@p691 nvarchar(4000),@p692 decimal(18,2),@p693 decimal(18,2),@p694 nvarchar(4000),@p695 nvarchar(4000),@p696 decimal(18,2),@p697 nvarchar(4000),@p698 nvarchar(4000),@p699 nvarchar(4000),@p700 nvarchar(4000),@p701 int,@p702 nvarchar(4000),@p703 nvarchar(4000),@p704 nvarchar(4000),@p705 nvarchar(4000),@p706 nvarchar(4000),@p707 nvarchar(4000),@p708 nvarchar(4000),@p709 nvarchar(4000),@p710 nvarchar(4000),@p711 nvarchar(4000),@p712 int,@p713 nvarchar(4000),@p714 nvarchar(4000),@p715 nvarchar(4000),@p716 nvarchar(4000),@p717 nvarchar(4000),@p718 int,@p719 nvarchar(4000),@p720 int,@p721 int,@p722 datetime2(7),@p723 datetime2(7),@p724 datetime2(7),@p725 nvarchar(4000),@p726 nvarchar(4000),@p727 nvarchar(4000),@p728 nvarchar(4000),@p729 nvarchar(4000),@p730 nvarchar(4000),@p731 nvarchar(4000),@p732 nvarchar(4000),@p733 nvarchar(4000),@p734 nvarchar(4000),@p735 nvarchar(4000),@p736 nvarchar(4000),@p737 nvarchar(4000),@p738 nvarchar(4000),@p739 datetime2(7),@p740 nvarchar(4000),@p741 nvarchar(4000),@p742 int,@p743 int,@p744 int,@p745 nvarchar(4000),@p746 nvarchar(4000),@p747 nvarchar(4000),@p748 decimal(18,2),@p749 decimal(18,2),@p750 nvarchar(4000),@p751 nvarchar(4000),@p752 decimal(18,2),@p753 nvarchar(4000),@p754 nvarchar(4000),@p755 nvarchar(4000),@p756 nvarchar(4000),@p757 int,@p758 nvarchar(4000),@p759 nvarchar(4000),@p760 nvarchar(4000),@p761 nvarchar(4000),@p762 nvarchar(4000),@p763 nvarchar(4000),@p764 nvarchar(4000),@p765 nvarchar(4000),@p766 nvarchar(4000),@p767 nvarchar(4000),@p768 int,@p769 nvarchar(4000),@p770 nvarchar(4000),@p771 nvarchar(4000),@p772 nvarchar(4000),@p773 nvarchar(4000),@p774 int,@p775 nvarchar(4000),@p776 int,@p777 int,@p778 datetime2(7),@p779 datetime2(7),@p780 datetime2(7),@p781 nvarchar(4000),@p782 nvarchar(4000),@p783 nvarchar(4000),@p784 nvarchar(4000),@p785 nvarchar(4000),@p786 nvarchar(4000),@p787 nvarchar(4000),@p788 nvarchar(4000),@p789 nvarchar(4000),@p790 nvarchar(4000),@p791 nvarchar(4000),@p792 nvarchar(4000),@p793 nvarchar(4000),@p794 nvarchar(4000),@p795 datetime2(7),@p796 nvarchar(4000),@p797 nvarchar(4000),@p798 int,@p799 int,@p800 int,@p801 nvarchar(4000),@p802 nvarchar(4000),@p803 nvarchar(4000),@p804 decimal(18,2),@p805 decimal(18,2),@p806 nvarchar(4000),@p807 nvarchar(4000),@p808 decimal(18,2),@p809 nvarchar(4000),@p810 nvarchar(4000),@p811 nvarchar(4000),@p812 nvarchar(4000),@p813 int,@p814 nvarchar(4000),@p815 nvarchar(4000),@p816 nvarchar(4000),@p817 nvarchar(4000),@p818 nvarchar(4000),@p819 nvarchar(4000),@p820 nvarchar(4000),@p821 nvarchar(4000),@p822 nvarchar(4000),@p823 nvarchar(4000),@p824 int,@p825 nvarchar(4000),@p826 nvarchar(4000),@p827 nvarchar(4000),@p828 nvarchar(4000),@p829 nvarchar(4000),@p830 int,@p831 nvarchar(4000),@p832 int,@p833 int,@p834 datetime2(7),@p835 datetime2(7),@p836 datetime2(7),@p837 nvarchar(4000),@p838 nvarchar(4000),@p839 nvarchar(4000),@p840 nvarchar(4000),@p841 nvarchar(4000),@p842 nvarchar(4000),@p843 nvarchar(4000),@p844 nvarchar(4000),@p845 nvarchar(4000),@p846 nvarchar(4000),@p847 nvarchar(4000),@p848 nvarchar(4000),@p849 nvarchar(4000),@p850 nvarchar(4000),@p851 datetime2(7),@p852 nvarchar(4000),@p853 nvarchar(4000),@p854 int,@p855 int,@p856 int,@p857 nvarchar(4000),@p858 nvarchar(4000),@p859 nvarchar(4000),@p860 decimal(18,2),@p861 decimal(18,2),@p862 nvarchar(4000),@p863 nvarchar(4000),@p864 decimal(18,2),@p865 nvarchar(4000),@p866 nvarchar(4000),@p867 nvarchar(4000),@p868 nvarchar(4000),@p869 int,@p870 nvarchar(4000),@p871 nvarchar(4000),@p872 nvarchar(4000),@p873 nvarchar(4000),@p874 nvarchar(4000),@p875 nvarchar(4000),@p876 nvarchar(4000),@p877 nvarchar(4000),@p878 nvarchar(4000),@p879 nvarchar(4000),@p880 int,@p881 nvarchar(4000),@p882 nvarchar(4000),@p883 nvarchar(4000),@p884 nvarchar(4000),@p885 nvarchar(4000),@p886 int,@p887 nvarchar(4000),@p888 int,@p889 int,@p890 datetime2(7),@p891 datetime2(7),@p892 datetime2(7),@p893 nvarchar(4000),@p894 nvarchar(4000),@p895 nvarchar(4000),@p896 nvarchar(4000),@p897 nvarchar(4000),@p898 nvarchar(4000),@p899 nvarchar(4000),@p900 nvarchar(4000),@p901 nvarchar(4000),@p902 nvarchar(4000),@p903 nvarchar(4000),@p904 nvarchar(4000),@p905 nvarchar(4000),@p906 nvarchar(4000),@p907 datetime2(7),@p908 nvarchar(4000),@p909 nvarchar(4000),@p910 int,@p911 int,@p912 int,@p913 nvarchar(4000),@p914 nvarchar(4000),@p915 nvarchar(4000),@p916 decimal(18,2),@p917 decimal(18,2),@p918 nvarchar(4000),@p919 nvarchar(4000),@p920 decimal(18,2),@p921 nvarchar(4000),@p922 nvarchar(4000),@p923 nvarchar(4000),@p924 nvarchar(4000),@p925 int,@p926 nvarchar(4000),@p927 nvarchar(4000),@p928 nvarchar(4000),@p929 nvarchar(4000),@p930 nvarchar(4000),@p931 nvarchar(4000),@p932 nvarchar(4000),@p933 nvarchar(4000),@p934 nvarchar(4000),@p935 nvarchar(4000),@p936 int,@p937 nvarchar(4000),@p938 nvarchar(4000),@p939 nvarchar(4000),@p940 nvarchar(4000),@p941 nvarchar(4000),@p942 int,@p943 nvarchar(4000),@p944 int,@p945 int,@p946 datetime2(7),@p947 datetime2(7),@p948 datetime2(7),@p949 nvarchar(4000),@p950 nvarchar(4000),@p951 nvarchar(4000),@p952 nvarchar(4000),@p953 nvarchar(4000),@p954 nvarchar(4000),@p955 nvarchar(4000),@p956 nvarchar(4000),@p957 nvarchar(4000),@p958 nvarchar(4000),@p959 nvarchar(4000),@p960 nvarchar(4000),@p961 nvarchar(4000),@p962 nvarchar(4000),@p963 datetime2(7),@p964 nvarchar(4000),@p965 nvarchar(4000),@p966 int,@p967 int,@p968 int,@p969 nvarchar(4000),@p970 nvarchar(4000),@p971 nvarchar(4000),@p972 decimal(18,2),@p973 decimal(18,2),@p974 nvarchar(4000),@p975 nvarchar(4000),@p976 decimal(18,2),@p977 nvarchar(4000),@p978 nvarchar(4000),@p979 nvarchar(4000),@p980 nvarchar(4000),@p981 int,@p982 nvarchar(4000),@p983 nvarchar(4000),@p984 nvarchar(4000),@p985 nvarchar(4000),@p986 nvarchar(4000),@p987 nvarchar(4000),@p988 nvarchar(4000),@p989 nvarchar(4000),@p990 nvarchar(4000),@p991 nvarchar(4000),@p992 int,@p993 nvarchar(4000),@p994 nvarchar(4000),@p995 nvarchar(4000),@p996 nvarchar(4000),@p997 nvarchar(4000),@p998 int,@p999 nvarchar(4000),@p1000 int,@p1001 int,@p1002 datetime2(7),@p1003 datetime2(7),@p1004 datetime2(7),@p1005 nvarchar(4000),@p1006 nvarchar(4000),@p1007 nvarchar(4000),@p1008 nvarchar(4000),@p1009 nvarchar(4000),@p1010 nvarchar(4000),@p1011 nvarchar(4000),@p1012 nvarchar(4000),@p1013 nvarchar(4000),@p1014 nvarchar(4000),@p1015 nvarchar(4000),@p1016 nvarchar(4000),@p1017 nvarchar(4000),@p1018 nvarchar(4000),@p1019 datetime2(7),@p1020 nvarchar(4000),@p1021 nvarchar(4000),@p1022 int,@p1023 int,@p1024 int,@p1025 nvarchar(4000),@p1026 nvarchar(4000),@p1027 nvarchar(4000),@p1028 decimal(18,2),@p1029 decimal(18,2),@p1030 nvarchar(4000),@p1031 nvarchar(4000),@p1032 decimal(18,2),@p1033 nvarchar(4000),@p1034 nvarchar(4000),@p1035 nvarchar(4000),@p1036 nvarchar(4000),@p1037 int,@p1038 nvarchar(4000),@p1039 nvarchar(4000),@p1040 nvarchar(4000),@p1041 nvarchar(4000),@p1042 nvarchar(4000),@p1043 nvarchar(4000),@p1044 nvarchar(4000),@p1045 nvarchar(4000),@p1046 nvarchar(4000),@p1047 nvarchar(4000),@p1048 int,@p1049 nvarchar(4000),@p1050 nvarchar(4000),@p1051 nvarchar(4000),@p1052 nvarchar(4000),@p1053 nvarchar(4000),@p1054 int,@p1055 nvarchar(4000),@p1056 int,@p1057 int,@p1058 datetime2(7),@p1059 datetime2(7),@p1060 datetime2(7),@p1061 nvarchar(4000),@p1062 nvarchar(4000),@p1063 nvarchar(4000),@p1064 nvarchar(4000),@p1065 nvarchar(4000),@p1066 nvarchar(4000),@p1067 nvarchar(4000),@p1068 nvarchar(4000),@p1069 nvarchar(4000),@p1070 nvarchar(4000),@p1071 nvarchar(4000),@p1072 nvarchar(4000),@p1073 nvarchar(4000),@p1074 nvarchar(4000),@p1075 datetime2(7),@p1076 nvarchar(4000),@p1077 nvarchar(4000),@p1078 int,@p1079 int,@p1080 int,@p1081 nvarchar(4000),@p1082 nvarchar(4000),@p1083 nvarchar(4000),@p1084 decimal(18,2),@p1085 decimal(18,2),@p1086 nvarchar(4000),@p1087 nvarchar(4000),@p1088 decimal(18,2),@p1089 nvarchar(4000),@p1090 nvarchar(4000),@p1091 nvarchar(4000),@p1092 nvarchar(4000),@p1093 int,@p1094 nvarchar(4000),@p1095 nvarchar(4000),@p1096 nvarchar(4000),@p1097 nvarchar(4000),@p1098 nvarchar(4000),@p1099 nvarchar(4000),@p1100 nvarchar(4000),@p1101 nvarchar(4000),@p1102 nvarchar(4000),@p1103 nvarchar(4000),@p1104 int,@p1105 nvarchar(4000),@p1106 nvarchar(4000),@p1107 nvarchar(4000),@p1108 nvarchar(4000),@p1109 nvarchar(4000),@p1110 int,@p1111 nvarchar(4000),@p1112 int,@p1113 int,@p1114 datetime2(7),@p1115 datetime2(7),@p1116 datetime2(7),@p1117 nvarchar(4000),@p1118 nvarchar(4000),@p1119 nvarchar(4000),@p1120 nvarchar(4000),@p1121 nvarchar(4000),@p1122 nvarchar(4000),@p1123 nvarchar(4000),@p1124 nvarchar(4000),@p1125 nvarchar(4000),@p1126 nvarchar(4000),@p1127 nvarchar(4000),@p1128 nvarchar(4000),@p1129 nvarchar(4000),@p1130 nvarchar(4000),@p1131 datetime2(7),@p1132 nvarchar(4000),@p1133 nvarchar(4000),@p1134 int,@p1135 int,@p1136 int,@p1137 nvarchar(4000),@p1138 nvarchar(4000),@p1139 nvarchar(4000),@p1140 decimal(18,2),@p1141 decimal(18,2),@p1142 nvarchar(4000),@p1143 nvarchar(4000),@p1144 decimal(18,2),@p1145 nvarchar(4000),@p1146 nvarchar(4000),@p1147 nvarchar(4000),@p1148 nvarchar(4000),@p1149 int,@p1150 nvarchar(4000),@p1151 nvarchar(4000),@p1152 nvarchar(4000),@p1153 nvarchar(4000),@p1154 nvarchar(4000),@p1155 nvarchar(4000),@p1156 nvarchar(4000),@p1157 nvarchar(4000),@p1158 nvarchar(4000),@p1159 nvarchar(4000),@p1160 int,@p1161 nvarchar(4000),@p1162 nvarchar(4000),@p1163 nvarchar(4000),@p1164 nvarchar(4000),@p1165 nvarchar(4000),@p1166 int,@p1167 nvarchar(4000),@p1168 int,@p1169 int,@p1170 datetime2(7),@p1171 datetime2(7),@p1172 datetime2(7),@p1173 nvarchar(4000),@p1174 nvarchar(4000),@p1175 nvarchar(4000),@p1176 nvarchar(4000),@p1177 nvarchar(4000),@p1178 nvarchar(4000),@p1179 nvarchar(4000),@p1180 nvarchar(4000),@p1181 nvarchar(4000),@p1182 nvarchar(4000),@p1183 nvarchar(4000),@p1184 nvarchar(4000),@p1185 nvarchar(4000),@p1186 nvarchar(4000),@p1187 datetime2(7),@p1188 nvarchar(4000),@p1189 nvarchar(4000),@p1190 int,@p1191 int,@p1192 int,@p1193 nvarchar(4000),@p1194 nvarchar(4000),@p1195 nvarchar(4000),@p1196 decimal(18,2),@p1197 decimal(18,2),@p1198 nvarchar(4000),@p1199 nvarchar(4000),@p1200 decimal(18,2),@p1201 nvarchar(4000),@p1202 nvarchar(4000),@p1203 nvarchar(4000),@p1204 nvarchar(4000),@p1205 int,@p1206 nvarchar(4000),@p1207 nvarchar(4000),@p1208 nvarchar(4000),@p1209 nvarchar(4000),@p1210 nvarchar(4000),@p1211 nvarchar(4000),@p1212 nvarchar(4000),@p1213 nvarchar(4000),@p1214 nvarchar(4000),@p1215 nvarchar(4000),@p1216 int,@p1217 nvarchar(4000),@p1218 nvarchar(4000),@p1219 nvarchar(4000),@p1220 nvarchar(4000),@p1221 nvarchar(4000),@p1222 int,@p1223 nvarchar(4000),@p1224 int,@p1225 int,@p1226 datetime2(7),@p1227 datetime2(7),@p1228 datetime2(7),@p1229 nvarchar(4000),@p1230 nvarchar(4000),@p1231 nvarchar(4000),@p1232 nvarchar(4000),@p1233 nvarchar(4000),@p1234 nvarchar(4000),@p1235 nvarchar(4000),@p1236 nvarchar(4000),@p1237 nvarchar(4000),@p1238 nvarchar(4000),@p1239 nvarchar(4000),@p1240 nvarchar(4000),@p1241 nvarchar(4000),@p1242 nvarchar(4000),@p1243 datetime2(7),@p1244 nvarchar(4000),@p1245 nvarchar(4000),@p1246 int,@p1247 int,@p1248 int,@p1249 nvarchar(4000),@p1250 nvarchar(4000),@p1251 nvarchar(4000),@p1252 decimal(18,2),@p1253 decimal(18,2),@p1254 nvarchar(4000),@p1255 nvarchar(4000),@p1256 decimal(18,2),@p1257 nvarchar(4000),@p1258 nvarchar(4000),@p1259 nvarchar(4000),@p1260 nvarchar(4000),@p1261 int,@p1262 nvarchar(4000),@p1263 nvarchar(4000),@p1264 nvarchar(4000),@p1265 nvarchar(4000),@p1266 nvarchar(4000),@p1267 nvarchar(4000),@p1268 nvarchar(4000),@p1269 nvarchar(4000),@p1270 nvarchar(4000),@p1271 nvarchar(4000),@p1272 int,@p1273 nvarchar(4000),@p1274 nvarchar(4000),@p1275 nvarchar(4000),@p1276 nvarchar(4000),@p1277 nvarchar(4000),@p1278 int,@p1279 nvarchar(4000),@p1280 int,@p1281 int,@p1282 datetime2(7),@p1283 datetime2(7),@p1284 datetime2(7),@p1285 nvarchar(4000),@p1286 nvarchar(4000),@p1287 nvarchar(4000),@p1288 nvarchar(4000),@p1289 nvarchar(4000),@p1290 nvarchar(4000),@p1291 nvarchar(4000),@p1292 nvarchar(4000),@p1293 nvarchar(4000),@p1294 nvarchar(4000),@p1295 nvarchar(4000),@p1296 nvarchar(4000),@p1297 nvarchar(4000),@p1298 nvarchar(4000),@p1299 datetime2(7),@p1300 nvarchar(4000),@p1301 nvarchar(4000),@p1302 int,@p1303 int,@p1304 int,@p1305 nvarchar(4000),@p1306 nvarchar(4000),@p1307 nvarchar(4000),@p1308 decimal(18,2),@p1309 decimal(18,2),@p1310 nvarchar(4000),@p1311 nvarchar(4000),@p1312 decimal(18,2),@p1313 nvarchar(4000),@p1314 nvarchar(4000),@p1315 nvarchar(4000),@p1316 nvarchar(4000),@p1317 int,@p1318 nvarchar(4000),@p1319 nvarchar(4000),@p1320 nvarchar(4000),@p1321 nvarchar(4000),@p1322 nvarchar(4000),@p1323 nvarchar(4000),@p1324 nvarchar(4000),@p1325 nvarchar(4000),@p1326 nvarchar(4000),@p1327 nvarchar(4000),@p1328 int,@p1329 nvarchar(4000),@p1330 nvarchar(4000),@p1331 nvarchar(4000),@p1332 nvarchar(4000),@p1333 nvarchar(4000),@p1334 int,@p1335 nvarchar(4000),@p1336 int,@p1337 int,@p1338 datetime2(7),@p1339 datetime2(7),@p1340 datetime2(7),@p1341 nvarchar(4000),@p1342 nvarchar(4000),@p1343 nvarchar(4000),@p1344 nvarchar(4000),@p1345 nvarchar(4000),@p1346 nvarchar(4000),@p1347 nvarchar(4000),@p1348 nvarchar(4000),@p1349 nvarchar(4000),@p1350 nvarchar(4000),@p1351 nvarchar(4000),@p1352 nvarchar(4000),@p1353 nvarchar(4000),@p1354 nvarchar(4000),@p1355 datetime2(7),@p1356 nvarchar(4000),@p1357 nvarchar(4000),@p1358 int,@p1359 int,@p1360 int,@p1361 nvarchar(4000),@p1362 nvarchar(4000),@p1363 nvarchar(4000),@p1364 decimal(18,2),@p1365 decimal(18,2),@p1366 nvarchar(4000),@p1367 nvarchar(4000),@p1368 decimal(18,2),@p1369 nvarchar(4000),@p1370 nvarchar(4000),@p1371 nvarchar(4000),@p1372 nvarchar(4000),@p1373 int,@p1374 nvarchar(4000),@p1375 nvarchar(4000),@p1376 nvarchar(4000),@p1377 nvarchar(4000),@p1378 nvarchar(4000),@p1379 nvarchar(4000),@p1380 nvarchar(4000),@p1381 nvarchar(4000),@p1382 nvarchar(4000),@p1383 nvarchar(4000),@p1384 int,@p1385 nvarchar(4000),@p1386 nvarchar(4000),@p1387 nvarchar(4000),@p1388 nvarchar(4000),@p1389 nvarchar(4000),@p1390 int,@p1391 nvarchar(4000),@p1392 int,@p1393 int,@p1394 datetime2(7),@p1395 datetime2(7),@p1396 datetime2(7),@p1397 nvarchar(4000),@p1398 nvarchar(4000),@p1399 nvarchar(4000),@p1400 nvarchar(4000),@p1401 nvarchar(4000),@p1402 nvarchar(4000),@p1403 nvarchar(4000),@p1404 nvarchar(4000),@p1405 nvarchar(4000),@p1406 nvarchar(4000),@p1407 nvarchar(4000),@p1408 nvarchar(4000),@p1409 nvarchar(4000),@p1410 nvarchar(4000),@p1411 datetime2(7),@p1412 nvarchar(4000),@p1413 nvarchar(4000),@p1414 int,@p1415 int,@p1416 int,@p1417 nvarchar(4000),@p1418 nvarchar(4000),@p1419 nvarchar(4000),@p1420 decimal(18,2),@p1421 decimal(18,2),@p1422 nvarchar(4000),@p1423 nvarchar(4000),@p1424 decimal(18,2),@p1425 nvarchar(4000),@p1426 nvarchar(4000),@p1427 nvarchar(4000),@p1428 nvarchar(4000),@p1429 int,@p1430 nvarchar(4000),@p1431 nvarchar(4000),@p1432 nvarchar(4000),@p1433 nvarchar(4000),@p1434 nvarchar(4000),@p1435 nvarchar(4000),@p1436 nvarchar(4000),@p1437 nvarchar(4000),@p1438 nvarchar(4000),@p1439 nvarchar(4000),@p1440 int,@p1441 nvarchar(4000),@p1442 nvarchar(4000),@p1443 nvarchar(4000),@p1444 nvarchar(4000),@p1445 nvarchar(4000),@p1446 int,@p1447 nvarchar(4000),@p1448 int,@p1449 int,@p1450 datetime2(7),@p1451 datetime2(7),@p1452 datetime2(7),@p1453 nvarchar(4000),@p1454 nvarchar(4000),@p1455 nvarchar(4000),@p1456 nvarchar(4000),@p1457 nvarchar(4000),@p1458 nvarchar(4000),@p1459 nvarchar(4000),@p1460 nvarchar(4000),@p1461 nvarchar(4000),@p1462 nvarchar(4000),@p1463 nvarchar(4000),@p1464 nvarchar(4000),@p1465 nvarchar(4000),@p1466 nvarchar(4000),@p1467 datetime2(7),@p1468 nvarchar(4000),@p1469 nvarchar(4000),@p1470 int,@p1471 int,@p1472 int,@p1473 nvarchar(4000),@p1474 nvarchar(4000),@p1475 nvarchar(4000),@p1476 decimal(18,2),@p1477 decimal(18,2),@p1478 nvarchar(4000),@p1479 nvarchar(4000),@p1480 decimal(18,2),@p1481 nvarchar(4000),@p1482 nvarchar(4000),@p1483 nvarchar(4000),@p1484 nvarchar(4000),@p1485 int,@p1486 nvarchar(4000),@p1487 nvarchar(4000),@p1488 nvarchar(4000),@p1489 nvarchar(4000),@p1490 nvarchar(4000),@p1491 nvarchar(4000),@p1492 nvarchar(4000),@p1493 nvarchar(4000),@p1494 nvarchar(4000),@p1495 nvarchar(4000),@p1496 int,@p1497 nvarchar(4000),@p1498 nvarchar(4000),@p1499 nvarchar(4000),@p1500 nvarchar(4000),@p1501 nvarchar(4000),@p1502 int,@p1503 nvarchar(4000),@p1504 int,@p1505 int,@p1506 datetime2(7),@p1507 datetime2(7),@p1508 datetime2(7),@p1509 nvarchar(4000),@p1510 nvarchar(4000),@p1511 nvarchar(4000),@p1512 nvarchar(4000),@p1513 nvarchar(4000),@p1514 nvarchar(4000),@p1515 nvarchar(4000),@p1516 nvarchar(4000),@p1517 nvarchar(4000),@p1518 nvarchar(4000),@p1519 nvarchar(4000),@p1520 nvarchar(4000),@p1521 nvarchar(4000),@p1522 nvarchar(4000),@p1523 datetime2(7),@p1524 nvarchar(4000),@p1525 nvarchar(4000),@p1526 int,@p1527 int,@p1528 int,@p1529 nvarchar(4000),@p1530 nvarchar(4000),@p1531 nvarchar(4000),@p1532 decimal(18,2),@p1533 decimal(18,2),@p1534 nvarchar(4000),@p1535 nvarchar(4000),@p1536 decimal(18,2),@p1537 nvarchar(4000),@p1538 nvarchar(4000),@p1539 nvarchar(4000),@p1540 nvarchar(4000),@p1541 int,@p1542 nvarchar(4000),@p1543 nvarchar(4000),@p1544 nvarchar(4000),@p1545 nvarchar(4000),@p1546 nvarchar(4000),@p1547 nvarchar(4000),@p1548 nvarchar(4000),@p1549 nvarchar(4000),@p1550 nvarchar(4000),@p1551 nvarchar(4000),@p1552 int,@p1553 nvarchar(4000),@p1554 nvarchar(4000),@p1555 nvarchar(4000),@p1556 nvarchar(4000),@p1557 nvarchar(4000),@p1558 int,@p1559 nvarchar(4000),@p1560 int,@p1561 int,@p1562 datetime2(7),@p1563 datetime2(7),@p1564 datetime2(7),@p1565 nvarchar(4000),@p1566 nvarchar(4000),@p1567 nvarchar(4000),@p1568 nvarchar(4000),@p1569 nvarchar(4000),@p1570 nvarchar(4000),@p1571 nvarchar(4000),@p1572 nvarchar(4000),@p1573 nvarchar(4000),@p1574 nvarchar(4000),@p1575 nvarchar(4000),@p1576 nvarchar(4000),@p1577 nvarchar(4000),@p1578 nvarchar(4000),@p1579 datetime2(7),@p1580 nvarchar(4000),@p1581 nvarchar(4000),@p1582 int,@p1583 int,@p1584 int,@p1585 nvarchar(4000),@p1586 nvarchar(4000),@p1587 nvarchar(4000),@p1588 decimal(18,2),@p1589 decimal(18,2),@p1590 nvarchar(4000),@p1591 nvarchar(4000),@p1592 decimal(18,2),@p1593 nvarchar(4000),@p1594 nvarchar(4000),@p1595 nvarchar(4000),@p1596 nvarchar(4000),@p1597 int,@p1598 nvarchar(4000),@p1599 nvarchar(4000),@p1600 nvarchar(4000),@p1601 nvarchar(4000),@p1602 nvarchar(4000),@p1603 nvarchar(4000),@p1604 nvarchar(4000),@p1605 nvarchar(4000),@p1606 nvarchar(4000),@p1607 nvarchar(4000),@p1608 int,@p1609 nvarchar(4000),@p1610 nvarchar(4000),@p1611 nvarchar(4000),@p1612 nvarchar(4000),@p1613 nvarchar(4000),@p1614 int,@p1615 nvarchar(4000),@p1616 int,@p1617 int,@p1618 datetime2(7),@p1619 datetime2(7),@p1620 datetime2(7),@p1621 nvarchar(4000),@p1622 nvarchar(4000),@p1623 nvarchar(4000),@p1624 nvarchar(4000),@p1625 nvarchar(4000),@p1626 nvarchar(4000),@p1627 nvarchar(4000),@p1628 nvarchar(4000),@p1629 nvarchar(4000),@p1630 nvarchar(4000),@p1631 nvarchar(4000),@p1632 nvarchar(4000),@p1633 nvarchar(4000),@p1634 nvarchar(4000),@p1635 datetime2(7),@p1636 nvarchar(4000),@p1637 nvarchar(4000),@p1638 int,@p1639 int,@p1640 int,@p1641 nvarchar(4000),@p1642 nvarchar(4000),@p1643 nvarchar(4000),@p1644 decimal(18,2),@p1645 decimal(18,2),@p1646 nvarchar(4000),@p1647 nvarchar(4000),@p1648 decimal(18,2),@p1649 nvarchar(4000),@p1650 nvarchar(4000),@p1651 nvarchar(4000),@p1652 nvarchar(4000),@p1653 int,@p1654 nvarchar(4000),@p1655 nvarchar(4000),@p1656 nvarchar(4000),@p1657 nvarchar(4000),@p1658 nvarchar(4000),@p1659 nvarchar(4000),@p1660 nvarchar(4000),@p1661 nvarchar(4000),@p1662 nvarchar(4000),@p1663 nvarchar(4000),@p1664 int,@p1665 nvarchar(4000),@p1666 nvarchar(4000),@p1667 nvarchar(4000),@p1668 nvarchar(4000),@p1669 nvarchar(4000),@p1670 int,@p1671 nvarchar(4000),@p1672 int,@p1673 int,@p1674 datetime2(7),@p1675 datetime2(7),@p1676 datetime2(7),@p1677 nvarchar(4000),@p1678 nvarchar(4000),@p1679 nvarchar(4000),@p1680 nvarchar(4000),@p1681 nvarchar(4000),@p1682 nvarchar(4000),@p1683 nvarchar(4000),@p1684 nvarchar(4000),@p1685 nvarchar(4000),@p1686 nvarchar(4000),@p1687 nvarchar(4000),@p1688 nvarchar(4000),@p1689 nvarchar(4000),@p1690 nvarchar(4000),@p1691 datetime2(7),@p1692 nvarchar(4000),@p1693 nvarchar(4000),@p1694 int,@p1695 int,@p1696 int,@p1697 nvarchar(4000),@p1698 nvarchar(4000),@p1699 nvarchar(4000),@p1700 decimal(18,2),@p1701 decimal(18,2),@p1702 nvarchar(4000),@p1703 nvarchar(4000),@p1704 decimal(18,2),@p1705 nvarchar(4000),@p1706 nvarchar(4000),@p1707 nvarchar(4000),@p1708 nvarchar(4000),@p1709 int,@p1710 nvarchar(4000),@p1711 nvarchar(4000),@p1712 nvarchar(4000),@p1713 nvarchar(4000),@p1714 nvarchar(4000),@p1715 nvarchar(4000),@p1716 nvarchar(4000),@p1717 nvarchar(4000),@p1718 nvarchar(4000),@p1719 nvarchar(4000),@p1720 int,@p1721 nvarchar(4000),@p1722 nvarchar(4000),@p1723 nvarchar(4000),@p1724 nvarchar(4000),@p1725 nvarchar(4000),@p1726 int,@p1727 nvarchar(4000),@p1728 int,@p1729 int,@p1730 datetime2(7),@p1731 datetime2(7),@p1732 datetime2(7),@p1733 nvarchar(4000),@p1734 nvarchar(4000),@p1735 nvarchar(4000),@p1736 nvarchar(4000),@p1737 nvarchar(4000),@p1738 nvarchar(4000),@p1739 nvarchar(4000),@p1740 nvarchar(4000),@p1741 nvarchar(4000),@p1742 nvarchar(4000),@p1743 nvarchar(4000),@p1744 nvarchar(4000),@p1745 nvarchar(4000),@p1746 nvarchar(4000),@p1747 datetime2(7),@p1748 nvarchar(4000),@p1749 nvarchar(4000),@p1750 int,@p1751 int,@p1752 int,@p1753 nvarchar(4000),@p1754 nvarchar(4000),@p1755 nvarchar(4000),@p1756 decimal(18,2),@p1757 decimal(18,2),@p1758 nvarchar(4000),@p1759 nvarchar(4000),@p1760 decimal(18,2),@p1761 nvarchar(4000),@p1762 nvarchar(4000),@p1763 nvarchar(4000),@p1764 nvarchar(4000),@p1765 int,@p1766 nvarchar(4000),@p1767 nvarchar(4000),@p1768 nvarchar(4000),@p1769 nvarchar(4000),@p1770 nvarchar(4000),@p1771 nvarchar(4000),@p1772 nvarchar(4000),@p1773 nvarchar(4000),@p1774 nvarchar(4000),@p1775 nvarchar(4000),@p1776 int,@p1777 nvarchar(4000),@p1778 nvarchar(4000),@p1779 nvarchar(4000),@p1780 nvarchar(4000),@p1781 nvarchar(4000),@p1782 int,@p1783 nvarchar(4000),@p1784 int,@p1785 int,@p1786 datetime2(7),@p1787 datetime2(7),@p1788 datetime2(7),@p1789 nvarchar(4000),@p1790 nvarchar(4000),@p1791 nvarchar(4000),@p1792 nvarchar(4000),@p1793 nvarchar(4000),@p1794 nvarchar(4000),@p1795 nvarchar(4000),@p1796 nvarchar(4000),@p1797 nvarchar(4000),@p1798 nvarchar(4000),@p1799 nvarchar(4000),@p1800 nvarchar(4000),@p1801 nvarchar(4000),@p1802 nvarchar(4000),@p1803 datetime2(7),@p1804 nvarchar(4000),@p1805 nvarchar(4000),@p1806 int,@p1807 int,@p1808 int,@p1809 nvarchar(4000),@p1810 nvarchar(4000),@p1811 nvarchar(4000),@p1812 decimal(18,2),@p1813 decimal(18,2),@p1814 nvarchar(4000),@p1815 nvarchar(4000),@p1816 decimal(18,2),@p1817 nvarchar(4000),@p1818 nvarchar(4000),@p1819 nvarchar(4000),@p1820 nvarchar(4000),@p1821 int,@p1822 nvarchar(4000),@p1823 nvarchar(4000),@p1824 nvarchar(4000),@p1825 nvarchar(4000),@p1826 nvarchar(4000),@p1827 nvarchar(4000),@p1828 nvarchar(4000),@p1829 nvarchar(4000),@p1830 nvarchar(4000),@p1831 nvarchar(4000),@p1832 int,@p1833 nvarchar(4000),@p1834 nvarchar(4000),@p1835 nvarchar(4000),@p1836 nvarchar(4000),@p1837 nvarchar(4000),@p1838 int,@p1839 nvarchar(4000),@p1840 int,@p1841 int,@p1842 datetime2(7),@p1843 datetime2(7),@p1844 datetime2(7),@p1845 nvarchar(4000),@p1846 nvarchar(4000),@p1847 nvarchar(4000),@p1848 nvarchar(4000),@p1849 nvarchar(4000),@p1850 nvarchar(4000),@p1851 nvarchar(4000),@p1852 nvarchar(4000),@p1853 nvarchar(4000),@p1854 nvarchar(4000),@p1855 nvarchar(4000),@p1856 nvarchar(4000),@p1857 nvarchar(4000),@p1858 nvarchar(4000),@p1859 datetime2(7),@p1860 nvarchar(4000),@p1861 nvarchar(4000),@p1862 int,@p1863 int,@p1864 int,@p1865 nvarchar(4000),@p1866 nvarchar(4000),@p1867 nvarchar(4000),@p1868 decimal(18,2),@p1869 decimal(18,2),@p1870 nvarchar(4000),@p1871 nvarchar(4000),@p1872 decimal(18,2),@p1873 nvarchar(4000),@p1874 nvarchar(4000),@p1875 nvarchar(4000),@p1876 nvarchar(4000),@p1877 int,@p1878 nvarchar(4000),@p1879 nvarchar(4000),@p1880 nvarchar(4000),@p1881 nvarchar(4000),@p1882 nvarchar(4000),@p1883 nvarchar(4000),@p1884 nvarchar(4000),@p1885 nvarchar(4000),@p1886 nvarchar(4000),@p1887 nvarchar(4000),@p1888 int,@p1889 nvarchar(4000),@p1890 nvarchar(4000),@p1891 nvarchar(4000),@p1892 nvarchar(4000),@p1893 nvarchar(4000),@p1894 int,@p1895 nvarchar(4000),@p1896 int,@p1897 int,@p1898 datetime2(7),@p1899 datetime2(7),@p1900 datetime2(7),@p1901 nvarchar(4000),@p1902 nvarchar(4000),@p1903 nvarchar(4000),@p1904 nvarchar(4000),@p1905 nvarchar(4000),@p1906 nvarchar(4000),@p1907 nvarchar(4000),@p1908 nvarchar(4000),@p1909 nvarchar(4000),@p1910 nvarchar(4000),@p1911 nvarchar(4000),@p1912 nvarchar(4000),@p1913 nvarchar(4000),@p1914 nvarchar(4000),@p1915 datetime2(7),@p1916 nvarchar(4000),@p1917 nvarchar(4000),@p1918 int,@p1919 int,@p1920 int,@p1921 nvarchar(4000),@p1922 nvarchar(4000),@p1923 nvarchar(4000),@p1924 decimal(18,2),@p1925 decimal(18,2),@p1926 nvarchar(4000),@p1927 nvarchar(4000),@p1928 decimal(18,2),@p1929 nvarchar(4000),@p1930 nvarchar(4000),@p1931 nvarchar(4000),@p1932 nvarchar(4000),@p1933 int,@p1934 nvarchar(4000),@p1935 nvarchar(4000),@p1936 nvarchar(4000),@p1937 nvarchar(4000),@p1938 nvarchar(4000),@p1939 nvarchar(4000),@p1940 nvarchar(4000),@p1941 nvarchar(4000),@p1942 nvarchar(4000),@p1943 nvarchar(4000),@p1944 int,@p1945 nvarchar(4000),@p1946 nvarchar(4000),@p1947 nvarchar(4000),@p1948 nvarchar(4000),@p1949 nvarchar(4000),@p1950 int,@p1951 nvarchar(4000),@p1952 int,@p1953 int,@p1954 datetime2(7),@p1955 datetime2(7),@p1956 datetime2(7),@p1957 nvarchar(4000),@p1958 nvarchar(4000),@p1959 nvarchar(4000))SET NOCOUNT ON; DECLARE @inserted0 TABLE ([item_id] int, [_Position] [int]); MERGE [raw_data] USING ( VALUES (@p0, @p1, @p2, @p3, @p4, @p5, @p6, @p7, @p8, @p9, @p10, @p11, @p12, @p13, @p14, @p15, @p16, @p17, @p18, @p19, @p20, @p21, @p22, @p23, @p24, @p25, @p26, @p27, @p28, @p29, @p30, @p31, @p32, @p33, @p34, @p35, @p36, @p37, @p38, @p39, @p40, @p41, @p42, @p43, @p44, @p45, @p46, @p47, @p48, @p49, @p50, @p51, @p52, @p53, @p54, @p55, 0), (@p56, @p57, @p58, @p59, @p60, @p61, @p62, @p63, @p64, @p65, @p66, @p67, @p68, @p69, @p70, @p71, @p72, @p73, @p74, @p75, @p76, @p77, @p78, @p79, @p80, @p81, @p82, @p83, @p84, @p85, @p86, @p87, @p88, @p89, @p90, @p91, @p92, @p93, @p94, @p95, @p96, @p97, @p98, @p99, @p100, @p101, @p102, @p103, @p104, @p105, @p106, @p107, @p108, @p109, @p110, @p111, 1), (@p112, @p113, @p114, @p115, @p116, @p117, @p118, @p119, @p120, @p121, @p122, @p123, @p124, @p125, @p126, @p127, @p128, @p129, @p130, @p131, @p132, @p133, @p134, @p135, @p136, @p137, @p138, @p139, @p140, @p141, @p142, @p143, @p144, @p145, @p146, @p147, @p148, @p149, @p150, @p151, @p152, @p153, @p154, @p155, @p156, @p157, @p158, @p159, @p160, @p161, @p162, @p163, @p164, @p165, @p166, @p167, 2), (@p168, @p169, @p170, @p171, @p172, @p173, @p174, @p175, @p176, @p177, @p178, @p179, @p180, @p181, @p182, @p183, @p184, @p185, @p186, @p187, @p188, @p189, @p190, @p191, @p192, @p193, @p194, @p195, @p196, @p197, @p198, @p199, @p200, @p201, @p202, @p203, @p204, @p205, @p206, @p207, @p208, @p209, @p210, @p211, @p212, @p213, @p214, @p215, @p216, @p217, @p218, @p219, @p220, @p221, @p222, @p223, 3), (@p224, @p225, @p226, @p227, @p228, @p229, @p230, @p231, @p232, @p233, @p234, @p235, @p236, @p237, @p238, @p239, @p240, @p241, @p242, @p243, @p244, @p245, @p246, @p247, @p248, @p249, @p250, @p251, @p252, @p253, @p254, @p255, @p256, @p257, @p258, @p259, @p260, @p261, @p262, @p263, @p264, @p265, @p266, @p267, @p268, @p269, @p270, @p271, @p272, @p273, @p274, @p275, @p276, @p277, @p278, @p279, 4), (@p280, @p281, @p282, @p283, @p284, @p285, @p286, @p287, @p288, @p289, @p290, @p291, @p292, @p293, @p294, @p295, @p296, @p297, @p298, @p299, @p300, @p301, @p302, @p303, @p304, @p305, @p306, @p307, @p308, @p309, @p310, @p311, @p312, @p313, @p314, @p315, @p316, @p317, @p318, @p319, @p320, @p321, @p322, @p323, @p324, @p325, @p326, @p327, @p328, @p329, @p330, @p331, @p332, @p333, @p334, @p335, 5), (@p336, @p337, @p338, @p339, @p340, @p341, @p342, @p343, @p344, @p345, @p346, @p347, @p348, @p349, @p350, @p351, @p352, @p353, @p354, @p355, @p356, @p357, @p358, @p359, @p360, @p361, @p362, @p363, @p364, @p365, @p366, @p367, @p368, @p369, @p370, @p371, @p372, @p373, @p374, @p375, @p376, @p377, @p378, @p379, @p380, @p381, @p382, @p383, @p384, @p385, @p386, @p387, @p388, @p389, @p390, @p391, 6), (@p392, @p393, @p394, @p395, @p396, @p397, @p398, @p399, @p400, @p401, @p402, @p403, @p404, @p405, @p406, @p407, @p408, @p409, @p410, @p411, @p412, @p413, @p414, @p415, @p416, @p417, @p418, @p419, @p420, @p421, @p422, @p423, @p424, @p425, @p426, @p427, @p428, @p429, @p430, @p431, @p432, @p433, @p434, @p435, @p436, @p437, @p438, @p439, @p440, @p441, @p442, @p443, @p444, @p445, @p446, @p447, 7), (@p448, @p449, @p450, @p451, @p452, @p453, @p454, @p455, @p456, @p457, @p458, @p459, @p460, @p461, @p462, @p463, @p464, @p465, @p466, @p467, @p468, @p469, @p470, @p471, @p472, @p473, @p474, @p475, @p476, @p477, @p478, @p479, @p480, @p481, @p482, @p483, @p484, @p485, @p486, @p487, @p488, @p489, @p490, @p491, @p492, @p493, @p494, @p495, @p496, @p497, @p498, @p499, @p500, @p501, @p502, @p503, 8), (@p504, @p505, @p506, @p507, @p508, @p509, @p510, @p511, @p512, @p513, @p514, @p515, @p516, @p517, @p518, @p519, @p520, @p521, @p522, @p523, @p524, @p525, @p526, @p527, @p528, @p529, @p530, @p531, @p532, @p533, @p534, @p535, @p536, @p537, @p538, @p539, @p540, @p541, @p542, @p543, @p544, @p545, @p546, @p547, @p548, @p549, @p550, @p551, @p552, @p553, @p554, @p555, @p556, @p557, @p558, @p559, 9), (@p560, @p561, @p562, @p563, @p564, @p565, @p566, @p567, @p568, @p569, @p570, @p571, @p572, @p573, @p574, @p575, @p576, @p577, @p578, @p579, @p580, @p581, @p582, @p583, @p584, @p585, @p586, @p587, @p588, @p589, @p590, @p591, @p592, @p593, @p594, @p595, @p596, @p597, @p598, @p599, @p600, @p601, @p602, @p603, @p604, @p605, @p606, @p607, @p608, @p609, @p610, @p611, @p612, @p613, @p614, @p615, 10), (@p616, @p617, @p618, @p619, @p620, @p621, @p622, @p623, @p624, @p625, @p626, @p627, @p628, @p629, @p630, @p631, @p632, @p633, @p634, @p635, @p636, @p637, @p638, @p639, @p640, @p641, @p642, @p643, @p644, @p645, @p646, @p647, @p648, @p649, @p650, @p651, @p652, @p653, @p654, @p655, @p656, @p657, @p658, @p659, @p660, @p661, @p662, @p663, @p664, @p665, @p666, @p667, @p668, @p669, @p670, @p671, 11), (@p672, @p673, @p674, @p675, @p676, @p677, @p678, @p679, @p680, @p681, @p682, @p683, @p684, @p685, @p686, @p687, @p688, @p689, @p690, @p691, @p692, @p693, @p694, @p695, @p696, @p697, @p698, @p699, @p700, @p701, @p702, @p703, @p704, @p705, @p706, @p707, @p708, @p709, @p710, @p711, @p712, @p713, @p714, @p715, @p716, @p717, @p718, @p719, @p720, @p721, @p722, @p723, @p724, @p725, @p726, @p727, 12), (@p728, @p729, @p730, @p731, @p732, @p733, @p734, @p735, @p736, @p737, @p738, @p739, @p740, @p741, @p742, @p743, @p744, @p745, @p746, @p747, @p748, @p749, @p750, @p751, @p752, @p753, @p754, @p755, @p756, @p757, @p758, @p759, @p760, @p761, @p762, @p763, @p764, @p765, @p766, @p767, @p768, @p769, @p770, @p771, @p772, @p773, @p774, @p775, @p776, @p777, @p778, @p779, @p780, @p781, @p782, @p783, 13), (@p784, @p785, @p786, @p787, @p788, @p789, @p790, @p791, @p792, @p793, @p794, @p795, @p796, @p797, @p798, @p799, @p800, @p801, @p802, @p803, @p804, @p805, @p806, @p807, @p808, @p809, @p810, @p811, @p812, @p813, @p814, @p815, @p816, @p817, @p818, @p819, @p820, @p821, @p822, @p823, @p824, @p825, @p826, @p827, @p828, @p829, @p830, @p831, @p832, @p833, @p834, @p835, @p836, @p837, @p838, @p839, 14), (@p840, @p841, @p842, @p843, @p844, @p845, @p846, @p847, @p848, @p849, @p850, @p851, @p852, @p853, @p854, @p855, @p856, @p857, @p858, @p859, @p860, @p861, @p862, @p863, @p864, @p865, @p866, @p867, @p868, @p869, @p870, @p871, @p872, @p873, @p874, @p875, @p876, @p877, @p878, @p879, @p880, @p881, @p882, @p883, @p884, @p885, @p886, @p887, @p888, @p889, @p890, @p891, @p892, @p893, @p894, @p895, 15), (@p896, @p897, @p898, @p899, @p900, @p901, @p902, @p903, @p904, @p905, @p906, @p907, @p908, @p909, @p910, @p911, @p912, @p913, @p914, @p915, @p916, @p917, @p918, @p919, @p920, @p921, @p922, @p923, @p924, @p925, @p926, @p927, @p928, @p929, @p930, @p931, @p932, @p933, @p934, @p935, @p936, @p937, @p938, @p939, @p940, @p941, @p942, @p943, @p944, @p945, @p946, @p947, @p948, @p949, @p950, @p951, 16), (@p952, @p953, @p954, @p955, @p956, @p957, @p958, @p959, @p960, @p961, @p962, @p963, @p964, @p965, @p966, @p967, @p968, @p969, @p970, @p971, @p972, @p973, @p974, @p975, @p976, @p977, @p978, @p979, @p980, @p981, @p982, @p983, @p984, @p985, @p986, @p987, @p988, @p989, @p990, @p991, @p992, @p993, @p994, @p995, @p996, @p997, @p998, @p999, @p1000, @p1001, @p1002, @p1003, @p1004, @p1005, @p1006, @p1007, 17), (@p1008, @p1009, @p1010, @p1011, @p1012, @p1013, @p1014, @p1015, @p1016, @p1017, @p1018, @p1019, @p1020, @p1021, @p1022, @p1023, @p1024, @p1025, @p1026, @p1027, @p1028, @p1029, @p1030, @p1031, @p1032, @p1033, @p1034, @p1035, @p1036, @p1037, @p1038, @p1039, @p1040, @p1041, @p1042, @p1043, @p1044, @p1045, @p1046, @p1047, @p1048, @p1049, @p1050, @p1051, @p1052, @p1053, @p1054, @p1055, @p1056, @p1057, @p1058, @p1059, @p1060, @p1061, @p1062, @p1063, 18), (@p1064, @p1065, @p1066, @p1067, @p1068, @p1069, @p1070, @p1071, @p1072, @p1073, @p1074, @p1075, @p1076, @p1077, @p1078, @p1079, @p1080, @p1081, @p1082, @p1083, @p1084, @p1085, @p1086, @p1087, @p1088, @p1089, @p1090, @p1091, @p1092, @p1093, @p1094, @p1095, @p1096, @p1097, @p1098, @p1099, @p1100, @p1101, @p1102, @p1103, @p1104, @p1105, @p1106, @p1107, @p1108, @p1109, @p1110, @p1111, @p1112, @p1113, @p1114, @p1115, @p1116, @p1117, @p1118, @p1119, 19), (@p1120, @p1121, @p1122, @p1123, @p1124, @p1125, @p1126, @p1127, @p1128, @p1129, @p1130, @p1131, @p1132, @p1133, @p1134, @p1135, @p1136, @p1137, @p1138, @p1139, @p1140, @p1141, @p1142, @p1143, @p1144, @p1145, @p1146, @p1147, @p1148, @p1149, @p1150, @p1151, @p1152, @p1153, @p1154, @p1155, @p1156, @p1157, @p1158, @p1159, @p1160, @p1161, @p1162, @p1163, @p1164, @p1165, @p1166, @p1167, @p1168, @p1169, @p1170, @p1171, @p1172, @p1173, @p1174, @p1175, 20), (@p1176, @p1177, @p1178, @p1179, @p1180, @p1181, @p1182, @p1183, @p1184, @p1185, @p1186, @p1187, @p1188, @p1189, @p1190, @p1191, @p1192, @p1193, @p1194, @p1195, @p1196, @p1197, @p1198, @p1199, @p1200, @p1201, @p1202, @p1203, @p1204, @p1205, @p1206, @p1207, @p1208, @p1209, @p1210, @p1211, @p1212, @p1213, @p1214, @p1215, @p1216, @p1217, @p1218, @p1219, @p1220, @p1221, @p1222, @p1223, @p1224, @p1225, @p1226, @p1227, @p1228, @p1229, @p1230, @p1231, 21), (@p1232, @p1233, @p1234, @p1235, @p1236, @p1237, @p1238, @p1239, @p1240, @p1241, @p1242, @p1243, @p1244, @p1245, @p1246, @p1247, @p1248, @p1249, @p1250, @p1251, @p1252, @p1253, @p1254, @p1255, @p1256, @p1257, @p1258, @p1259, @p1260, @p1261, @p1262, @p1263, @p1264, @p1265, @p1266, @p1267, @p1268, @p1269, @p1270, @p1271, @p1272, @p1273, @p1274, @p1275, @p1276, @p1277, @p1278, @p1279, @p1280, @p1281, @p1282, @p1283, @p1284, @p1285, @p1286, @p1287, 22), (@p1288, @p1289, @p1290, @p1291, @p1292, @p1293, @p1294, @p1295, @p1296, @p1297, @p1298, @p1299, @p1300, @p1301, @p1302, @p1303, @p1304, @p1305, @p1306, @p1307, @p1308, @p1309, @p1310, @p1311, @p1312, @p1313, @p1314, @p1315, @p1316, @p1317, @p1318, @p1319, @p1320, @p1321, @p1322, @p1323, @p1324, @p1325, @p1326, @p1327, @p1328, @p1329, @p1330, @p1331, @p1332, @p1333, @p1334, @p1335, @p1336, @p1337, @p1338, @p1339, @p1340, @p1341, @p1342, @p1343, 23), (@p1344, @p1345, @p1346, @p1347, @p1348, @p1349, @p1350, @p1351, @p1352, @p1353, @p1354, @p1355, @p1356, @p1357, @p1358, @p1359, @p1360, @p1361, @p1362, @p1363, @p1364, @p1365, @p1366, @p1367, @p1368, @p1369, @p1370, @p1371, @p1372, @p1373, @p1374, @p1375, @p1376, @p1377, @p1378, @p1379, @p1380, @p1381, @p1382, @p1383, @p1384, @p1385, @p1386, @p1387, @p1388, @p1389, @p1390, @p1391, @p1392, @p1393, @p1394, @p1395, @p1396, @p1397, @p1398, @p1399, 24), (@p1400, @p1401, @p1402, @p1403, @p1404, @p1405, @p1406, @p1407, @p1408, @p1409, @p1410, @p1411, @p1412, @p1413, @p1414, @p1415, @p1416, @p1417, @p1418, @p1419, @p1420, @p1421, @p1422, @p1423, @p1424, @p1425, @p1426, @p1427, @p1428, @p1429, @p1430, @p1431, @p1432, @p1433, @p1434, @p1435, @p1436, @p1437, @p1438, @p1439, @p1440, @p1441, @p1442, @p1443, @p1444, @p1445, @p1446, @p1447, @p1448, @p1449, @p1450, @p1451, @p1452, @p1453, @p1454, @p1455, 25), (@p1456, @p1457, @p1458, @p1459, @p1460, @p1461, @p1462, @p1463, @p1464, @p1465, @p1466, @p1467, @p1468, @p1469, @p1470, @p1471, @p1472, @p1473, @p1474, @p1475, @p1476, @p1477, @p1478, @p1479, @p1480, @p1481, @p1482, @p1483, @p1484, @p1485, @p1486, @p1487, @p1488, @p1489, @p1490, @p1491, @p1492, @p1493, @p1494, @p1495, @p1496, @p1497, @p1498, @p1499, @p1500, @p1501, @p1502, @p1503, @p1504, @p1505, @p1506, @p1507, @p1508, @p1509, @p1510, @p1511, 26), (@p1512, @p1513, @p1514, @p1515, @p1516, @p1517, @p1518, @p1519, @p1520, @p1521, @p1522, @p1523, @p1524, @p1525, @p1526, @p1527, @p1528, @p1529, @p1530, @p1531, @p1532, @p1533, @p1534, @p1535, @p1536, @p1537, @p1538, @p1539, @p1540, @p1541, @p1542, @p1543, @p1544, @p1545, @p1546, @p1547, @p1548, @p1549, @p1550, @p1551, @p1552, @p1553, @p1554, @p1555, @p1556, @p1557, @p1558, @p1559, @p1560, @p1561, @p1562, @p1563, @p1564, @p1565, @p1566, @p1567, 27), (@p1568, @p1569, @p1570, @p1571, @p1572, @p1573, @p1574, @p1575, @p1576, @p1577, @p1578, @p1579, @p1580, @p1581, @p1582, @p1583, @p1584, @p1585, @p1586, @p1587, @p1588, @p1589, @p1590, @p1591, @p1592, @p1593, @p1594, @p1595, @p1596, @p1597, @p1598, @p1599, @p1600, @p1601, @p1602, @p1603, @p1604, @p1605, @p1606, @p1607, @p1608, @p1609, @p1610, @p1611, @p1612, @p1613, @p1614, @p1615, @p1616, @p1617, @p1618, @p1619, @p1620, @p1621, @p1622, @p1623, 28), (@p1624, @p1625, @p1626, @p1627, @p1628, @p1629, @p1630, @p1631, @p1632, @p1633, @p1634, @p1635, @p1636, @p1637, @p1638, @p1639, @p1640, @p1641, @p1642, @p1643, @p1644, @p1645, @p1646, @p1647, @p1648, @p1649, @p1650, @p1651, @p1652, @p1653, @p1654, @p1655, @p1656, @p1657, @p1658, @p1659, @p1660, @p1661, @p1662, @p1663, @p1664, @p1665, @p1666, @p1667, @p1668, @p1669, @p1670, @p1671, @p1672, @p1673, @p1674, @p1675, @p1676, @p1677, @p1678, @p1679, 29), (@p1680, @p1681, @p1682, @p1683, @p1684, @p1685, @p1686, @p1687, @p1688, @p1689, @p1690, @p1691, @p1692, @p1693, @p1694, @p1695, @p1696, @p1697, @p1698, @p1699, @p1700, @p1701, @p1702, @p1703, @p1704, @p1705, @p1706, @p1707, @p1708, @p1709, @p1710, @p1711, @p1712, @p1713, @p1714, @p1715, @p1716, @p1717, @p1718, @p1719, @p1720, @p1721, @p1722, @p1723, @p1724, @p1725, @p1726, @p1727, @p1728, @p1729, @p1730, @p1731, @p1732, @p1733, @p1734, @p1735, 30), (@p1736, @p1737, @p1738, @p1739, @p1740, @p1741, @p1742, @p1743, @p1744, @p1745, @p1746, @p1747, @p1748, @p1749, @p1750, @p1751, @p1752, @p1753, @p1754, @p1755, @p1756, @p1757, @p1758, @p1759, @p1760, @p1761, @p1762, @p1763, @p1764, @p1765, @p1766, @p1767, @p1768, @p1769, @p1770, @p1771, @p1772, @p1773, @p1774, @p1775, @p1776, @p1777, @p1778, @p1779, @p1780, @p1781, @p1782, @p1783, @p1784, @p1785, @p1786, @p1787, @p1788, @p1789, @p1790, @p1791, 31), (@p1792, @p1793, @p1794, @p1795, @p1796, @p1797, @p1798, @p1799, @p1800, @p1801, @p1802, @p1803, @p1804, @p1805, @p1806, @p1807, @p1808, @p1809, @p1810, @p1811, @p1812, @p1813, @p1814, @p1815, @p1816, @p1817, @p1818, @p1819, @p1820, @p1821, @p1822, @p1823, @p1824, @p1825, @p1826, @p1827, @p1828, @p1829, @p1830, @p1831, @p1832, @p1833, @p1834, @p1835, @p1836, @p1837, @p1838, @p1839, @p1840, @p1841, @p1842, @p1843, @p1844, @p1845, @p1846, @p1847, 32), (@p1848, @p1849, @p1850, @p1851, @p1852, @p1853, @p1854, @p1855, @p1856, @p1857, @p1858, @p1859, @p1860, @p1861, @p1862, @p1863, @p1864, @p1865, @p1866, @p1867, @p1868, @p1869, @p1870, @p1871, @p1872, @p1873, @p1874, @p1875, @p1876, @p1877, @p1878, @p1879, @p1880, @p1881, @p1882, @p1883, @p1884, @p1885, @p1886, @p1887, @p1888, @p1889, @p1890, @p1891, @p1892, @p1893, @p1894, @p1895, @p1896, @p1897, @p1898, @p1899, @p1900, @p1901, @p1902, @p1903, 33), (@p1904, @p1905, @p1906, @p1907, @p1908, @p1909, @p1910, @p1911, @p1912, @p1913, @p1914, @p1915, @p1916, @p1917, @p1918, @p1919, @p1920, @p1921, @p1922, @p1923, @p1924, @p1925, @p1926, @p1927, @p1928, @p1929, @p1930, @p1931, @p1932, @p1933, @p1934, @p1935, @p1936, @p1937, @p1938, @p1939, @p1940, @p1941, @p1942, @p1943, @p1944, @p1945, @p1946, @p1947, @p1948, @p1949, @p1950, @p1951, @p1952, @p1953, @p1954, @p1955, @p1956, @p1957, @p1958, @p1959, 34)) AS i ([addressee_cntry_cd], [addressee_city], [addressee_district], [addressee_email], [addressee_full_address], [addressee_home_address], [addressee_name], [addressee_postcode], [addressee_province], [addressee_subdistrict], [addressee_tel], [create_table], [delivery_code], [delivery_recipient_name], [delivery_relation_id], [delivery_status_id], [dest_outlet_id], [dest_outlet_port], [document_number], [item_barcode], [item_cod], [item_gross_weight], [item_height], [item_length], [item_price], [item_width], [lat], [log_id], [long], [outlet_id], [outlet_port], [podUrl], [remark], [scan_cntry_cd], [scan_cntry_postcode], [sender_cntry_cd], [sender_district], [sender_email], [sender_full_address], [sender_home_address], [member_id], [sender_name], [sender_postcode], [sender_province], [sender_subdistrict], [sender_tel], [server_id], [signatureUrl], [state], [status_code], [status_dtm], [timestamp], [transmit_dtm], [user_id], [wckt_id], [wkstn_no], _Position) ON 1=0 WHEN NOT MATCHED THEN INSERT ([addressee_cntry_cd], [addressee_city], [addressee_district], [addressee_email], [addressee_full_address], [addressee_home_address], [addressee_name], [addressee_postcode], [addressee_province], [addressee_subdistrict], [addressee_tel], [create_table], [delivery_code], [delivery_recipient_name], [delivery_relation_id], [delivery_status_id], [dest_outlet_id], [dest_outlet_port], [document_number], [item_barcode], [item_cod], [item_gross_weight], [item_height], [item_length], [item_price], [item_width], [lat], [log_id], [long], [outlet_id], [outlet_port], [podUrl], [remark], [scan_cntry_cd], [scan_cntry_postcode], [sender_cntry_cd], [sender_district], [sender_email], [sender_full_address], [sender_home_address], [member_id], [sender_name], [sender_postcode], [sender_province], [sender_subdistrict], [sender_tel], [server_id], [signatureUrl], [state], [status_code], [status_dtm], [timestamp], [transmit_dtm], [user_id], [wckt_id], [wkstn_no]) VALUES (i.[addressee_cntry_cd], i.[addressee_city], i.[addressee_district], i.[addressee_email], i.[addressee_full_address], i.[addressee_home_address], i.[addressee_name], i.[addressee_postcode], i.[addressee_province], i.[addressee_subdistrict], i.[addressee_tel], i.[create_table], i.[delivery_code], i.[delivery_recipient_name], i.[delivery_relation_id], i.[delivery_status_id], i.[dest_outlet_id], i.[dest_outlet_port], i.[document_number], i.[item_barcode], i.[item_cod], i.[item_gross_weight], i.[item_height], i.[item_length], i.[item_price], i.[item_width], i.[lat], i.[log_id], i.[long], i.[outlet_id], i.[outlet_port], i.[podUrl], i.[remark], i.[scan_cntry_cd], i.[scan_cntry_postcode], i.[sender_cntry_cd], i.[sender_district], i.[sender_email], i.[sender_full_address], i.[sender_home_address], i.[member_id], i.[sender_name], i.[sender_postcode], i.[sender_province], i.[sender_subdistrict], i.[sender_tel], i.[server_id], i.[signatureUrl], i.[state], i.[status_code], i.[status_dtm], i.[timestamp], i.[transmit_dtm], i.[user_id], i.[wckt_id], i.[wkstn_no]) OUTPUT INSERTED.[item_id], i._Position INTO @inserted0;  SELECT [t].[item_id] FROM [raw_data] t INNER JOIN @inserted0 i ON ([t].[item_id] = [i].[item_id]) ORDER BY [i].[_Position];  ",4,4,0,414,14,4
"(@p0 nvarchar(4000),@p1 nvarchar(4000),@p2 nvarchar(4000),@p3 nvarchar(4000),@p4 nvarchar(4000),@p5 nvarchar(4000),@p6 nvarchar(4000),@p7 nvarchar(4000),@p8 nvarchar(4000),@p9 nvarchar(4000),@p10 nvarchar(4000),@p11 datetime2(7),@p12 nvarchar(4000),@p13 nvarchar(4000),@p14 int,@p15 int,@p16 int,@p17 nvarchar(4000),@p18 nvarchar(4000),@p19 nvarchar(4000),@p20 decimal(18,2),@p21 decimal(18,2),@p22 nvarchar(4000),@p23 nvarchar(4000),@p24 decimal(18,2),@p25 nvarchar(4000),@p26 nvarchar(4000),@p27 nvarchar(4000),@p28 nvarchar(4000),@p29 int,@p30 nvarchar(4000),@p31 nvarchar(4000),@p32 nvarchar(4000),@p33 nvarchar(4000),@p34 nvarchar(4000),@p35 nvarchar(4000),@p36 nvarchar(4000),@p37 nvarchar(4000),@p38 nvarchar(4000),@p39 nvarchar(4000),@p40 int,@p41 nvarchar(4000),@p42 nvarchar(4000),@p43 nvarchar(4000),@p44 nvarchar(4000),@p45 nvarchar(4000),@p46 int,@p47 nvarchar(4000),@p48 int,@p49 int,@p50 datetime2(7),@p51 datetime2(7),@p52 datetime2(7),@p53 nvarchar(4000),@p54 nvarchar(4000),@p55 nvarchar(4000),@p56 nvarchar(4000),@p57 nvarchar(4000),@p58 nvarchar(4000),@p59 nvarchar(4000),@p60 nvarchar(4000),@p61 nvarchar(4000),@p62 nvarchar(4000),@p63 nvarchar(4000),@p64 nvarchar(4000),@p65 nvarchar(4000),@p66 nvarchar(4000),@p67 datetime2(7),@p68 nvarchar(4000),@p69 nvarchar(4000),@p70 int,@p71 int,@p72 int,@p73 nvarchar(4000),@p74 nvarchar(4000),@p75 nvarchar(4000),@p76 decimal(18,2),@p77 decimal(18,2),@p78 nvarchar(4000),@p79 nvarchar(4000),@p80 decimal(18,2),@p81 nvarchar(4000),@p82 nvarchar(4000),@p83 nvarchar(4000),@p84 nvarchar(4000),@p85 int,@p86 nvarchar(4000),@p87 nvarchar(4000),@p88 nvarchar(4000),@p89 nvarchar(4000),@p90 nvarchar(4000),@p91 nvarchar(4000),@p92 nvarchar(4000),@p93 nvarchar(4000),@p94 nvarchar(4000),@p95 nvarchar(4000),@p96 int,@p97 nvarchar(4000),@p98 nvarchar(4000),@p99 nvarchar(4000),@p100 nvarchar(4000),@p101 nvarchar(4000),@p102 int,@p103 nvarchar(4000),@p104 int,@p105 int,@p106 datetime2(7),@p107 datetime2(7),@p108 datetime2(7),@p109 nvarchar(4000),@p110 nvarchar(4000),@p111 nvarchar(4000),@p112 nvarchar(4000),@p113 nvarchar(4000),@p114 nvarchar(4000),@p115 nvarchar(4000),@p116 nvarchar(4000),@p117 nvarchar(4000),@p118 nvarchar(4000),@p119 nvarchar(4000),@p120 nvarchar(4000),@p121 nvarchar(4000),@p122 nvarchar(4000),@p123 datetime2(7),@p124 nvarchar(4000),@p125 nvarchar(4000),@p126 int,@p127 int,@p128 int,@p129 nvarchar(4000),@p130 nvarchar(4000),@p131 nvarchar(4000),@p132 decimal(18,2),@p133 decimal(18,2),@p134 nvarchar(4000),@p135 nvarchar(4000),@p136 decimal(18,2),@p137 nvarchar(4000),@p138 nvarchar(4000),@p139 nvarchar(4000),@p140 nvarchar(4000),@p141 int,@p142 nvarchar(4000),@p143 nvarchar(4000),@p144 nvarchar(4000),@p145 nvarchar(4000),@p146 nvarchar(4000),@p147 nvarchar(4000),@p148 nvarchar(4000),@p149 nvarchar(4000),@p150 nvarchar(4000),@p151 nvarchar(4000),@p152 int,@p153 nvarchar(4000),@p154 nvarchar(4000),@p155 nvarchar(4000),@p156 nvarchar(4000),@p157 nvarchar(4000),@p158 int,@p159 nvarchar(4000),@p160 int,@p161 int,@p162 datetime2(7),@p163 datetime2(7),@p164 datetime2(7),@p165 nvarchar(4000),@p166 nvarchar(4000),@p167 nvarchar(4000),@p168 nvarchar(4000),@p169 nvarchar(4000),@p170 nvarchar(4000),@p171 nvarchar(4000),@p172 nvarchar(4000),@p173 nvarchar(4000),@p174 nvarchar(4000),@p175 nvarchar(4000),@p176 nvarchar(4000),@p177 nvarchar(4000),@p178 nvarchar(4000),@p179 datetime2(7),@p180 nvarchar(4000),@p181 nvarchar(4000),@p182 int,@p183 int,@p184 int,@p185 nvarchar(4000),@p186 nvarchar(4000),@p187 nvarchar(4000),@p188 decimal(18,2),@p189 decimal(18,2),@p190 nvarchar(4000),@p191 nvarchar(4000),@p192 decimal(18,2),@p193 nvarchar(4000),@p194 nvarchar(4000),@p195 nvarchar(4000),@p196 nvarchar(4000),@p197 int,@p198 nvarchar(4000),@p199 nvarchar(4000),@p200 nvarchar(4000),@p201 nvarchar(4000),@p202 nvarchar(4000),@p203 nvarchar(4000),@p204 nvarchar(4000),@p205 nvarchar(4000),@p206 nvarchar(4000),@p207 nvarchar(4000),@p208 int,@p209 nvarchar(4000),@p210 nvarchar(4000),@p211 nvarchar(4000),@p212 nvarchar(4000),@p213 nvarchar(4000),@p214 int,@p215 nvarchar(4000),@p216 int,@p217 int,@p218 datetime2(7),@p219 datetime2(7),@p220 datetime2(7),@p221 nvarchar(4000),@p222 nvarchar(4000),@p223 nvarchar(4000),@p224 nvarchar(4000),@p225 nvarchar(4000),@p226 nvarchar(4000),@p227 nvarchar(4000),@p228 nvarchar(4000),@p229 nvarchar(4000),@p230 nvarchar(4000),@p231 nvarchar(4000),@p232 nvarchar(4000),@p233 nvarchar(4000),@p234 nvarchar(4000),@p235 datetime2(7),@p236 nvarchar(4000),@p237 nvarchar(4000),@p238 int,@p239 int,@p240 int,@p241 nvarchar(4000),@p242 nvarchar(4000),@p243 nvarchar(4000),@p244 decimal(18,2),@p245 decimal(18,2),@p246 nvarchar(4000),@p247 nvarchar(4000),@p248 decimal(18,2),@p249 nvarchar(4000),@p250 nvarchar(4000),@p251 nvarchar(4000),@p252 nvarchar(4000),@p253 int,@p254 nvarchar(4000),@p255 nvarchar(4000),@p256 nvarchar(4000),@p257 nvarchar(4000),@p258 nvarchar(4000),@p259 nvarchar(4000),@p260 nvarchar(4000),@p261 nvarchar(4000),@p262 nvarchar(4000),@p263 nvarchar(4000),@p264 int,@p265 nvarchar(4000),@p266 nvarchar(4000),@p267 nvarchar(4000),@p268 nvarchar(4000),@p269 nvarchar(4000),@p270 int,@p271 nvarchar(4000),@p272 int,@p273 int,@p274 datetime2(7),@p275 datetime2(7),@p276 datetime2(7),@p277 nvarchar(4000),@p278 nvarchar(4000),@p279 nvarchar(4000),@p280 nvarchar(4000),@p281 nvarchar(4000),@p282 nvarchar(4000),@p283 nvarchar(4000),@p284 nvarchar(4000),@p285 nvarchar(4000),@p286 nvarchar(4000),@p287 nvarchar(4000),@p288 nvarchar(4000),@p289 nvarchar(4000),@p290 nvarchar(4000),@p291 datetime2(7),@p292 nvarchar(4000),@p293 nvarchar(4000),@p294 int,@p295 int,@p296 int,@p297 nvarchar(4000),@p298 nvarchar(4000),@p299 nvarchar(4000),@p300 decimal(18,2),@p301 decimal(18,2),@p302 nvarchar(4000),@p303 nvarchar(4000),@p304 decimal(18,2),@p305 nvarchar(4000),@p306 nvarchar(4000),@p307 nvarchar(4000),@p308 nvarchar(4000),@p309 int,@p310 nvarchar(4000),@p311 nvarchar(4000),@p312 nvarchar(4000),@p313 nvarchar(4000),@p314 nvarchar(4000),@p315 nvarchar(4000),@p316 nvarchar(4000),@p317 nvarchar(4000),@p318 nvarchar(4000),@p319 nvarchar(4000),@p320 int,@p321 nvarchar(4000),@p322 nvarchar(4000),@p323 nvarchar(4000),@p324 nvarchar(4000),@p325 nvarchar(4000),@p326 int,@p327 nvarchar(4000),@p328 int,@p329 int,@p330 datetime2(7),@p331 datetime2(7),@p332 datetime2(7),@p333 nvarchar(4000),@p334 nvarchar(4000),@p335 nvarchar(4000),@p336 nvarchar(4000),@p337 nvarchar(4000),@p338 nvarchar(4000),@p339 nvarchar(4000),@p340 nvarchar(4000),@p341 nvarchar(4000),@p342 nvarchar(4000),@p343 nvarchar(4000),@p344 nvarchar(4000),@p345 nvarchar(4000),@p346 nvarchar(4000),@p347 datetime2(7),@p348 nvarchar(4000),@p349 nvarchar(4000),@p350 int,@p351 int,@p352 int,@p353 nvarchar(4000),@p354 nvarchar(4000),@p355 nvarchar(4000),@p356 decimal(18,2),@p357 decimal(18,2),@p358 nvarchar(4000),@p359 nvarchar(4000),@p360 decimal(18,2),@p361 nvarchar(4000),@p362 nvarchar(4000),@p363 nvarchar(4000),@p364 nvarchar(4000),@p365 int,@p366 nvarchar(4000),@p367 nvarchar(4000),@p368 nvarchar(4000),@p369 nvarchar(4000),@p370 nvarchar(4000),@p371 nvarchar(4000),@p372 nvarchar(4000),@p373 nvarchar(4000),@p374 nvarchar(4000),@p375 nvarchar(4000),@p376 int,@p377 nvarchar(4000),@p378 nvarchar(4000),@p379 nvarchar(4000),@p380 nvarchar(4000),@p381 nvarchar(4000),@p382 int,@p383 nvarchar(4000),@p384 int,@p385 int,@p386 datetime2(7),@p387 datetime2(7),@p388 datetime2(7),@p389 nvarchar(4000),@p390 nvarchar(4000),@p391 nvarchar(4000),@p392 nvarchar(4000),@p393 nvarchar(4000),@p394 nvarchar(4000),@p395 nvarchar(4000),@p396 nvarchar(4000),@p397 nvarchar(4000),@p398 nvarchar(4000),@p399 nvarchar(4000),@p400 nvarchar(4000),@p401 nvarchar(4000),@p402 nvarchar(4000),@p403 datetime2(7),@p404 nvarchar(4000),@p405 nvarchar(4000),@p406 int,@p407 int,@p408 int,@p409 nvarchar(4000),@p410 nvarchar(4000),@p411 nvarchar(4000),@p412 decimal(18,2),@p413 decimal(18,2),@p414 nvarchar(4000),@p415 nvarchar(4000),@p416 decimal(18,2),@p417 nvarchar(4000),@p418 nvarchar(4000),@p419 nvarchar(4000),@p420 nvarchar(4000),@p421 int,@p422 nvarchar(4000),@p423 nvarchar(4000),@p424 nvarchar(4000),@p425 nvarchar(4000),@p426 nvarchar(4000),@p427 nvarchar(4000),@p428 nvarchar(4000),@p429 nvarchar(4000),@p430 nvarchar(4000),@p431 nvarchar(4000),@p432 int,@p433 nvarchar(4000),@p434 nvarchar(4000),@p435 nvarchar(4000),@p436 nvarchar(4000),@p437 nvarchar(4000),@p438 int,@p439 nvarchar(4000),@p440 int,@p441 int,@p442 datetime2(7),@p443 datetime2(7),@p444 datetime2(7),@p445 nvarchar(4000),@p446 nvarchar(4000),@p447 nvarchar(4000),@p448 nvarchar(4000),@p449 nvarchar(4000),@p450 nvarchar(4000),@p451 nvarchar(4000),@p452 nvarchar(4000),@p453 nvarchar(4000),@p454 nvarchar(4000),@p455 nvarchar(4000),@p456 nvarchar(4000),@p457 nvarchar(4000),@p458 nvarchar(4000),@p459 datetime2(7),@p460 nvarchar(4000),@p461 nvarchar(4000),@p462 int,@p463 int,@p464 int,@p465 nvarchar(4000),@p466 nvarchar(4000),@p467 nvarchar(4000),@p468 decimal(18,2),@p469 decimal(18,2),@p470 nvarchar(4000),@p471 nvarchar(4000),@p472 decimal(18,2),@p473 nvarchar(4000),@p474 nvarchar(4000),@p475 nvarchar(4000),@p476 nvarchar(4000),@p477 int,@p478 nvarchar(4000),@p479 nvarchar(4000),@p480 nvarchar(4000),@p481 nvarchar(4000),@p482 nvarchar(4000),@p483 nvarchar(4000),@p484 nvarchar(4000),@p485 nvarchar(4000),@p486 nvarchar(4000),@p487 nvarchar(4000),@p488 int,@p489 nvarchar(4000),@p490 nvarchar(4000),@p491 nvarchar(4000),@p492 nvarchar(4000),@p493 nvarchar(4000),@p494 int,@p495 nvarchar(4000),@p496 int,@p497 int,@p498 datetime2(7),@p499 datetime2(7),@p500 datetime2(7),@p501 nvarchar(4000),@p502 nvarchar(4000),@p503 nvarchar(4000),@p504 nvarchar(4000),@p505 nvarchar(4000),@p506 nvarchar(4000),@p507 nvarchar(4000),@p508 nvarchar(4000),@p509 nvarchar(4000),@p510 nvarchar(4000),@p511 nvarchar(4000),@p512 nvarchar(4000),@p513 nvarchar(4000),@p514 nvarchar(4000),@p515 datetime2(7),@p516 nvarchar(4000),@p517 nvarchar(4000),@p518 int,@p519 int,@p520 int,@p521 nvarchar(4000),@p522 nvarchar(4000),@p523 nvarchar(4000),@p524 decimal(18,2),@p525 decimal(18,2),@p526 nvarchar(4000),@p527 nvarchar(4000),@p528 decimal(18,2),@p529 nvarchar(4000),@p530 nvarchar(4000),@p531 nvarchar(4000),@p532 nvarchar(4000),@p533 int,@p534 nvarchar(4000),@p535 nvarchar(4000),@p536 nvarchar(4000),@p537 nvarchar(4000),@p538 nvarchar(4000),@p539 nvarchar(4000),@p540 nvarchar(4000),@p541 nvarchar(4000),@p542 nvarchar(4000),@p543 nvarchar(4000),@p544 int,@p545 nvarchar(4000),@p546 nvarchar(4000),@p547 nvarchar(4000),@p548 nvarchar(4000),@p549 nvarchar(4000),@p550 int,@p551 nvarchar(4000),@p552 int,@p553 int,@p554 datetime2(7),@p555 datetime2(7),@p556 datetime2(7),@p557 nvarchar(4000),@p558 nvarchar(4000),@p559 nvarchar(4000),@p560 nvarchar(4000),@p561 nvarchar(4000),@p562 nvarchar(4000),@p563 nvarchar(4000),@p564 nvarchar(4000),@p565 nvarchar(4000),@p566 nvarchar(4000),@p567 nvarchar(4000),@p568 nvarchar(4000),@p569 nvarchar(4000),@p570 nvarchar(4000),@p571 datetime2(7),@p572 nvarchar(4000),@p573 nvarchar(4000),@p574 int,@p575 int,@p576 int,@p577 nvarchar(4000),@p578 nvarchar(4000),@p579 nvarchar(4000),@p580 decimal(18,2),@p581 decimal(18,2),@p582 nvarchar(4000),@p583 nvarchar(4000),@p584 decimal(18,2),@p585 nvarchar(4000),@p586 nvarchar(4000),@p587 nvarchar(4000),@p588 nvarchar(4000),@p589 int,@p590 nvarchar(4000),@p591 nvarchar(4000),@p592 nvarchar(4000),@p593 nvarchar(4000),@p594 nvarchar(4000),@p595 nvarchar(4000),@p596 nvarchar(4000),@p597 nvarchar(4000),@p598 nvarchar(4000),@p599 nvarchar(4000),@p600 int,@p601 nvarchar(4000),@p602 nvarchar(4000),@p603 nvarchar(4000),@p604 nvarchar(4000),@p605 nvarchar(4000),@p606 int,@p607 nvarchar(4000),@p608 int,@p609 int,@p610 datetime2(7),@p611 datetime2(7),@p612 datetime2(7),@p613 nvarchar(4000),@p614 nvarchar(4000),@p615 nvarchar(4000),@p616 nvarchar(4000),@p617 nvarchar(4000),@p618 nvarchar(4000),@p619 nvarchar(4000),@p620 nvarchar(4000),@p621 nvarchar(4000),@p622 nvarchar(4000),@p623 nvarchar(4000),@p624 nvarchar(4000),@p625 nvarchar(4000),@p626 nvarchar(4000),@p627 datetime2(7),@p628 nvarchar(4000),@p629 nvarchar(4000),@p630 int,@p631 int,@p632 int,@p633 nvarchar(4000),@p634 nvarchar(4000),@p635 nvarchar(4000),@p636 decimal(18,2),@p637 decimal(18,2),@p638 nvarchar(4000),@p639 nvarchar(4000),@p640 decimal(18,2),@p641 nvarchar(4000),@p642 nvarchar(4000),@p643 nvarchar(4000),@p644 nvarchar(4000),@p645 int,@p646 nvarchar(4000),@p647 nvarchar(4000),@p648 nvarchar(4000),@p649 nvarchar(4000),@p650 nvarchar(4000),@p651 nvarchar(4000),@p652 nvarchar(4000),@p653 nvarchar(4000),@p654 nvarchar(4000),@p655 nvarchar(4000),@p656 int,@p657 nvarchar(4000),@p658 nvarchar(4000),@p659 nvarchar(4000),@p660 nvarchar(4000),@p661 nvarchar(4000),@p662 int,@p663 nvarchar(4000),@p664 int,@p665 int,@p666 datetime2(7),@p667 datetime2(7),@p668 datetime2(7),@p669 nvarchar(4000),@p670 nvarchar(4000),@p671 nvarchar(4000),@p672 nvarchar(4000),@p673 nvarchar(4000),@p674 nvarchar(4000),@p675 nvarchar(4000),@p676 nvarchar(4000),@p677 nvarchar(4000),@p678 nvarchar(4000),@p679 nvarchar(4000),@p680 nvarchar(4000),@p681 nvarchar(4000),@p682 nvarchar(4000),@p683 datetime2(7),@p684 nvarchar(4000),@p685 nvarchar(4000),@p686 int,@p687 int,@p688 int,@p689 nvarchar(4000),@p690 nvarchar(4000),@p691 nvarchar(4000),@p692 decimal(18,2),@p693 decimal(18,2),@p694 nvarchar(4000),@p695 nvarchar(4000),@p696 decimal(18,2),@p697 nvarchar(4000),@p698 nvarchar(4000),@p699 nvarchar(4000),@p700 nvarchar(4000),@p701 int,@p702 nvarchar(4000),@p703 nvarchar(4000),@p704 nvarchar(4000),@p705 nvarchar(4000),@p706 nvarchar(4000),@p707 nvarchar(4000),@p708 nvarchar(4000),@p709 nvarchar(4000),@p710 nvarchar(4000),@p711 nvarchar(4000),@p712 int,@p713 nvarchar(4000),@p714 nvarchar(4000),@p715 nvarchar(4000),@p716 nvarchar(4000),@p717 nvarchar(4000),@p718 int,@p719 nvarchar(4000),@p720 int,@p721 int,@p722 datetime2(7),@p723 datetime2(7),@p724 datetime2(7),@p725 nvarchar(4000),@p726 nvarchar(4000),@p727 nvarchar(4000),@p728 nvarchar(4000),@p729 nvarchar(4000),@p730 nvarchar(4000),@p731 nvarchar(4000),@p732 nvarchar(4000),@p733 nvarchar(4000),@p734 nvarchar(4000),@p735 nvarchar(4000),@p736 nvarchar(4000),@p737 nvarchar(4000),@p738 nvarchar(4000),@p739 datetime2(7),@p740 nvarchar(4000),@p741 nvarchar(4000),@p742 int,@p743 int,@p744 int,@p745 nvarchar(4000),@p746 nvarchar(4000),@p747 nvarchar(4000),@p748 nvarchar(4000),@p749 decimal(18,2),@p750 nvarchar(4000),@p751 nvarchar(4000),@p752 decimal(18,2),@p753 nvarchar(4000),@p754 nvarchar(4000),@p755 nvarchar(4000),@p756 nvarchar(4000),@p757 int,@p758 nvarchar(4000),@p759 nvarchar(4000),@p760 nvarchar(4000),@p761 nvarchar(4000),@p762 nvarchar(4000),@p763 nvarchar(4000),@p764 nvarchar(4000),@p765 nvarchar(4000),@p766 nvarchar(4000),@p767 nvarchar(4000),@p768 int,@p769 nvarchar(4000),@p770 nvarchar(4000),@p771 nvarchar(4000),@p772 nvarchar(4000),@p773 nvarchar(4000),@p774 int,@p775 nvarchar(4000),@p776 int,@p777 int,@p778 datetime2(7),@p779 datetime2(7),@p780 datetime2(7),@p781 nvarchar(4000),@p782 nvarchar(4000),@p783 nvarchar(4000),@p784 nvarchar(4000),@p785 nvarchar(4000),@p786 nvarchar(4000),@p787 nvarchar(4000),@p788 nvarchar(4000),@p789 nvarchar(4000),@p790 nvarchar(4000),@p791 nvarchar(4000),@p792 nvarchar(4000),@p793 nvarchar(4000),@p794 nvarchar(4000),@p795 datetime2(7),@p796 nvarchar(4000),@p797 nvarchar(4000),@p798 int,@p799 int,@p800 int,@p801 nvarchar(4000),@p802 nvarchar(4000),@p803 nvarchar(4000),@p804 decimal(18,2),@p805 decimal(18,2),@p806 nvarchar(4000),@p807 nvarchar(4000),@p808 decimal(18,2),@p809 nvarchar(4000),@p810 nvarchar(4000),@p811 nvarchar(4000),@p812 nvarchar(4000),@p813 int,@p814 nvarchar(4000),@p815 nvarchar(4000),@p816 nvarchar(4000),@p817 nvarchar(4000),@p818 nvarchar(4000),@p819 nvarchar(4000),@p820 nvarchar(4000),@p821 nvarchar(4000),@p822 nvarchar(4000),@p823 nvarchar(4000),@p824 int,@p825 nvarchar(4000),@p826 nvarchar(4000),@p827 nvarchar(4000),@p828 nvarchar(4000),@p829 nvarchar(4000),@p830 int,@p831 nvarchar(4000),@p832 int,@p833 int,@p834 datetime2(7),@p835 datetime2(7),@p836 datetime2(7),@p837 nvarchar(4000),@p838 nvarchar(4000),@p839 nvarchar(4000),@p840 nvarchar(4000),@p841 nvarchar(4000),@p842 nvarchar(4000),@p843 nvarchar(4000),@p844 nvarchar(4000),@p845 nvarchar(4000),@p846 nvarchar(4000),@p847 nvarchar(4000),@p848 nvarchar(4000),@p849 nvarchar(4000),@p850 nvarchar(4000),@p851 datetime2(7),@p852 nvarchar(4000),@p853 nvarchar(4000),@p854 int,@p855 int,@p856 int,@p857 nvarchar(4000),@p858 nvarchar(4000),@p859 nvarchar(4000),@p860 decimal(18,2),@p861 decimal(18,2),@p862 nvarchar(4000),@p863 nvarchar(4000),@p864 decimal(18,2),@p865 nvarchar(4000),@p866 nvarchar(4000),@p867 nvarchar(4000),@p868 nvarchar(4000),@p869 int,@p870 nvarchar(4000),@p871 nvarchar(4000),@p872 nvarchar(4000),@p873 nvarchar(4000),@p874 nvarchar(4000),@p875 nvarchar(4000),@p876 nvarchar(4000),@p877 nvarchar(4000),@p878 nvarchar(4000),@p879 nvarchar(4000),@p880 int,@p881 nvarchar(4000),@p882 nvarchar(4000),@p883 nvarchar(4000),@p884 nvarchar(4000),@p885 nvarchar(4000),@p886 int,@p887 nvarchar(4000),@p888 int,@p889 int,@p890 datetime2(7),@p891 datetime2(7),@p892 datetime2(7),@p893 nvarchar(4000),@p894 nvarchar(4000),@p895 nvarchar(4000),@p896 nvarchar(4000),@p897 nvarchar(4000),@p898 nvarchar(4000),@p899 nvarchar(4000),@p900 nvarchar(4000),@p901 nvarchar(4000),@p902 nvarchar(4000),@p903 nvarchar(4000),@p904 nvarchar(4000),@p905 nvarchar(4000),@p906 nvarchar(4000),@p907 datetime2(7),@p908 nvarchar(4000),@p909 nvarchar(4000),@p910 int,@p911 int,@p912 int,@p913 nvarchar(4000),@p914 nvarchar(4000),@p915 nvarchar(4000),@p916 decimal(18,2),@p917 decimal(18,2),@p918 nvarchar(4000),@p919 nvarchar(4000),@p920 decimal(18,2),@p921 nvarchar(4000),@p922 nvarchar(4000),@p923 nvarchar(4000),@p924 nvarchar(4000),@p925 int,@p926 nvarchar(4000),@p927 nvarchar(4000),@p928 nvarchar(4000),@p929 nvarchar(4000),@p930 nvarchar(4000),@p931 nvarchar(4000),@p932 nvarchar(4000),@p933 nvarchar(4000),@p934 nvarchar(4000),@p935 nvarchar(4000),@p936 int,@p937 nvarchar(4000),@p938 nvarchar(4000),@p939 nvarchar(4000),@p940 nvarchar(4000),@p941 nvarchar(4000),@p942 int,@p943 nvarchar(4000),@p944 int,@p945 int,@p946 datetime2(7),@p947 datetime2(7),@p948 datetime2(7),@p949 nvarchar(4000),@p950 nvarchar(4000),@p951 nvarchar(4000),@p952 nvarchar(4000),@p953 nvarchar(4000),@p954 nvarchar(4000),@p955 nvarchar(4000),@p956 nvarchar(4000),@p957 nvarchar(4000),@p958 nvarchar(4000),@p959 nvarchar(4000),@p960 nvarchar(4000),@p961 nvarchar(4000),@p962 nvarchar(4000),@p963 datetime2(7),@p964 nvarchar(4000),@p965 nvarchar(4000),@p966 int,@p967 int,@p968 int,@p969 nvarchar(4000),@p970 nvarchar(4000),@p971 nvarchar(4000),@p972 decimal(18,2),@p973 decimal(18,2),@p974 nvarchar(4000),@p975 nvarchar(4000),@p976 decimal(18,2),@p977 nvarchar(4000),@p978 nvarchar(4000),@p979 nvarchar(4000),@p980 nvarchar(4000),@p981 int,@p982 nvarchar(4000),@p983 nvarchar(4000),@p984 nvarchar(4000),@p985 nvarchar(4000),@p986 nvarchar(4000),@p987 nvarchar(4000),@p988 nvarchar(4000),@p989 nvarchar(4000),@p990 nvarchar(4000),@p991 nvarchar(4000),@p992 int,@p993 nvarchar(4000),@p994 nvarchar(4000),@p995 nvarchar(4000),@p996 nvarchar(4000),@p997 nvarchar(4000),@p998 int,@p999 nvarchar(4000),@p1000 int,@p1001 int,@p1002 datetime2(7),@p1003 datetime2(7),@p1004 datetime2(7),@p1005 nvarchar(4000),@p1006 nvarchar(4000),@p1007 nvarchar(4000),@p1008 nvarchar(4000),@p1009 nvarchar(4000),@p1010 nvarchar(4000),@p1011 nvarchar(4000),@p1012 nvarchar(4000),@p1013 nvarchar(4000),@p1014 nvarchar(4000),@p1015 nvarchar(4000),@p1016 nvarchar(4000),@p1017 nvarchar(4000),@p1018 nvarchar(4000),@p1019 datetime2(7),@p1020 nvarchar(4000),@p1021 nvarchar(4000),@p1022 int,@p1023 int,@p1024 int,@p1025 nvarchar(4000),@p1026 nvarchar(4000),@p1027 nvarchar(4000),@p1028 decimal(18,2),@p1029 decimal(18,2),@p1030 nvarchar(4000),@p1031 nvarchar(4000),@p1032 decimal(18,2),@p1033 nvarchar(4000),@p1034 nvarchar(4000),@p1035 nvarchar(4000),@p1036 nvarchar(4000),@p1037 int,@p1038 nvarchar(4000),@p1039 nvarchar(4000),@p1040 nvarchar(4000),@p1041 nvarchar(4000),@p1042 nvarchar(4000),@p1043 nvarchar(4000),@p1044 nvarchar(4000),@p1045 nvarchar(4000),@p1046 nvarchar(4000),@p1047 nvarchar(4000),@p1048 int,@p1049 nvarchar(4000),@p1050 nvarchar(4000),@p1051 nvarchar(4000),@p1052 nvarchar(4000),@p1053 nvarchar(4000),@p1054 int,@p1055 nvarchar(4000),@p1056 int,@p1057 int,@p1058 datetime2(7),@p1059 datetime2(7),@p1060 datetime2(7),@p1061 nvarchar(4000),@p1062 nvarchar(4000),@p1063 nvarchar(4000),@p1064 nvarchar(4000),@p1065 nvarchar(4000),@p1066 nvarchar(4000),@p1067 nvarchar(4000),@p1068 nvarchar(4000),@p1069 nvarchar(4000),@p1070 nvarchar(4000),@p1071 nvarchar(4000),@p1072 nvarchar(4000),@p1073 nvarchar(4000),@p1074 nvarchar(4000),@p1075 datetime2(7),@p1076 nvarchar(4000),@p1077 nvarchar(4000),@p1078 int,@p1079 int,@p1080 int,@p1081 nvarchar(4000),@p1082 nvarchar(4000),@p1083 nvarchar(4000),@p1084 nvarchar(4000),@p1085 decimal(18,2),@p1086 nvarchar(4000),@p1087 nvarchar(4000),@p1088 decimal(18,2),@p1089 nvarchar(4000),@p1090 nvarchar(4000),@p1091 nvarchar(4000),@p1092 nvarchar(4000),@p1093 int,@p1094 nvarchar(4000),@p1095 nvarchar(4000),@p1096 nvarchar(4000),@p1097 nvarchar(4000),@p1098 nvarchar(4000),@p1099 nvarchar(4000),@p1100 nvarchar(4000),@p1101 nvarchar(4000),@p1102 nvarchar(4000),@p1103 nvarchar(4000),@p1104 int,@p1105 nvarchar(4000),@p1106 nvarchar(4000),@p1107 nvarchar(4000),@p1108 nvarchar(4000),@p1109 nvarchar(4000),@p1110 int,@p1111 nvarchar(4000),@p1112 int,@p1113 int,@p1114 datetime2(7),@p1115 datetime2(7),@p1116 datetime2(7),@p1117 nvarchar(4000),@p1118 nvarchar(4000),@p1119 nvarchar(4000),@p1120 nvarchar(4000),@p1121 nvarchar(4000),@p1122 nvarchar(4000),@p1123 nvarchar(4000),@p1124 nvarchar(4000),@p1125 nvarchar(4000),@p1126 nvarchar(4000),@p1127 nvarchar(4000),@p1128 nvarchar(4000),@p1129 nvarchar(4000),@p1130 nvarchar(4000),@p1131 datetime2(7),@p1132 nvarchar(4000),@p1133 nvarchar(4000),@p1134 int,@p1135 int,@p1136 int,@p1137 nvarchar(4000),@p1138 nvarchar(4000),@p1139 nvarchar(4000),@p1140 decimal(18,2),@p1141 decimal(18,2),@p1142 nvarchar(4000),@p1143 nvarchar(4000),@p1144 decimal(18,2),@p1145 nvarchar(4000),@p1146 nvarchar(4000),@p1147 nvarchar(4000),@p1148 nvarchar(4000),@p1149 int,@p1150 nvarchar(4000),@p1151 nvarchar(4000),@p1152 nvarchar(4000),@p1153 nvarchar(4000),@p1154 nvarchar(4000),@p1155 nvarchar(4000),@p1156 nvarchar(4000),@p1157 nvarchar(4000),@p1158 nvarchar(4000),@p1159 nvarchar(4000),@p1160 int,@p1161 nvarchar(4000),@p1162 nvarchar(4000),@p1163 nvarchar(4000),@p1164 nvarchar(4000),@p1165 nvarchar(4000),@p1166 int,@p1167 nvarchar(4000),@p1168 int,@p1169 int,@p1170 datetime2(7),@p1171 datetime2(7),@p1172 datetime2(7),@p1173 nvarchar(4000),@p1174 nvarchar(4000),@p1175 nvarchar(4000),@p1176 nvarchar(4000),@p1177 nvarchar(4000),@p1178 nvarchar(4000),@p1179 nvarchar(4000),@p1180 nvarchar(4000),@p1181 nvarchar(4000),@p1182 nvarchar(4000),@p1183 nvarchar(4000),@p1184 nvarchar(4000),@p1185 nvarchar(4000),@p1186 nvarchar(4000),@p1187 datetime2(7),@p1188 nvarchar(4000),@p1189 nvarchar(4000),@p1190 int,@p1191 int,@p1192 int,@p1193 nvarchar(4000),@p1194 nvarchar(4000),@p1195 nvarchar(4000),@p1196 decimal(18,2),@p1197 decimal(18,2),@p1198 nvarchar(4000),@p1199 nvarchar(4000),@p1200 decimal(18,2),@p1201 nvarchar(4000),@p1202 nvarchar(4000),@p1203 nvarchar(4000),@p1204 nvarchar(4000),@p1205 int,@p1206 nvarchar(4000),@p1207 nvarchar(4000),@p1208 nvarchar(4000),@p1209 nvarchar(4000),@p1210 nvarchar(4000),@p1211 nvarchar(4000),@p1212 nvarchar(4000),@p1213 nvarchar(4000),@p1214 nvarchar(4000),@p1215 nvarchar(4000),@p1216 int,@p1217 nvarchar(4000),@p1218 nvarchar(4000),@p1219 nvarchar(4000),@p1220 nvarchar(4000),@p1221 nvarchar(4000),@p1222 int,@p1223 nvarchar(4000),@p1224 int,@p1225 int,@p1226 datetime2(7),@p1227 datetime2(7),@p1228 datetime2(7),@p1229 nvarchar(4000),@p1230 nvarchar(4000),@p1231 nvarchar(4000),@p1232 nvarchar(4000),@p1233 nvarchar(4000),@p1234 nvarchar(4000),@p1235 nvarchar(4000),@p1236 nvarchar(4000),@p1237 nvarchar(4000),@p1238 nvarchar(4000),@p1239 nvarchar(4000),@p1240 nvarchar(4000),@p1241 nvarchar(4000),@p1242 nvarchar(4000),@p1243 datetime2(7),@p1244 nvarchar(4000),@p1245 nvarchar(4000),@p1246 int,@p1247 int,@p1248 int,@p1249 nvarchar(4000),@p1250 nvarchar(4000),@p1251 nvarchar(4000),@p1252 decimal(18,2),@p1253 decimal(18,2),@p1254 nvarchar(4000),@p1255 nvarchar(4000),@p1256 decimal(18,2),@p1257 nvarchar(4000),@p1258 nvarchar(4000),@p1259 nvarchar(4000),@p1260 nvarchar(4000),@p1261 int,@p1262 nvarchar(4000),@p1263 nvarchar(4000),@p1264 nvarchar(4000),@p1265 nvarchar(4000),@p1266 nvarchar(4000),@p1267 nvarchar(4000),@p1268 nvarchar(4000),@p1269 nvarchar(4000),@p1270 nvarchar(4000),@p1271 nvarchar(4000),@p1272 int,@p1273 nvarchar(4000),@p1274 nvarchar(4000),@p1275 nvarchar(4000),@p1276 nvarchar(4000),@p1277 nvarchar(4000),@p1278 int,@p1279 nvarchar(4000),@p1280 int,@p1281 int,@p1282 datetime2(7),@p1283 datetime2(7),@p1284 datetime2(7),@p1285 nvarchar(4000),@p1286 nvarchar(4000),@p1287 nvarchar(4000),@p1288 nvarchar(4000),@p1289 nvarchar(4000),@p1290 nvarchar(4000),@p1291 nvarchar(4000),@p1292 nvarchar(4000),@p1293 nvarchar(4000),@p1294 nvarchar(4000),@p1295 nvarchar(4000),@p1296 nvarchar(4000),@p1297 nvarchar(4000),@p1298 nvarchar(4000),@p1299 datetime2(7),@p1300 nvarchar(4000),@p1301 nvarchar(4000),@p1302 int,@p1303 int,@p1304 int,@p1305 nvarchar(4000),@p1306 nvarchar(4000),@p1307 nvarchar(4000),@p1308 decimal(18,2),@p1309 decimal(18,2),@p1310 nvarchar(4000),@p1311 nvarchar(4000),@p1312 decimal(18,2),@p1313 nvarchar(4000),@p1314 nvarchar(4000),@p1315 nvarchar(4000),@p1316 nvarchar(4000),@p1317 int,@p1318 nvarchar(4000),@p1319 nvarchar(4000),@p1320 nvarchar(4000),@p1321 nvarchar(4000),@p1322 nvarchar(4000),@p1323 nvarchar(4000),@p1324 nvarchar(4000),@p1325 nvarchar(4000),@p1326 nvarchar(4000),@p1327 nvarchar(4000),@p1328 int,@p1329 nvarchar(4000),@p1330 nvarchar(4000),@p1331 nvarchar(4000),@p1332 nvarchar(4000),@p1333 nvarchar(4000),@p1334 int,@p1335 nvarchar(4000),@p1336 int,@p1337 int,@p1338 datetime2(7),@p1339 datetime2(7),@p1340 datetime2(7),@p1341 nvarchar(4000),@p1342 nvarchar(4000),@p1343 nvarchar(4000),@p1344 nvarchar(4000),@p1345 nvarchar(4000),@p1346 nvarchar(4000),@p1347 nvarchar(4000),@p1348 nvarchar(4000),@p1349 nvarchar(4000),@p1350 nvarchar(4000),@p1351 nvarchar(4000),@p1352 nvarchar(4000),@p1353 nvarchar(4000),@p1354 nvarchar(4000),@p1355 datetime2(7),@p1356 nvarchar(4000),@p1357 nvarchar(4000),@p1358 int,@p1359 int,@p1360 int,@p1361 nvarchar(4000),@p1362 nvarchar(4000),@p1363 nvarchar(4000),@p1364 decimal(18,2),@p1365 decimal(18,2),@p1366 nvarchar(4000),@p1367 nvarchar(4000),@p1368 decimal(18,2),@p1369 nvarchar(4000),@p1370 nvarchar(4000),@p1371 nvarchar(4000),@p1372 nvarchar(4000),@p1373 int,@p1374 nvarchar(4000),@p1375 nvarchar(4000),@p1376 nvarchar(4000),@p1377 nvarchar(4000),@p1378 nvarchar(4000),@p1379 nvarchar(4000),@p1380 nvarchar(4000),@p1381 nvarchar(4000),@p1382 nvarchar(4000),@p1383 nvarchar(4000),@p1384 int,@p1385 nvarchar(4000),@p1386 nvarchar(4000),@p1387 nvarchar(4000),@p1388 nvarchar(4000),@p1389 nvarchar(4000),@p1390 int,@p1391 nvarchar(4000),@p1392 int,@p1393 int,@p1394 datetime2(7),@p1395 datetime2(7),@p1396 datetime2(7),@p1397 nvarchar(4000),@p1398 nvarchar(4000),@p1399 nvarchar(4000),@p1400 nvarchar(4000),@p1401 nvarchar(4000),@p1402 nvarchar(4000),@p1403 nvarchar(4000),@p1404 nvarchar(4000),@p1405 nvarchar(4000),@p1406 nvarchar(4000),@p1407 nvarchar(4000),@p1408 nvarchar(4000),@p1409 nvarchar(4000),@p1410 nvarchar(4000),@p1411 datetime2(7),@p1412 nvarchar(4000),@p1413 nvarchar(4000),@p1414 int,@p1415 int,@p1416 int,@p1417 nvarchar(4000),@p1418 nvarchar(4000),@p1419 nvarchar(4000),@p1420 nvarchar(4000),@p1421 decimal(18,2),@p1422 nvarchar(4000),@p1423 nvarchar(4000),@p1424 decimal(18,2),@p1425 nvarchar(4000),@p1426 nvarchar(4000),@p1427 nvarchar(4000),@p1428 nvarchar(4000),@p1429 int,@p1430 nvarchar(4000),@p1431 nvarchar(4000),@p1432 nvarchar(4000),@p1433 nvarchar(4000),@p1434 nvarchar(4000),@p1435 nvarchar(4000),@p1436 nvarchar(4000),@p1437 nvarchar(4000),@p1438 nvarchar(4000),@p1439 nvarchar(4000),@p1440 int,@p1441 nvarchar(4000),@p1442 nvarchar(4000),@p1443 nvarchar(4000),@p1444 nvarchar(4000),@p1445 nvarchar(4000),@p1446 int,@p1447 nvarchar(4000),@p1448 int,@p1449 int,@p1450 datetime2(7),@p1451 datetime2(7),@p1452 datetime2(7),@p1453 nvarchar(4000),@p1454 nvarchar(4000),@p1455 nvarchar(4000),@p1456 nvarchar(4000),@p1457 nvarchar(4000),@p1458 nvarchar(4000),@p1459 nvarchar(4000),@p1460 nvarchar(4000),@p1461 nvarchar(4000),@p1462 nvarchar(4000),@p1463 nvarchar(4000),@p1464 nvarchar(4000),@p1465 nvarchar(4000),@p1466 nvarchar(4000),@p1467 datetime2(7),@p1468 nvarchar(4000),@p1469 nvarchar(4000),@p1470 int,@p1471 int,@p1472 int,@p1473 nvarchar(4000),@p1474 nvarchar(4000),@p1475 nvarchar(4000),@p1476 nvarchar(4000),@p1477 decimal(18,2),@p1478 nvarchar(4000),@p1479 nvarchar(4000),@p1480 decimal(18,2),@p1481 nvarchar(4000),@p1482 nvarchar(4000),@p1483 nvarchar(4000),@p1484 nvarchar(4000),@p1485 int,@p1486 nvarchar(4000),@p1487 nvarchar(4000),@p1488 nvarchar(4000),@p1489 nvarchar(4000),@p1490 nvarchar(4000),@p1491 nvarchar(4000),@p1492 nvarchar(4000),@p1493 nvarchar(4000),@p1494 nvarchar(4000),@p1495 nvarchar(4000),@p1496 int,@p1497 nvarchar(4000),@p1498 nvarchar(4000),@p1499 nvarchar(4000),@p1500 nvarchar(4000),@p1501 nvarchar(4000),@p1502 int,@p1503 nvarchar(4000),@p1504 int,@p1505 int,@p1506 datetime2(7),@p1507 datetime2(7),@p1508 datetime2(7),@p1509 nvarchar(4000),@p1510 nvarchar(4000),@p1511 nvarchar(4000),@p1512 nvarchar(4000),@p1513 nvarchar(4000),@p1514 nvarchar(4000),@p1515 nvarchar(4000),@p1516 nvarchar(4000),@p1517 nvarchar(4000),@p1518 nvarchar(4000),@p1519 nvarchar(4000),@p1520 nvarchar(4000),@p1521 nvarchar(4000),@p1522 nvarchar(4000),@p1523 datetime2(7),@p1524 nvarchar(4000),@p1525 nvarchar(4000),@p1526 int,@p1527 int,@p1528 int,@p1529 nvarchar(4000),@p1530 nvarchar(4000),@p1531 nvarchar(4000),@p1532 nvarchar(4000),@p1533 decimal(18,2),@p1534 nvarchar(4000),@p1535 nvarchar(4000),@p1536 decimal(18,2),@p1537 nvarchar(4000),@p1538 nvarchar(4000),@p1539 nvarchar(4000),@p1540 nvarchar(4000),@p1541 int,@p1542 nvarchar(4000),@p1543 nvarchar(4000),@p1544 nvarchar(4000),@p1545 nvarchar(4000),@p1546 nvarchar(4000),@p1547 nvarchar(4000),@p1548 nvarchar(4000),@p1549 nvarchar(4000),@p1550 nvarchar(4000),@p1551 nvarchar(4000),@p1552 int,@p1553 nvarchar(4000),@p1554 nvarchar(4000),@p1555 nvarchar(4000),@p1556 nvarchar(4000),@p1557 nvarchar(4000),@p1558 int,@p1559 nvarchar(4000),@p1560 int,@p1561 int,@p1562 datetime2(7),@p1563 datetime2(7),@p1564 datetime2(7),@p1565 nvarchar(4000),@p1566 nvarchar(4000),@p1567 nvarchar(4000),@p1568 nvarchar(4000),@p1569 nvarchar(4000),@p1570 nvarchar(4000),@p1571 nvarchar(4000),@p1572 nvarchar(4000),@p1573 nvarchar(4000),@p1574 nvarchar(4000),@p1575 nvarchar(4000),@p1576 nvarchar(4000),@p1577 nvarchar(4000),@p1578 nvarchar(4000),@p1579 datetime2(7),@p1580 nvarchar(4000),@p1581 nvarchar(4000),@p1582 int,@p1583 int,@p1584 int,@p1585 nvarchar(4000),@p1586 nvarchar(4000),@p1587 nvarchar(4000),@p1588 nvarchar(4000),@p1589 decimal(18,2),@p1590 nvarchar(4000),@p1591 nvarchar(4000),@p1592 decimal(18,2),@p1593 nvarchar(4000),@p1594 nvarchar(4000),@p1595 nvarchar(4000),@p1596 nvarchar(4000),@p1597 int,@p1598 nvarchar(4000),@p1599 nvarchar(4000),@p1600 nvarchar(4000),@p1601 nvarchar(4000),@p1602 nvarchar(4000),@p1603 nvarchar(4000),@p1604 nvarchar(4000),@p1605 nvarchar(4000),@p1606 nvarchar(4000),@p1607 nvarchar(4000),@p1608 int,@p1609 nvarchar(4000),@p1610 nvarchar(4000),@p1611 nvarchar(4000),@p1612 nvarchar(4000),@p1613 nvarchar(4000),@p1614 int,@p1615 nvarchar(4000),@p1616 int,@p1617 int,@p1618 datetime2(7),@p1619 datetime2(7),@p1620 datetime2(7),@p1621 nvarchar(4000),@p1622 nvarchar(4000),@p1623 nvarchar(4000),@p1624 nvarchar(4000),@p1625 nvarchar(4000),@p1626 nvarchar(4000),@p1627 nvarchar(4000),@p1628 nvarchar(4000),@p1629 nvarchar(4000),@p1630 nvarchar(4000),@p1631 nvarchar(4000),@p1632 nvarchar(4000),@p1633 nvarchar(4000),@p1634 nvarchar(4000),@p1635 datetime2(7),@p1636 nvarchar(4000),@p1637 nvarchar(4000),@p1638 int,@p1639 int,@p1640 int,@p1641 nvarchar(4000),@p1642 nvarchar(4000),@p1643 nvarchar(4000),@p1644 nvarchar(4000),@p1645 decimal(18,2),@p1646 nvarchar(4000),@p1647 nvarchar(4000),@p1648 decimal(18,2),@p1649 nvarchar(4000),@p1650 nvarchar(4000),@p1651 nvarchar(4000),@p1652 nvarchar(4000),@p1653 int,@p1654 nvarchar(4000),@p1655 nvarchar(4000),@p1656 nvarchar(4000),@p1657 nvarchar(4000),@p1658 nvarchar(4000),@p1659 nvarchar(4000),@p1660 nvarchar(4000),@p1661 nvarchar(4000),@p1662 nvarchar(4000),@p1663 nvarchar(4000),@p1664 int,@p1665 nvarchar(4000),@p1666 nvarchar(4000),@p1667 nvarchar(4000),@p1668 nvarchar(4000),@p1669 nvarchar(4000),@p1670 int,@p1671 nvarchar(4000),@p1672 int,@p1673 int,@p1674 datetime2(7),@p1675 datetime2(7),@p1676 datetime2(7),@p1677 nvarchar(4000),@p1678 nvarchar(4000),@p1679 nvarchar(4000),@p1680 nvarchar(4000),@p1681 nvarchar(4000),@p1682 nvarchar(4000),@p1683 nvarchar(4000),@p1684 nvarchar(4000),@p1685 nvarchar(4000),@p1686 nvarchar(4000),@p1687 nvarchar(4000),@p1688 nvarchar(4000),@p1689 nvarchar(4000),@p1690 nvarchar(4000),@p1691 datetime2(7),@p1692 nvarchar(4000),@p1693 nvarchar(4000),@p1694 int,@p1695 int,@p1696 int,@p1697 nvarchar(4000),@p1698 nvarchar(4000),@p1699 nvarchar(4000),@p1700 nvarchar(4000),@p1701 decimal(18,2),@p1702 nvarchar(4000),@p1703 nvarchar(4000),@p1704 decimal(18,2),@p1705 nvarchar(4000),@p1706 nvarchar(4000),@p1707 nvarchar(4000),@p1708 nvarchar(4000),@p1709 int,@p1710 nvarchar(4000),@p1711 nvarchar(4000),@p1712 nvarchar(4000),@p1713 nvarchar(4000),@p1714 nvarchar(4000),@p1715 nvarchar(4000),@p1716 nvarchar(4000),@p1717 nvarchar(4000),@p1718 nvarchar(4000),@p1719 nvarchar(4000),@p1720 int,@p1721 nvarchar(4000),@p1722 nvarchar(4000),@p1723 nvarchar(4000),@p1724 nvarchar(4000),@p1725 nvarchar(4000),@p1726 int,@p1727 nvarchar(4000),@p1728 int,@p1729 int,@p1730 datetime2(7),@p1731 datetime2(7),@p1732 datetime2(7),@p1733 nvarchar(4000),@p1734 nvarchar(4000),@p1735 nvarchar(4000),@p1736 nvarchar(4000),@p1737 nvarchar(4000),@p1738 nvarchar(4000),@p1739 nvarchar(4000),@p1740 nvarchar(4000),@p1741 nvarchar(4000),@p1742 nvarchar(4000),@p1743 nvarchar(4000),@p1744 nvarchar(4000),@p1745 nvarchar(4000),@p1746 nvarchar(4000),@p1747 datetime2(7),@p1748 nvarchar(4000),@p1749 nvarchar(4000),@p1750 int,@p1751 int,@p1752 int,@p1753 nvarchar(4000),@p1754 nvarchar(4000),@p1755 nvarchar(4000),@p1756 decimal(18,2),@p1757 decimal(18,2),@p1758 nvarchar(4000),@p1759 nvarchar(4000),@p1760 decimal(18,2),@p1761 nvarchar(4000),@p1762 nvarchar(4000),@p1763 nvarchar(4000),@p1764 nvarchar(4000),@p1765 int,@p1766 nvarchar(4000),@p1767 nvarchar(4000),@p1768 nvarchar(4000),@p1769 nvarchar(4000),@p1770 nvarchar(4000),@p1771 nvarchar(4000),@p1772 nvarchar(4000),@p1773 nvarchar(4000),@p1774 nvarchar(4000),@p1775 nvarchar(4000),@p1776 int,@p1777 nvarchar(4000),@p1778 nvarchar(4000),@p1779 nvarchar(4000),@p1780 nvarchar(4000),@p1781 nvarchar(4000),@p1782 int,@p1783 nvarchar(4000),@p1784 int,@p1785 int,@p1786 datetime2(7),@p1787 datetime2(7),@p1788 datetime2(7),@p1789 nvarchar(4000),@p1790 nvarchar(4000),@p1791 nvarchar(4000),@p1792 nvarchar(4000),@p1793 nvarchar(4000),@p1794 nvarchar(4000),@p1795 nvarchar(4000),@p1796 nvarchar(4000),@p1797 nvarchar(4000),@p1798 nvarchar(4000),@p1799 nvarchar(4000),@p1800 nvarchar(4000),@p1801 nvarchar(4000),@p1802 nvarchar(4000),@p1803 datetime2(7),@p1804 nvarchar(4000),@p1805 nvarchar(4000),@p1806 int,@p1807 int,@p1808 int,@p1809 nvarchar(4000),@p1810 nvarchar(4000),@p1811 nvarchar(4000),@p1812 decimal(18,2),@p1813 decimal(18,2),@p1814 nvarchar(4000),@p1815 nvarchar(4000),@p1816 decimal(18,2),@p1817 nvarchar(4000),@p1818 nvarchar(4000),@p1819 nvarchar(4000),@p1820 nvarchar(4000),@p1821 int,@p1822 nvarchar(4000),@p1823 nvarchar(4000),@p1824 nvarchar(4000),@p1825 nvarchar(4000),@p1826 nvarchar(4000),@p1827 nvarchar(4000),@p1828 nvarchar(4000),@p1829 nvarchar(4000),@p1830 nvarchar(4000),@p1831 nvarchar(4000),@p1832 int,@p1833 nvarchar(4000),@p1834 nvarchar(4000),@p1835 nvarchar(4000),@p1836 nvarchar(4000),@p1837 nvarchar(4000),@p1838 int,@p1839 nvarchar(4000),@p1840 int,@p1841 int,@p1842 datetime2(7),@p1843 datetime2(7),@p1844 datetime2(7),@p1845 nvarchar(4000),@p1846 nvarchar(4000),@p1847 nvarchar(4000),@p1848 nvarchar(4000),@p1849 nvarchar(4000),@p1850 nvarchar(4000),@p1851 nvarchar(4000),@p1852 nvarchar(4000),@p1853 nvarchar(4000),@p1854 nvarchar(4000),@p1855 nvarchar(4000),@p1856 nvarchar(4000),@p1857 nvarchar(4000),@p1858 nvarchar(4000),@p1859 datetime2(7),@p1860 nvarchar(4000),@p1861 nvarchar(4000),@p1862 int,@p1863 int,@p1864 int,@p1865 nvarchar(4000),@p1866 nvarchar(4000),@p1867 nvarchar(4000),@p1868 nvarchar(4000),@p1869 decimal(18,2),@p1870 nvarchar(4000),@p1871 nvarchar(4000),@p1872 decimal(18,2),@p1873 nvarchar(4000),@p1874 nvarchar(4000),@p1875 nvarchar(4000),@p1876 nvarchar(4000),@p1877 int,@p1878 nvarchar(4000),@p1879 nvarchar(4000),@p1880 nvarchar(4000),@p1881 nvarchar(4000),@p1882 nvarchar(4000),@p1883 nvarchar(4000),@p1884 nvarchar(4000),@p1885 nvarchar(4000),@p1886 nvarchar(4000),@p1887 nvarchar(4000),@p1888 int,@p1889 nvarchar(4000),@p1890 nvarchar(4000),@p1891 nvarchar(4000),@p1892 nvarchar(4000),@p1893 nvarchar(4000),@p1894 int,@p1895 nvarchar(4000),@p1896 int,@p1897 int,@p1898 datetime2(7),@p1899 datetime2(7),@p1900 datetime2(7),@p1901 nvarchar(4000),@p1902 nvarchar(4000),@p1903 nvarchar(4000),@p1904 nvarchar(4000),@p1905 nvarchar(4000),@p1906 nvarchar(4000),@p1907 nvarchar(4000),@p1908 nvarchar(4000),@p1909 nvarchar(4000),@p1910 nvarchar(4000),@p1911 nvarchar(4000),@p1912 nvarchar(4000),@p1913 nvarchar(4000),@p1914 nvarchar(4000),@p1915 datetime2(7),@p1916 nvarchar(4000),@p1917 nvarchar(4000),@p1918 int,@p1919 int,@p1920 int,@p1921 nvarchar(4000),@p1922 nvarchar(4000),@p1923 nvarchar(4000),@p1924 decimal(18,2),@p1925 decimal(18,2),@p1926 nvarchar(4000),@p1927 nvarchar(4000),@p1928 decimal(18,2),@p1929 nvarchar(4000),@p1930 nvarchar(4000),@p1931 nvarchar(4000),@p1932 nvarchar(4000),@p1933 int,@p1934 nvarchar(4000),@p1935 nvarchar(4000),@p1936 nvarchar(4000),@p1937 nvarchar(4000),@p1938 nvarchar(4000),@p1939 nvarchar(4000),@p1940 nvarchar(4000),@p1941 nvarchar(4000),@p1942 nvarchar(4000),@p1943 nvarchar(4000),@p1944 int,@p1945 nvarchar(4000),@p1946 nvarchar(4000),@p1947 nvarchar(4000),@p1948 nvarchar(4000),@p1949 nvarchar(4000),@p1950 int,@p1951 nvarchar(4000),@p1952 int,@p1953 int,@p1954 datetime2(7),@p1955 datetime2(7),@p1956 datetime2(7),@p1957 nvarchar(4000),@p1958 nvarchar(4000),@p1959 nvarchar(4000),@p1960 nvarchar(4000),@p1961 nvarchar(4000),@p1962 nvarchar(4000),@p1963 nvarchar(4000),@p1964 nvarchar(4000),@p1965 nvarchar(4000),@p1966 nvarchar(4000),@p1967 nvarchar(4000),@p1968 nvarchar(4000),@p1969 nvarchar(4000),@p1970 nvarchar(4000),@p1971 datetime2(7),@p1972 nvarchar(4000),@p1973 nvarchar(4000),@p1974 int,@p1975 int,@p1976 int,@p1977 nvarchar(4000),@p1978 nvarchar(4000),@p1979 nvarchar(4000),@p1980 decimal(18,2),@p1981 decimal(18,2),@p1982 nvarchar(4000),@p1983 nvarchar(4000),@p1984 decimal(18,2),@p1985 nvarchar(4000),@p1986 nvarchar(4000),@p1987 nvarchar(4000),@p1988 nvarchar(4000),@p1989 int,@p1990 nvarchar(4000),@p1991 nvarchar(4000),@p1992 nvarchar(4000),@p1993 nvarchar(4000),@p1994 nvarchar(4000),@p1995 nvarchar(4000),@p1996 nvarchar(4000),@p1997 nvarchar(4000),@p1998 nvarchar(4000),@p1999 nvarchar(4000),@p2000 int,@p2001 nvarchar(4000),@p2002 nvarchar(4000),@p2003 nvarchar(4000),@p2004 nvarchar(4000),@p2005 nvarchar(4000),@p2006 int,@p2007 nvarchar(4000),@p2008 int,@p2009 int,@p2010 datetime2(7),@p2011 datetime2(7),@p2012 datetime2(7),@p2013 nvarchar(4000),@p2014 nvarchar(4000),@p2015 nvarchar(4000),@p2016 nvarchar(4000),@p2017 nvarchar(4000),@p2018 nvarchar(4000),@p2019 nvarchar(4000),@p2020 nvarchar(4000),@p2021 nvarchar(4000),@p2022 nvarchar(4000),@p2023 nvarchar(4000),@p2024 nvarchar(4000),@p2025 nvarchar(4000),@p2026 nvarchar(4000),@p2027 datetime2(7),@p2028 nvarchar(4000),@p2029 nvarchar(4000),@p2030 int,@p2031 int,@p2032 int,@p2033 nvarchar(4000),@p2034 nvarchar(4000),@p2035 nvarchar(4000),@p2036 decimal(18,2),@p2037 decimal(18,2),@p2038 nvarchar(4000),@p2039 nvarchar(4000),@p2040 decimal(18,2),@p2041 nvarchar(4000),@p2042 nvarchar(4000),@p2043 nvarchar(4000),@p2044 nvarchar(4000),@p2045 int,@p2046 nvarchar(4000),@p2047 nvarchar(4000),@p2048 nvarchar(4000),@p2049 nvarchar(4000),@p2050 nvarchar(4000),@p2051 nvarchar(4000),@p2052 nvarchar(4000),@p2053 nvarchar(4000),@p2054 nvarchar(4000),@p2055 nvarchar(4000),@p2056 int,@p2057 nvarchar(4000),@p2058 nvarchar(4000),@p2059 nvarchar(4000),@p2060 nvarchar(4000),@p2061 nvarchar(4000),@p2062 int,@p2063 nvarchar(4000),@p2064 int,@p2065 int,@p2066 datetime2(7),@p2067 datetime2(7),@p2068 datetime2(7),@p2069 nvarchar(4000),@p2070 nvarchar(4000),@p2071 nvarchar(4000))SET NOCOUNT ON; DECLARE @inserted0 TABLE ([item_id] int, [_Position] [int]); MERGE [raw_data] USING ( VALUES (@p0, @p1, @p2, @p3, @p4, @p5, @p6, @p7, @p8, @p9, @p10, @p11, @p12, @p13, @p14, @p15, @p16, @p17, @p18, @p19, @p20, @p21, @p22, @p23, @p24, @p25, @p26, @p27, @p28, @p29, @p30, @p31, @p32, @p33, @p34, @p35, @p36, @p37, @p38, @p39, @p40, @p41, @p42, @p43, @p44, @p45, @p46, @p47, @p48, @p49, @p50, @p51, @p52, @p53, @p54, @p55, 0), (@p56, @p57, @p58, @p59, @p60, @p61, @p62, @p63, @p64, @p65, @p66, @p67, @p68, @p69, @p70, @p71, @p72, @p73, @p74, @p75, @p76, @p77, @p78, @p79, @p80, @p81, @p82, @p83, @p84, @p85, @p86, @p87, @p88, @p89, @p90, @p91, @p92, @p93, @p94, @p95, @p96, @p97, @p98, @p99, @p100, @p101, @p102, @p103, @p104, @p105, @p106, @p107, @p108, @p109, @p110, @p111, 1), (@p112, @p113, @p114, @p115, @p116, @p117, @p118, @p119, @p120, @p121, @p122, @p123, @p124, @p125, @p126, @p127, @p128, @p129, @p130, @p131, @p132, @p133, @p134, @p135, @p136, @p137, @p138, @p139, @p140, @p141, @p142, @p143, @p144, @p145, @p146, @p147, @p148, @p149, @p150, @p151, @p152, @p153, @p154, @p155, @p156, @p157, @p158, @p159, @p160, @p161, @p162, @p163, @p164, @p165, @p166, @p167, 2), (@p168, @p169, @p170, @p171, @p172, @p173, @p174, @p175, @p176, @p177, @p178, @p179, @p180, @p181, @p182, @p183, @p184, @p185, @p186, @p187, @p188, @p189, @p190, @p191, @p192, @p193, @p194, @p195, @p196, @p197, @p198, @p199, @p200, @p201, @p202, @p203, @p204, @p205, @p206, @p207, @p208, @p209, @p210, @p211, @p212, @p213, @p214, @p215, @p216, @p217, @p218, @p219, @p220, @p221, @p222, @p223, 3), (@p224, @p225, @p226, @p227, @p228, @p229, @p230, @p231, @p232, @p233, @p234, @p235, @p236, @p237, @p238, @p239, @p240, @p241, @p242, @p243, @p244, @p245, @p246, @p247, @p248, @p249, @p250, @p251, @p252, @p253, @p254, @p255, @p256, @p257, @p258, @p259, @p260, @p261, @p262, @p263, @p264, @p265, @p266, @p267, @p268, @p269, @p270, @p271, @p272, @p273, @p274, @p275, @p276, @p277, @p278, @p279, 4), (@p280, @p281, @p282, @p283, @p284, @p285, @p286, @p287, @p288, @p289, @p290, @p291, @p292, @p293, @p294, @p295, @p296, @p297, @p298, @p299, @p300, @p301, @p302, @p303, @p304, @p305, @p306, @p307, @p308, @p309, @p310, @p311, @p312, @p313, @p314, @p315, @p316, @p317, @p318, @p319, @p320, @p321, @p322, @p323, @p324, @p325, @p326, @p327, @p328, @p329, @p330, @p331, @p332, @p333, @p334, @p335, 5), (@p336, @p337, @p338, @p339, @p340, @p341, @p342, @p343, @p344, @p345, @p346, @p347, @p348, @p349, @p350, @p351, @p352, @p353, @p354, @p355, @p356, @p357, @p358, @p359, @p360, @p361, @p362, @p363, @p364, @p365, @p366, @p367, @p368, @p369, @p370, @p371, @p372, @p373, @p374, @p375, @p376, @p377, @p378, @p379, @p380, @p381, @p382, @p383, @p384, @p385, @p386, @p387, @p388, @p389, @p390, @p391, 6), (@p392, @p393, @p394, @p395, @p396, @p397, @p398, @p399, @p400, @p401, @p402, @p403, @p404, @p405, @p406, @p407, @p408, @p409, @p410, @p411, @p412, @p413, @p414, @p415, @p416, @p417, @p418, @p419, @p420, @p421, @p422, @p423, @p424, @p425, @p426, @p427, @p428, @p429, @p430, @p431, @p432, @p433, @p434, @p435, @p436, @p437, @p438, @p439, @p440, @p441, @p442, @p443, @p444, @p445, @p446, @p447, 7), (@p448, @p449, @p450, @p451, @p452, @p453, @p454, @p455, @p456, @p457, @p458, @p459, @p460, @p461, @p462, @p463, @p464, @p465, @p466, @p467, @p468, @p469, @p470, @p471, @p472, @p473, @p474, @p475, @p476, @p477, @p478, @p479, @p480, @p481, @p482, @p483, @p484, @p485, @p486, @p487, @p488, @p489, @p490, @p491, @p492, @p493, @p494, @p495, @p496, @p497, @p498, @p499, @p500, @p501, @p502, @p503, 8), (@p504, @p505, @p506, @p507, @p508, @p509, @p510, @p511, @p512, @p513, @p514, @p515, @p516, @p517, @p518, @p519, @p520, @p521, @p522, @p523, @p524, @p525, @p526, @p527, @p528, @p529, @p530, @p531, @p532, @p533, @p534, @p535, @p536, @p537, @p538, @p539, @p540, @p541, @p542, @p543, @p544, @p545, @p546, @p547, @p548, @p549, @p550, @p551, @p552, @p553, @p554, @p555, @p556, @p557, @p558, @p559, 9), (@p560, @p561, @p562, @p563, @p564, @p565, @p566, @p567, @p568, @p569, @p570, @p571, @p572, @p573, @p574, @p575, @p576, @p577, @p578, @p579, @p580, @p581, @p582, @p583, @p584, @p585, @p586, @p587, @p588, @p589, @p590, @p591, @p592, @p593, @p594, @p595, @p596, @p597, @p598, @p599, @p600, @p601, @p602, @p603, @p604, @p605, @p606, @p607, @p608, @p609, @p610, @p611, @p612, @p613, @p614, @p615, 10), (@p616, @p617, @p618, @p619, @p620, @p621, @p622, @p623, @p624, @p625, @p626, @p627, @p628, @p629, @p630, @p631, @p632, @p633, @p634, @p635, @p636, @p637, @p638, @p639, @p640, @p641, @p642, @p643, @p644, @p645, @p646, @p647, @p648, @p649, @p650, @p651, @p652, @p653, @p654, @p655, @p656, @p657, @p658, @p659, @p660, @p661, @p662, @p663, @p664, @p665, @p666, @p667, @p668, @p669, @p670, @p671, 11), (@p672, @p673, @p674, @p675, @p676, @p677, @p678, @p679, @p680, @p681, @p682, @p683, @p684, @p685, @p686, @p687, @p688, @p689, @p690, @p691, @p692, @p693, @p694, @p695, @p696, @p697, @p698, @p699, @p700, @p701, @p702, @p703, @p704, @p705, @p706, @p707, @p708, @p709, @p710, @p711, @p712, @p713, @p714, @p715, @p716, @p717, @p718, @p719, @p720, @p721, @p722, @p723, @p724, @p725, @p726, @p727, 12), (@p728, @p729, @p730, @p731, @p732, @p733, @p734, @p735, @p736, @p737, @p738, @p739, @p740, @p741, @p742, @p743, @p744, @p745, @p746, @p747, @p748, @p749, @p750, @p751, @p752, @p753, @p754, @p755, @p756, @p757, @p758, @p759, @p760, @p761, @p762, @p763, @p764, @p765, @p766, @p767, @p768, @p769, @p770, @p771, @p772, @p773, @p774, @p775, @p776, @p777, @p778, @p779, @p780, @p781, @p782, @p783, 13), (@p784, @p785, @p786, @p787, @p788, @p789, @p790, @p791, @p792, @p793, @p794, @p795, @p796, @p797, @p798, @p799, @p800, @p801, @p802, @p803, @p804, @p805, @p806, @p807, @p808, @p809, @p810, @p811, @p812, @p813, @p814, @p815, @p816, @p817, @p818, @p819, @p820, @p821, @p822, @p823, @p824, @p825, @p826, @p827, @p828, @p829, @p830, @p831, @p832, @p833, @p834, @p835, @p836, @p837, @p838, @p839, 14), (@p840, @p841, @p842, @p843, @p844, @p845, @p846, @p847, @p848, @p849, @p850, @p851, @p852, @p853, @p854, @p855, @p856, @p857, @p858, @p859, @p860, @p861, @p862, @p863, @p864, @p865, @p866, @p867, @p868, @p869, @p870, @p871, @p872, @p873, @p874, @p875, @p876, @p877, @p878, @p879, @p880, @p881, @p882, @p883, @p884, @p885, @p886, @p887, @p888, @p889, @p890, @p891, @p892, @p893, @p894, @p895, 15), (@p896, @p897, @p898, @p899, @p900, @p901, @p902, @p903, @p904, @p905, @p906, @p907, @p908, @p909, @p910, @p911, @p912, @p913, @p914, @p915, @p916, @p917, @p918, @p919, @p920, @p921, @p922, @p923, @p924, @p925, @p926, @p927, @p928, @p929, @p930, @p931, @p932, @p933, @p934, @p935, @p936, @p937, @p938, @p939, @p940, @p941, @p942, @p943, @p944, @p945, @p946, @p947, @p948, @p949, @p950, @p951, 16), (@p952, @p953, @p954, @p955, @p956, @p957, @p958, @p959, @p960, @p961, @p962, @p963, @p964, @p965, @p966, @p967, @p968, @p969, @p970, @p971, @p972, @p973, @p974, @p975, @p976, @p977, @p978, @p979, @p980, @p981, @p982, @p983, @p984, @p985, @p986, @p987, @p988, @p989, @p990, @p991, @p992, @p993, @p994, @p995, @p996, @p997, @p998, @p999, @p1000, @p1001, @p1002, @p1003, @p1004, @p1005, @p1006, @p1007, 17), (@p1008, @p1009, @p1010, @p1011, @p1012, @p1013, @p1014, @p1015, @p1016, @p1017, @p1018, @p1019, @p1020, @p1021, @p1022, @p1023, @p1024, @p1025, @p1026, @p1027, @p1028, @p1029, @p1030, @p1031, @p1032, @p1033, @p1034, @p1035, @p1036, @p1037, @p1038, @p1039, @p1040, @p1041, @p1042, @p1043, @p1044, @p1045, @p1046, @p1047, @p1048, @p1049, @p1050, @p1051, @p1052, @p1053, @p1054, @p1055, @p1056, @p1057, @p1058, @p1059, @p1060, @p1061, @p1062, @p1063, 18), (@p1064, @p1065, @p1066, @p1067, @p1068, @p1069, @p1070, @p1071, @p1072, @p1073, @p1074, @p1075, @p1076, @p1077, @p1078, @p1079, @p1080, @p1081, @p1082, @p1083, @p1084, @p1085, @p1086, @p1087, @p1088, @p1089, @p1090, @p1091, @p1092, @p1093, @p1094, @p1095, @p1096, @p1097, @p1098, @p1099, @p1100, @p1101, @p1102, @p1103, @p1104, @p1105, @p1106, @p1107, @p1108, @p1109, @p1110, @p1111, @p1112, @p1113, @p1114, @p1115, @p1116, @p1117, @p1118, @p1119, 19), (@p1120, @p1121, @p1122, @p1123, @p1124, @p1125, @p1126, @p1127, @p1128, @p1129, @p1130, @p1131, @p1132, @p1133, @p1134, @p1135, @p1136, @p1137, @p1138, @p1139, @p1140, @p1141, @p1142, @p1143, @p1144, @p1145, @p1146, @p1147, @p1148, @p1149, @p1150, @p1151, @p1152, @p1153, @p1154, @p1155, @p1156, @p1157, @p1158, @p1159, @p1160, @p1161, @p1162, @p1163, @p1164, @p1165, @p1166, @p1167, @p1168, @p1169, @p1170, @p1171, @p1172, @p1173, @p1174, @p1175, 20), (@p1176, @p1177, @p1178, @p1179, @p1180, @p1181, @p1182, @p1183, @p1184, @p1185, @p1186, @p1187, @p1188, @p1189, @p1190, @p1191, @p1192, @p1193, @p1194, @p1195, @p1196, @p1197, @p1198, @p1199, @p1200, @p1201, @p1202, @p1203, @p1204, @p1205, @p1206, @p1207, @p1208, @p1209, @p1210, @p1211, @p1212, @p1213, @p1214, @p1215, @p1216, @p1217, @p1218, @p1219, @p1220, @p1221, @p1222, @p1223, @p1224, @p1225, @p1226, @p1227, @p1228, @p1229, @p1230, @p1231, 21), (@p1232, @p1233, @p1234, @p1235, @p1236, @p1237, @p1238, @p1239, @p1240, @p1241, @p1242, @p1243, @p1244, @p1245, @p1246, @p1247, @p1248, @p1249, @p1250, @p1251, @p1252, @p1253, @p1254, @p1255, @p1256, @p1257, @p1258, @p1259, @p1260, @p1261, @p1262, @p1263, @p1264, @p1265, @p1266, @p1267, @p1268, @p1269, @p1270, @p1271, @p1272, @p1273, @p1274, @p1275, @p1276, @p1277, @p1278, @p1279, @p1280, @p1281, @p1282, @p1283, @p1284, @p1285, @p1286, @p1287, 22), (@p1288, @p1289, @p1290, @p1291, @p1292, @p1293, @p1294, @p1295, @p1296, @p1297, @p1298, @p1299, @p1300, @p1301, @p1302, @p1303, @p1304, @p1305, @p1306, @p1307, @p1308, @p1309, @p1310, @p1311, @p1312, @p1313, @p1314, @p1315, @p1316, @p1317, @p1318, @p1319, @p1320, @p1321, @p1322, @p1323, @p1324, @p1325, @p1326, @p1327, @p1328, @p1329, @p1330, @p1331, @p1332, @p1333, @p1334, @p1335, @p1336, @p1337, @p1338, @p1339, @p1340, @p1341, @p1342, @p1343, 23), (@p1344, @p1345, @p1346, @p1347, @p1348, @p1349, @p1350, @p1351, @p1352, @p1353, @p1354, @p1355, @p1356, @p1357, @p1358, @p1359, @p1360, @p1361, @p1362, @p1363, @p1364, @p1365, @p1366, @p1367, @p1368, @p1369, @p1370, @p1371, @p1372, @p1373, @p1374, @p1375, @p1376, @p1377, @p1378, @p1379, @p1380, @p1381, @p1382, @p1383, @p1384, @p1385, @p1386, @p1387, @p1388, @p1389, @p1390, @p1391, @p1392, @p1393, @p1394, @p1395, @p1396, @p1397, @p1398, @p1399, 24), (@p1400, @p1401, @p1402, @p1403, @p1404, @p1405, @p1406, @p1407, @p1408, @p1409, @p1410, @p1411, @p1412, @p1413, @p1414, @p1415, @p1416, @p1417, @p1418, @p1419, @p1420, @p1421, @p1422, @p1423, @p1424, @p1425, @p1426, @p1427, @p1428, @p1429, @p1430, @p1431, @p1432, @p1433, @p1434, @p1435, @p1436, @p1437, @p1438, @p1439, @p1440, @p1441, @p1442, @p1443, @p1444, @p1445, @p1446, @p1447, @p1448, @p1449, @p1450, @p1451, @p1452, @p1453, @p1454, @p1455, 25), (@p1456, @p1457, @p1458, @p1459, @p1460, @p1461, @p1462, @p1463, @p1464, @p1465, @p1466, @p1467, @p1468, @p1469, @p1470, @p1471, @p1472, @p1473, @p1474, @p1475, @p1476, @p1477, @p1478, @p1479, @p1480, @p1481, @p1482, @p1483, @p1484, @p1485, @p1486, @p1487, @p1488, @p1489, @p1490, @p1491, @p1492, @p1493, @p1494, @p1495, @p1496, @p1497, @p1498, @p1499, @p1500, @p1501, @p1502, @p1503, @p1504, @p1505, @p1506, @p1507, @p1508, @p1509, @p1510, @p1511, 26), (@p1512, @p1513, @p1514, @p1515, @p1516, @p1517, @p1518, @p1519, @p1520, @p1521, @p1522, @p1523, @p1524, @p1525, @p1526, @p1527, @p1528, @p1529, @p1530, @p1531, @p1532, @p1533, @p1534, @p1535, @p1536, @p1537, @p1538, @p1539, @p1540, @p1541, @p1542, @p1543, @p1544, @p1545, @p1546, @p1547, @p1548, @p1549, @p1550, @p1551, @p1552, @p1553, @p1554, @p1555, @p1556, @p1557, @p1558, @p1559, @p1560, @p1561, @p1562, @p1563, @p1564, @p1565, @p1566, @p1567, 27), (@p1568, @p1569, @p1570, @p1571, @p1572, @p1573, @p1574, @p1575, @p1576, @p1577, @p1578, @p1579, @p1580, @p1581, @p1582, @p1583, @p1584, @p1585, @p1586, @p1587, @p1588, @p1589, @p1590, @p1591, @p1592, @p1593, @p1594, @p1595, @p1596, @p1597, @p1598, @p1599, @p1600, @p1601, @p1602, @p1603, @p1604, @p1605, @p1606, @p1607, @p1608, @p1609, @p1610, @p1611, @p1612, @p1613, @p1614, @p1615, @p1616, @p1617, @p1618, @p1619, @p1620, @p1621, @p1622, @p1623, 28), (@p1624, @p1625, @p1626, @p1627, @p1628, @p1629, @p1630, @p1631, @p1632, @p1633, @p1634, @p1635, @p1636, @p1637, @p1638, @p1639, @p1640, @p1641, @p1642, @p1643, @p1644, @p1645, @p1646, @p1647, @p1648, @p1649, @p1650, @p1651, @p1652, @p1653, @p1654, @p1655, @p1656, @p1657, @p1658, @p1659, @p1660, @p1661, @p1662, @p1663, @p1664, @p1665, @p1666, @p1667, @p1668, @p1669, @p1670, @p1671, @p1672, @p1673, @p1674, @p1675, @p1676, @p1677, @p1678, @p1679, 29), (@p1680, @p1681, @p1682, @p1683, @p1684, @p1685, @p1686, @p1687, @p1688, @p1689, @p1690, @p1691, @p1692, @p1693, @p1694, @p1695, @p1696, @p1697, @p1698, @p1699, @p1700, @p1701, @p1702, @p1703, @p1704, @p1705, @p1706, @p1707, @p1708, @p1709, @p1710, @p1711, @p1712, @p1713, @p1714, @p1715, @p1716, @p1717, @p1718, @p1719, @p1720, @p1721, @p1722, @p1723, @p1724, @p1725, @p1726, @p1727, @p1728, @p1729, @p1730, @p1731, @p1732, @p1733, @p1734, @p1735, 30), (@p1736, @p1737, @p1738, @p1739, @p1740, @p1741, @p1742, @p1743, @p1744, @p1745, @p1746, @p1747, @p1748, @p1749, @p1750, @p1751, @p1752, @p1753, @p1754, @p1755, @p1756, @p1757, @p1758, @p1759, @p1760, @p1761, @p1762, @p1763, @p1764, @p1765, @p1766, @p1767, @p1768, @p1769, @p1770, @p1771, @p1772, @p1773, @p1774, @p1775, @p1776, @p1777, @p1778, @p1779, @p1780, @p1781, @p1782, @p1783, @p1784, @p1785, @p1786, @p1787, @p1788, @p1789, @p1790, @p1791, 31), (@p1792, @p1793, @p1794, @p1795, @p1796, @p1797, @p1798, @p1799, @p1800, @p1801, @p1802, @p1803, @p1804, @p1805, @p1806, @p1807, @p1808, @p1809, @p1810, @p1811, @p1812, @p1813, @p1814, @p1815, @p1816, @p1817, @p1818, @p1819, @p1820, @p1821, @p1822, @p1823, @p1824, @p1825, @p1826, @p1827, @p1828, @p1829, @p1830, @p1831, @p1832, @p1833, @p1834, @p1835, @p1836, @p1837, @p1838, @p1839, @p1840, @p1841, @p1842, @p1843, @p1844, @p1845, @p1846, @p1847, 32), (@p1848, @p1849, @p1850, @p1851, @p1852, @p1853, @p1854, @p1855, @p1856, @p1857, @p1858, @p1859, @p1860, @p1861, @p1862, @p1863, @p1864, @p1865, @p1866, @p1867, @p1868, @p1869, @p1870, @p1871, @p1872, @p1873, @p1874, @p1875, @p1876, @p1877, @p1878, @p1879, @p1880, @p1881, @p1882, @p1883, @p1884, @p1885, @p1886, @p1887, @p1888, @p1889, @p1890, @p1891, @p1892, @p1893, @p1894, @p1895, @p1896, @p1897, @p1898, @p1899, @p1900, @p1901, @p1902, @p1903, 33), (@p1904, @p1905, @p1906, @p1907, @p1908, @p1909, @p1910, @p1911, @p1912, @p1913, @p1914, @p1915, @p1916, @p1917, @p1918, @p1919, @p1920, @p1921, @p1922, @p1923, @p1924, @p1925, @p1926, @p1927, @p1928, @p1929, @p1930, @p1931, @p1932, @p1933, @p1934, @p1935, @p1936, @p1937, @p1938, @p1939, @p1940, @p1941, @p1942, @p1943, @p1944, @p1945, @p1946, @p1947, @p1948, @p1949, @p1950, @p1951, @p1952, @p1953, @p1954, @p1955, @p1956, @p1957, @p1958, @p1959, 34), (@p1960, @p1961, @p1962, @p1963, @p1964, @p1965, @p1966, @p1967, @p1968, @p1969, @p1970, @p1971, @p1972, @p1973, @p1974, @p1975, @p1976, @p1977, @p1978, @p1979, @p1980, @p1981, @p1982, @p1983, @p1984, @p1985, @p1986, @p1987, @p1988, @p1989, @p1990, @p1991, @p1992, @p1993, @p1994, @p1995, @p1996, @p1997, @p1998, @p1999, @p2000, @p2001, @p2002, @p2003, @p2004, @p2005, @p2006, @p2007, @p2008, @p2009, @p2010, @p2011, @p2012, @p2013, @p2014, @p2015, 35), (@p2016, @p2017, @p2018, @p2019, @p2020, @p2021, @p2022, @p2023, @p2024, @p2025, @p2026, @p2027, @p2028, @p2029, @p2030, @p2031, @p2032, @p2033, @p2034, @p2035, @p2036, @p2037, @p2038, @p2039, @p2040, @p2041, @p2042, @p2043, @p2044, @p2045, @p2046, @p2047, @p2048, @p2049, @p2050, @p2051, @p2052, @p2053, @p2054, @p2055, @p2056, @p2057, @p2058, @p2059, @p2060, @p2061, @p2062, @p2063, @p2064, @p2065, @p2066, @p2067, @p2068, @p2069, @p2070, @p2071, 36)) AS i ([addressee_cntry_cd], [addressee_city], [addressee_district], [addressee_email], [addressee_full_address], [addressee_home_address], [addressee_name], [addressee_postcode], [addressee_province], [addressee_subdistrict], [addressee_tel], [create_table], [delivery_code], [delivery_recipient_name], [delivery_relation_id], [delivery_status_id], [dest_outlet_id], [dest_outlet_port], [document_number], [item_barcode], [item_cod], [item_gross_weight], [item_height], [item_length], [item_price], [item_width], [lat], [log_id], [long], [outlet_id], [outlet_port], [podUrl], [remark], [scan_cntry_cd], [scan_cntry_postcode], [sender_cntry_cd], [sender_district], [sender_email], [sender_full_address], [sender_home_address], [member_id], [sender_name], [sender_postcode], [sender_province], [sender_subdistrict], [sender_tel], [server_id], [signatureUrl], [state], [status_code], [status_dtm], [timestamp], [transmit_dtm], [user_id], [wckt_id], [wkstn_no], _Position) ON 1=0 WHEN NOT MATCHED THEN INSERT ([addressee_cntry_cd], [addressee_city], [addressee_district], [addressee_email], [addressee_full_address], [addressee_home_address], [addressee_name], [addressee_postcode], [addressee_province], [addressee_subdistrict], [addressee_tel], [create_table], [delivery_code], [delivery_recipient_name], [delivery_relation_id], [delivery_status_id], [dest_outlet_id], [dest_outlet_port], [document_number], [item_barcode], [item_cod], [item_gross_weight], [item_height], [item_length], [item_price], [item_width], [lat], [log_id], [long], [outlet_id], [outlet_port], [podUrl], [remark], [scan_cntry_cd], [scan_cntry_postcode], [sender_cntry_cd], [sender_district], [sender_email], [sender_full_address], [sender_home_address], [member_id], [sender_name], [sender_postcode], [sender_province], [sender_subdistrict], [sender_tel], [server_id], [signatureUrl], [state], [status_code], [status_dtm], [timestamp], [transmit_dtm], [user_id], [wckt_id], [wkstn_no]) VALUES (i.[addressee_cntry_cd], i.[addressee_city], i.[addressee_district], i.[addressee_email], i.[addressee_full_address], i.[addressee_home_address], i.[addressee_name], i.[addressee_postcode], i.[addressee_province], i.[addressee_subdistrict], i.[addressee_tel], i.[create_table], i.[delivery_code], i.[delivery_recipient_name], i.[delivery_relation_id], i.[delivery_status_id], i.[dest_outlet_id], i.[dest_outlet_port], i.[document_number], i.[item_barcode], i.[item_cod], i.[item_gross_weight], i.[item_height], i.[item_length], i.[item_price], i.[item_width], i.[lat], i.[log_id], i.[long], i.[outlet_id], i.[outlet_port], i.[podUrl], i.[remark], i.[scan_cntry_cd], i.[scan_cntry_postcode], i.[sender_cntry_cd], i.[sender_district], i.[sender_email], i.[sender_full_address], i.[sender_home_address], i.[member_id], i.[sender_name], i.[sender_postcode], i.[sender_province], i.[sender_subdistrict], i.[sender_tel], i.[server_id], i.[signatureUrl], i.[state], i.[status_code], i.[status_dtm], i.[timestamp], i.[transmit_dtm], i.[user_id], i.[wckt_id], i.[wkstn_no]) OUTPUT INSERTED.[item_id], i._Position INTO @inserted0;  SELECT [t].[item_id] FROM [raw_data] t INNER JOIN @inserted0 i ON ([t].[item_id] = [i].[item_id]) ORDER BY [i].[_Position];  ",4,4,0,438,2,4
"(@p0 nvarchar(4000),@p1 nvarchar(4000),@p2 nvarchar(4000),@p3 nvarchar(4000),@p4 nvarchar(4000),@p5 nvarchar(4000),@p6 nvarchar(4000),@p7 nvarchar(4000),@p8 nvarchar(4000),@p9 nvarchar(4000),@p10 nvarchar(4000),@p11 datetime2(7),@p12 nvarchar(4000),@p13 nvarchar(4000),@p14 int,@p15 int,@p16 int,@p17 nvarchar(4000),@p18 nvarchar(4000),@p19 nvarchar(4000),@p20 decimal(18,2),@p21 decimal(18,2),@p22 nvarchar(4000),@p23 nvarchar(4000),@p24 decimal(18,2),@p25 nvarchar(4000),@p26 nvarchar(4000),@p27 nvarchar(4000),@p28 nvarchar(4000),@p29 int,@p30 nvarchar(4000),@p31 nvarchar(4000),@p32 nvarchar(4000),@p33 nvarchar(4000),@p34 nvarchar(4000),@p35 nvarchar(4000),@p36 nvarchar(4000),@p37 nvarchar(4000),@p38 nvarchar(4000),@p39 nvarchar(4000),@p40 int,@p41 nvarchar(4000),@p42 nvarchar(4000),@p43 nvarchar(4000),@p44 nvarchar(4000),@p45 nvarchar(4000),@p46 int,@p47 nvarchar(4000),@p48 int,@p49 int,@p50 datetime2(7),@p51 datetime2(7),@p52 datetime2(7),@p53 nvarchar(4000),@p54 nvarchar(4000),@p55 nvarchar(4000),@p56 nvarchar(4000),@p57 nvarchar(4000),@p58 nvarchar(4000),@p59 nvarchar(4000),@p60 nvarchar(4000),@p61 nvarchar(4000),@p62 nvarchar(4000),@p63 nvarchar(4000),@p64 nvarchar(4000),@p65 nvarchar(4000),@p66 nvarchar(4000),@p67 datetime2(7),@p68 nvarchar(4000),@p69 nvarchar(4000),@p70 int,@p71 int,@p72 int,@p73 nvarchar(4000),@p74 nvarchar(4000),@p75 nvarchar(4000),@p76 decimal(18,2),@p77 decimal(18,2),@p78 nvarchar(4000),@p79 nvarchar(4000),@p80 decimal(18,2),@p81 nvarchar(4000),@p82 nvarchar(4000),@p83 nvarchar(4000),@p84 nvarchar(4000),@p85 int,@p86 nvarchar(4000),@p87 nvarchar(4000),@p88 nvarchar(4000),@p89 nvarchar(4000),@p90 nvarchar(4000),@p91 nvarchar(4000),@p92 nvarchar(4000),@p93 nvarchar(4000),@p94 nvarchar(4000),@p95 nvarchar(4000),@p96 int,@p97 nvarchar(4000),@p98 nvarchar(4000),@p99 nvarchar(4000),@p100 nvarchar(4000),@p101 nvarchar(4000),@p102 int,@p103 nvarchar(4000),@p104 int,@p105 int,@p106 datetime2(7),@p107 datetime2(7),@p108 datetime2(7),@p109 nvarchar(4000),@p110 nvarchar(4000),@p111 nvarchar(4000),@p112 nvarchar(4000),@p113 nvarchar(4000),@p114 nvarchar(4000),@p115 nvarchar(4000),@p116 nvarchar(4000),@p117 nvarchar(4000),@p118 nvarchar(4000),@p119 nvarchar(4000),@p120 nvarchar(4000),@p121 nvarchar(4000),@p122 nvarchar(4000),@p123 datetime2(7),@p124 nvarchar(4000),@p125 nvarchar(4000),@p126 int,@p127 int,@p128 int,@p129 nvarchar(4000),@p130 nvarchar(4000),@p131 nvarchar(4000),@p132 decimal(18,2),@p133 decimal(18,2),@p134 nvarchar(4000),@p135 nvarchar(4000),@p136 decimal(18,2),@p137 nvarchar(4000),@p138 nvarchar(4000),@p139 nvarchar(4000),@p140 nvarchar(4000),@p141 int,@p142 nvarchar(4000),@p143 nvarchar(4000),@p144 nvarchar(4000),@p145 nvarchar(4000),@p146 nvarchar(4000),@p147 nvarchar(4000),@p148 nvarchar(4000),@p149 nvarchar(4000),@p150 nvarchar(4000),@p151 nvarchar(4000),@p152 int,@p153 nvarchar(4000),@p154 nvarchar(4000),@p155 nvarchar(4000),@p156 nvarchar(4000),@p157 nvarchar(4000),@p158 int,@p159 nvarchar(4000),@p160 int,@p161 int,@p162 datetime2(7),@p163 datetime2(7),@p164 datetime2(7),@p165 nvarchar(4000),@p166 nvarchar(4000),@p167 nvarchar(4000),@p168 nvarchar(4000),@p169 nvarchar(4000),@p170 nvarchar(4000),@p171 nvarchar(4000),@p172 nvarchar(4000),@p173 nvarchar(4000),@p174 nvarchar(4000),@p175 nvarchar(4000),@p176 nvarchar(4000),@p177 nvarchar(4000),@p178 nvarchar(4000),@p179 datetime2(7),@p180 nvarchar(4000),@p181 nvarchar(4000),@p182 int,@p183 int,@p184 int,@p185 nvarchar(4000),@p186 nvarchar(4000),@p187 nvarchar(4000),@p188 decimal(18,2),@p189 decimal(18,2),@p190 nvarchar(4000),@p191 nvarchar(4000),@p192 decimal(18,2),@p193 nvarchar(4000),@p194 nvarchar(4000),@p195 nvarchar(4000),@p196 nvarchar(4000),@p197 int,@p198 nvarchar(4000),@p199 nvarchar(4000),@p200 nvarchar(4000),@p201 nvarchar(4000),@p202 nvarchar(4000),@p203 nvarchar(4000),@p204 nvarchar(4000),@p205 nvarchar(4000),@p206 nvarchar(4000),@p207 nvarchar(4000),@p208 int,@p209 nvarchar(4000),@p210 nvarchar(4000),@p211 nvarchar(4000),@p212 nvarchar(4000),@p213 nvarchar(4000),@p214 int,@p215 nvarchar(4000),@p216 int,@p217 int,@p218 datetime2(7),@p219 datetime2(7),@p220 datetime2(7),@p221 nvarchar(4000),@p222 nvarchar(4000),@p223 nvarchar(4000),@p224 nvarchar(4000),@p225 nvarchar(4000),@p226 nvarchar(4000),@p227 nvarchar(4000),@p228 nvarchar(4000),@p229 nvarchar(4000),@p230 nvarchar(4000),@p231 nvarchar(4000),@p232 nvarchar(4000),@p233 nvarchar(4000),@p234 nvarchar(4000),@p235 datetime2(7),@p236 nvarchar(4000),@p237 nvarchar(4000),@p238 int,@p239 int,@p240 int,@p241 nvarchar(4000),@p242 nvarchar(4000),@p243 nvarchar(4000),@p244 decimal(18,2),@p245 decimal(18,2),@p246 nvarchar(4000),@p247 nvarchar(4000),@p248 decimal(18,2),@p249 nvarchar(4000),@p250 nvarchar(4000),@p251 nvarchar(4000),@p252 nvarchar(4000),@p253 int,@p254 nvarchar(4000),@p255 nvarchar(4000),@p256 nvarchar(4000),@p257 nvarchar(4000),@p258 nvarchar(4000),@p259 nvarchar(4000),@p260 nvarchar(4000),@p261 nvarchar(4000),@p262 nvarchar(4000),@p263 nvarchar(4000),@p264 int,@p265 nvarchar(4000),@p266 nvarchar(4000),@p267 nvarchar(4000),@p268 nvarchar(4000),@p269 nvarchar(4000),@p270 int,@p271 nvarchar(4000),@p272 int,@p273 int,@p274 datetime2(7),@p275 datetime2(7),@p276 datetime2(7),@p277 nvarchar(4000),@p278 nvarchar(4000),@p279 nvarchar(4000),@p280 nvarchar(4000),@p281 nvarchar(4000),@p282 nvarchar(4000),@p283 nvarchar(4000),@p284 nvarchar(4000),@p285 nvarchar(4000),@p286 nvarchar(4000),@p287 nvarchar(4000),@p288 nvarchar(4000),@p289 nvarchar(4000),@p290 nvarchar(4000),@p291 datetime2(7),@p292 nvarchar(4000),@p293 nvarchar(4000),@p294 int,@p295 int,@p296 int,@p297 nvarchar(4000),@p298 nvarchar(4000),@p299 nvarchar(4000),@p300 decimal(18,2),@p301 decimal(18,2),@p302 nvarchar(4000),@p303 nvarchar(4000),@p304 decimal(18,2),@p305 nvarchar(4000),@p306 nvarchar(4000),@p307 nvarchar(4000),@p308 nvarchar(4000),@p309 int,@p310 nvarchar(4000),@p311 nvarchar(4000),@p312 nvarchar(4000),@p313 nvarchar(4000),@p314 nvarchar(4000),@p315 nvarchar(4000),@p316 nvarchar(4000),@p317 nvarchar(4000),@p318 nvarchar(4000),@p319 nvarchar(4000),@p320 int,@p321 nvarchar(4000),@p322 nvarchar(4000),@p323 nvarchar(4000),@p324 nvarchar(4000),@p325 nvarchar(4000),@p326 int,@p327 nvarchar(4000),@p328 int,@p329 int,@p330 datetime2(7),@p331 datetime2(7),@p332 datetime2(7),@p333 nvarchar(4000),@p334 nvarchar(4000),@p335 nvarchar(4000),@p336 nvarchar(4000),@p337 nvarchar(4000),@p338 nvarchar(4000),@p339 nvarchar(4000),@p340 nvarchar(4000),@p341 nvarchar(4000),@p342 nvarchar(4000),@p343 nvarchar(4000),@p344 nvarchar(4000),@p345 nvarchar(4000),@p346 nvarchar(4000),@p347 datetime2(7),@p348 nvarchar(4000),@p349 nvarchar(4000),@p350 int,@p351 int,@p352 int,@p353 nvarchar(4000),@p354 nvarchar(4000),@p355 nvarchar(4000),@p356 decimal(18,2),@p357 decimal(18,2),@p358 nvarchar(4000),@p359 nvarchar(4000),@p360 decimal(18,2),@p361 nvarchar(4000),@p362 nvarchar(4000),@p363 nvarchar(4000),@p364 nvarchar(4000),@p365 int,@p366 nvarchar(4000),@p367 nvarchar(4000),@p368 nvarchar(4000),@p369 nvarchar(4000),@p370 nvarchar(4000),@p371 nvarchar(4000),@p372 nvarchar(4000),@p373 nvarchar(4000),@p374 nvarchar(4000),@p375 nvarchar(4000),@p376 int,@p377 nvarchar(4000),@p378 nvarchar(4000),@p379 nvarchar(4000),@p380 nvarchar(4000),@p381 nvarchar(4000),@p382 int,@p383 nvarchar(4000),@p384 int,@p385 int,@p386 datetime2(7),@p387 datetime2(7),@p388 datetime2(7),@p389 nvarchar(4000),@p390 nvarchar(4000),@p391 nvarchar(4000),@p392 nvarchar(4000),@p393 nvarchar(4000),@p394 nvarchar(4000),@p395 nvarchar(4000),@p396 nvarchar(4000),@p397 nvarchar(4000),@p398 nvarchar(4000),@p399 nvarchar(4000),@p400 nvarchar(4000),@p401 nvarchar(4000),@p402 nvarchar(4000),@p403 datetime2(7),@p404 nvarchar(4000),@p405 nvarchar(4000),@p406 int,@p407 int,@p408 int,@p409 nvarchar(4000),@p410 nvarchar(4000),@p411 nvarchar(4000),@p412 decimal(18,2),@p413 decimal(18,2),@p414 nvarchar(4000),@p415 nvarchar(4000),@p416 decimal(18,2),@p417 nvarchar(4000),@p418 nvarchar(4000),@p419 nvarchar(4000),@p420 nvarchar(4000),@p421 int,@p422 nvarchar(4000),@p423 nvarchar(4000),@p424 nvarchar(4000),@p425 nvarchar(4000),@p426 nvarchar(4000),@p427 nvarchar(4000),@p428 nvarchar(4000),@p429 nvarchar(4000),@p430 nvarchar(4000),@p431 nvarchar(4000),@p432 int,@p433 nvarchar(4000),@p434 nvarchar(4000),@p435 nvarchar(4000),@p436 nvarchar(4000),@p437 nvarchar(4000),@p438 int,@p439 nvarchar(4000),@p440 int,@p441 int,@p442 datetime2(7),@p443 datetime2(7),@p444 datetime2(7),@p445 nvarchar(4000),@p446 nvarchar(4000),@p447 nvarchar(4000),@p448 nvarchar(4000),@p449 nvarchar(4000),@p450 nvarchar(4000),@p451 nvarchar(4000),@p452 nvarchar(4000),@p453 nvarchar(4000),@p454 nvarchar(4000),@p455 nvarchar(4000),@p456 nvarchar(4000),@p457 nvarchar(4000),@p458 nvarchar(4000),@p459 datetime2(7),@p460 nvarchar(4000),@p461 nvarchar(4000),@p462 int,@p463 int,@p464 int,@p465 nvarchar(4000),@p466 nvarchar(4000),@p467 nvarchar(4000),@p468 decimal(18,2),@p469 decimal(18,2),@p470 nvarchar(4000),@p471 nvarchar(4000),@p472 decimal(18,2),@p473 nvarchar(4000),@p474 nvarchar(4000),@p475 nvarchar(4000),@p476 nvarchar(4000),@p477 int,@p478 nvarchar(4000),@p479 nvarchar(4000),@p480 nvarchar(4000),@p481 nvarchar(4000),@p482 nvarchar(4000),@p483 nvarchar(4000),@p484 nvarchar(4000),@p485 nvarchar(4000),@p486 nvarchar(4000),@p487 nvarchar(4000),@p488 int,@p489 nvarchar(4000),@p490 nvarchar(4000),@p491 nvarchar(4000),@p492 nvarchar(4000),@p493 nvarchar(4000),@p494 int,@p495 nvarchar(4000),@p496 int,@p497 int,@p498 datetime2(7),@p499 datetime2(7),@p500 datetime2(7),@p501 nvarchar(4000),@p502 nvarchar(4000),@p503 nvarchar(4000),@p504 nvarchar(4000),@p505 nvarchar(4000),@p506 nvarchar(4000),@p507 nvarchar(4000),@p508 nvarchar(4000),@p509 nvarchar(4000),@p510 nvarchar(4000),@p511 nvarchar(4000),@p512 nvarchar(4000),@p513 nvarchar(4000),@p514 nvarchar(4000),@p515 datetime2(7),@p516 nvarchar(4000),@p517 nvarchar(4000),@p518 int,@p519 int,@p520 int,@p521 nvarchar(4000),@p522 nvarchar(4000),@p523 nvarchar(4000),@p524 decimal(18,2),@p525 decimal(18,2),@p526 nvarchar(4000),@p527 nvarchar(4000),@p528 decimal(18,2),@p529 nvarchar(4000),@p530 nvarchar(4000),@p531 nvarchar(4000),@p532 nvarchar(4000),@p533 int,@p534 nvarchar(4000),@p535 nvarchar(4000),@p536 nvarchar(4000),@p537 nvarchar(4000),@p538 nvarchar(4000),@p539 nvarchar(4000),@p540 nvarchar(4000),@p541 nvarchar(4000),@p542 nvarchar(4000),@p543 nvarchar(4000),@p544 int,@p545 nvarchar(4000),@p546 nvarchar(4000),@p547 nvarchar(4000),@p548 nvarchar(4000),@p549 nvarchar(4000),@p550 int,@p551 nvarchar(4000),@p552 int,@p553 int,@p554 datetime2(7),@p555 datetime2(7),@p556 datetime2(7),@p557 nvarchar(4000),@p558 nvarchar(4000),@p559 nvarchar(4000),@p560 nvarchar(4000),@p561 nvarchar(4000),@p562 nvarchar(4000),@p563 nvarchar(4000),@p564 nvarchar(4000),@p565 nvarchar(4000),@p566 nvarchar(4000),@p567 nvarchar(4000),@p568 nvarchar(4000),@p569 nvarchar(4000),@p570 nvarchar(4000),@p571 datetime2(7),@p572 nvarchar(4000),@p573 nvarchar(4000),@p574 int,@p575 int,@p576 int,@p577 nvarchar(4000),@p578 nvarchar(4000),@p579 nvarchar(4000),@p580 decimal(18,2),@p581 decimal(18,2),@p582 nvarchar(4000),@p583 nvarchar(4000),@p584 decimal(18,2),@p585 nvarchar(4000),@p586 nvarchar(4000),@p587 nvarchar(4000),@p588 nvarchar(4000),@p589 int,@p590 nvarchar(4000),@p591 nvarchar(4000),@p592 nvarchar(4000),@p593 nvarchar(4000),@p594 nvarchar(4000),@p595 nvarchar(4000),@p596 nvarchar(4000),@p597 nvarchar(4000),@p598 nvarchar(4000),@p599 nvarchar(4000),@p600 int,@p601 nvarchar(4000),@p602 nvarchar(4000),@p603 nvarchar(4000),@p604 nvarchar(4000),@p605 nvarchar(4000),@p606 int,@p607 nvarchar(4000),@p608 int,@p609 int,@p610 datetime2(7),@p611 datetime2(7),@p612 datetime2(7),@p613 nvarchar(4000),@p614 nvarchar(4000),@p615 nvarchar(4000),@p616 nvarchar(4000),@p617 nvarchar(4000),@p618 nvarchar(4000),@p619 nvarchar(4000),@p620 nvarchar(4000),@p621 nvarchar(4000),@p622 nvarchar(4000),@p623 nvarchar(4000),@p624 nvarchar(4000),@p625 nvarchar(4000),@p626 nvarchar(4000),@p627 datetime2(7),@p628 nvarchar(4000),@p629 nvarchar(4000),@p630 int,@p631 int,@p632 int,@p633 nvarchar(4000),@p634 nvarchar(4000),@p635 nvarchar(4000),@p636 decimal(18,2),@p637 decimal(18,2),@p638 nvarchar(4000),@p639 nvarchar(4000),@p640 decimal(18,2),@p641 nvarchar(4000),@p642 nvarchar(4000),@p643 nvarchar(4000),@p644 nvarchar(4000),@p645 int,@p646 nvarchar(4000),@p647 nvarchar(4000),@p648 nvarchar(4000),@p649 nvarchar(4000),@p650 nvarchar(4000),@p651 nvarchar(4000),@p652 nvarchar(4000),@p653 nvarchar(4000),@p654 nvarchar(4000),@p655 nvarchar(4000),@p656 int,@p657 nvarchar(4000),@p658 nvarchar(4000),@p659 nvarchar(4000),@p660 nvarchar(4000),@p661 nvarchar(4000),@p662 int,@p663 nvarchar(4000),@p664 int,@p665 int,@p666 datetime2(7),@p667 datetime2(7),@p668 datetime2(7),@p669 nvarchar(4000),@p670 nvarchar(4000),@p671 nvarchar(4000),@p672 nvarchar(4000),@p673 nvarchar(4000),@p674 nvarchar(4000),@p675 nvarchar(4000),@p676 nvarchar(4000),@p677 nvarchar(4000),@p678 nvarchar(4000),@p679 nvarchar(4000),@p680 nvarchar(4000),@p681 nvarchar(4000),@p682 nvarchar(4000),@p683 datetime2(7),@p684 nvarchar(4000),@p685 nvarchar(4000),@p686 int,@p687 int,@p688 int,@p689 nvarchar(4000),@p690 nvarchar(4000),@p691 nvarchar(4000),@p692 decimal(18,2),@p693 decimal(18,2),@p694 nvarchar(4000),@p695 nvarchar(4000),@p696 decimal(18,2),@p697 nvarchar(4000),@p698 nvarchar(4000),@p699 nvarchar(4000),@p700 nvarchar(4000),@p701 int,@p702 nvarchar(4000),@p703 nvarchar(4000),@p704 nvarchar(4000),@p705 nvarchar(4000),@p706 nvarchar(4000),@p707 nvarchar(4000),@p708 nvarchar(4000),@p709 nvarchar(4000),@p710 nvarchar(4000),@p711 nvarchar(4000),@p712 int,@p713 nvarchar(4000),@p714 nvarchar(4000),@p715 nvarchar(4000),@p716 nvarchar(4000),@p717 nvarchar(4000),@p718 int,@p719 nvarchar(4000),@p720 int,@p721 int,@p722 datetime2(7),@p723 datetime2(7),@p724 datetime2(7),@p725 nvarchar(4000),@p726 nvarchar(4000),@p727 nvarchar(4000),@p728 nvarchar(4000),@p729 nvarchar(4000),@p730 nvarchar(4000),@p731 nvarchar(4000),@p732 nvarchar(4000),@p733 nvarchar(4000),@p734 nvarchar(4000),@p735 nvarchar(4000),@p736 nvarchar(4000),@p737 nvarchar(4000),@p738 nvarchar(4000),@p739 datetime2(7),@p740 nvarchar(4000),@p741 nvarchar(4000),@p742 int,@p743 int,@p744 int,@p745 nvarchar(4000),@p746 nvarchar(4000),@p747 nvarchar(4000),@p748 nvarchar(4000),@p749 decimal(18,2),@p750 nvarchar(4000),@p751 nvarchar(4000),@p752 decimal(18,2),@p753 nvarchar(4000),@p754 nvarchar(4000),@p755 nvarchar(4000),@p756 nvarchar(4000),@p757 int,@p758 nvarchar(4000),@p759 nvarchar(4000),@p760 nvarchar(4000),@p761 nvarchar(4000),@p762 nvarchar(4000),@p763 nvarchar(4000),@p764 nvarchar(4000),@p765 nvarchar(4000),@p766 nvarchar(4000),@p767 nvarchar(4000),@p768 int,@p769 nvarchar(4000),@p770 nvarchar(4000),@p771 nvarchar(4000),@p772 nvarchar(4000),@p773 nvarchar(4000),@p774 int,@p775 nvarchar(4000),@p776 int,@p777 int,@p778 datetime2(7),@p779 datetime2(7),@p780 datetime2(7),@p781 nvarchar(4000),@p782 nvarchar(4000),@p783 nvarchar(4000),@p784 nvarchar(4000),@p785 nvarchar(4000),@p786 nvarchar(4000),@p787 nvarchar(4000),@p788 nvarchar(4000),@p789 nvarchar(4000),@p790 nvarchar(4000),@p791 nvarchar(4000),@p792 nvarchar(4000),@p793 nvarchar(4000),@p794 nvarchar(4000),@p795 datetime2(7),@p796 nvarchar(4000),@p797 nvarchar(4000),@p798 int,@p799 int,@p800 int,@p801 nvarchar(4000),@p802 nvarchar(4000),@p803 nvarchar(4000),@p804 decimal(18,2),@p805 decimal(18,2),@p806 nvarchar(4000),@p807 nvarchar(4000),@p808 decimal(18,2),@p809 nvarchar(4000),@p810 nvarchar(4000),@p811 nvarchar(4000),@p812 nvarchar(4000),@p813 int,@p814 nvarchar(4000),@p815 nvarchar(4000),@p816 nvarchar(4000),@p817 nvarchar(4000),@p818 nvarchar(4000),@p819 nvarchar(4000),@p820 nvarchar(4000),@p821 nvarchar(4000),@p822 nvarchar(4000),@p823 nvarchar(4000),@p824 int,@p825 nvarchar(4000),@p826 nvarchar(4000),@p827 nvarchar(4000),@p828 nvarchar(4000),@p829 nvarchar(4000),@p830 int,@p831 nvarchar(4000),@p832 int,@p833 int,@p834 datetime2(7),@p835 datetime2(7),@p836 datetime2(7),@p837 nvarchar(4000),@p838 nvarchar(4000),@p839 nvarchar(4000),@p840 nvarchar(4000),@p841 nvarchar(4000),@p842 nvarchar(4000),@p843 nvarchar(4000),@p844 nvarchar(4000),@p845 nvarchar(4000),@p846 nvarchar(4000),@p847 nvarchar(4000),@p848 nvarchar(4000),@p849 nvarchar(4000),@p850 nvarchar(4000),@p851 datetime2(7),@p852 nvarchar(4000),@p853 nvarchar(4000),@p854 int,@p855 int,@p856 int,@p857 nvarchar(4000),@p858 nvarchar(4000),@p859 nvarchar(4000),@p860 decimal(18,2),@p861 decimal(18,2),@p862 nvarchar(4000),@p863 nvarchar(4000),@p864 decimal(18,2),@p865 nvarchar(4000),@p866 nvarchar(4000),@p867 nvarchar(4000),@p868 nvarchar(4000),@p869 int,@p870 nvarchar(4000),@p871 nvarchar(4000),@p872 nvarchar(4000),@p873 nvarchar(4000),@p874 nvarchar(4000),@p875 nvarchar(4000),@p876 nvarchar(4000),@p877 nvarchar(4000),@p878 nvarchar(4000),@p879 nvarchar(4000),@p880 int,@p881 nvarchar(4000),@p882 nvarchar(4000),@p883 nvarchar(4000),@p884 nvarchar(4000),@p885 nvarchar(4000),@p886 int,@p887 nvarchar(4000),@p888 int,@p889 int,@p890 datetime2(7),@p891 datetime2(7),@p892 datetime2(7),@p893 nvarchar(4000),@p894 nvarchar(4000),@p895 nvarchar(4000),@p896 nvarchar(4000),@p897 nvarchar(4000),@p898 nvarchar(4000),@p899 nvarchar(4000),@p900 nvarchar(4000),@p901 nvarchar(4000),@p902 nvarchar(4000),@p903 nvarchar(4000),@p904 nvarchar(4000),@p905 nvarchar(4000),@p906 nvarchar(4000),@p907 datetime2(7),@p908 nvarchar(4000),@p909 nvarchar(4000),@p910 int,@p911 int,@p912 int,@p913 nvarchar(4000),@p914 nvarchar(4000),@p915 nvarchar(4000),@p916 decimal(18,2),@p917 decimal(18,2),@p918 nvarchar(4000),@p919 nvarchar(4000),@p920 decimal(18,2),@p921 nvarchar(4000),@p922 nvarchar(4000),@p923 nvarchar(4000),@p924 nvarchar(4000),@p925 int,@p926 nvarchar(4000),@p927 nvarchar(4000),@p928 nvarchar(4000),@p929 nvarchar(4000),@p930 nvarchar(4000),@p931 nvarchar(4000),@p932 nvarchar(4000),@p933 nvarchar(4000),@p934 nvarchar(4000),@p935 nvarchar(4000),@p936 int,@p937 nvarchar(4000),@p938 nvarchar(4000),@p939 nvarchar(4000),@p940 nvarchar(4000),@p941 nvarchar(4000),@p942 int,@p943 nvarchar(4000),@p944 int,@p945 int,@p946 datetime2(7),@p947 datetime2(7),@p948 datetime2(7),@p949 nvarchar(4000),@p950 nvarchar(4000),@p951 nvarchar(4000),@p952 nvarchar(4000),@p953 nvarchar(4000),@p954 nvarchar(4000),@p955 nvarchar(4000),@p956 nvarchar(4000),@p957 nvarchar(4000),@p958 nvarchar(4000),@p959 nvarchar(4000),@p960 nvarchar(4000),@p961 nvarchar(4000),@p962 nvarchar(4000),@p963 datetime2(7),@p964 nvarchar(4000),@p965 nvarchar(4000),@p966 int,@p967 int,@p968 int,@p969 nvarchar(4000),@p970 nvarchar(4000),@p971 nvarchar(4000),@p972 nvarchar(4000),@p973 decimal(18,2),@p974 nvarchar(4000),@p975 nvarchar(4000),@p976 decimal(18,2),@p977 nvarchar(4000),@p978 nvarchar(4000),@p979 nvarchar(4000),@p980 nvarchar(4000),@p981 int,@p982 nvarchar(4000),@p983 nvarchar(4000),@p984 nvarchar(4000),@p985 nvarchar(4000),@p986 nvarchar(4000),@p987 nvarchar(4000),@p988 nvarchar(4000),@p989 nvarchar(4000),@p990 nvarchar(4000),@p991 nvarchar(4000),@p992 int,@p993 nvarchar(4000),@p994 nvarchar(4000),@p995 nvarchar(4000),@p996 nvarchar(4000),@p997 nvarchar(4000),@p998 int,@p999 nvarchar(4000),@p1000 int,@p1001 int,@p1002 datetime2(7),@p1003 datetime2(7),@p1004 datetime2(7),@p1005 nvarchar(4000),@p1006 nvarchar(4000),@p1007 nvarchar(4000),@p1008 nvarchar(4000),@p1009 nvarchar(4000),@p1010 nvarchar(4000),@p1011 nvarchar(4000),@p1012 nvarchar(4000),@p1013 nvarchar(4000),@p1014 nvarchar(4000),@p1015 nvarchar(4000),@p1016 nvarchar(4000),@p1017 nvarchar(4000),@p1018 nvarchar(4000),@p1019 datetime2(7),@p1020 nvarchar(4000),@p1021 nvarchar(4000),@p1022 int,@p1023 int,@p1024 int,@p1025 nvarchar(4000),@p1026 nvarchar(4000),@p1027 nvarchar(4000),@p1028 decimal(18,2),@p1029 decimal(18,2),@p1030 nvarchar(4000),@p1031 nvarchar(4000),@p1032 decimal(18,2),@p1033 nvarchar(4000),@p1034 nvarchar(4000),@p1035 nvarchar(4000),@p1036 nvarchar(4000),@p1037 int,@p1038 nvarchar(4000),@p1039 nvarchar(4000),@p1040 nvarchar(4000),@p1041 nvarchar(4000),@p1042 nvarchar(4000),@p1043 nvarchar(4000),@p1044 nvarchar(4000),@p1045 nvarchar(4000),@p1046 nvarchar(4000),@p1047 nvarchar(4000),@p1048 int,@p1049 nvarchar(4000),@p1050 nvarchar(4000),@p1051 nvarchar(4000),@p1052 nvarchar(4000),@p1053 nvarchar(4000),@p1054 int,@p1055 nvarchar(4000),@p1056 int,@p1057 int,@p1058 datetime2(7),@p1059 datetime2(7),@p1060 datetime2(7),@p1061 nvarchar(4000),@p1062 nvarchar(4000),@p1063 nvarchar(4000),@p1064 nvarchar(4000),@p1065 nvarchar(4000),@p1066 nvarchar(4000),@p1067 nvarchar(4000),@p1068 nvarchar(4000),@p1069 nvarchar(4000),@p1070 nvarchar(4000),@p1071 nvarchar(4000),@p1072 nvarchar(4000),@p1073 nvarchar(4000),@p1074 nvarchar(4000),@p1075 datetime2(7),@p1076 nvarchar(4000),@p1077 nvarchar(4000),@p1078 int,@p1079 int,@p1080 int,@p1081 nvarchar(4000),@p1082 nvarchar(4000),@p1083 nvarchar(4000),@p1084 decimal(18,2),@p1085 decimal(18,2),@p1086 nvarchar(4000),@p1087 nvarchar(4000),@p1088 decimal(18,2),@p1089 nvarchar(4000),@p1090 nvarchar(4000),@p1091 nvarchar(4000),@p1092 nvarchar(4000),@p1093 int,@p1094 nvarchar(4000),@p1095 nvarchar(4000),@p1096 nvarchar(4000),@p1097 nvarchar(4000),@p1098 nvarchar(4000),@p1099 nvarchar(4000),@p1100 nvarchar(4000),@p1101 nvarchar(4000),@p1102 nvarchar(4000),@p1103 nvarchar(4000),@p1104 int,@p1105 nvarchar(4000),@p1106 nvarchar(4000),@p1107 nvarchar(4000),@p1108 nvarchar(4000),@p1109 nvarchar(4000),@p1110 int,@p1111 nvarchar(4000),@p1112 int,@p1113 int,@p1114 datetime2(7),@p1115 datetime2(7),@p1116 datetime2(7),@p1117 nvarchar(4000),@p1118 nvarchar(4000),@p1119 nvarchar(4000),@p1120 nvarchar(4000),@p1121 nvarchar(4000),@p1122 nvarchar(4000),@p1123 nvarchar(4000),@p1124 nvarchar(4000),@p1125 nvarchar(4000),@p1126 nvarchar(4000),@p1127 nvarchar(4000),@p1128 nvarchar(4000),@p1129 nvarchar(4000),@p1130 nvarchar(4000),@p1131 datetime2(7),@p1132 nvarchar(4000),@p1133 nvarchar(4000),@p1134 int,@p1135 int,@p1136 int,@p1137 nvarchar(4000),@p1138 nvarchar(4000),@p1139 nvarchar(4000),@p1140 decimal(18,2),@p1141 decimal(18,2),@p1142 nvarchar(4000),@p1143 nvarchar(4000),@p1144 decimal(18,2),@p1145 nvarchar(4000),@p1146 nvarchar(4000),@p1147 nvarchar(4000),@p1148 nvarchar(4000),@p1149 int,@p1150 nvarchar(4000),@p1151 nvarchar(4000),@p1152 nvarchar(4000),@p1153 nvarchar(4000),@p1154 nvarchar(4000),@p1155 nvarchar(4000),@p1156 nvarchar(4000),@p1157 nvarchar(4000),@p1158 nvarchar(4000),@p1159 nvarchar(4000),@p1160 int,@p1161 nvarchar(4000),@p1162 nvarchar(4000),@p1163 nvarchar(4000),@p1164 nvarchar(4000),@p1165 nvarchar(4000),@p1166 int,@p1167 nvarchar(4000),@p1168 int,@p1169 int,@p1170 datetime2(7),@p1171 datetime2(7),@p1172 datetime2(7),@p1173 nvarchar(4000),@p1174 nvarchar(4000),@p1175 nvarchar(4000),@p1176 nvarchar(4000),@p1177 nvarchar(4000),@p1178 nvarchar(4000),@p1179 nvarchar(4000),@p1180 nvarchar(4000),@p1181 nvarchar(4000),@p1182 nvarchar(4000),@p1183 nvarchar(4000),@p1184 nvarchar(4000),@p1185 nvarchar(4000),@p1186 nvarchar(4000),@p1187 datetime2(7),@p1188 nvarchar(4000),@p1189 nvarchar(4000),@p1190 int,@p1191 int,@p1192 int,@p1193 nvarchar(4000),@p1194 nvarchar(4000),@p1195 nvarchar(4000),@p1196 decimal(18,2),@p1197 decimal(18,2),@p1198 nvarchar(4000),@p1199 nvarchar(4000),@p1200 decimal(18,2),@p1201 nvarchar(4000),@p1202 nvarchar(4000),@p1203 nvarchar(4000),@p1204 nvarchar(4000),@p1205 int,@p1206 nvarchar(4000),@p1207 nvarchar(4000),@p1208 nvarchar(4000),@p1209 nvarchar(4000),@p1210 nvarchar(4000),@p1211 nvarchar(4000),@p1212 nvarchar(4000),@p1213 nvarchar(4000),@p1214 nvarchar(4000),@p1215 nvarchar(4000),@p1216 int,@p1217 nvarchar(4000),@p1218 nvarchar(4000),@p1219 nvarchar(4000),@p1220 nvarchar(4000),@p1221 nvarchar(4000),@p1222 int,@p1223 nvarchar(4000),@p1224 int,@p1225 int,@p1226 datetime2(7),@p1227 datetime2(7),@p1228 datetime2(7),@p1229 nvarchar(4000),@p1230 nvarchar(4000),@p1231 nvarchar(4000),@p1232 nvarchar(4000),@p1233 nvarchar(4000),@p1234 nvarchar(4000),@p1235 nvarchar(4000),@p1236 nvarchar(4000),@p1237 nvarchar(4000),@p1238 nvarchar(4000),@p1239 nvarchar(4000),@p1240 nvarchar(4000),@p1241 nvarchar(4000),@p1242 nvarchar(4000),@p1243 datetime2(7),@p1244 nvarchar(4000),@p1245 nvarchar(4000),@p1246 int,@p1247 int,@p1248 int,@p1249 nvarchar(4000),@p1250 nvarchar(4000),@p1251 nvarchar(4000),@p1252 decimal(18,2),@p1253 decimal(18,2),@p1254 nvarchar(4000),@p1255 nvarchar(4000),@p1256 decimal(18,2),@p1257 nvarchar(4000),@p1258 nvarchar(4000),@p1259 nvarchar(4000),@p1260 nvarchar(4000),@p1261 int,@p1262 nvarchar(4000),@p1263 nvarchar(4000),@p1264 nvarchar(4000),@p1265 nvarchar(4000),@p1266 nvarchar(4000),@p1267 nvarchar(4000),@p1268 nvarchar(4000),@p1269 nvarchar(4000),@p1270 nvarchar(4000),@p1271 nvarchar(4000),@p1272 int,@p1273 nvarchar(4000),@p1274 nvarchar(4000),@p1275 nvarchar(4000),@p1276 nvarchar(4000),@p1277 nvarchar(4000),@p1278 int,@p1279 nvarchar(4000),@p1280 int,@p1281 int,@p1282 datetime2(7),@p1283 datetime2(7),@p1284 datetime2(7),@p1285 nvarchar(4000),@p1286 nvarchar(4000),@p1287 nvarchar(4000),@p1288 nvarchar(4000),@p1289 nvarchar(4000),@p1290 nvarchar(4000),@p1291 nvarchar(4000),@p1292 nvarchar(4000),@p1293 nvarchar(4000),@p1294 nvarchar(4000),@p1295 nvarchar(4000),@p1296 nvarchar(4000),@p1297 nvarchar(4000),@p1298 nvarchar(4000),@p1299 datetime2(7),@p1300 nvarchar(4000),@p1301 nvarchar(4000),@p1302 int,@p1303 int,@p1304 int,@p1305 nvarchar(4000),@p1306 nvarchar(4000),@p1307 nvarchar(4000),@p1308 decimal(18,2),@p1309 decimal(18,2),@p1310 nvarchar(4000),@p1311 nvarchar(4000),@p1312 decimal(18,2),@p1313 nvarchar(4000),@p1314 nvarchar(4000),@p1315 nvarchar(4000),@p1316 nvarchar(4000),@p1317 int,@p1318 nvarchar(4000),@p1319 nvarchar(4000),@p1320 nvarchar(4000),@p1321 nvarchar(4000),@p1322 nvarchar(4000),@p1323 nvarchar(4000),@p1324 nvarchar(4000),@p1325 nvarchar(4000),@p1326 nvarchar(4000),@p1327 nvarchar(4000),@p1328 int,@p1329 nvarchar(4000),@p1330 nvarchar(4000),@p1331 nvarchar(4000),@p1332 nvarchar(4000),@p1333 nvarchar(4000),@p1334 int,@p1335 nvarchar(4000),@p1336 int,@p1337 int,@p1338 datetime2(7),@p1339 datetime2(7),@p1340 datetime2(7),@p1341 nvarchar(4000),@p1342 nvarchar(4000),@p1343 nvarchar(4000),@p1344 nvarchar(4000),@p1345 nvarchar(4000),@p1346 nvarchar(4000),@p1347 nvarchar(4000),@p1348 nvarchar(4000),@p1349 nvarchar(4000),@p1350 nvarchar(4000),@p1351 nvarchar(4000),@p1352 nvarchar(4000),@p1353 nvarchar(4000),@p1354 nvarchar(4000),@p1355 datetime2(7),@p1356 nvarchar(4000),@p1357 nvarchar(4000),@p1358 int,@p1359 int,@p1360 int,@p1361 nvarchar(4000),@p1362 nvarchar(4000),@p1363 nvarchar(4000),@p1364 decimal(18,2),@p1365 decimal(18,2),@p1366 nvarchar(4000),@p1367 nvarchar(4000),@p1368 decimal(18,2),@p1369 nvarchar(4000),@p1370 nvarchar(4000),@p1371 nvarchar(4000),@p1372 nvarchar(4000),@p1373 int,@p1374 nvarchar(4000),@p1375 nvarchar(4000),@p1376 nvarchar(4000),@p1377 nvarchar(4000),@p1378 nvarchar(4000),@p1379 nvarchar(4000),@p1380 nvarchar(4000),@p1381 nvarchar(4000),@p1382 nvarchar(4000),@p1383 nvarchar(4000),@p1384 int,@p1385 nvarchar(4000),@p1386 nvarchar(4000),@p1387 nvarchar(4000),@p1388 nvarchar(4000),@p1389 nvarchar(4000),@p1390 int,@p1391 nvarchar(4000),@p1392 int,@p1393 int,@p1394 datetime2(7),@p1395 datetime2(7),@p1396 datetime2(7),@p1397 nvarchar(4000),@p1398 nvarchar(4000),@p1399 nvarchar(4000),@p1400 nvarchar(4000),@p1401 nvarchar(4000),@p1402 nvarchar(4000),@p1403 nvarchar(4000),@p1404 nvarchar(4000),@p1405 nvarchar(4000),@p1406 nvarchar(4000),@p1407 nvarchar(4000),@p1408 nvarchar(4000),@p1409 nvarchar(4000),@p1410 nvarchar(4000),@p1411 datetime2(7),@p1412 nvarchar(4000),@p1413 nvarchar(4000),@p1414 int,@p1415 int,@p1416 int,@p1417 nvarchar(4000),@p1418 nvarchar(4000),@p1419 nvarchar(4000),@p1420 decimal(18,2),@p1421 decimal(18,2),@p1422 nvarchar(4000),@p1423 nvarchar(4000),@p1424 decimal(18,2),@p1425 nvarchar(4000),@p1426 nvarchar(4000),@p1427 nvarchar(4000),@p1428 nvarchar(4000),@p1429 int,@p1430 nvarchar(4000),@p1431 nvarchar(4000),@p1432 nvarchar(4000),@p1433 nvarchar(4000),@p1434 nvarchar(4000),@p1435 nvarchar(4000),@p1436 nvarchar(4000),@p1437 nvarchar(4000),@p1438 nvarchar(4000),@p1439 nvarchar(4000),@p1440 int,@p1441 nvarchar(4000),@p1442 nvarchar(4000),@p1443 nvarchar(4000),@p1444 nvarchar(4000),@p1445 nvarchar(4000),@p1446 int,@p1447 nvarchar(4000),@p1448 int,@p1449 int,@p1450 datetime2(7),@p1451 datetime2(7),@p1452 datetime2(7),@p1453 nvarchar(4000),@p1454 nvarchar(4000),@p1455 nvarchar(4000),@p1456 nvarchar(4000),@p1457 nvarchar(4000),@p1458 nvarchar(4000),@p1459 nvarchar(4000),@p1460 nvarchar(4000),@p1461 nvarchar(4000),@p1462 nvarchar(4000),@p1463 nvarchar(4000),@p1464 nvarchar(4000),@p1465 nvarchar(4000),@p1466 nvarchar(4000),@p1467 datetime2(7),@p1468 nvarchar(4000),@p1469 nvarchar(4000),@p1470 int,@p1471 int,@p1472 int,@p1473 nvarchar(4000),@p1474 nvarchar(4000),@p1475 nvarchar(4000),@p1476 decimal(18,2),@p1477 decimal(18,2),@p1478 nvarchar(4000),@p1479 nvarchar(4000),@p1480 decimal(18,2),@p1481 nvarchar(4000),@p1482 nvarchar(4000),@p1483 nvarchar(4000),@p1484 nvarchar(4000),@p1485 int,@p1486 nvarchar(4000),@p1487 nvarchar(4000),@p1488 nvarchar(4000),@p1489 nvarchar(4000),@p1490 nvarchar(4000),@p1491 nvarchar(4000),@p1492 nvarchar(4000),@p1493 nvarchar(4000),@p1494 nvarchar(4000),@p1495 nvarchar(4000),@p1496 int,@p1497 nvarchar(4000),@p1498 nvarchar(4000),@p1499 nvarchar(4000),@p1500 nvarchar(4000),@p1501 nvarchar(4000),@p1502 int,@p1503 nvarchar(4000),@p1504 int,@p1505 int,@p1506 datetime2(7),@p1507 datetime2(7),@p1508 datetime2(7),@p1509 nvarchar(4000),@p1510 nvarchar(4000),@p1511 nvarchar(4000),@p1512 nvarchar(4000),@p1513 nvarchar(4000),@p1514 nvarchar(4000),@p1515 nvarchar(4000),@p1516 nvarchar(4000),@p1517 nvarchar(4000),@p1518 nvarchar(4000),@p1519 nvarchar(4000),@p1520 nvarchar(4000),@p1521 nvarchar(4000),@p1522 nvarchar(4000),@p1523 datetime2(7),@p1524 nvarchar(4000),@p1525 nvarchar(4000),@p1526 int,@p1527 int,@p1528 int,@p1529 nvarchar(4000),@p1530 nvarchar(4000),@p1531 nvarchar(4000),@p1532 decimal(18,2),@p1533 decimal(18,2),@p1534 nvarchar(4000),@p1535 nvarchar(4000),@p1536 decimal(18,2),@p1537 nvarchar(4000),@p1538 nvarchar(4000),@p1539 nvarchar(4000),@p1540 nvarchar(4000),@p1541 int,@p1542 nvarchar(4000),@p1543 nvarchar(4000),@p1544 nvarchar(4000),@p1545 nvarchar(4000),@p1546 nvarchar(4000),@p1547 nvarchar(4000),@p1548 nvarchar(4000),@p1549 nvarchar(4000),@p1550 nvarchar(4000),@p1551 nvarchar(4000),@p1552 int,@p1553 nvarchar(4000),@p1554 nvarchar(4000),@p1555 nvarchar(4000),@p1556 nvarchar(4000),@p1557 nvarchar(4000),@p1558 int,@p1559 nvarchar(4000),@p1560 int,@p1561 int,@p1562 datetime2(7),@p1563 datetime2(7),@p1564 datetime2(7),@p1565 nvarchar(4000),@p1566 nvarchar(4000),@p1567 nvarchar(4000),@p1568 nvarchar(4000),@p1569 nvarchar(4000),@p1570 nvarchar(4000),@p1571 nvarchar(4000),@p1572 nvarchar(4000),@p1573 nvarchar(4000),@p1574 nvarchar(4000),@p1575 nvarchar(4000),@p1576 nvarchar(4000),@p1577 nvarchar(4000),@p1578 nvarchar(4000),@p1579 datetime2(7),@p1580 nvarchar(4000),@p1581 nvarchar(4000),@p1582 int,@p1583 int,@p1584 int,@p1585 nvarchar(4000),@p1586 nvarchar(4000),@p1587 nvarchar(4000),@p1588 decimal(18,2),@p1589 decimal(18,2),@p1590 nvarchar(4000),@p1591 nvarchar(4000),@p1592 decimal(18,2),@p1593 nvarchar(4000),@p1594 nvarchar(4000),@p1595 nvarchar(4000),@p1596 nvarchar(4000),@p1597 int,@p1598 nvarchar(4000),@p1599 nvarchar(4000),@p1600 nvarchar(4000),@p1601 nvarchar(4000),@p1602 nvarchar(4000),@p1603 nvarchar(4000),@p1604 nvarchar(4000),@p1605 nvarchar(4000),@p1606 nvarchar(4000),@p1607 nvarchar(4000),@p1608 int,@p1609 nvarchar(4000),@p1610 nvarchar(4000),@p1611 nvarchar(4000),@p1612 nvarchar(4000),@p1613 nvarchar(4000),@p1614 int,@p1615 nvarchar(4000),@p1616 int,@p1617 int,@p1618 datetime2(7),@p1619 datetime2(7),@p1620 datetime2(7),@p1621 nvarchar(4000),@p1622 nvarchar(4000),@p1623 nvarchar(4000),@p1624 nvarchar(4000),@p1625 nvarchar(4000),@p1626 nvarchar(4000),@p1627 nvarchar(4000),@p1628 nvarchar(4000),@p1629 nvarchar(4000),@p1630 nvarchar(4000),@p1631 nvarchar(4000),@p1632 nvarchar(4000),@p1633 nvarchar(4000),@p1634 nvarchar(4000),@p1635 datetime2(7),@p1636 nvarchar(4000),@p1637 nvarchar(4000),@p1638 int,@p1639 int,@p1640 int,@p1641 nvarchar(4000),@p1642 nvarchar(4000),@p1643 nvarchar(4000),@p1644 decimal(18,2),@p1645 decimal(18,2),@p1646 nvarchar(4000),@p1647 nvarchar(4000),@p1648 decimal(18,2),@p1649 nvarchar(4000),@p1650 nvarchar(4000),@p1651 nvarchar(4000),@p1652 nvarchar(4000),@p1653 int,@p1654 nvarchar(4000),@p1655 nvarchar(4000),@p1656 nvarchar(4000),@p1657 nvarchar(4000),@p1658 nvarchar(4000),@p1659 nvarchar(4000),@p1660 nvarchar(4000),@p1661 nvarchar(4000),@p1662 nvarchar(4000),@p1663 nvarchar(4000),@p1664 int,@p1665 nvarchar(4000),@p1666 nvarchar(4000),@p1667 nvarchar(4000),@p1668 nvarchar(4000),@p1669 nvarchar(4000),@p1670 int,@p1671 nvarchar(4000),@p1672 int,@p1673 int,@p1674 datetime2(7),@p1675 datetime2(7),@p1676 datetime2(7),@p1677 nvarchar(4000),@p1678 nvarchar(4000),@p1679 nvarchar(4000),@p1680 nvarchar(4000),@p1681 nvarchar(4000),@p1682 nvarchar(4000),@p1683 nvarchar(4000),@p1684 nvarchar(4000),@p1685 nvarchar(4000),@p1686 nvarchar(4000),@p1687 nvarchar(4000),@p1688 nvarchar(4000),@p1689 nvarchar(4000),@p1690 nvarchar(4000),@p1691 datetime2(7),@p1692 nvarchar(4000),@p1693 nvarchar(4000),@p1694 int,@p1695 int,@p1696 int,@p1697 nvarchar(4000),@p1698 nvarchar(4000),@p1699 nvarchar(4000),@p1700 decimal(18,2),@p1701 decimal(18,2),@p1702 nvarchar(4000),@p1703 nvarchar(4000),@p1704 decimal(18,2),@p1705 nvarchar(4000),@p1706 nvarchar(4000),@p1707 nvarchar(4000),@p1708 nvarchar(4000),@p1709 int,@p1710 nvarchar(4000),@p1711 nvarchar(4000),@p1712 nvarchar(4000),@p1713 nvarchar(4000),@p1714 nvarchar(4000),@p1715 nvarchar(4000),@p1716 nvarchar(4000),@p1717 nvarchar(4000),@p1718 nvarchar(4000),@p1719 nvarchar(4000),@p1720 int,@p1721 nvarchar(4000),@p1722 nvarchar(4000),@p1723 nvarchar(4000),@p1724 nvarchar(4000),@p1725 nvarchar(4000),@p1726 int,@p1727 nvarchar(4000),@p1728 int,@p1729 int,@p1730 datetime2(7),@p1731 datetime2(7),@p1732 datetime2(7),@p1733 nvarchar(4000),@p1734 nvarchar(4000),@p1735 nvarchar(4000),@p1736 nvarchar(4000),@p1737 nvarchar(4000),@p1738 nvarchar(4000),@p1739 nvarchar(4000),@p1740 nvarchar(4000),@p1741 nvarchar(4000),@p1742 nvarchar(4000),@p1743 nvarchar(4000),@p1744 nvarchar(4000),@p1745 nvarchar(4000),@p1746 nvarchar(4000),@p1747 datetime2(7),@p1748 nvarchar(4000),@p1749 nvarchar(4000),@p1750 int,@p1751 int,@p1752 int,@p1753 nvarchar(4000),@p1754 nvarchar(4000),@p1755 nvarchar(4000),@p1756 decimal(18,2),@p1757 decimal(18,2),@p1758 nvarchar(4000),@p1759 nvarchar(4000),@p1760 decimal(18,2),@p1761 nvarchar(4000),@p1762 nvarchar(4000),@p1763 nvarchar(4000),@p1764 nvarchar(4000),@p1765 int,@p1766 nvarchar(4000),@p1767 nvarchar(4000),@p1768 nvarchar(4000),@p1769 nvarchar(4000),@p1770 nvarchar(4000),@p1771 nvarchar(4000),@p1772 nvarchar(4000),@p1773 nvarchar(4000),@p1774 nvarchar(4000),@p1775 nvarchar(4000),@p1776 int,@p1777 nvarchar(4000),@p1778 nvarchar(4000),@p1779 nvarchar(4000),@p1780 nvarchar(4000),@p1781 nvarchar(4000),@p1782 int,@p1783 nvarchar(4000),@p1784 int,@p1785 int,@p1786 datetime2(7),@p1787 datetime2(7),@p1788 datetime2(7),@p1789 nvarchar(4000),@p1790 nvarchar(4000),@p1791 nvarchar(4000),@p1792 nvarchar(4000),@p1793 nvarchar(4000),@p1794 nvarchar(4000),@p1795 nvarchar(4000),@p1796 nvarchar(4000),@p1797 nvarchar(4000),@p1798 nvarchar(4000),@p1799 nvarchar(4000),@p1800 nvarchar(4000),@p1801 nvarchar(4000),@p1802 nvarchar(4000),@p1803 datetime2(7),@p1804 nvarchar(4000),@p1805 nvarchar(4000),@p1806 int,@p1807 int,@p1808 int,@p1809 nvarchar(4000),@p1810 nvarchar(4000),@p1811 nvarchar(4000),@p1812 nvarchar(4000),@p1813 decimal(18,2),@p1814 nvarchar(4000),@p1815 nvarchar(4000),@p1816 decimal(18,2),@p1817 nvarchar(4000),@p1818 nvarchar(4000),@p1819 nvarchar(4000),@p1820 nvarchar(4000),@p1821 int,@p1822 nvarchar(4000),@p1823 nvarchar(4000),@p1824 nvarchar(4000),@p1825 nvarchar(4000),@p1826 nvarchar(4000),@p1827 nvarchar(4000),@p1828 nvarchar(4000),@p1829 nvarchar(4000),@p1830 nvarchar(4000),@p1831 nvarchar(4000),@p1832 int,@p1833 nvarchar(4000),@p1834 nvarchar(4000),@p1835 nvarchar(4000),@p1836 nvarchar(4000),@p1837 nvarchar(4000),@p1838 int,@p1839 nvarchar(4000),@p1840 int,@p1841 int,@p1842 datetime2(7),@p1843 datetime2(7),@p1844 datetime2(7),@p1845 nvarchar(4000),@p1846 nvarchar(4000),@p1847 nvarchar(4000),@p1848 nvarchar(4000),@p1849 nvarchar(4000),@p1850 nvarchar(4000),@p1851 nvarchar(4000),@p1852 nvarchar(4000),@p1853 nvarchar(4000),@p1854 nvarchar(4000),@p1855 nvarchar(4000),@p1856 nvarchar(4000),@p1857 nvarchar(4000),@p1858 nvarchar(4000),@p1859 datetime2(7),@p1860 nvarchar(4000),@p1861 nvarchar(4000),@p1862 int,@p1863 int,@p1864 int,@p1865 nvarchar(4000),@p1866 nvarchar(4000),@p1867 nvarchar(4000),@p1868 nvarchar(4000),@p1869 decimal(18,2),@p1870 nvarchar(4000),@p1871 nvarchar(4000),@p1872 decimal(18,2),@p1873 nvarchar(4000),@p1874 nvarchar(4000),@p1875 nvarchar(4000),@p1876 nvarchar(4000),@p1877 int,@p1878 nvarchar(4000),@p1879 nvarchar(4000),@p1880 nvarchar(4000),@p1881 nvarchar(4000),@p1882 nvarchar(4000),@p1883 nvarchar(4000),@p1884 nvarchar(4000),@p1885 nvarchar(4000),@p1886 nvarchar(4000),@p1887 nvarchar(4000),@p1888 int,@p1889 nvarchar(4000),@p1890 nvarchar(4000),@p1891 nvarchar(4000),@p1892 nvarchar(4000),@p1893 nvarchar(4000),@p1894 int,@p1895 nvarchar(4000),@p1896 int,@p1897 int,@p1898 datetime2(7),@p1899 datetime2(7),@p1900 datetime2(7),@p1901 nvarchar(4000),@p1902 nvarchar(4000),@p1903 nvarchar(4000),@p1904 nvarchar(4000),@p1905 nvarchar(4000),@p1906 nvarchar(4000),@p1907 nvarchar(4000),@p1908 nvarchar(4000),@p1909 nvarchar(4000),@p1910 nvarchar(4000),@p1911 nvarchar(4000),@p1912 nvarchar(4000),@p1913 nvarchar(4000),@p1914 nvarchar(4000),@p1915 datetime2(7),@p1916 nvarchar(4000),@p1917 nvarchar(4000),@p1918 int,@p1919 int,@p1920 int,@p1921 nvarchar(4000),@p1922 nvarchar(4000),@p1923 nvarchar(4000),@p1924 decimal(18,2),@p1925 decimal(18,2),@p1926 nvarchar(4000),@p1927 nvarchar(4000),@p1928 decimal(18,2),@p1929 nvarchar(4000),@p1930 nvarchar(4000),@p1931 nvarchar(4000),@p1932 nvarchar(4000),@p1933 int,@p1934 nvarchar(4000),@p1935 nvarchar(4000),@p1936 nvarchar(4000),@p1937 nvarchar(4000),@p1938 nvarchar(4000),@p1939 nvarchar(4000),@p1940 nvarchar(4000),@p1941 nvarchar(4000),@p1942 nvarchar(4000),@p1943 nvarchar(4000),@p1944 int,@p1945 nvarchar(4000),@p1946 nvarchar(4000),@p1947 nvarchar(4000),@p1948 nvarchar(4000),@p1949 nvarchar(4000),@p1950 int,@p1951 nvarchar(4000),@p1952 int,@p1953 int,@p1954 datetime2(7),@p1955 datetime2(7),@p1956 datetime2(7),@p1957 nvarchar(4000),@p1958 nvarchar(4000),@p1959 nvarchar(4000),@p1960 nvarchar(4000),@p1961 nvarchar(4000),@p1962 nvarchar(4000),@p1963 nvarchar(4000),@p1964 nvarchar(4000),@p1965 nvarchar(4000),@p1966 nvarchar(4000),@p1967 nvarchar(4000),@p1968 nvarchar(4000),@p1969 nvarchar(4000),@p1970 nvarchar(4000),@p1971 datetime2(7),@p1972 nvarchar(4000),@p1973 nvarchar(4000),@p1974 int,@p1975 int,@p1976 int,@p1977 nvarchar(4000),@p1978 nvarchar(4000),@p1979 nvarchar(4000),@p1980 decimal(18,2),@p1981 decimal(18,2),@p1982 nvarchar(4000),@p1983 nvarchar(4000),@p1984 decimal(18,2),@p1985 nvarchar(4000),@p1986 nvarchar(4000),@p1987 nvarchar(4000),@p1988 nvarchar(4000),@p1989 int,@p1990 nvarchar(4000),@p1991 nvarchar(4000),@p1992 nvarchar(4000),@p1993 nvarchar(4000),@p1994 nvarchar(4000),@p1995 nvarchar(4000),@p1996 nvarchar(4000),@p1997 nvarchar(4000),@p1998 nvarchar(4000),@p1999 nvarchar(4000),@p2000 int,@p2001 nvarchar(4000),@p2002 nvarchar(4000),@p2003 nvarchar(4000),@p2004 nvarchar(4000),@p2005 nvarchar(4000),@p2006 int,@p2007 nvarchar(4000),@p2008 int,@p2009 int,@p2010 datetime2(7),@p2011 datetime2(7),@p2012 datetime2(7),@p2013 nvarchar(4000),@p2014 nvarchar(4000),@p2015 nvarchar(4000),@p2016 nvarchar(4000),@p2017 nvarchar(4000),@p2018 nvarchar(4000),@p2019 nvarchar(4000),@p2020 nvarchar(4000),@p2021 nvarchar(4000),@p2022 nvarchar(4000),@p2023 nvarchar(4000),@p2024 nvarchar(4000),@p2025 nvarchar(4000),@p2026 nvarchar(4000),@p2027 datetime2(7),@p2028 nvarchar(4000),@p2029 nvarchar(4000),@p2030 int,@p2031 int,@p2032 int,@p2033 nvarchar(4000),@p2034 nvarchar(4000),@p2035 nvarchar(4000),@p2036 decimal(18,2),@p2037 decimal(18,2),@p2038 nvarchar(4000),@p2039 nvarchar(4000),@p2040 decimal(18,2),@p2041 nvarchar(4000),@p2042 nvarchar(4000),@p2043 nvarchar(4000),@p2044 nvarchar(4000),@p2045 int,@p2046 nvarchar(4000),@p2047 nvarchar(4000),@p2048 nvarchar(4000),@p2049 nvarchar(4000),@p2050 nvarchar(4000),@p2051 nvarchar(4000),@p2052 nvarchar(4000),@p2053 nvarchar(4000),@p2054 nvarchar(4000),@p2055 nvarchar(4000),@p2056 int,@p2057 nvarchar(4000),@p2058 nvarchar(4000),@p2059 nvarchar(4000),@p2060 nvarchar(4000),@p2061 nvarchar(4000),@p2062 int,@p2063 nvarchar(4000),@p2064 int,@p2065 int,@p2066 datetime2(7),@p2067 datetime2(7),@p2068 datetime2(7),@p2069 nvarchar(4000),@p2070 nvarchar(4000),@p2071 nvarchar(4000))SET NOCOUNT ON; DECLARE @inserted0 TABLE ([item_id] int, [_Position] [int]); MERGE [raw_data] USING ( VALUES (@p0, @p1, @p2, @p3, @p4, @p5, @p6, @p7, @p8, @p9, @p10, @p11, @p12, @p13, @p14, @p15, @p16, @p17, @p18, @p19, @p20, @p21, @p22, @p23, @p24, @p25, @p26, @p27, @p28, @p29, @p30, @p31, @p32, @p33, @p34, @p35, @p36, @p37, @p38, @p39, @p40, @p41, @p42, @p43, @p44, @p45, @p46, @p47, @p48, @p49, @p50, @p51, @p52, @p53, @p54, @p55, 0), (@p56, @p57, @p58, @p59, @p60, @p61, @p62, @p63, @p64, @p65, @p66, @p67, @p68, @p69, @p70, @p71, @p72, @p73, @p74, @p75, @p76, @p77, @p78, @p79, @p80, @p81, @p82, @p83, @p84, @p85, @p86, @p87, @p88, @p89, @p90, @p91, @p92, @p93, @p94, @p95, @p96, @p97, @p98, @p99, @p100, @p101, @p102, @p103, @p104, @p105, @p106, @p107, @p108, @p109, @p110, @p111, 1), (@p112, @p113, @p114, @p115, @p116, @p117, @p118, @p119, @p120, @p121, @p122, @p123, @p124, @p125, @p126, @p127, @p128, @p129, @p130, @p131, @p132, @p133, @p134, @p135, @p136, @p137, @p138, @p139, @p140, @p141, @p142, @p143, @p144, @p145, @p146, @p147, @p148, @p149, @p150, @p151, @p152, @p153, @p154, @p155, @p156, @p157, @p158, @p159, @p160, @p161, @p162, @p163, @p164, @p165, @p166, @p167, 2), (@p168, @p169, @p170, @p171, @p172, @p173, @p174, @p175, @p176, @p177, @p178, @p179, @p180, @p181, @p182, @p183, @p184, @p185, @p186, @p187, @p188, @p189, @p190, @p191, @p192, @p193, @p194, @p195, @p196, @p197, @p198, @p199, @p200, @p201, @p202, @p203, @p204, @p205, @p206, @p207, @p208, @p209, @p210, @p211, @p212, @p213, @p214, @p215, @p216, @p217, @p218, @p219, @p220, @p221, @p222, @p223, 3), (@p224, @p225, @p226, @p227, @p228, @p229, @p230, @p231, @p232, @p233, @p234, @p235, @p236, @p237, @p238, @p239, @p240, @p241, @p242, @p243, @p244, @p245, @p246, @p247, @p248, @p249, @p250, @p251, @p252, @p253, @p254, @p255, @p256, @p257, @p258, @p259, @p260, @p261, @p262, @p263, @p264, @p265, @p266, @p267, @p268, @p269, @p270, @p271, @p272, @p273, @p274, @p275, @p276, @p277, @p278, @p279, 4), (@p280, @p281, @p282, @p283, @p284, @p285, @p286, @p287, @p288, @p289, @p290, @p291, @p292, @p293, @p294, @p295, @p296, @p297, @p298, @p299, @p300, @p301, @p302, @p303, @p304, @p305, @p306, @p307, @p308, @p309, @p310, @p311, @p312, @p313, @p314, @p315, @p316, @p317, @p318, @p319, @p320, @p321, @p322, @p323, @p324, @p325, @p326, @p327, @p328, @p329, @p330, @p331, @p332, @p333, @p334, @p335, 5), (@p336, @p337, @p338, @p339, @p340, @p341, @p342, @p343, @p344, @p345, @p346, @p347, @p348, @p349, @p350, @p351, @p352, @p353, @p354, @p355, @p356, @p357, @p358, @p359, @p360, @p361, @p362, @p363, @p364, @p365, @p366, @p367, @p368, @p369, @p370, @p371, @p372, @p373, @p374, @p375, @p376, @p377, @p378, @p379, @p380, @p381, @p382, @p383, @p384, @p385, @p386, @p387, @p388, @p389, @p390, @p391, 6), (@p392, @p393, @p394, @p395, @p396, @p397, @p398, @p399, @p400, @p401, @p402, @p403, @p404, @p405, @p406, @p407, @p408, @p409, @p410, @p411, @p412, @p413, @p414, @p415, @p416, @p417, @p418, @p419, @p420, @p421, @p422, @p423, @p424, @p425, @p426, @p427, @p428, @p429, @p430, @p431, @p432, @p433, @p434, @p435, @p436, @p437, @p438, @p439, @p440, @p441, @p442, @p443, @p444, @p445, @p446, @p447, 7), (@p448, @p449, @p450, @p451, @p452, @p453, @p454, @p455, @p456, @p457, @p458, @p459, @p460, @p461, @p462, @p463, @p464, @p465, @p466, @p467, @p468, @p469, @p470, @p471, @p472, @p473, @p474, @p475, @p476, @p477, @p478, @p479, @p480, @p481, @p482, @p483, @p484, @p485, @p486, @p487, @p488, @p489, @p490, @p491, @p492, @p493, @p494, @p495, @p496, @p497, @p498, @p499, @p500, @p501, @p502, @p503, 8), (@p504, @p505, @p506, @p507, @p508, @p509, @p510, @p511, @p512, @p513, @p514, @p515, @p516, @p517, @p518, @p519, @p520, @p521, @p522, @p523, @p524, @p525, @p526, @p527, @p528, @p529, @p530, @p531, @p532, @p533, @p534, @p535, @p536, @p537, @p538, @p539, @p540, @p541, @p542, @p543, @p544, @p545, @p546, @p547, @p548, @p549, @p550, @p551, @p552, @p553, @p554, @p555, @p556, @p557, @p558, @p559, 9), (@p560, @p561, @p562, @p563, @p564, @p565, @p566, @p567, @p568, @p569, @p570, @p571, @p572, @p573, @p574, @p575, @p576, @p577, @p578, @p579, @p580, @p581, @p582, @p583, @p584, @p585, @p586, @p587, @p588, @p589, @p590, @p591, @p592, @p593, @p594, @p595, @p596, @p597, @p598, @p599, @p600, @p601, @p602, @p603, @p604, @p605, @p606, @p607, @p608, @p609, @p610, @p611, @p612, @p613, @p614, @p615, 10), (@p616, @p617, @p618, @p619, @p620, @p621, @p622, @p623, @p624, @p625, @p626, @p627, @p628, @p629, @p630, @p631, @p632, @p633, @p634, @p635, @p636, @p637, @p638, @p639, @p640, @p641, @p642, @p643, @p644, @p645, @p646, @p647, @p648, @p649, @p650, @p651, @p652, @p653, @p654, @p655, @p656, @p657, @p658, @p659, @p660, @p661, @p662, @p663, @p664, @p665, @p666, @p667, @p668, @p669, @p670, @p671, 11), (@p672, @p673, @p674, @p675, @p676, @p677, @p678, @p679, @p680, @p681, @p682, @p683, @p684, @p685, @p686, @p687, @p688, @p689, @p690, @p691, @p692, @p693, @p694, @p695, @p696, @p697, @p698, @p699, @p700, @p701, @p702, @p703, @p704, @p705, @p706, @p707, @p708, @p709, @p710, @p711, @p712, @p713, @p714, @p715, @p716, @p717, @p718, @p719, @p720, @p721, @p722, @p723, @p724, @p725, @p726, @p727, 12), (@p728, @p729, @p730, @p731, @p732, @p733, @p734, @p735, @p736, @p737, @p738, @p739, @p740, @p741, @p742, @p743, @p744, @p745, @p746, @p747, @p748, @p749, @p750, @p751, @p752, @p753, @p754, @p755, @p756, @p757, @p758, @p759, @p760, @p761, @p762, @p763, @p764, @p765, @p766, @p767, @p768, @p769, @p770, @p771, @p772, @p773, @p774, @p775, @p776, @p777, @p778, @p779, @p780, @p781, @p782, @p783, 13), (@p784, @p785, @p786, @p787, @p788, @p789, @p790, @p791, @p792, @p793, @p794, @p795, @p796, @p797, @p798, @p799, @p800, @p801, @p802, @p803, @p804, @p805, @p806, @p807, @p808, @p809, @p810, @p811, @p812, @p813, @p814, @p815, @p816, @p817, @p818, @p819, @p820, @p821, @p822, @p823, @p824, @p825, @p826, @p827, @p828, @p829, @p830, @p831, @p832, @p833, @p834, @p835, @p836, @p837, @p838, @p839, 14), (@p840, @p841, @p842, @p843, @p844, @p845, @p846, @p847, @p848, @p849, @p850, @p851, @p852, @p853, @p854, @p855, @p856, @p857, @p858, @p859, @p860, @p861, @p862, @p863, @p864, @p865, @p866, @p867, @p868, @p869, @p870, @p871, @p872, @p873, @p874, @p875, @p876, @p877, @p878, @p879, @p880, @p881, @p882, @p883, @p884, @p885, @p886, @p887, @p888, @p889, @p890, @p891, @p892, @p893, @p894, @p895, 15), (@p896, @p897, @p898, @p899, @p900, @p901, @p902, @p903, @p904, @p905, @p906, @p907, @p908, @p909, @p910, @p911, @p912, @p913, @p914, @p915, @p916, @p917, @p918, @p919, @p920, @p921, @p922, @p923, @p924, @p925, @p926, @p927, @p928, @p929, @p930, @p931, @p932, @p933, @p934, @p935, @p936, @p937, @p938, @p939, @p940, @p941, @p942, @p943, @p944, @p945, @p946, @p947, @p948, @p949, @p950, @p951, 16), (@p952, @p953, @p954, @p955, @p956, @p957, @p958, @p959, @p960, @p961, @p962, @p963, @p964, @p965, @p966, @p967, @p968, @p969, @p970, @p971, @p972, @p973, @p974, @p975, @p976, @p977, @p978, @p979, @p980, @p981, @p982, @p983, @p984, @p985, @p986, @p987, @p988, @p989, @p990, @p991, @p992, @p993, @p994, @p995, @p996, @p997, @p998, @p999, @p1000, @p1001, @p1002, @p1003, @p1004, @p1005, @p1006, @p1007, 17), (@p1008, @p1009, @p1010, @p1011, @p1012, @p1013, @p1014, @p1015, @p1016, @p1017, @p1018, @p1019, @p1020, @p1021, @p1022, @p1023, @p1024, @p1025, @p1026, @p1027, @p1028, @p1029, @p1030, @p1031, @p1032, @p1033, @p1034, @p1035, @p1036, @p1037, @p1038, @p1039, @p1040, @p1041, @p1042, @p1043, @p1044, @p1045, @p1046, @p1047, @p1048, @p1049, @p1050, @p1051, @p1052, @p1053, @p1054, @p1055, @p1056, @p1057, @p1058, @p1059, @p1060, @p1061, @p1062, @p1063, 18), (@p1064, @p1065, @p1066, @p1067, @p1068, @p1069, @p1070, @p1071, @p1072, @p1073, @p1074, @p1075, @p1076, @p1077, @p1078, @p1079, @p1080, @p1081, @p1082, @p1083, @p1084, @p1085, @p1086, @p1087, @p1088, @p1089, @p1090, @p1091, @p1092, @p1093, @p1094, @p1095, @p1096, @p1097, @p1098, @p1099, @p1100, @p1101, @p1102, @p1103, @p1104, @p1105, @p1106, @p1107, @p1108, @p1109, @p1110, @p1111, @p1112, @p1113, @p1114, @p1115, @p1116, @p1117, @p1118, @p1119, 19), (@p1120, @p1121, @p1122, @p1123, @p1124, @p1125, @p1126, @p1127, @p1128, @p1129, @p1130, @p1131, @p1132, @p1133, @p1134, @p1135, @p1136, @p1137, @p1138, @p1139, @p1140, @p1141, @p1142, @p1143, @p1144, @p1145, @p1146, @p1147, @p1148, @p1149, @p1150, @p1151, @p1152, @p1153, @p1154, @p1155, @p1156, @p1157, @p1158, @p1159, @p1160, @p1161, @p1162, @p1163, @p1164, @p1165, @p1166, @p1167, @p1168, @p1169, @p1170, @p1171, @p1172, @p1173, @p1174, @p1175, 20), (@p1176, @p1177, @p1178, @p1179, @p1180, @p1181, @p1182, @p1183, @p1184, @p1185, @p1186, @p1187, @p1188, @p1189, @p1190, @p1191, @p1192, @p1193, @p1194, @p1195, @p1196, @p1197, @p1198, @p1199, @p1200, @p1201, @p1202, @p1203, @p1204, @p1205, @p1206, @p1207, @p1208, @p1209, @p1210, @p1211, @p1212, @p1213, @p1214, @p1215, @p1216, @p1217, @p1218, @p1219, @p1220, @p1221, @p1222, @p1223, @p1224, @p1225, @p1226, @p1227, @p1228, @p1229, @p1230, @p1231, 21), (@p1232, @p1233, @p1234, @p1235, @p1236, @p1237, @p1238, @p1239, @p1240, @p1241, @p1242, @p1243, @p1244, @p1245, @p1246, @p1247, @p1248, @p1249, @p1250, @p1251, @p1252, @p1253, @p1254, @p1255, @p1256, @p1257, @p1258, @p1259, @p1260, @p1261, @p1262, @p1263, @p1264, @p1265, @p1266, @p1267, @p1268, @p1269, @p1270, @p1271, @p1272, @p1273, @p1274, @p1275, @p1276, @p1277, @p1278, @p1279, @p1280, @p1281, @p1282, @p1283, @p1284, @p1285, @p1286, @p1287, 22), (@p1288, @p1289, @p1290, @p1291, @p1292, @p1293, @p1294, @p1295, @p1296, @p1297, @p1298, @p1299, @p1300, @p1301, @p1302, @p1303, @p1304, @p1305, @p1306, @p1307, @p1308, @p1309, @p1310, @p1311, @p1312, @p1313, @p1314, @p1315, @p1316, @p1317, @p1318, @p1319, @p1320, @p1321, @p1322, @p1323, @p1324, @p1325, @p1326, @p1327, @p1328, @p1329, @p1330, @p1331, @p1332, @p1333, @p1334, @p1335, @p1336, @p1337, @p1338, @p1339, @p1340, @p1341, @p1342, @p1343, 23), (@p1344, @p1345, @p1346, @p1347, @p1348, @p1349, @p1350, @p1351, @p1352, @p1353, @p1354, @p1355, @p1356, @p1357, @p1358, @p1359, @p1360, @p1361, @p1362, @p1363, @p1364, @p1365, @p1366, @p1367, @p1368, @p1369, @p1370, @p1371, @p1372, @p1373, @p1374, @p1375, @p1376, @p1377, @p1378, @p1379, @p1380, @p1381, @p1382, @p1383, @p1384, @p1385, @p1386, @p1387, @p1388, @p1389, @p1390, @p1391, @p1392, @p1393, @p1394, @p1395, @p1396, @p1397, @p1398, @p1399, 24), (@p1400, @p1401, @p1402, @p1403, @p1404, @p1405, @p1406, @p1407, @p1408, @p1409, @p1410, @p1411, @p1412, @p1413, @p1414, @p1415, @p1416, @p1417, @p1418, @p1419, @p1420, @p1421, @p1422, @p1423, @p1424, @p1425, @p1426, @p1427, @p1428, @p1429, @p1430, @p1431, @p1432, @p1433, @p1434, @p1435, @p1436, @p1437, @p1438, @p1439, @p1440, @p1441, @p1442, @p1443, @p1444, @p1445, @p1446, @p1447, @p1448, @p1449, @p1450, @p1451, @p1452, @p1453, @p1454, @p1455, 25), (@p1456, @p1457, @p1458, @p1459, @p1460, @p1461, @p1462, @p1463, @p1464, @p1465, @p1466, @p1467, @p1468, @p1469, @p1470, @p1471, @p1472, @p1473, @p1474, @p1475, @p1476, @p1477, @p1478, @p1479, @p1480, @p1481, @p1482, @p1483, @p1484, @p1485, @p1486, @p1487, @p1488, @p1489, @p1490, @p1491, @p1492, @p1493, @p1494, @p1495, @p1496, @p1497, @p1498, @p1499, @p1500, @p1501, @p1502, @p1503, @p1504, @p1505, @p1506, @p1507, @p1508, @p1509, @p1510, @p1511, 26), (@p1512, @p1513, @p1514, @p1515, @p1516, @p1517, @p1518, @p1519, @p1520, @p1521, @p1522, @p1523, @p1524, @p1525, @p1526, @p1527, @p1528, @p1529, @p1530, @p1531, @p1532, @p1533, @p1534, @p1535, @p1536, @p1537, @p1538, @p1539, @p1540, @p1541, @p1542, @p1543, @p1544, @p1545, @p1546, @p1547, @p1548, @p1549, @p1550, @p1551, @p1552, @p1553, @p1554, @p1555, @p1556, @p1557, @p1558, @p1559, @p1560, @p1561, @p1562, @p1563, @p1564, @p1565, @p1566, @p1567, 27), (@p1568, @p1569, @p1570, @p1571, @p1572, @p1573, @p1574, @p1575, @p1576, @p1577, @p1578, @p1579, @p1580, @p1581, @p1582, @p1583, @p1584, @p1585, @p1586, @p1587, @p1588, @p1589, @p1590, @p1591, @p1592, @p1593, @p1594, @p1595, @p1596, @p1597, @p1598, @p1599, @p1600, @p1601, @p1602, @p1603, @p1604, @p1605, @p1606, @p1607, @p1608, @p1609, @p1610, @p1611, @p1612, @p1613, @p1614, @p1615, @p1616, @p1617, @p1618, @p1619, @p1620, @p1621, @p1622, @p1623, 28), (@p1624, @p1625, @p1626, @p1627, @p1628, @p1629, @p1630, @p1631, @p1632, @p1633, @p1634, @p1635, @p1636, @p1637, @p1638, @p1639, @p1640, @p1641, @p1642, @p1643, @p1644, @p1645, @p1646, @p1647, @p1648, @p1649, @p1650, @p1651, @p1652, @p1653, @p1654, @p1655, @p1656, @p1657, @p1658, @p1659, @p1660, @p1661, @p1662, @p1663, @p1664, @p1665, @p1666, @p1667, @p1668, @p1669, @p1670, @p1671, @p1672, @p1673, @p1674, @p1675, @p1676, @p1677, @p1678, @p1679, 29), (@p1680, @p1681, @p1682, @p1683, @p1684, @p1685, @p1686, @p1687, @p1688, @p1689, @p1690, @p1691, @p1692, @p1693, @p1694, @p1695, @p1696, @p1697, @p1698, @p1699, @p1700, @p1701, @p1702, @p1703, @p1704, @p1705, @p1706, @p1707, @p1708, @p1709, @p1710, @p1711, @p1712, @p1713, @p1714, @p1715, @p1716, @p1717, @p1718, @p1719, @p1720, @p1721, @p1722, @p1723, @p1724, @p1725, @p1726, @p1727, @p1728, @p1729, @p1730, @p1731, @p1732, @p1733, @p1734, @p1735, 30), (@p1736, @p1737, @p1738, @p1739, @p1740, @p1741, @p1742, @p1743, @p1744, @p1745, @p1746, @p1747, @p1748, @p1749, @p1750, @p1751, @p1752, @p1753, @p1754, @p1755, @p1756, @p1757, @p1758, @p1759, @p1760, @p1761, @p1762, @p1763, @p1764, @p1765, @p1766, @p1767, @p1768, @p1769, @p1770, @p1771, @p1772, @p1773, @p1774, @p1775, @p1776, @p1777, @p1778, @p1779, @p1780, @p1781, @p1782, @p1783, @p1784, @p1785, @p1786, @p1787, @p1788, @p1789, @p1790, @p1791, 31), (@p1792, @p1793, @p1794, @p1795, @p1796, @p1797, @p1798, @p1799, @p1800, @p1801, @p1802, @p1803, @p1804, @p1805, @p1806, @p1807, @p1808, @p1809, @p1810, @p1811, @p1812, @p1813, @p1814, @p1815, @p1816, @p1817, @p1818, @p1819, @p1820, @p1821, @p1822, @p1823, @p1824, @p1825, @p1826, @p1827, @p1828, @p1829, @p1830, @p1831, @p1832, @p1833, @p1834, @p1835, @p1836, @p1837, @p1838, @p1839, @p1840, @p1841, @p1842, @p1843, @p1844, @p1845, @p1846, @p1847, 32), (@p1848, @p1849, @p1850, @p1851, @p1852, @p1853, @p1854, @p1855, @p1856, @p1857, @p1858, @p1859, @p1860, @p1861, @p1862, @p1863, @p1864, @p1865, @p1866, @p1867, @p1868, @p1869, @p1870, @p1871, @p1872, @p1873, @p1874, @p1875, @p1876, @p1877, @p1878, @p1879, @p1880, @p1881, @p1882, @p1883, @p1884, @p1885, @p1886, @p1887, @p1888, @p1889, @p1890, @p1891, @p1892, @p1893, @p1894, @p1895, @p1896, @p1897, @p1898, @p1899, @p1900, @p1901, @p1902, @p1903, 33), (@p1904, @p1905, @p1906, @p1907, @p1908, @p1909, @p1910, @p1911, @p1912, @p1913, @p1914, @p1915, @p1916, @p1917, @p1918, @p1919, @p1920, @p1921, @p1922, @p1923, @p1924, @p1925, @p1926, @p1927, @p1928, @p1929, @p1930, @p1931, @p1932, @p1933, @p1934, @p1935, @p1936, @p1937, @p1938, @p1939, @p1940, @p1941, @p1942, @p1943, @p1944, @p1945, @p1946, @p1947, @p1948, @p1949, @p1950, @p1951, @p1952, @p1953, @p1954, @p1955, @p1956, @p1957, @p1958, @p1959, 34), (@p1960, @p1961, @p1962, @p1963, @p1964, @p1965, @p1966, @p1967, @p1968, @p1969, @p1970, @p1971, @p1972, @p1973, @p1974, @p1975, @p1976, @p1977, @p1978, @p1979, @p1980, @p1981, @p1982, @p1983, @p1984, @p1985, @p1986, @p1987, @p1988, @p1989, @p1990, @p1991, @p1992, @p1993, @p1994, @p1995, @p1996, @p1997, @p1998, @p1999, @p2000, @p2001, @p2002, @p2003, @p2004, @p2005, @p2006, @p2007, @p2008, @p2009, @p2010, @p2011, @p2012, @p2013, @p2014, @p2015, 35), (@p2016, @p2017, @p2018, @p2019, @p2020, @p2021, @p2022, @p2023, @p2024, @p2025, @p2026, @p2027, @p2028, @p2029, @p2030, @p2031, @p2032, @p2033, @p2034, @p2035, @p2036, @p2037, @p2038, @p2039, @p2040, @p2041, @p2042, @p2043, @p2044, @p2045, @p2046, @p2047, @p2048, @p2049, @p2050, @p2051, @p2052, @p2053, @p2054, @p2055, @p2056, @p2057, @p2058, @p2059, @p2060, @p2061, @p2062, @p2063, @p2064, @p2065, @p2066, @p2067, @p2068, @p2069, @p2070, @p2071, 36)) AS i ([addressee_cntry_cd], [addressee_city], [addressee_district], [addressee_email], [addressee_full_address], [addressee_home_address], [addressee_name], [addressee_postcode], [addressee_province], [addressee_subdistrict], [addressee_tel], [create_table], [delivery_code], [delivery_recipient_name], [delivery_relation_id], [delivery_status_id], [dest_outlet_id], [dest_outlet_port], [document_number], [item_barcode], [item_cod], [item_gross_weight], [item_height], [item_length], [item_price], [item_width], [lat], [log_id], [long], [outlet_id], [outlet_port], [podUrl], [remark], [scan_cntry_cd], [scan_cntry_postcode], [sender_cntry_cd], [sender_district], [sender_email], [sender_full_address], [sender_home_address], [member_id], [sender_name], [sender_postcode], [sender_province], [sender_subdistrict], [sender_tel], [server_id], [signatureUrl], [state], [status_code], [status_dtm], [timestamp], [transmit_dtm], [user_id], [wckt_id], [wkstn_no], _Position) ON 1=0 WHEN NOT MATCHED THEN INSERT ([addressee_cntry_cd], [addressee_city], [addressee_district], [addressee_email], [addressee_full_address], [addressee_home_address], [addressee_name], [addressee_postcode], [addressee_province], [addressee_subdistrict], [addressee_tel], [create_table], [delivery_code], [delivery_recipient_name], [delivery_relation_id], [delivery_status_id], [dest_outlet_id], [dest_outlet_port], [document_number], [item_barcode], [item_cod], [item_gross_weight], [item_height], [item_length], [item_price], [item_width], [lat], [log_id], [long], [outlet_id], [outlet_port], [podUrl], [remark], [scan_cntry_cd], [scan_cntry_postcode], [sender_cntry_cd], [sender_district], [sender_email], [sender_full_address], [sender_home_address], [member_id], [sender_name], [sender_postcode], [sender_province], [sender_subdistrict], [sender_tel], [server_id], [signatureUrl], [state], [status_code], [status_dtm], [timestamp], [transmit_dtm], [user_id], [wckt_id], [wkstn_no]) VALUES (i.[addressee_cntry_cd], i.[addressee_city], i.[addressee_district], i.[addressee_email], i.[addressee_full_address], i.[addressee_home_address], i.[addressee_name], i.[addressee_postcode], i.[addressee_province], i.[addressee_subdistrict], i.[addressee_tel], i.[create_table], i.[delivery_code], i.[delivery_recipient_name], i.[delivery_relation_id], i.[delivery_status_id], i.[dest_outlet_id], i.[dest_outlet_port], i.[document_number], i.[item_barcode], i.[item_cod], i.[item_gross_weight], i.[item_height], i.[item_length], i.[item_price], i.[item_width], i.[lat], i.[log_id], i.[long], i.[outlet_id], i.[outlet_port], i.[podUrl], i.[remark], i.[scan_cntry_cd], i.[scan_cntry_postcode], i.[sender_cntry_cd], i.[sender_district], i.[sender_email], i.[sender_full_address], i.[sender_home_address], i.[member_id], i.[sender_name], i.[sender_postcode], i.[sender_province], i.[sender_subdistrict], i.[sender_tel], i.[server_id], i.[signatureUrl], i.[state], i.[status_code], i.[status_dtm], i.[timestamp], i.[transmit_dtm], i.[user_id], i.[wckt_id], i.[wkstn_no]) OUTPUT INSERTED.[item_id], i._Position INTO @inserted0;  SELECT [t].[item_id] FROM [raw_data] t INNER JOIN @inserted0 i ON ([t].[item_id] = [i].[item_id]) ORDER BY [i].[_Position];  ",4,4,0,449,8,4
"(@p0 nvarchar(4000),@p1 nvarchar(4000),@p2 nvarchar(4000),@p3 nvarchar(4000),@p4 nvarchar(4000),@p5 nvarchar(4000),@p6 nvarchar(4000),@p7 nvarchar(4000),@p8 nvarchar(4000),@p9 nvarchar(4000),@p10 nvarchar(4000),@p11 datetime2(7),@p12 nvarchar(4000),@p13 nvarchar(4000),@p14 int,@p15 int,@p16 int,@p17 nvarchar(4000),@p18 nvarchar(4000),@p19 nvarchar(4000),@p20 nvarchar(4000),@p21 decimal(18,2),@p22 nvarchar(4000),@p23 nvarchar(4000),@p24 decimal(18,2),@p25 nvarchar(4000),@p26 nvarchar(4000),@p27 nvarchar(4000),@p28 nvarchar(4000),@p29 int,@p30 nvarchar(4000),@p31 nvarchar(4000),@p32 nvarchar(4000),@p33 nvarchar(4000),@p34 nvarchar(4000),@p35 nvarchar(4000),@p36 nvarchar(4000),@p37 nvarchar(4000),@p38 nvarchar(4000),@p39 nvarchar(4000),@p40 int,@p41 nvarchar(4000),@p42 nvarchar(4000),@p43 nvarchar(4000),@p44 nvarchar(4000),@p45 nvarchar(4000),@p46 int,@p47 nvarchar(4000),@p48 int,@p49 int,@p50 datetime2(7),@p51 datetime2(7),@p52 datetime2(7),@p53 nvarchar(4000),@p54 nvarchar(4000),@p55 nvarchar(4000),@p56 nvarchar(4000),@p57 nvarchar(4000),@p58 nvarchar(4000),@p59 nvarchar(4000),@p60 nvarchar(4000),@p61 nvarchar(4000),@p62 nvarchar(4000),@p63 nvarchar(4000),@p64 nvarchar(4000),@p65 nvarchar(4000),@p66 nvarchar(4000),@p67 datetime2(7),@p68 nvarchar(4000),@p69 nvarchar(4000),@p70 int,@p71 int,@p72 int,@p73 nvarchar(4000),@p74 nvarchar(4000),@p75 nvarchar(4000),@p76 nvarchar(4000),@p77 decimal(18,2),@p78 nvarchar(4000),@p79 nvarchar(4000),@p80 decimal(18,2),@p81 nvarchar(4000),@p82 nvarchar(4000),@p83 nvarchar(4000),@p84 nvarchar(4000),@p85 int,@p86 nvarchar(4000),@p87 nvarchar(4000),@p88 nvarchar(4000),@p89 nvarchar(4000),@p90 nvarchar(4000),@p91 nvarchar(4000),@p92 nvarchar(4000),@p93 nvarchar(4000),@p94 nvarchar(4000),@p95 nvarchar(4000),@p96 int,@p97 nvarchar(4000),@p98 nvarchar(4000),@p99 nvarchar(4000),@p100 nvarchar(4000),@p101 nvarchar(4000),@p102 int,@p103 nvarchar(4000),@p104 int,@p105 int,@p106 datetime2(7),@p107 datetime2(7),@p108 datetime2(7),@p109 nvarchar(4000),@p110 nvarchar(4000),@p111 nvarchar(4000),@p112 nvarchar(4000),@p113 nvarchar(4000),@p114 nvarchar(4000),@p115 nvarchar(4000),@p116 nvarchar(4000),@p117 nvarchar(4000),@p118 nvarchar(4000),@p119 nvarchar(4000),@p120 nvarchar(4000),@p121 nvarchar(4000),@p122 nvarchar(4000),@p123 datetime2(7),@p124 nvarchar(4000),@p125 nvarchar(4000),@p126 int,@p127 int,@p128 int,@p129 nvarchar(4000),@p130 nvarchar(4000),@p131 nvarchar(4000),@p132 decimal(18,2),@p133 decimal(18,2),@p134 nvarchar(4000),@p135 nvarchar(4000),@p136 decimal(18,2),@p137 nvarchar(4000),@p138 nvarchar(4000),@p139 nvarchar(4000),@p140 nvarchar(4000),@p141 int,@p142 nvarchar(4000),@p143 nvarchar(4000),@p144 nvarchar(4000),@p145 nvarchar(4000),@p146 nvarchar(4000),@p147 nvarchar(4000),@p148 nvarchar(4000),@p149 nvarchar(4000),@p150 nvarchar(4000),@p151 nvarchar(4000),@p152 int,@p153 nvarchar(4000),@p154 nvarchar(4000),@p155 nvarchar(4000),@p156 nvarchar(4000),@p157 nvarchar(4000),@p158 int,@p159 nvarchar(4000),@p160 int,@p161 int,@p162 datetime2(7),@p163 datetime2(7),@p164 datetime2(7),@p165 nvarchar(4000),@p166 nvarchar(4000),@p167 nvarchar(4000),@p168 nvarchar(4000),@p169 nvarchar(4000),@p170 nvarchar(4000),@p171 nvarchar(4000),@p172 nvarchar(4000),@p173 nvarchar(4000),@p174 nvarchar(4000),@p175 nvarchar(4000),@p176 nvarchar(4000),@p177 nvarchar(4000),@p178 nvarchar(4000),@p179 datetime2(7),@p180 nvarchar(4000),@p181 nvarchar(4000),@p182 int,@p183 int,@p184 int,@p185 nvarchar(4000),@p186 nvarchar(4000),@p187 nvarchar(4000),@p188 decimal(18,2),@p189 decimal(18,2),@p190 nvarchar(4000),@p191 nvarchar(4000),@p192 decimal(18,2),@p193 nvarchar(4000),@p194 nvarchar(4000),@p195 nvarchar(4000),@p196 nvarchar(4000),@p197 int,@p198 nvarchar(4000),@p199 nvarchar(4000),@p200 nvarchar(4000),@p201 nvarchar(4000),@p202 nvarchar(4000),@p203 nvarchar(4000),@p204 nvarchar(4000),@p205 nvarchar(4000),@p206 nvarchar(4000),@p207 nvarchar(4000),@p208 int,@p209 nvarchar(4000),@p210 nvarchar(4000),@p211 nvarchar(4000),@p212 nvarchar(4000),@p213 nvarchar(4000),@p214 int,@p215 nvarchar(4000),@p216 int,@p217 int,@p218 datetime2(7),@p219 datetime2(7),@p220 datetime2(7),@p221 nvarchar(4000),@p222 nvarchar(4000),@p223 nvarchar(4000),@p224 nvarchar(4000),@p225 nvarchar(4000),@p226 nvarchar(4000),@p227 nvarchar(4000),@p228 nvarchar(4000),@p229 nvarchar(4000),@p230 nvarchar(4000),@p231 nvarchar(4000),@p232 nvarchar(4000),@p233 nvarchar(4000),@p234 nvarchar(4000),@p235 datetime2(7),@p236 nvarchar(4000),@p237 nvarchar(4000),@p238 int,@p239 int,@p240 int,@p241 nvarchar(4000),@p242 nvarchar(4000),@p243 nvarchar(4000),@p244 decimal(18,2),@p245 decimal(18,2),@p246 nvarchar(4000),@p247 nvarchar(4000),@p248 decimal(18,2),@p249 nvarchar(4000),@p250 nvarchar(4000),@p251 nvarchar(4000),@p252 nvarchar(4000),@p253 int,@p254 nvarchar(4000),@p255 nvarchar(4000),@p256 nvarchar(4000),@p257 nvarchar(4000),@p258 nvarchar(4000),@p259 nvarchar(4000),@p260 nvarchar(4000),@p261 nvarchar(4000),@p262 nvarchar(4000),@p263 nvarchar(4000),@p264 int,@p265 nvarchar(4000),@p266 nvarchar(4000),@p267 nvarchar(4000),@p268 nvarchar(4000),@p269 nvarchar(4000),@p270 int,@p271 nvarchar(4000),@p272 int,@p273 int,@p274 datetime2(7),@p275 datetime2(7),@p276 datetime2(7),@p277 nvarchar(4000),@p278 nvarchar(4000),@p279 nvarchar(4000),@p280 nvarchar(4000),@p281 nvarchar(4000),@p282 nvarchar(4000),@p283 nvarchar(4000),@p284 nvarchar(4000),@p285 nvarchar(4000),@p286 nvarchar(4000),@p287 nvarchar(4000),@p288 nvarchar(4000),@p289 nvarchar(4000),@p290 nvarchar(4000),@p291 datetime2(7),@p292 nvarchar(4000),@p293 nvarchar(4000),@p294 int,@p295 int,@p296 int,@p297 nvarchar(4000),@p298 nvarchar(4000),@p299 nvarchar(4000),@p300 decimal(18,2),@p301 decimal(18,2),@p302 nvarchar(4000),@p303 nvarchar(4000),@p304 decimal(18,2),@p305 nvarchar(4000),@p306 nvarchar(4000),@p307 nvarchar(4000),@p308 nvarchar(4000),@p309 int,@p310 nvarchar(4000),@p311 nvarchar(4000),@p312 nvarchar(4000),@p313 nvarchar(4000),@p314 nvarchar(4000),@p315 nvarchar(4000),@p316 nvarchar(4000),@p317 nvarchar(4000),@p318 nvarchar(4000),@p319 nvarchar(4000),@p320 int,@p321 nvarchar(4000),@p322 nvarchar(4000),@p323 nvarchar(4000),@p324 nvarchar(4000),@p325 nvarchar(4000),@p326 int,@p327 nvarchar(4000),@p328 int,@p329 int,@p330 datetime2(7),@p331 datetime2(7),@p332 datetime2(7),@p333 nvarchar(4000),@p334 nvarchar(4000),@p335 nvarchar(4000),@p336 nvarchar(4000),@p337 nvarchar(4000),@p338 nvarchar(4000),@p339 nvarchar(4000),@p340 nvarchar(4000),@p341 nvarchar(4000),@p342 nvarchar(4000),@p343 nvarchar(4000),@p344 nvarchar(4000),@p345 nvarchar(4000),@p346 nvarchar(4000),@p347 datetime2(7),@p348 nvarchar(4000),@p349 nvarchar(4000),@p350 int,@p351 int,@p352 int,@p353 nvarchar(4000),@p354 nvarchar(4000),@p355 nvarchar(4000),@p356 decimal(18,2),@p357 decimal(18,2),@p358 nvarchar(4000),@p359 nvarchar(4000),@p360 decimal(18,2),@p361 nvarchar(4000),@p362 nvarchar(4000),@p363 nvarchar(4000),@p364 nvarchar(4000),@p365 int,@p366 nvarchar(4000),@p367 nvarchar(4000),@p368 nvarchar(4000),@p369 nvarchar(4000),@p370 nvarchar(4000),@p371 nvarchar(4000),@p372 nvarchar(4000),@p373 nvarchar(4000),@p374 nvarchar(4000),@p375 nvarchar(4000),@p376 int,@p377 nvarchar(4000),@p378 nvarchar(4000),@p379 nvarchar(4000),@p380 nvarchar(4000),@p381 nvarchar(4000),@p382 int,@p383 nvarchar(4000),@p384 int,@p385 int,@p386 datetime2(7),@p387 datetime2(7),@p388 datetime2(7),@p389 nvarchar(4000),@p390 nvarchar(4000),@p391 nvarchar(4000),@p392 nvarchar(4000),@p393 nvarchar(4000),@p394 nvarchar(4000),@p395 nvarchar(4000),@p396 nvarchar(4000),@p397 nvarchar(4000),@p398 nvarchar(4000),@p399 nvarchar(4000),@p400 nvarchar(4000),@p401 nvarchar(4000),@p402 nvarchar(4000),@p403 datetime2(7),@p404 nvarchar(4000),@p405 nvarchar(4000),@p406 int,@p407 int,@p408 int,@p409 nvarchar(4000),@p410 nvarchar(4000),@p411 nvarchar(4000),@p412 decimal(18,2),@p413 decimal(18,2),@p414 nvarchar(4000),@p415 nvarchar(4000),@p416 decimal(18,2),@p417 nvarchar(4000),@p418 nvarchar(4000),@p419 nvarchar(4000),@p420 nvarchar(4000),@p421 int,@p422 nvarchar(4000),@p423 nvarchar(4000),@p424 nvarchar(4000),@p425 nvarchar(4000),@p426 nvarchar(4000),@p427 nvarchar(4000),@p428 nvarchar(4000),@p429 nvarchar(4000),@p430 nvarchar(4000),@p431 nvarchar(4000),@p432 int,@p433 nvarchar(4000),@p434 nvarchar(4000),@p435 nvarchar(4000),@p436 nvarchar(4000),@p437 nvarchar(4000),@p438 int,@p439 nvarchar(4000),@p440 int,@p441 int,@p442 datetime2(7),@p443 datetime2(7),@p444 datetime2(7),@p445 nvarchar(4000),@p446 nvarchar(4000),@p447 nvarchar(4000),@p448 nvarchar(4000),@p449 nvarchar(4000),@p450 nvarchar(4000),@p451 nvarchar(4000),@p452 nvarchar(4000),@p453 nvarchar(4000),@p454 nvarchar(4000),@p455 nvarchar(4000),@p456 nvarchar(4000),@p457 nvarchar(4000),@p458 nvarchar(4000),@p459 datetime2(7),@p460 nvarchar(4000),@p461 nvarchar(4000),@p462 int,@p463 int,@p464 int,@p465 nvarchar(4000),@p466 nvarchar(4000),@p467 nvarchar(4000),@p468 nvarchar(4000),@p469 decimal(18,2),@p470 nvarchar(4000),@p471 nvarchar(4000),@p472 decimal(18,2),@p473 nvarchar(4000),@p474 nvarchar(4000),@p475 nvarchar(4000),@p476 nvarchar(4000),@p477 int,@p478 nvarchar(4000),@p479 nvarchar(4000),@p480 nvarchar(4000),@p481 nvarchar(4000),@p482 nvarchar(4000),@p483 nvarchar(4000),@p484 nvarchar(4000),@p485 nvarchar(4000),@p486 nvarchar(4000),@p487 nvarchar(4000),@p488 int,@p489 nvarchar(4000),@p490 nvarchar(4000),@p491 nvarchar(4000),@p492 nvarchar(4000),@p493 nvarchar(4000),@p494 int,@p495 nvarchar(4000),@p496 int,@p497 int,@p498 datetime2(7),@p499 datetime2(7),@p500 datetime2(7),@p501 nvarchar(4000),@p502 nvarchar(4000),@p503 nvarchar(4000),@p504 nvarchar(4000),@p505 nvarchar(4000),@p506 nvarchar(4000),@p507 nvarchar(4000),@p508 nvarchar(4000),@p509 nvarchar(4000),@p510 nvarchar(4000),@p511 nvarchar(4000),@p512 nvarchar(4000),@p513 nvarchar(4000),@p514 nvarchar(4000),@p515 datetime2(7),@p516 nvarchar(4000),@p517 nvarchar(4000),@p518 int,@p519 int,@p520 int,@p521 nvarchar(4000),@p522 nvarchar(4000),@p523 nvarchar(4000),@p524 decimal(18,2),@p525 decimal(18,2),@p526 nvarchar(4000),@p527 nvarchar(4000),@p528 decimal(18,2),@p529 nvarchar(4000),@p530 nvarchar(4000),@p531 nvarchar(4000),@p532 nvarchar(4000),@p533 int,@p534 nvarchar(4000),@p535 nvarchar(4000),@p536 nvarchar(4000),@p537 nvarchar(4000),@p538 nvarchar(4000),@p539 nvarchar(4000),@p540 nvarchar(4000),@p541 nvarchar(4000),@p542 nvarchar(4000),@p543 nvarchar(4000),@p544 int,@p545 nvarchar(4000),@p546 nvarchar(4000),@p547 nvarchar(4000),@p548 nvarchar(4000),@p549 nvarchar(4000),@p550 int,@p551 nvarchar(4000),@p552 int,@p553 int,@p554 datetime2(7),@p555 datetime2(7),@p556 datetime2(7),@p557 nvarchar(4000),@p558 nvarchar(4000),@p559 nvarchar(4000),@p560 nvarchar(4000),@p561 nvarchar(4000),@p562 nvarchar(4000),@p563 nvarchar(4000),@p564 nvarchar(4000),@p565 nvarchar(4000),@p566 nvarchar(4000),@p567 nvarchar(4000),@p568 nvarchar(4000),@p569 nvarchar(4000),@p570 nvarchar(4000),@p571 datetime2(7),@p572 nvarchar(4000),@p573 nvarchar(4000),@p574 int,@p575 int,@p576 int,@p577 nvarchar(4000),@p578 nvarchar(4000),@p579 nvarchar(4000),@p580 decimal(18,2),@p581 decimal(18,2),@p582 nvarchar(4000),@p583 nvarchar(4000),@p584 decimal(18,2),@p585 nvarchar(4000),@p586 nvarchar(4000),@p587 nvarchar(4000),@p588 nvarchar(4000),@p589 int,@p590 nvarchar(4000),@p591 nvarchar(4000),@p592 nvarchar(4000),@p593 nvarchar(4000),@p594 nvarchar(4000),@p595 nvarchar(4000),@p596 nvarchar(4000),@p597 nvarchar(4000),@p598 nvarchar(4000),@p599 nvarchar(4000),@p600 int,@p601 nvarchar(4000),@p602 nvarchar(4000),@p603 nvarchar(4000),@p604 nvarchar(4000),@p605 nvarchar(4000),@p606 int,@p607 nvarchar(4000),@p608 int,@p609 int,@p610 datetime2(7),@p611 datetime2(7),@p612 datetime2(7),@p613 nvarchar(4000),@p614 nvarchar(4000),@p615 nvarchar(4000),@p616 nvarchar(4000),@p617 nvarchar(4000),@p618 nvarchar(4000),@p619 nvarchar(4000),@p620 nvarchar(4000),@p621 nvarchar(4000),@p622 nvarchar(4000),@p623 nvarchar(4000),@p624 nvarchar(4000),@p625 nvarchar(4000),@p626 nvarchar(4000),@p627 datetime2(7),@p628 nvarchar(4000),@p629 nvarchar(4000),@p630 int,@p631 int,@p632 int,@p633 nvarchar(4000),@p634 nvarchar(4000),@p635 nvarchar(4000),@p636 decimal(18,2),@p637 decimal(18,2),@p638 nvarchar(4000),@p639 nvarchar(4000),@p640 decimal(18,2),@p641 nvarchar(4000),@p642 nvarchar(4000),@p643 nvarchar(4000),@p644 nvarchar(4000),@p645 int,@p646 nvarchar(4000),@p647 nvarchar(4000),@p648 nvarchar(4000),@p649 nvarchar(4000),@p650 nvarchar(4000),@p651 nvarchar(4000),@p652 nvarchar(4000),@p653 nvarchar(4000),@p654 nvarchar(4000),@p655 nvarchar(4000),@p656 int,@p657 nvarchar(4000),@p658 nvarchar(4000),@p659 nvarchar(4000),@p660 nvarchar(4000),@p661 nvarchar(4000),@p662 int,@p663 nvarchar(4000),@p664 int,@p665 int,@p666 datetime2(7),@p667 datetime2(7),@p668 datetime2(7),@p669 nvarchar(4000),@p670 nvarchar(4000),@p671 nvarchar(4000),@p672 nvarchar(4000),@p673 nvarchar(4000),@p674 nvarchar(4000),@p675 nvarchar(4000),@p676 nvarchar(4000),@p677 nvarchar(4000),@p678 nvarchar(4000),@p679 nvarchar(4000),@p680 nvarchar(4000),@p681 nvarchar(4000),@p682 nvarchar(4000),@p683 datetime2(7),@p684 nvarchar(4000),@p685 nvarchar(4000),@p686 int,@p687 int,@p688 int,@p689 nvarchar(4000),@p690 nvarchar(4000),@p691 nvarchar(4000),@p692 decimal(18,2),@p693 decimal(18,2),@p694 nvarchar(4000),@p695 nvarchar(4000),@p696 decimal(18,2),@p697 nvarchar(4000),@p698 nvarchar(4000),@p699 nvarchar(4000),@p700 nvarchar(4000),@p701 int,@p702 nvarchar(4000),@p703 nvarchar(4000),@p704 nvarchar(4000),@p705 nvarchar(4000),@p706 nvarchar(4000),@p707 nvarchar(4000),@p708 nvarchar(4000),@p709 nvarchar(4000),@p710 nvarchar(4000),@p711 nvarchar(4000),@p712 int,@p713 nvarchar(4000),@p714 nvarchar(4000),@p715 nvarchar(4000),@p716 nvarchar(4000),@p717 nvarchar(4000),@p718 int,@p719 nvarchar(4000),@p720 int,@p721 int,@p722 datetime2(7),@p723 datetime2(7),@p724 datetime2(7),@p725 nvarchar(4000),@p726 nvarchar(4000),@p727 nvarchar(4000),@p728 nvarchar(4000),@p729 nvarchar(4000),@p730 nvarchar(4000),@p731 nvarchar(4000),@p732 nvarchar(4000),@p733 nvarchar(4000),@p734 nvarchar(4000),@p735 nvarchar(4000),@p736 nvarchar(4000),@p737 nvarchar(4000),@p738 nvarchar(4000),@p739 datetime2(7),@p740 nvarchar(4000),@p741 nvarchar(4000),@p742 int,@p743 int,@p744 int,@p745 nvarchar(4000),@p746 nvarchar(4000),@p747 nvarchar(4000),@p748 decimal(18,2),@p749 decimal(18,2),@p750 nvarchar(4000),@p751 nvarchar(4000),@p752 decimal(18,2),@p753 nvarchar(4000),@p754 nvarchar(4000),@p755 nvarchar(4000),@p756 nvarchar(4000),@p757 int,@p758 nvarchar(4000),@p759 nvarchar(4000),@p760 nvarchar(4000),@p761 nvarchar(4000),@p762 nvarchar(4000),@p763 nvarchar(4000),@p764 nvarchar(4000),@p765 nvarchar(4000),@p766 nvarchar(4000),@p767 nvarchar(4000),@p768 int,@p769 nvarchar(4000),@p770 nvarchar(4000),@p771 nvarchar(4000),@p772 nvarchar(4000),@p773 nvarchar(4000),@p774 int,@p775 nvarchar(4000),@p776 int,@p777 int,@p778 datetime2(7),@p779 datetime2(7),@p780 datetime2(7),@p781 nvarchar(4000),@p782 nvarchar(4000),@p783 nvarchar(4000),@p784 nvarchar(4000),@p785 nvarchar(4000),@p786 nvarchar(4000),@p787 nvarchar(4000),@p788 nvarchar(4000),@p789 nvarchar(4000),@p790 nvarchar(4000),@p791 nvarchar(4000),@p792 nvarchar(4000),@p793 nvarchar(4000),@p794 nvarchar(4000),@p795 datetime2(7),@p796 nvarchar(4000),@p797 nvarchar(4000),@p798 int,@p799 int,@p800 int,@p801 nvarchar(4000),@p802 nvarchar(4000),@p803 nvarchar(4000),@p804 decimal(18,2),@p805 decimal(18,2),@p806 nvarchar(4000),@p807 nvarchar(4000),@p808 decimal(18,2),@p809 nvarchar(4000),@p810 nvarchar(4000),@p811 nvarchar(4000),@p812 nvarchar(4000),@p813 int,@p814 nvarchar(4000),@p815 nvarchar(4000),@p816 nvarchar(4000),@p817 nvarchar(4000),@p818 nvarchar(4000),@p819 nvarchar(4000),@p820 nvarchar(4000),@p821 nvarchar(4000),@p822 nvarchar(4000),@p823 nvarchar(4000),@p824 int,@p825 nvarchar(4000),@p826 nvarchar(4000),@p827 nvarchar(4000),@p828 nvarchar(4000),@p829 nvarchar(4000),@p830 int,@p831 nvarchar(4000),@p832 int,@p833 int,@p834 datetime2(7),@p835 datetime2(7),@p836 datetime2(7),@p837 nvarchar(4000),@p838 nvarchar(4000),@p839 nvarchar(4000),@p840 nvarchar(4000),@p841 nvarchar(4000),@p842 nvarchar(4000),@p843 nvarchar(4000),@p844 nvarchar(4000),@p845 nvarchar(4000),@p846 nvarchar(4000),@p847 nvarchar(4000),@p848 nvarchar(4000),@p849 nvarchar(4000),@p850 nvarchar(4000),@p851 datetime2(7),@p852 nvarchar(4000),@p853 nvarchar(4000),@p854 int,@p855 int,@p856 int,@p857 nvarchar(4000),@p858 nvarchar(4000),@p859 nvarchar(4000),@p860 decimal(18,2),@p861 decimal(18,2),@p862 nvarchar(4000),@p863 nvarchar(4000),@p864 decimal(18,2),@p865 nvarchar(4000),@p866 nvarchar(4000),@p867 nvarchar(4000),@p868 nvarchar(4000),@p869 int,@p870 nvarchar(4000),@p871 nvarchar(4000),@p872 nvarchar(4000),@p873 nvarchar(4000),@p874 nvarchar(4000),@p875 nvarchar(4000),@p876 nvarchar(4000),@p877 nvarchar(4000),@p878 nvarchar(4000),@p879 nvarchar(4000),@p880 int,@p881 nvarchar(4000),@p882 nvarchar(4000),@p883 nvarchar(4000),@p884 nvarchar(4000),@p885 nvarchar(4000),@p886 int,@p887 nvarchar(4000),@p888 int,@p889 int,@p890 datetime2(7),@p891 datetime2(7),@p892 datetime2(7),@p893 nvarchar(4000),@p894 nvarchar(4000),@p895 nvarchar(4000),@p896 nvarchar(4000),@p897 nvarchar(4000),@p898 nvarchar(4000),@p899 nvarchar(4000),@p900 nvarchar(4000),@p901 nvarchar(4000),@p902 nvarchar(4000),@p903 nvarchar(4000),@p904 nvarchar(4000),@p905 nvarchar(4000),@p906 nvarchar(4000),@p907 datetime2(7),@p908 nvarchar(4000),@p909 nvarchar(4000),@p910 int,@p911 int,@p912 int,@p913 nvarchar(4000),@p914 nvarchar(4000),@p915 nvarchar(4000),@p916 decimal(18,2),@p917 decimal(18,2),@p918 nvarchar(4000),@p919 nvarchar(4000),@p920 decimal(18,2),@p921 nvarchar(4000),@p922 nvarchar(4000),@p923 nvarchar(4000),@p924 nvarchar(4000),@p925 int,@p926 nvarchar(4000),@p927 nvarchar(4000),@p928 nvarchar(4000),@p929 nvarchar(4000),@p930 nvarchar(4000),@p931 nvarchar(4000),@p932 nvarchar(4000),@p933 nvarchar(4000),@p934 nvarchar(4000),@p935 nvarchar(4000),@p936 int,@p937 nvarchar(4000),@p938 nvarchar(4000),@p939 nvarchar(4000),@p940 nvarchar(4000),@p941 nvarchar(4000),@p942 int,@p943 nvarchar(4000),@p944 int,@p945 int,@p946 datetime2(7),@p947 datetime2(7),@p948 datetime2(7),@p949 nvarchar(4000),@p950 nvarchar(4000),@p951 nvarchar(4000),@p952 nvarchar(4000),@p953 nvarchar(4000),@p954 nvarchar(4000),@p955 nvarchar(4000),@p956 nvarchar(4000),@p957 nvarchar(4000),@p958 nvarchar(4000),@p959 nvarchar(4000),@p960 nvarchar(4000),@p961 nvarchar(4000),@p962 nvarchar(4000),@p963 datetime2(7),@p964 nvarchar(4000),@p965 nvarchar(4000),@p966 int,@p967 int,@p968 int,@p969 nvarchar(4000),@p970 nvarchar(4000),@p971 nvarchar(4000),@p972 decimal(18,2),@p973 decimal(18,2),@p974 nvarchar(4000),@p975 nvarchar(4000),@p976 decimal(18,2),@p977 nvarchar(4000),@p978 nvarchar(4000),@p979 nvarchar(4000),@p980 nvarchar(4000),@p981 int,@p982 nvarchar(4000),@p983 nvarchar(4000),@p984 nvarchar(4000),@p985 nvarchar(4000),@p986 nvarchar(4000),@p987 nvarchar(4000),@p988 nvarchar(4000),@p989 nvarchar(4000),@p990 nvarchar(4000),@p991 nvarchar(4000),@p992 int,@p993 nvarchar(4000),@p994 nvarchar(4000),@p995 nvarchar(4000),@p996 nvarchar(4000),@p997 nvarchar(4000),@p998 int,@p999 nvarchar(4000),@p1000 int,@p1001 int,@p1002 datetime2(7),@p1003 datetime2(7),@p1004 datetime2(7),@p1005 nvarchar(4000),@p1006 nvarchar(4000),@p1007 nvarchar(4000),@p1008 nvarchar(4000),@p1009 nvarchar(4000),@p1010 nvarchar(4000),@p1011 nvarchar(4000),@p1012 nvarchar(4000),@p1013 nvarchar(4000),@p1014 nvarchar(4000),@p1015 nvarchar(4000),@p1016 nvarchar(4000),@p1017 nvarchar(4000),@p1018 nvarchar(4000),@p1019 datetime2(7),@p1020 nvarchar(4000),@p1021 nvarchar(4000),@p1022 int,@p1023 int,@p1024 int,@p1025 nvarchar(4000),@p1026 nvarchar(4000),@p1027 nvarchar(4000),@p1028 decimal(18,2),@p1029 decimal(18,2),@p1030 nvarchar(4000),@p1031 nvarchar(4000),@p1032 decimal(18,2),@p1033 nvarchar(4000),@p1034 nvarchar(4000),@p1035 nvarchar(4000),@p1036 nvarchar(4000),@p1037 int,@p1038 nvarchar(4000),@p1039 nvarchar(4000),@p1040 nvarchar(4000),@p1041 nvarchar(4000),@p1042 nvarchar(4000),@p1043 nvarchar(4000),@p1044 nvarchar(4000),@p1045 nvarchar(4000),@p1046 nvarchar(4000),@p1047 nvarchar(4000),@p1048 int,@p1049 nvarchar(4000),@p1050 nvarchar(4000),@p1051 nvarchar(4000),@p1052 nvarchar(4000),@p1053 nvarchar(4000),@p1054 int,@p1055 nvarchar(4000),@p1056 int,@p1057 int,@p1058 datetime2(7),@p1059 datetime2(7),@p1060 datetime2(7),@p1061 nvarchar(4000),@p1062 nvarchar(4000),@p1063 nvarchar(4000),@p1064 nvarchar(4000),@p1065 nvarchar(4000),@p1066 nvarchar(4000),@p1067 nvarchar(4000),@p1068 nvarchar(4000),@p1069 nvarchar(4000),@p1070 nvarchar(4000),@p1071 nvarchar(4000),@p1072 nvarchar(4000),@p1073 nvarchar(4000),@p1074 nvarchar(4000),@p1075 datetime2(7),@p1076 nvarchar(4000),@p1077 nvarchar(4000),@p1078 int,@p1079 int,@p1080 int,@p1081 nvarchar(4000),@p1082 nvarchar(4000),@p1083 nvarchar(4000),@p1084 nvarchar(4000),@p1085 decimal(18,2),@p1086 nvarchar(4000),@p1087 nvarchar(4000),@p1088 decimal(18,2),@p1089 nvarchar(4000),@p1090 nvarchar(4000),@p1091 nvarchar(4000),@p1092 nvarchar(4000),@p1093 int,@p1094 nvarchar(4000),@p1095 nvarchar(4000),@p1096 nvarchar(4000),@p1097 nvarchar(4000),@p1098 nvarchar(4000),@p1099 nvarchar(4000),@p1100 nvarchar(4000),@p1101 nvarchar(4000),@p1102 nvarchar(4000),@p1103 nvarchar(4000),@p1104 int,@p1105 nvarchar(4000),@p1106 nvarchar(4000),@p1107 nvarchar(4000),@p1108 nvarchar(4000),@p1109 nvarchar(4000),@p1110 int,@p1111 nvarchar(4000),@p1112 int,@p1113 int,@p1114 datetime2(7),@p1115 datetime2(7),@p1116 datetime2(7),@p1117 nvarchar(4000),@p1118 nvarchar(4000),@p1119 nvarchar(4000),@p1120 nvarchar(4000),@p1121 nvarchar(4000),@p1122 nvarchar(4000),@p1123 nvarchar(4000),@p1124 nvarchar(4000),@p1125 nvarchar(4000),@p1126 nvarchar(4000),@p1127 nvarchar(4000),@p1128 nvarchar(4000),@p1129 nvarchar(4000),@p1130 nvarchar(4000),@p1131 datetime2(7),@p1132 nvarchar(4000),@p1133 nvarchar(4000),@p1134 int,@p1135 int,@p1136 int,@p1137 nvarchar(4000),@p1138 nvarchar(4000),@p1139 nvarchar(4000),@p1140 nvarchar(4000),@p1141 decimal(18,2),@p1142 nvarchar(4000),@p1143 nvarchar(4000),@p1144 decimal(18,2),@p1145 nvarchar(4000),@p1146 nvarchar(4000),@p1147 nvarchar(4000),@p1148 nvarchar(4000),@p1149 int,@p1150 nvarchar(4000),@p1151 nvarchar(4000),@p1152 nvarchar(4000),@p1153 nvarchar(4000),@p1154 nvarchar(4000),@p1155 nvarchar(4000),@p1156 nvarchar(4000),@p1157 nvarchar(4000),@p1158 nvarchar(4000),@p1159 nvarchar(4000),@p1160 int,@p1161 nvarchar(4000),@p1162 nvarchar(4000),@p1163 nvarchar(4000),@p1164 nvarchar(4000),@p1165 nvarchar(4000),@p1166 int,@p1167 nvarchar(4000),@p1168 int,@p1169 int,@p1170 datetime2(7),@p1171 datetime2(7),@p1172 datetime2(7),@p1173 nvarchar(4000),@p1174 nvarchar(4000),@p1175 nvarchar(4000),@p1176 nvarchar(4000),@p1177 nvarchar(4000),@p1178 nvarchar(4000),@p1179 nvarchar(4000),@p1180 nvarchar(4000),@p1181 nvarchar(4000),@p1182 nvarchar(4000),@p1183 nvarchar(4000),@p1184 nvarchar(4000),@p1185 nvarchar(4000),@p1186 nvarchar(4000),@p1187 datetime2(7),@p1188 nvarchar(4000),@p1189 nvarchar(4000),@p1190 int,@p1191 int,@p1192 int,@p1193 nvarchar(4000),@p1194 nvarchar(4000),@p1195 nvarchar(4000),@p1196 nvarchar(4000),@p1197 decimal(18,2),@p1198 nvarchar(4000),@p1199 nvarchar(4000),@p1200 decimal(18,2),@p1201 nvarchar(4000),@p1202 nvarchar(4000),@p1203 nvarchar(4000),@p1204 nvarchar(4000),@p1205 int,@p1206 nvarchar(4000),@p1207 nvarchar(4000),@p1208 nvarchar(4000),@p1209 nvarchar(4000),@p1210 nvarchar(4000),@p1211 nvarchar(4000),@p1212 nvarchar(4000),@p1213 nvarchar(4000),@p1214 nvarchar(4000),@p1215 nvarchar(4000),@p1216 int,@p1217 nvarchar(4000),@p1218 nvarchar(4000),@p1219 nvarchar(4000),@p1220 nvarchar(4000),@p1221 nvarchar(4000),@p1222 int,@p1223 nvarchar(4000),@p1224 int,@p1225 int,@p1226 datetime2(7),@p1227 datetime2(7),@p1228 datetime2(7),@p1229 nvarchar(4000),@p1230 nvarchar(4000),@p1231 nvarchar(4000),@p1232 nvarchar(4000),@p1233 nvarchar(4000),@p1234 nvarchar(4000),@p1235 nvarchar(4000),@p1236 nvarchar(4000),@p1237 nvarchar(4000),@p1238 nvarchar(4000),@p1239 nvarchar(4000),@p1240 nvarchar(4000),@p1241 nvarchar(4000),@p1242 nvarchar(4000),@p1243 datetime2(7),@p1244 nvarchar(4000),@p1245 nvarchar(4000),@p1246 int,@p1247 int,@p1248 int,@p1249 nvarchar(4000),@p1250 nvarchar(4000),@p1251 nvarchar(4000),@p1252 nvarchar(4000),@p1253 decimal(18,2),@p1254 nvarchar(4000),@p1255 nvarchar(4000),@p1256 decimal(18,2),@p1257 nvarchar(4000),@p1258 nvarchar(4000),@p1259 nvarchar(4000),@p1260 nvarchar(4000),@p1261 int,@p1262 nvarchar(4000),@p1263 nvarchar(4000),@p1264 nvarchar(4000),@p1265 nvarchar(4000),@p1266 nvarchar(4000),@p1267 nvarchar(4000),@p1268 nvarchar(4000),@p1269 nvarchar(4000),@p1270 nvarchar(4000),@p1271 nvarchar(4000),@p1272 int,@p1273 nvarchar(4000),@p1274 nvarchar(4000),@p1275 nvarchar(4000),@p1276 nvarchar(4000),@p1277 nvarchar(4000),@p1278 int,@p1279 nvarchar(4000),@p1280 int,@p1281 int,@p1282 datetime2(7),@p1283 datetime2(7),@p1284 datetime2(7),@p1285 nvarchar(4000),@p1286 nvarchar(4000),@p1287 nvarchar(4000),@p1288 nvarchar(4000),@p1289 nvarchar(4000),@p1290 nvarchar(4000),@p1291 nvarchar(4000),@p1292 nvarchar(4000),@p1293 nvarchar(4000),@p1294 nvarchar(4000),@p1295 nvarchar(4000),@p1296 nvarchar(4000),@p1297 nvarchar(4000),@p1298 nvarchar(4000),@p1299 datetime2(7),@p1300 nvarchar(4000),@p1301 nvarchar(4000),@p1302 int,@p1303 int,@p1304 int,@p1305 nvarchar(4000),@p1306 nvarchar(4000),@p1307 nvarchar(4000),@p1308 nvarchar(4000),@p1309 decimal(18,2),@p1310 nvarchar(4000),@p1311 nvarchar(4000),@p1312 decimal(18,2),@p1313 nvarchar(4000),@p1314 nvarchar(4000),@p1315 nvarchar(4000),@p1316 nvarchar(4000),@p1317 int,@p1318 nvarchar(4000),@p1319 nvarchar(4000),@p1320 nvarchar(4000),@p1321 nvarchar(4000),@p1322 nvarchar(4000),@p1323 nvarchar(4000),@p1324 nvarchar(4000),@p1325 nvarchar(4000),@p1326 nvarchar(4000),@p1327 nvarchar(4000),@p1328 int,@p1329 nvarchar(4000),@p1330 nvarchar(4000),@p1331 nvarchar(4000),@p1332 nvarchar(4000),@p1333 nvarchar(4000),@p1334 int,@p1335 nvarchar(4000),@p1336 int,@p1337 int,@p1338 datetime2(7),@p1339 datetime2(7),@p1340 datetime2(7),@p1341 nvarchar(4000),@p1342 nvarchar(4000),@p1343 nvarchar(4000),@p1344 nvarchar(4000),@p1345 nvarchar(4000),@p1346 nvarchar(4000),@p1347 nvarchar(4000),@p1348 nvarchar(4000),@p1349 nvarchar(4000),@p1350 nvarchar(4000),@p1351 nvarchar(4000),@p1352 nvarchar(4000),@p1353 nvarchar(4000),@p1354 nvarchar(4000),@p1355 datetime2(7),@p1356 nvarchar(4000),@p1357 nvarchar(4000),@p1358 int,@p1359 int,@p1360 int,@p1361 nvarchar(4000),@p1362 nvarchar(4000),@p1363 nvarchar(4000),@p1364 nvarchar(4000),@p1365 decimal(18,2),@p1366 nvarchar(4000),@p1367 nvarchar(4000),@p1368 decimal(18,2),@p1369 nvarchar(4000),@p1370 nvarchar(4000),@p1371 nvarchar(4000),@p1372 nvarchar(4000),@p1373 int,@p1374 nvarchar(4000),@p1375 nvarchar(4000),@p1376 nvarchar(4000),@p1377 nvarchar(4000),@p1378 nvarchar(4000),@p1379 nvarchar(4000),@p1380 nvarchar(4000),@p1381 nvarchar(4000),@p1382 nvarchar(4000),@p1383 nvarchar(4000),@p1384 int,@p1385 nvarchar(4000),@p1386 nvarchar(4000),@p1387 nvarchar(4000),@p1388 nvarchar(4000),@p1389 nvarchar(4000),@p1390 int,@p1391 nvarchar(4000),@p1392 int,@p1393 int,@p1394 datetime2(7),@p1395 datetime2(7),@p1396 datetime2(7),@p1397 nvarchar(4000),@p1398 nvarchar(4000),@p1399 nvarchar(4000),@p1400 nvarchar(4000),@p1401 nvarchar(4000),@p1402 nvarchar(4000),@p1403 nvarchar(4000),@p1404 nvarchar(4000),@p1405 nvarchar(4000),@p1406 nvarchar(4000),@p1407 nvarchar(4000),@p1408 nvarchar(4000),@p1409 nvarchar(4000),@p1410 nvarchar(4000),@p1411 datetime2(7),@p1412 nvarchar(4000),@p1413 nvarchar(4000),@p1414 int,@p1415 int,@p1416 int,@p1417 nvarchar(4000),@p1418 nvarchar(4000),@p1419 nvarchar(4000),@p1420 nvarchar(4000),@p1421 decimal(18,2),@p1422 nvarchar(4000),@p1423 nvarchar(4000),@p1424 decimal(18,2),@p1425 nvarchar(4000),@p1426 nvarchar(4000),@p1427 nvarchar(4000),@p1428 nvarchar(4000),@p1429 int,@p1430 nvarchar(4000),@p1431 nvarchar(4000),@p1432 nvarchar(4000),@p1433 nvarchar(4000),@p1434 nvarchar(4000),@p1435 nvarchar(4000),@p1436 nvarchar(4000),@p1437 nvarchar(4000),@p1438 nvarchar(4000),@p1439 nvarchar(4000),@p1440 int,@p1441 nvarchar(4000),@p1442 nvarchar(4000),@p1443 nvarchar(4000),@p1444 nvarchar(4000),@p1445 nvarchar(4000),@p1446 int,@p1447 nvarchar(4000),@p1448 int,@p1449 int,@p1450 datetime2(7),@p1451 datetime2(7),@p1452 datetime2(7),@p1453 nvarchar(4000),@p1454 nvarchar(4000),@p1455 nvarchar(4000),@p1456 nvarchar(4000),@p1457 nvarchar(4000),@p1458 nvarchar(4000),@p1459 nvarchar(4000),@p1460 nvarchar(4000),@p1461 nvarchar(4000),@p1462 nvarchar(4000),@p1463 nvarchar(4000),@p1464 nvarchar(4000),@p1465 nvarchar(4000),@p1466 nvarchar(4000),@p1467 datetime2(7),@p1468 nvarchar(4000),@p1469 nvarchar(4000),@p1470 int,@p1471 int,@p1472 int,@p1473 nvarchar(4000),@p1474 nvarchar(4000),@p1475 nvarchar(4000),@p1476 nvarchar(4000),@p1477 decimal(18,2),@p1478 nvarchar(4000),@p1479 nvarchar(4000),@p1480 decimal(18,2),@p1481 nvarchar(4000),@p1482 nvarchar(4000),@p1483 nvarchar(4000),@p1484 nvarchar(4000),@p1485 int,@p1486 nvarchar(4000),@p1487 nvarchar(4000),@p1488 nvarchar(4000),@p1489 nvarchar(4000),@p1490 nvarchar(4000),@p1491 nvarchar(4000),@p1492 nvarchar(4000),@p1493 nvarchar(4000),@p1494 nvarchar(4000),@p1495 nvarchar(4000),@p1496 int,@p1497 nvarchar(4000),@p1498 nvarchar(4000),@p1499 nvarchar(4000),@p1500 nvarchar(4000),@p1501 nvarchar(4000),@p1502 int,@p1503 nvarchar(4000),@p1504 int,@p1505 int,@p1506 datetime2(7),@p1507 datetime2(7),@p1508 datetime2(7),@p1509 nvarchar(4000),@p1510 nvarchar(4000),@p1511 nvarchar(4000),@p1512 nvarchar(4000),@p1513 nvarchar(4000),@p1514 nvarchar(4000),@p1515 nvarchar(4000),@p1516 nvarchar(4000),@p1517 nvarchar(4000),@p1518 nvarchar(4000),@p1519 nvarchar(4000),@p1520 nvarchar(4000),@p1521 nvarchar(4000),@p1522 nvarchar(4000),@p1523 datetime2(7),@p1524 nvarchar(4000),@p1525 nvarchar(4000),@p1526 int,@p1527 int,@p1528 int,@p1529 nvarchar(4000),@p1530 nvarchar(4000),@p1531 nvarchar(4000),@p1532 nvarchar(4000),@p1533 decimal(18,2),@p1534 nvarchar(4000),@p1535 nvarchar(4000),@p1536 decimal(18,2),@p1537 nvarchar(4000),@p1538 nvarchar(4000),@p1539 nvarchar(4000),@p1540 nvarchar(4000),@p1541 int,@p1542 nvarchar(4000),@p1543 nvarchar(4000),@p1544 nvarchar(4000),@p1545 nvarchar(4000),@p1546 nvarchar(4000),@p1547 nvarchar(4000),@p1548 nvarchar(4000),@p1549 nvarchar(4000),@p1550 nvarchar(4000),@p1551 nvarchar(4000),@p1552 int,@p1553 nvarchar(4000),@p1554 nvarchar(4000),@p1555 nvarchar(4000),@p1556 nvarchar(4000),@p1557 nvarchar(4000),@p1558 int,@p1559 nvarchar(4000),@p1560 int,@p1561 int,@p1562 datetime2(7),@p1563 datetime2(7),@p1564 datetime2(7),@p1565 nvarchar(4000),@p1566 nvarchar(4000),@p1567 nvarchar(4000),@p1568 nvarchar(4000),@p1569 nvarchar(4000),@p1570 nvarchar(4000),@p1571 nvarchar(4000),@p1572 nvarchar(4000),@p1573 nvarchar(4000),@p1574 nvarchar(4000),@p1575 nvarchar(4000),@p1576 nvarchar(4000),@p1577 nvarchar(4000),@p1578 nvarchar(4000),@p1579 datetime2(7),@p1580 nvarchar(4000),@p1581 nvarchar(4000),@p1582 int,@p1583 int,@p1584 int,@p1585 nvarchar(4000),@p1586 nvarchar(4000),@p1587 nvarchar(4000),@p1588 nvarchar(4000),@p1589 decimal(18,2),@p1590 nvarchar(4000),@p1591 nvarchar(4000),@p1592 decimal(18,2),@p1593 nvarchar(4000),@p1594 nvarchar(4000),@p1595 nvarchar(4000),@p1596 nvarchar(4000),@p1597 int,@p1598 nvarchar(4000),@p1599 nvarchar(4000),@p1600 nvarchar(4000),@p1601 nvarchar(4000),@p1602 nvarchar(4000),@p1603 nvarchar(4000),@p1604 nvarchar(4000),@p1605 nvarchar(4000),@p1606 nvarchar(4000),@p1607 nvarchar(4000),@p1608 int,@p1609 nvarchar(4000),@p1610 nvarchar(4000),@p1611 nvarchar(4000),@p1612 nvarchar(4000),@p1613 nvarchar(4000),@p1614 int,@p1615 nvarchar(4000),@p1616 int,@p1617 int,@p1618 datetime2(7),@p1619 datetime2(7),@p1620 datetime2(7),@p1621 nvarchar(4000),@p1622 nvarchar(4000),@p1623 nvarchar(4000),@p1624 nvarchar(4000),@p1625 nvarchar(4000),@p1626 nvarchar(4000),@p1627 nvarchar(4000),@p1628 nvarchar(4000),@p1629 nvarchar(4000),@p1630 nvarchar(4000),@p1631 nvarchar(4000),@p1632 nvarchar(4000),@p1633 nvarchar(4000),@p1634 nvarchar(4000),@p1635 datetime2(7),@p1636 nvarchar(4000),@p1637 nvarchar(4000),@p1638 int,@p1639 int,@p1640 int,@p1641 nvarchar(4000),@p1642 nvarchar(4000),@p1643 nvarchar(4000),@p1644 nvarchar(4000),@p1645 decimal(18,2),@p1646 nvarchar(4000),@p1647 nvarchar(4000),@p1648 decimal(18,2),@p1649 nvarchar(4000),@p1650 nvarchar(4000),@p1651 nvarchar(4000),@p1652 nvarchar(4000),@p1653 int,@p1654 nvarchar(4000),@p1655 nvarchar(4000),@p1656 nvarchar(4000),@p1657 nvarchar(4000),@p1658 nvarchar(4000),@p1659 nvarchar(4000),@p1660 nvarchar(4000),@p1661 nvarchar(4000),@p1662 nvarchar(4000),@p1663 nvarchar(4000),@p1664 int,@p1665 nvarchar(4000),@p1666 nvarchar(4000),@p1667 nvarchar(4000),@p1668 nvarchar(4000),@p1669 nvarchar(4000),@p1670 int,@p1671 nvarchar(4000),@p1672 int,@p1673 int,@p1674 datetime2(7),@p1675 datetime2(7),@p1676 datetime2(7),@p1677 nvarchar(4000),@p1678 nvarchar(4000),@p1679 nvarchar(4000),@p1680 nvarchar(4000),@p1681 nvarchar(4000),@p1682 nvarchar(4000),@p1683 nvarchar(4000),@p1684 nvarchar(4000),@p1685 nvarchar(4000),@p1686 nvarchar(4000),@p1687 nvarchar(4000),@p1688 nvarchar(4000),@p1689 nvarchar(4000),@p1690 nvarchar(4000),@p1691 datetime2(7),@p1692 nvarchar(4000),@p1693 nvarchar(4000),@p1694 int,@p1695 int,@p1696 int,@p1697 nvarchar(4000),@p1698 nvarchar(4000),@p1699 nvarchar(4000),@p1700 nvarchar(4000),@p1701 decimal(18,2),@p1702 nvarchar(4000),@p1703 nvarchar(4000),@p1704 decimal(18,2),@p1705 nvarchar(4000),@p1706 nvarchar(4000),@p1707 nvarchar(4000),@p1708 nvarchar(4000),@p1709 int,@p1710 nvarchar(4000),@p1711 nvarchar(4000),@p1712 nvarchar(4000),@p1713 nvarchar(4000),@p1714 nvarchar(4000),@p1715 nvarchar(4000),@p1716 nvarchar(4000),@p1717 nvarchar(4000),@p1718 nvarchar(4000),@p1719 nvarchar(4000),@p1720 int,@p1721 nvarchar(4000),@p1722 nvarchar(4000),@p1723 nvarchar(4000),@p1724 nvarchar(4000),@p1725 nvarchar(4000),@p1726 int,@p1727 nvarchar(4000),@p1728 int,@p1729 int,@p1730 datetime2(7),@p1731 datetime2(7),@p1732 datetime2(7),@p1733 nvarchar(4000),@p1734 nvarchar(4000),@p1735 nvarchar(4000),@p1736 nvarchar(4000),@p1737 nvarchar(4000),@p1738 nvarchar(4000),@p1739 nvarchar(4000),@p1740 nvarchar(4000),@p1741 nvarchar(4000),@p1742 nvarchar(4000),@p1743 nvarchar(4000),@p1744 nvarchar(4000),@p1745 nvarchar(4000),@p1746 nvarchar(4000),@p1747 datetime2(7),@p1748 nvarchar(4000),@p1749 nvarchar(4000),@p1750 int,@p1751 int,@p1752 int,@p1753 nvarchar(4000),@p1754 nvarchar(4000),@p1755 nvarchar(4000),@p1756 nvarchar(4000),@p1757 decimal(18,2),@p1758 nvarchar(4000),@p1759 nvarchar(4000),@p1760 decimal(18,2),@p1761 nvarchar(4000),@p1762 nvarchar(4000),@p1763 nvarchar(4000),@p1764 nvarchar(4000),@p1765 int,@p1766 nvarchar(4000),@p1767 nvarchar(4000),@p1768 nvarchar(4000),@p1769 nvarchar(4000),@p1770 nvarchar(4000),@p1771 nvarchar(4000),@p1772 nvarchar(4000),@p1773 nvarchar(4000),@p1774 nvarchar(4000),@p1775 nvarchar(4000),@p1776 int,@p1777 nvarchar(4000),@p1778 nvarchar(4000),@p1779 nvarchar(4000),@p1780 nvarchar(4000),@p1781 nvarchar(4000),@p1782 int,@p1783 nvarchar(4000),@p1784 int,@p1785 int,@p1786 datetime2(7),@p1787 datetime2(7),@p1788 datetime2(7),@p1789 nvarchar(4000),@p1790 nvarchar(4000),@p1791 nvarchar(4000),@p1792 nvarchar(4000),@p1793 nvarchar(4000),@p1794 nvarchar(4000),@p1795 nvarchar(4000),@p1796 nvarchar(4000),@p1797 nvarchar(4000),@p1798 nvarchar(4000),@p1799 nvarchar(4000),@p1800 nvarchar(4000),@p1801 nvarchar(4000),@p1802 nvarchar(4000),@p1803 datetime2(7),@p1804 nvarchar(4000),@p1805 nvarchar(4000),@p1806 int,@p1807 int,@p1808 int,@p1809 nvarchar(4000),@p1810 nvarchar(4000),@p1811 nvarchar(4000),@p1812 nvarchar(4000),@p1813 decimal(18,2),@p1814 nvarchar(4000),@p1815 nvarchar(4000),@p1816 decimal(18,2),@p1817 nvarchar(4000),@p1818 nvarchar(4000),@p1819 nvarchar(4000),@p1820 nvarchar(4000),@p1821 int,@p1822 nvarchar(4000),@p1823 nvarchar(4000),@p1824 nvarchar(4000),@p1825 nvarchar(4000),@p1826 nvarchar(4000),@p1827 nvarchar(4000),@p1828 nvarchar(4000),@p1829 nvarchar(4000),@p1830 nvarchar(4000),@p1831 nvarchar(4000),@p1832 int,@p1833 nvarchar(4000),@p1834 nvarchar(4000),@p1835 nvarchar(4000),@p1836 nvarchar(4000),@p1837 nvarchar(4000),@p1838 int,@p1839 nvarchar(4000),@p1840 int,@p1841 int,@p1842 datetime2(7),@p1843 datetime2(7),@p1844 datetime2(7),@p1845 nvarchar(4000),@p1846 nvarchar(4000),@p1847 nvarchar(4000),@p1848 nvarchar(4000),@p1849 nvarchar(4000),@p1850 nvarchar(4000),@p1851 nvarchar(4000),@p1852 nvarchar(4000),@p1853 nvarchar(4000),@p1854 nvarchar(4000),@p1855 nvarchar(4000),@p1856 nvarchar(4000),@p1857 nvarchar(4000),@p1858 nvarchar(4000),@p1859 datetime2(7),@p1860 nvarchar(4000),@p1861 nvarchar(4000),@p1862 int,@p1863 int,@p1864 int,@p1865 nvarchar(4000),@p1866 nvarchar(4000),@p1867 nvarchar(4000),@p1868 nvarchar(4000),@p1869 decimal(18,2),@p1870 nvarchar(4000),@p1871 nvarchar(4000),@p1872 decimal(18,2),@p1873 nvarchar(4000),@p1874 nvarchar(4000),@p1875 nvarchar(4000),@p1876 nvarchar(4000),@p1877 int,@p1878 nvarchar(4000),@p1879 nvarchar(4000),@p1880 nvarchar(4000),@p1881 nvarchar(4000),@p1882 nvarchar(4000),@p1883 nvarchar(4000),@p1884 nvarchar(4000),@p1885 nvarchar(4000),@p1886 nvarchar(4000),@p1887 nvarchar(4000),@p1888 int,@p1889 nvarchar(4000),@p1890 nvarchar(4000),@p1891 nvarchar(4000),@p1892 nvarchar(4000),@p1893 nvarchar(4000),@p1894 int,@p1895 nvarchar(4000),@p1896 int,@p1897 int,@p1898 datetime2(7),@p1899 datetime2(7),@p1900 datetime2(7),@p1901 nvarchar(4000),@p1902 nvarchar(4000),@p1903 nvarchar(4000),@p1904 nvarchar(4000),@p1905 nvarchar(4000),@p1906 nvarchar(4000),@p1907 nvarchar(4000),@p1908 nvarchar(4000),@p1909 nvarchar(4000),@p1910 nvarchar(4000),@p1911 nvarchar(4000),@p1912 nvarchar(4000),@p1913 nvarchar(4000),@p1914 nvarchar(4000),@p1915 datetime2(7),@p1916 nvarchar(4000),@p1917 nvarchar(4000),@p1918 int,@p1919 int,@p1920 int,@p1921 nvarchar(4000),@p1922 nvarchar(4000),@p1923 nvarchar(4000),@p1924 nvarchar(4000),@p1925 decimal(18,2),@p1926 nvarchar(4000),@p1927 nvarchar(4000),@p1928 decimal(18,2),@p1929 nvarchar(4000),@p1930 nvarchar(4000),@p1931 nvarchar(4000),@p1932 nvarchar(4000),@p1933 int,@p1934 nvarchar(4000),@p1935 nvarchar(4000),@p1936 nvarchar(4000),@p1937 nvarchar(4000),@p1938 nvarchar(4000),@p1939 nvarchar(4000),@p1940 nvarchar(4000),@p1941 nvarchar(4000),@p1942 nvarchar(4000),@p1943 nvarchar(4000),@p1944 int,@p1945 nvarchar(4000),@p1946 nvarchar(4000),@p1947 nvarchar(4000),@p1948 nvarchar(4000),@p1949 nvarchar(4000),@p1950 int,@p1951 nvarchar(4000),@p1952 int,@p1953 int,@p1954 datetime2(7),@p1955 datetime2(7),@p1956 datetime2(7),@p1957 nvarchar(4000),@p1958 nvarchar(4000),@p1959 nvarchar(4000),@p1960 nvarchar(4000),@p1961 nvarchar(4000),@p1962 nvarchar(4000),@p1963 nvarchar(4000),@p1964 nvarchar(4000),@p1965 nvarchar(4000),@p1966 nvarchar(4000),@p1967 nvarchar(4000),@p1968 nvarchar(4000),@p1969 nvarchar(4000),@p1970 nvarchar(4000),@p1971 datetime2(7),@p1972 nvarchar(4000),@p1973 nvarchar(4000),@p1974 int,@p1975 int,@p1976 int,@p1977 nvarchar(4000),@p1978 nvarchar(4000),@p1979 nvarchar(4000),@p1980 nvarchar(4000),@p1981 decimal(18,2),@p1982 nvarchar(4000),@p1983 nvarchar(4000),@p1984 decimal(18,2),@p1985 nvarchar(4000),@p1986 nvarchar(4000),@p1987 nvarchar(4000),@p1988 nvarchar(4000),@p1989 int,@p1990 nvarchar(4000),@p1991 nvarchar(4000),@p1992 nvarchar(4000),@p1993 nvarchar(4000),@p1994 nvarchar(4000),@p1995 nvarchar(4000),@p1996 nvarchar(4000),@p1997 nvarchar(4000),@p1998 nvarchar(4000),@p1999 nvarchar(4000),@p2000 int,@p2001 nvarchar(4000),@p2002 nvarchar(4000),@p2003 nvarchar(4000),@p2004 nvarchar(4000),@p2005 nvarchar(4000),@p2006 int,@p2007 nvarchar(4000),@p2008 int,@p2009 int,@p2010 datetime2(7),@p2011 datetime2(7),@p2012 datetime2(7),@p2013 nvarchar(4000),@p2014 nvarchar(4000),@p2015 nvarchar(4000),@p2016 nvarchar(4000),@p2017 nvarchar(4000),@p2018 nvarchar(4000),@p2019 nvarchar(4000),@p2020 nvarchar(4000),@p2021 nvarchar(4000),@p2022 nvarchar(4000),@p2023 nvarchar(4000),@p2024 nvarchar(4000),@p2025 nvarchar(4000),@p2026 nvarchar(4000),@p2027 datetime2(7),@p2028 nvarchar(4000),@p2029 nvarchar(4000),@p2030 int,@p2031 int,@p2032 int,@p2033 nvarchar(4000),@p2034 nvarchar(4000),@p2035 nvarchar(4000),@p2036 nvarchar(4000),@p2037 decimal(18,2),@p2038 nvarchar(4000),@p2039 nvarchar(4000),@p2040 decimal(18,2),@p2041 nvarchar(4000),@p2042 nvarchar(4000),@p2043 nvarchar(4000),@p2044 nvarchar(4000),@p2045 int,@p2046 nvarchar(4000),@p2047 nvarchar(4000),@p2048 nvarchar(4000),@p2049 nvarchar(4000),@p2050 nvarchar(4000),@p2051 nvarchar(4000),@p2052 nvarchar(4000),@p2053 nvarchar(4000),@p2054 nvarchar(4000),@p2055 nvarchar(4000),@p2056 int,@p2057 nvarchar(4000),@p2058 nvarchar(4000),@p2059 nvarchar(4000),@p2060 nvarchar(4000),@p2061 nvarchar(4000),@p2062 int,@p2063 nvarchar(4000),@p2064 int,@p2065 int,@p2066 datetime2(7),@p2067 datetime2(7),@p2068 datetime2(7),@p2069 nvarchar(4000),@p2070 nvarchar(4000),@p2071 nvarchar(4000))SET NOCOUNT ON; DECLARE @inserted0 TABLE ([item_id] int, [_Position] [int]); MERGE [raw_data] USING ( VALUES (@p0, @p1, @p2, @p3, @p4, @p5, @p6, @p7, @p8, @p9, @p10, @p11, @p12, @p13, @p14, @p15, @p16, @p17, @p18, @p19, @p20, @p21, @p22, @p23, @p24, @p25, @p26, @p27, @p28, @p29, @p30, @p31, @p32, @p33, @p34, @p35, @p36, @p37, @p38, @p39, @p40, @p41, @p42, @p43, @p44, @p45, @p46, @p47, @p48, @p49, @p50, @p51, @p52, @p53, @p54, @p55, 0), (@p56, @p57, @p58, @p59, @p60, @p61, @p62, @p63, @p64, @p65, @p66, @p67, @p68, @p69, @p70, @p71, @p72, @p73, @p74, @p75, @p76, @p77, @p78, @p79, @p80, @p81, @p82, @p83, @p84, @p85, @p86, @p87, @p88, @p89, @p90, @p91, @p92, @p93, @p94, @p95, @p96, @p97, @p98, @p99, @p100, @p101, @p102, @p103, @p104, @p105, @p106, @p107, @p108, @p109, @p110, @p111, 1), (@p112, @p113, @p114, @p115, @p116, @p117, @p118, @p119, @p120, @p121, @p122, @p123, @p124, @p125, @p126, @p127, @p128, @p129, @p130, @p131, @p132, @p133, @p134, @p135, @p136, @p137, @p138, @p139, @p140, @p141, @p142, @p143, @p144, @p145, @p146, @p147, @p148, @p149, @p150, @p151, @p152, @p153, @p154, @p155, @p156, @p157, @p158, @p159, @p160, @p161, @p162, @p163, @p164, @p165, @p166, @p167, 2), (@p168, @p169, @p170, @p171, @p172, @p173, @p174, @p175, @p176, @p177, @p178, @p179, @p180, @p181, @p182, @p183, @p184, @p185, @p186, @p187, @p188, @p189, @p190, @p191, @p192, @p193, @p194, @p195, @p196, @p197, @p198, @p199, @p200, @p201, @p202, @p203, @p204, @p205, @p206, @p207, @p208, @p209, @p210, @p211, @p212, @p213, @p214, @p215, @p216, @p217, @p218, @p219, @p220, @p221, @p222, @p223, 3), (@p224, @p225, @p226, @p227, @p228, @p229, @p230, @p231, @p232, @p233, @p234, @p235, @p236, @p237, @p238, @p239, @p240, @p241, @p242, @p243, @p244, @p245, @p246, @p247, @p248, @p249, @p250, @p251, @p252, @p253, @p254, @p255, @p256, @p257, @p258, @p259, @p260, @p261, @p262, @p263, @p264, @p265, @p266, @p267, @p268, @p269, @p270, @p271, @p272, @p273, @p274, @p275, @p276, @p277, @p278, @p279, 4), (@p280, @p281, @p282, @p283, @p284, @p285, @p286, @p287, @p288, @p289, @p290, @p291, @p292, @p293, @p294, @p295, @p296, @p297, @p298, @p299, @p300, @p301, @p302, @p303, @p304, @p305, @p306, @p307, @p308, @p309, @p310, @p311, @p312, @p313, @p314, @p315, @p316, @p317, @p318, @p319, @p320, @p321, @p322, @p323, @p324, @p325, @p326, @p327, @p328, @p329, @p330, @p331, @p332, @p333, @p334, @p335, 5), (@p336, @p337, @p338, @p339, @p340, @p341, @p342, @p343, @p344, @p345, @p346, @p347, @p348, @p349, @p350, @p351, @p352, @p353, @p354, @p355, @p356, @p357, @p358, @p359, @p360, @p361, @p362, @p363, @p364, @p365, @p366, @p367, @p368, @p369, @p370, @p371, @p372, @p373, @p374, @p375, @p376, @p377, @p378, @p379, @p380, @p381, @p382, @p383, @p384, @p385, @p386, @p387, @p388, @p389, @p390, @p391, 6), (@p392, @p393, @p394, @p395, @p396, @p397, @p398, @p399, @p400, @p401, @p402, @p403, @p404, @p405, @p406, @p407, @p408, @p409, @p410, @p411, @p412, @p413, @p414, @p415, @p416, @p417, @p418, @p419, @p420, @p421, @p422, @p423, @p424, @p425, @p426, @p427, @p428, @p429, @p430, @p431, @p432, @p433, @p434, @p435, @p436, @p437, @p438, @p439, @p440, @p441, @p442, @p443, @p444, @p445, @p446, @p447, 7), (@p448, @p449, @p450, @p451, @p452, @p453, @p454, @p455, @p456, @p457, @p458, @p459, @p460, @p461, @p462, @p463, @p464, @p465, @p466, @p467, @p468, @p469, @p470, @p471, @p472, @p473, @p474, @p475, @p476, @p477, @p478, @p479, @p480, @p481, @p482, @p483, @p484, @p485, @p486, @p487, @p488, @p489, @p490, @p491, @p492, @p493, @p494, @p495, @p496, @p497, @p498, @p499, @p500, @p501, @p502, @p503, 8), (@p504, @p505, @p506, @p507, @p508, @p509, @p510, @p511, @p512, @p513, @p514, @p515, @p516, @p517, @p518, @p519, @p520, @p521, @p522, @p523, @p524, @p525, @p526, @p527, @p528, @p529, @p530, @p531, @p532, @p533, @p534, @p535, @p536, @p537, @p538, @p539, @p540, @p541, @p542, @p543, @p544, @p545, @p546, @p547, @p548, @p549, @p550, @p551, @p552, @p553, @p554, @p555, @p556, @p557, @p558, @p559, 9), (@p560, @p561, @p562, @p563, @p564, @p565, @p566, @p567, @p568, @p569, @p570, @p571, @p572, @p573, @p574, @p575, @p576, @p577, @p578, @p579, @p580, @p581, @p582, @p583, @p584, @p585, @p586, @p587, @p588, @p589, @p590, @p591, @p592, @p593, @p594, @p595, @p596, @p597, @p598, @p599, @p600, @p601, @p602, @p603, @p604, @p605, @p606, @p607, @p608, @p609, @p610, @p611, @p612, @p613, @p614, @p615, 10), (@p616, @p617, @p618, @p619, @p620, @p621, @p622, @p623, @p624, @p625, @p626, @p627, @p628, @p629, @p630, @p631, @p632, @p633, @p634, @p635, @p636, @p637, @p638, @p639, @p640, @p641, @p642, @p643, @p644, @p645, @p646, @p647, @p648, @p649, @p650, @p651, @p652, @p653, @p654, @p655, @p656, @p657, @p658, @p659, @p660, @p661, @p662, @p663, @p664, @p665, @p666, @p667, @p668, @p669, @p670, @p671, 11), (@p672, @p673, @p674, @p675, @p676, @p677, @p678, @p679, @p680, @p681, @p682, @p683, @p684, @p685, @p686, @p687, @p688, @p689, @p690, @p691, @p692, @p693, @p694, @p695, @p696, @p697, @p698, @p699, @p700, @p701, @p702, @p703, @p704, @p705, @p706, @p707, @p708, @p709, @p710, @p711, @p712, @p713, @p714, @p715, @p716, @p717, @p718, @p719, @p720, @p721, @p722, @p723, @p724, @p725, @p726, @p727, 12), (@p728, @p729, @p730, @p731, @p732, @p733, @p734, @p735, @p736, @p737, @p738, @p739, @p740, @p741, @p742, @p743, @p744, @p745, @p746, @p747, @p748, @p749, @p750, @p751, @p752, @p753, @p754, @p755, @p756, @p757, @p758, @p759, @p760, @p761, @p762, @p763, @p764, @p765, @p766, @p767, @p768, @p769, @p770, @p771, @p772, @p773, @p774, @p775, @p776, @p777, @p778, @p779, @p780, @p781, @p782, @p783, 13), (@p784, @p785, @p786, @p787, @p788, @p789, @p790, @p791, @p792, @p793, @p794, @p795, @p796, @p797, @p798, @p799, @p800, @p801, @p802, @p803, @p804, @p805, @p806, @p807, @p808, @p809, @p810, @p811, @p812, @p813, @p814, @p815, @p816, @p817, @p818, @p819, @p820, @p821, @p822, @p823, @p824, @p825, @p826, @p827, @p828, @p829, @p830, @p831, @p832, @p833, @p834, @p835, @p836, @p837, @p838, @p839, 14), (@p840, @p841, @p842, @p843, @p844, @p845, @p846, @p847, @p848, @p849, @p850, @p851, @p852, @p853, @p854, @p855, @p856, @p857, @p858, @p859, @p860, @p861, @p862, @p863, @p864, @p865, @p866, @p867, @p868, @p869, @p870, @p871, @p872, @p873, @p874, @p875, @p876, @p877, @p878, @p879, @p880, @p881, @p882, @p883, @p884, @p885, @p886, @p887, @p888, @p889, @p890, @p891, @p892, @p893, @p894, @p895, 15), (@p896, @p897, @p898, @p899, @p900, @p901, @p902, @p903, @p904, @p905, @p906, @p907, @p908, @p909, @p910, @p911, @p912, @p913, @p914, @p915, @p916, @p917, @p918, @p919, @p920, @p921, @p922, @p923, @p924, @p925, @p926, @p927, @p928, @p929, @p930, @p931, @p932, @p933, @p934, @p935, @p936, @p937, @p938, @p939, @p940, @p941, @p942, @p943, @p944, @p945, @p946, @p947, @p948, @p949, @p950, @p951, 16), (@p952, @p953, @p954, @p955, @p956, @p957, @p958, @p959, @p960, @p961, @p962, @p963, @p964, @p965, @p966, @p967, @p968, @p969, @p970, @p971, @p972, @p973, @p974, @p975, @p976, @p977, @p978, @p979, @p980, @p981, @p982, @p983, @p984, @p985, @p986, @p987, @p988, @p989, @p990, @p991, @p992, @p993, @p994, @p995, @p996, @p997, @p998, @p999, @p1000, @p1001, @p1002, @p1003, @p1004, @p1005, @p1006, @p1007, 17), (@p1008, @p1009, @p1010, @p1011, @p1012, @p1013, @p1014, @p1015, @p1016, @p1017, @p1018, @p1019, @p1020, @p1021, @p1022, @p1023, @p1024, @p1025, @p1026, @p1027, @p1028, @p1029, @p1030, @p1031, @p1032, @p1033, @p1034, @p1035, @p1036, @p1037, @p1038, @p1039, @p1040, @p1041, @p1042, @p1043, @p1044, @p1045, @p1046, @p1047, @p1048, @p1049, @p1050, @p1051, @p1052, @p1053, @p1054, @p1055, @p1056, @p1057, @p1058, @p1059, @p1060, @p1061, @p1062, @p1063, 18), (@p1064, @p1065, @p1066, @p1067, @p1068, @p1069, @p1070, @p1071, @p1072, @p1073, @p1074, @p1075, @p1076, @p1077, @p1078, @p1079, @p1080, @p1081, @p1082, @p1083, @p1084, @p1085, @p1086, @p1087, @p1088, @p1089, @p1090, @p1091, @p1092, @p1093, @p1094, @p1095, @p1096, @p1097, @p1098, @p1099, @p1100, @p1101, @p1102, @p1103, @p1104, @p1105, @p1106, @p1107, @p1108, @p1109, @p1110, @p1111, @p1112, @p1113, @p1114, @p1115, @p1116, @p1117, @p1118, @p1119, 19), (@p1120, @p1121, @p1122, @p1123, @p1124, @p1125, @p1126, @p1127, @p1128, @p1129, @p1130, @p1131, @p1132, @p1133, @p1134, @p1135, @p1136, @p1137, @p1138, @p1139, @p1140, @p1141, @p1142, @p1143, @p1144, @p1145, @p1146, @p1147, @p1148, @p1149, @p1150, @p1151, @p1152, @p1153, @p1154, @p1155, @p1156, @p1157, @p1158, @p1159, @p1160, @p1161, @p1162, @p1163, @p1164, @p1165, @p1166, @p1167, @p1168, @p1169, @p1170, @p1171, @p1172, @p1173, @p1174, @p1175, 20), (@p1176, @p1177, @p1178, @p1179, @p1180, @p1181, @p1182, @p1183, @p1184, @p1185, @p1186, @p1187, @p1188, @p1189, @p1190, @p1191, @p1192, @p1193, @p1194, @p1195, @p1196, @p1197, @p1198, @p1199, @p1200, @p1201, @p1202, @p1203, @p1204, @p1205, @p1206, @p1207, @p1208, @p1209, @p1210, @p1211, @p1212, @p1213, @p1214, @p1215, @p1216, @p1217, @p1218, @p1219, @p1220, @p1221, @p1222, @p1223, @p1224, @p1225, @p1226, @p1227, @p1228, @p1229, @p1230, @p1231, 21), (@p1232, @p1233, @p1234, @p1235, @p1236, @p1237, @p1238, @p1239, @p1240, @p1241, @p1242, @p1243, @p1244, @p1245, @p1246, @p1247, @p1248, @p1249, @p1250, @p1251, @p1252, @p1253, @p1254, @p1255, @p1256, @p1257, @p1258, @p1259, @p1260, @p1261, @p1262, @p1263, @p1264, @p1265, @p1266, @p1267, @p1268, @p1269, @p1270, @p1271, @p1272, @p1273, @p1274, @p1275, @p1276, @p1277, @p1278, @p1279, @p1280, @p1281, @p1282, @p1283, @p1284, @p1285, @p1286, @p1287, 22), (@p1288, @p1289, @p1290, @p1291, @p1292, @p1293, @p1294, @p1295, @p1296, @p1297, @p1298, @p1299, @p1300, @p1301, @p1302, @p1303, @p1304, @p1305, @p1306, @p1307, @p1308, @p1309, @p1310, @p1311, @p1312, @p1313, @p1314, @p1315, @p1316, @p1317, @p1318, @p1319, @p1320, @p1321, @p1322, @p1323, @p1324, @p1325, @p1326, @p1327, @p1328, @p1329, @p1330, @p1331, @p1332, @p1333, @p1334, @p1335, @p1336, @p1337, @p1338, @p1339, @p1340, @p1341, @p1342, @p1343, 23), (@p1344, @p1345, @p1346, @p1347, @p1348, @p1349, @p1350, @p1351, @p1352, @p1353, @p1354, @p1355, @p1356, @p1357, @p1358, @p1359, @p1360, @p1361, @p1362, @p1363, @p1364, @p1365, @p1366, @p1367, @p1368, @p1369, @p1370, @p1371, @p1372, @p1373, @p1374, @p1375, @p1376, @p1377, @p1378, @p1379, @p1380, @p1381, @p1382, @p1383, @p1384, @p1385, @p1386, @p1387, @p1388, @p1389, @p1390, @p1391, @p1392, @p1393, @p1394, @p1395, @p1396, @p1397, @p1398, @p1399, 24), (@p1400, @p1401, @p1402, @p1403, @p1404, @p1405, @p1406, @p1407, @p1408, @p1409, @p1410, @p1411, @p1412, @p1413, @p1414, @p1415, @p1416, @p1417, @p1418, @p1419, @p1420, @p1421, @p1422, @p1423, @p1424, @p1425, @p1426, @p1427, @p1428, @p1429, @p1430, @p1431, @p1432, @p1433, @p1434, @p1435, @p1436, @p1437, @p1438, @p1439, @p1440, @p1441, @p1442, @p1443, @p1444, @p1445, @p1446, @p1447, @p1448, @p1449, @p1450, @p1451, @p1452, @p1453, @p1454, @p1455, 25), (@p1456, @p1457, @p1458, @p1459, @p1460, @p1461, @p1462, @p1463, @p1464, @p1465, @p1466, @p1467, @p1468, @p1469, @p1470, @p1471, @p1472, @p1473, @p1474, @p1475, @p1476, @p1477, @p1478, @p1479, @p1480, @p1481, @p1482, @p1483, @p1484, @p1485, @p1486, @p1487, @p1488, @p1489, @p1490, @p1491, @p1492, @p1493, @p1494, @p1495, @p1496, @p1497, @p1498, @p1499, @p1500, @p1501, @p1502, @p1503, @p1504, @p1505, @p1506, @p1507, @p1508, @p1509, @p1510, @p1511, 26), (@p1512, @p1513, @p1514, @p1515, @p1516, @p1517, @p1518, @p1519, @p1520, @p1521, @p1522, @p1523, @p1524, @p1525, @p1526, @p1527, @p1528, @p1529, @p1530, @p1531, @p1532, @p1533, @p1534, @p1535, @p1536, @p1537, @p1538, @p1539, @p1540, @p1541, @p1542, @p1543, @p1544, @p1545, @p1546, @p1547, @p1548, @p1549, @p1550, @p1551, @p1552, @p1553, @p1554, @p1555, @p1556, @p1557, @p1558, @p1559, @p1560, @p1561, @p1562, @p1563, @p1564, @p1565, @p1566, @p1567, 27), (@p1568, @p1569, @p1570, @p1571, @p1572, @p1573, @p1574, @p1575, @p1576, @p1577, @p1578, @p1579, @p1580, @p1581, @p1582, @p1583, @p1584, @p1585, @p1586, @p1587, @p1588, @p1589, @p1590, @p1591, @p1592, @p1593, @p1594, @p1595, @p1596, @p1597, @p1598, @p1599, @p1600, @p1601, @p1602, @p1603, @p1604, @p1605, @p1606, @p1607, @p1608, @p1609, @p1610, @p1611, @p1612, @p1613, @p1614, @p1615, @p1616, @p1617, @p1618, @p1619, @p1620, @p1621, @p1622, @p1623, 28), (@p1624, @p1625, @p1626, @p1627, @p1628, @p1629, @p1630, @p1631, @p1632, @p1633, @p1634, @p1635, @p1636, @p1637, @p1638, @p1639, @p1640, @p1641, @p1642, @p1643, @p1644, @p1645, @p1646, @p1647, @p1648, @p1649, @p1650, @p1651, @p1652, @p1653, @p1654, @p1655, @p1656, @p1657, @p1658, @p1659, @p1660, @p1661, @p1662, @p1663, @p1664, @p1665, @p1666, @p1667, @p1668, @p1669, @p1670, @p1671, @p1672, @p1673, @p1674, @p1675, @p1676, @p1677, @p1678, @p1679, 29), (@p1680, @p1681, @p1682, @p1683, @p1684, @p1685, @p1686, @p1687, @p1688, @p1689, @p1690, @p1691, @p1692, @p1693, @p1694, @p1695, @p1696, @p1697, @p1698, @p1699, @p1700, @p1701, @p1702, @p1703, @p1704, @p1705, @p1706, @p1707, @p1708, @p1709, @p1710, @p1711, @p1712, @p1713, @p1714, @p1715, @p1716, @p1717, @p1718, @p1719, @p1720, @p1721, @p1722, @p1723, @p1724, @p1725, @p1726, @p1727, @p1728, @p1729, @p1730, @p1731, @p1732, @p1733, @p1734, @p1735, 30), (@p1736, @p1737, @p1738, @p1739, @p1740, @p1741, @p1742, @p1743, @p1744, @p1745, @p1746, @p1747, @p1748, @p1749, @p1750, @p1751, @p1752, @p1753, @p1754, @p1755, @p1756, @p1757, @p1758, @p1759, @p1760, @p1761, @p1762, @p1763, @p1764, @p1765, @p1766, @p1767, @p1768, @p1769, @p1770, @p1771, @p1772, @p1773, @p1774, @p1775, @p1776, @p1777, @p1778, @p1779, @p1780, @p1781, @p1782, @p1783, @p1784, @p1785, @p1786, @p1787, @p1788, @p1789, @p1790, @p1791, 31), (@p1792, @p1793, @p1794, @p1795, @p1796, @p1797, @p1798, @p1799, @p1800, @p1801, @p1802, @p1803, @p1804, @p1805, @p1806, @p1807, @p1808, @p1809, @p1810, @p1811, @p1812, @p1813, @p1814, @p1815, @p1816, @p1817, @p1818, @p1819, @p1820, @p1821, @p1822, @p1823, @p1824, @p1825, @p1826, @p1827, @p1828, @p1829, @p1830, @p1831, @p1832, @p1833, @p1834, @p1835, @p1836, @p1837, @p1838, @p1839, @p1840, @p1841, @p1842, @p1843, @p1844, @p1845, @p1846, @p1847, 32), (@p1848, @p1849, @p1850, @p1851, @p1852, @p1853, @p1854, @p1855, @p1856, @p1857, @p1858, @p1859, @p1860, @p1861, @p1862, @p1863, @p1864, @p1865, @p1866, @p1867, @p1868, @p1869, @p1870, @p1871, @p1872, @p1873, @p1874, @p1875, @p1876, @p1877, @p1878, @p1879, @p1880, @p1881, @p1882, @p1883, @p1884, @p1885, @p1886, @p1887, @p1888, @p1889, @p1890, @p1891, @p1892, @p1893, @p1894, @p1895, @p1896, @p1897, @p1898, @p1899, @p1900, @p1901, @p1902, @p1903, 33), (@p1904, @p1905, @p1906, @p1907, @p1908, @p1909, @p1910, @p1911, @p1912, @p1913, @p1914, @p1915, @p1916, @p1917, @p1918, @p1919, @p1920, @p1921, @p1922, @p1923, @p1924, @p1925, @p1926, @p1927, @p1928, @p1929, @p1930, @p1931, @p1932, @p1933, @p1934, @p1935, @p1936, @p1937, @p1938, @p1939, @p1940, @p1941, @p1942, @p1943, @p1944, @p1945, @p1946, @p1947, @p1948, @p1949, @p1950, @p1951, @p1952, @p1953, @p1954, @p1955, @p1956, @p1957, @p1958, @p1959, 34), (@p1960, @p1961, @p1962, @p1963, @p1964, @p1965, @p1966, @p1967, @p1968, @p1969, @p1970, @p1971, @p1972, @p1973, @p1974, @p1975, @p1976, @p1977, @p1978, @p1979, @p1980, @p1981, @p1982, @p1983, @p1984, @p1985, @p1986, @p1987, @p1988, @p1989, @p1990, @p1991, @p1992, @p1993, @p1994, @p1995, @p1996, @p1997, @p1998, @p1999, @p2000, @p2001, @p2002, @p2003, @p2004, @p2005, @p2006, @p2007, @p2008, @p2009, @p2010, @p2011, @p2012, @p2013, @p2014, @p2015, 35), (@p2016, @p2017, @p2018, @p2019, @p2020, @p2021, @p2022, @p2023, @p2024, @p2025, @p2026, @p2027, @p2028, @p2029, @p2030, @p2031, @p2032, @p2033, @p2034, @p2035, @p2036, @p2037, @p2038, @p2039, @p2040, @p2041, @p2042, @p2043, @p2044, @p2045, @p2046, @p2047, @p2048, @p2049, @p2050, @p2051, @p2052, @p2053, @p2054, @p2055, @p2056, @p2057, @p2058, @p2059, @p2060, @p2061, @p2062, @p2063, @p2064, @p2065, @p2066, @p2067, @p2068, @p2069, @p2070, @p2071, 36)) AS i ([addressee_cntry_cd], [addressee_city], [addressee_district], [addressee_email], [addressee_full_address], [addressee_home_address], [addressee_name], [addressee_postcode], [addressee_province], [addressee_subdistrict], [addressee_tel], [create_table], [delivery_code], [delivery_recipient_name], [delivery_relation_id], [delivery_status_id], [dest_outlet_id], [dest_outlet_port], [document_number], [item_barcode], [item_cod], [item_gross_weight], [item_height], [item_length], [item_price], [item_width], [lat], [log_id], [long], [outlet_id], [outlet_port], [podUrl], [remark], [scan_cntry_cd], [scan_cntry_postcode], [sender_cntry_cd], [sender_district], [sender_email], [sender_full_address], [sender_home_address], [member_id], [sender_name], [sender_postcode], [sender_province], [sender_subdistrict], [sender_tel], [server_id], [signatureUrl], [state], [status_code], [status_dtm], [timestamp], [transmit_dtm], [user_id], [wckt_id], [wkstn_no], _Position) ON 1=0 WHEN NOT MATCHED THEN INSERT ([addressee_cntry_cd], [addressee_city], [addressee_district], [addressee_email], [addressee_full_address], [addressee_home_address], [addressee_name], [addressee_postcode], [addressee_province], [addressee_subdistrict], [addressee_tel], [create_table], [delivery_code], [delivery_recipient_name], [delivery_relation_id], [delivery_status_id], [dest_outlet_id], [dest_outlet_port], [document_number], [item_barcode], [item_cod], [item_gross_weight], [item_height], [item_length], [item_price], [item_width], [lat], [log_id], [long], [outlet_id], [outlet_port], [podUrl], [remark], [scan_cntry_cd], [scan_cntry_postcode], [sender_cntry_cd], [sender_district], [sender_email], [sender_full_address], [sender_home_address], [member_id], [sender_name], [sender_postcode], [sender_province], [sender_subdistrict], [sender_tel], [server_id], [signatureUrl], [state], [status_code], [status_dtm], [timestamp], [transmit_dtm], [user_id], [wckt_id], [wkstn_no]) VALUES (i.[addressee_cntry_cd], i.[addressee_city], i.[addressee_district], i.[addressee_email], i.[addressee_full_address], i.[addressee_home_address], i.[addressee_name], i.[addressee_postcode], i.[addressee_province], i.[addressee_subdistrict], i.[addressee_tel], i.[create_table], i.[delivery_code], i.[delivery_recipient_name], i.[delivery_relation_id], i.[delivery_status_id], i.[dest_outlet_id], i.[dest_outlet_port], i.[document_number], i.[item_barcode], i.[item_cod], i.[item_gross_weight], i.[item_height], i.[item_length], i.[item_price], i.[item_width], i.[lat], i.[log_id], i.[long], i.[outlet_id], i.[outlet_port], i.[podUrl], i.[remark], i.[scan_cntry_cd], i.[scan_cntry_postcode], i.[sender_cntry_cd], i.[sender_district], i.[sender_email], i.[sender_full_address], i.[sender_home_address], i.[member_id], i.[sender_name], i.[sender_postcode], i.[sender_province], i.[sender_subdistrict], i.[sender_tel], i.[server_id], i.[signatureUrl], i.[state], i.[status_code], i.[status_dtm], i.[timestamp], i.[transmit_dtm], i.[user_id], i.[wckt_id], i.[wkstn_no]) OUTPUT INSERTED.[item_id], i._Position INTO @inserted0;  SELECT [t].[item_id] FROM [raw_data] t INNER JOIN @inserted0 i ON ([t].[item_id] = [i].[item_id]) ORDER BY [i].[_Position];  ",4,4,0,430,1,4
"(@p0 nvarchar(4000),@p1 nvarchar(4000),@p2 nvarchar(4000),@p3 nvarchar(4000),@p4 nvarchar(4000),@p5 nvarchar(4000),@p6 nvarchar(4000),@p7 nvarchar(4000),@p8 nvarchar(4000),@p9 nvarchar(4000),@p10 nvarchar(4000),@p11 datetime2(7),@p12 nvarchar(4000),@p13 nvarchar(4000),@p14 int,@p15 int,@p16 int,@p17 nvarchar(4000),@p18 nvarchar(4000),@p19 nvarchar(4000),@p20 decimal(18,2),@p21 decimal(18,2),@p22 nvarchar(4000),@p23 nvarchar(4000),@p24 decimal(18,2),@p25 nvarchar(4000),@p26 nvarchar(4000),@p27 nvarchar(4000),@p28 nvarchar(4000),@p29 int,@p30 nvarchar(4000),@p31 nvarchar(4000),@p32 nvarchar(4000),@p33 nvarchar(4000),@p34 nvarchar(4000),@p35 nvarchar(4000),@p36 nvarchar(4000),@p37 nvarchar(4000),@p38 nvarchar(4000),@p39 nvarchar(4000),@p40 int,@p41 nvarchar(4000),@p42 nvarchar(4000),@p43 nvarchar(4000),@p44 nvarchar(4000),@p45 nvarchar(4000),@p46 int,@p47 nvarchar(4000),@p48 int,@p49 int,@p50 datetime2(7),@p51 datetime2(7),@p52 datetime2(7),@p53 nvarchar(4000),@p54 nvarchar(4000),@p55 nvarchar(4000),@p56 nvarchar(4000),@p57 nvarchar(4000),@p58 nvarchar(4000),@p59 nvarchar(4000),@p60 nvarchar(4000),@p61 nvarchar(4000),@p62 nvarchar(4000),@p63 nvarchar(4000),@p64 nvarchar(4000),@p65 nvarchar(4000),@p66 nvarchar(4000),@p67 datetime2(7),@p68 nvarchar(4000),@p69 nvarchar(4000),@p70 int,@p71 int,@p72 int,@p73 nvarchar(4000),@p74 nvarchar(4000),@p75 nvarchar(4000),@p76 decimal(18,2),@p77 decimal(18,2),@p78 nvarchar(4000),@p79 nvarchar(4000),@p80 decimal(18,2),@p81 nvarchar(4000),@p82 nvarchar(4000),@p83 nvarchar(4000),@p84 nvarchar(4000),@p85 int,@p86 nvarchar(4000),@p87 nvarchar(4000),@p88 nvarchar(4000),@p89 nvarchar(4000),@p90 nvarchar(4000),@p91 nvarchar(4000),@p92 nvarchar(4000),@p93 nvarchar(4000),@p94 nvarchar(4000),@p95 nvarchar(4000),@p96 int,@p97 nvarchar(4000),@p98 nvarchar(4000),@p99 nvarchar(4000),@p100 nvarchar(4000),@p101 nvarchar(4000),@p102 int,@p103 nvarchar(4000),@p104 int,@p105 int,@p106 datetime2(7),@p107 datetime2(7),@p108 datetime2(7),@p109 nvarchar(4000),@p110 nvarchar(4000),@p111 nvarchar(4000),@p112 nvarchar(4000),@p113 nvarchar(4000),@p114 nvarchar(4000),@p115 nvarchar(4000),@p116 nvarchar(4000),@p117 nvarchar(4000),@p118 nvarchar(4000),@p119 nvarchar(4000),@p120 nvarchar(4000),@p121 nvarchar(4000),@p122 nvarchar(4000),@p123 datetime2(7),@p124 nvarchar(4000),@p125 nvarchar(4000),@p126 int,@p127 int,@p128 int,@p129 nvarchar(4000),@p130 nvarchar(4000),@p131 nvarchar(4000),@p132 decimal(18,2),@p133 decimal(18,2),@p134 nvarchar(4000),@p135 nvarchar(4000),@p136 decimal(18,2),@p137 nvarchar(4000),@p138 nvarchar(4000),@p139 nvarchar(4000),@p140 nvarchar(4000),@p141 int,@p142 nvarchar(4000),@p143 nvarchar(4000),@p144 nvarchar(4000),@p145 nvarchar(4000),@p146 nvarchar(4000),@p147 nvarchar(4000),@p148 nvarchar(4000),@p149 nvarchar(4000),@p150 nvarchar(4000),@p151 nvarchar(4000),@p152 int,@p153 nvarchar(4000),@p154 nvarchar(4000),@p155 nvarchar(4000),@p156 nvarchar(4000),@p157 nvarchar(4000),@p158 int,@p159 nvarchar(4000),@p160 int,@p161 int,@p162 datetime2(7),@p163 datetime2(7),@p164 datetime2(7),@p165 nvarchar(4000),@p166 nvarchar(4000),@p167 nvarchar(4000),@p168 nvarchar(4000),@p169 nvarchar(4000),@p170 nvarchar(4000),@p171 nvarchar(4000),@p172 nvarchar(4000),@p173 nvarchar(4000),@p174 nvarchar(4000),@p175 nvarchar(4000),@p176 nvarchar(4000),@p177 nvarchar(4000),@p178 nvarchar(4000),@p179 datetime2(7),@p180 nvarchar(4000),@p181 nvarchar(4000),@p182 int,@p183 int,@p184 int,@p185 nvarchar(4000),@p186 nvarchar(4000),@p187 nvarchar(4000),@p188 nvarchar(4000),@p189 decimal(18,2),@p190 nvarchar(4000),@p191 nvarchar(4000),@p192 decimal(18,2),@p193 nvarchar(4000),@p194 nvarchar(4000),@p195 nvarchar(4000),@p196 nvarchar(4000),@p197 int,@p198 nvarchar(4000),@p199 nvarchar(4000),@p200 nvarchar(4000),@p201 nvarchar(4000),@p202 nvarchar(4000),@p203 nvarchar(4000),@p204 nvarchar(4000),@p205 nvarchar(4000),@p206 nvarchar(4000),@p207 nvarchar(4000),@p208 int,@p209 nvarchar(4000),@p210 nvarchar(4000),@p211 nvarchar(4000),@p212 nvarchar(4000),@p213 nvarchar(4000),@p214 int,@p215 nvarchar(4000),@p216 int,@p217 int,@p218 datetime2(7),@p219 datetime2(7),@p220 datetime2(7),@p221 nvarchar(4000),@p222 nvarchar(4000),@p223 nvarchar(4000),@p224 nvarchar(4000),@p225 nvarchar(4000),@p226 nvarchar(4000),@p227 nvarchar(4000),@p228 nvarchar(4000),@p229 nvarchar(4000),@p230 nvarchar(4000),@p231 nvarchar(4000),@p232 nvarchar(4000),@p233 nvarchar(4000),@p234 nvarchar(4000),@p235 datetime2(7),@p236 nvarchar(4000),@p237 nvarchar(4000),@p238 int,@p239 int,@p240 int,@p241 nvarchar(4000),@p242 nvarchar(4000),@p243 nvarchar(4000),@p244 nvarchar(4000),@p245 decimal(18,2),@p246 nvarchar(4000),@p247 nvarchar(4000),@p248 decimal(18,2),@p249 nvarchar(4000),@p250 nvarchar(4000),@p251 nvarchar(4000),@p252 nvarchar(4000),@p253 int,@p254 nvarchar(4000),@p255 nvarchar(4000),@p256 nvarchar(4000),@p257 nvarchar(4000),@p258 nvarchar(4000),@p259 nvarchar(4000),@p260 nvarchar(4000),@p261 nvarchar(4000),@p262 nvarchar(4000),@p263 nvarchar(4000),@p264 int,@p265 nvarchar(4000),@p266 nvarchar(4000),@p267 nvarchar(4000),@p268 nvarchar(4000),@p269 nvarchar(4000),@p270 int,@p271 nvarchar(4000),@p272 int,@p273 int,@p274 datetime2(7),@p275 datetime2(7),@p276 datetime2(7),@p277 nvarchar(4000),@p278 nvarchar(4000),@p279 nvarchar(4000),@p280 nvarchar(4000),@p281 nvarchar(4000),@p282 nvarchar(4000),@p283 nvarchar(4000),@p284 nvarchar(4000),@p285 nvarchar(4000),@p286 nvarchar(4000),@p287 nvarchar(4000),@p288 nvarchar(4000),@p289 nvarchar(4000),@p290 nvarchar(4000),@p291 datetime2(7),@p292 nvarchar(4000),@p293 nvarchar(4000),@p294 int,@p295 int,@p296 int,@p297 nvarchar(4000),@p298 nvarchar(4000),@p299 nvarchar(4000),@p300 nvarchar(4000),@p301 decimal(18,2),@p302 nvarchar(4000),@p303 nvarchar(4000),@p304 decimal(18,2),@p305 nvarchar(4000),@p306 nvarchar(4000),@p307 nvarchar(4000),@p308 nvarchar(4000),@p309 int,@p310 nvarchar(4000),@p311 nvarchar(4000),@p312 nvarchar(4000),@p313 nvarchar(4000),@p314 nvarchar(4000),@p315 nvarchar(4000),@p316 nvarchar(4000),@p317 nvarchar(4000),@p318 nvarchar(4000),@p319 nvarchar(4000),@p320 int,@p321 nvarchar(4000),@p322 nvarchar(4000),@p323 nvarchar(4000),@p324 nvarchar(4000),@p325 nvarchar(4000),@p326 int,@p327 nvarchar(4000),@p328 int,@p329 int,@p330 datetime2(7),@p331 datetime2(7),@p332 datetime2(7),@p333 nvarchar(4000),@p334 nvarchar(4000),@p335 nvarchar(4000),@p336 nvarchar(4000),@p337 nvarchar(4000),@p338 nvarchar(4000),@p339 nvarchar(4000),@p340 nvarchar(4000),@p341 nvarchar(4000),@p342 nvarchar(4000),@p343 nvarchar(4000),@p344 nvarchar(4000),@p345 nvarchar(4000),@p346 nvarchar(4000),@p347 datetime2(7),@p348 nvarchar(4000),@p349 nvarchar(4000),@p350 int,@p351 int,@p352 int,@p353 nvarchar(4000),@p354 nvarchar(4000),@p355 nvarchar(4000),@p356 decimal(18,2),@p357 decimal(18,2),@p358 nvarchar(4000),@p359 nvarchar(4000),@p360 decimal(18,2),@p361 nvarchar(4000),@p362 nvarchar(4000),@p363 nvarchar(4000),@p364 nvarchar(4000),@p365 int,@p366 nvarchar(4000),@p367 nvarchar(4000),@p368 nvarchar(4000),@p369 nvarchar(4000),@p370 nvarchar(4000),@p371 nvarchar(4000),@p372 nvarchar(4000),@p373 nvarchar(4000),@p374 nvarchar(4000),@p375 nvarchar(4000),@p376 int,@p377 nvarchar(4000),@p378 nvarchar(4000),@p379 nvarchar(4000),@p380 nvarchar(4000),@p381 nvarchar(4000),@p382 int,@p383 nvarchar(4000),@p384 int,@p385 int,@p386 datetime2(7),@p387 datetime2(7),@p388 datetime2(7),@p389 nvarchar(4000),@p390 nvarchar(4000),@p391 nvarchar(4000),@p392 nvarchar(4000),@p393 nvarchar(4000),@p394 nvarchar(4000),@p395 nvarchar(4000),@p396 nvarchar(4000),@p397 nvarchar(4000),@p398 nvarchar(4000),@p399 nvarchar(4000),@p400 nvarchar(4000),@p401 nvarchar(4000),@p402 nvarchar(4000),@p403 datetime2(7),@p404 nvarchar(4000),@p405 nvarchar(4000),@p406 int,@p407 int,@p408 int,@p409 nvarchar(4000),@p410 nvarchar(4000),@p411 nvarchar(4000),@p412 decimal(18,2),@p413 decimal(18,2),@p414 nvarchar(4000),@p415 nvarchar(4000),@p416 decimal(18,2),@p417 nvarchar(4000),@p418 nvarchar(4000),@p419 nvarchar(4000),@p420 nvarchar(4000),@p421 int,@p422 nvarchar(4000),@p423 nvarchar(4000),@p424 nvarchar(4000),@p425 nvarchar(4000),@p426 nvarchar(4000),@p427 nvarchar(4000),@p428 nvarchar(4000),@p429 nvarchar(4000),@p430 nvarchar(4000),@p431 nvarchar(4000),@p432 int,@p433 nvarchar(4000),@p434 nvarchar(4000),@p435 nvarchar(4000),@p436 nvarchar(4000),@p437 nvarchar(4000),@p438 int,@p439 nvarchar(4000),@p440 int,@p441 int,@p442 datetime2(7),@p443 datetime2(7),@p444 datetime2(7),@p445 nvarchar(4000),@p446 nvarchar(4000),@p447 nvarchar(4000),@p448 nvarchar(4000),@p449 nvarchar(4000),@p450 nvarchar(4000),@p451 nvarchar(4000),@p452 nvarchar(4000),@p453 nvarchar(4000),@p454 nvarchar(4000),@p455 nvarchar(4000),@p456 nvarchar(4000),@p457 nvarchar(4000),@p458 nvarchar(4000),@p459 datetime2(7),@p460 nvarchar(4000),@p461 nvarchar(4000),@p462 int,@p463 int,@p464 int,@p465 nvarchar(4000),@p466 nvarchar(4000),@p467 nvarchar(4000),@p468 decimal(18,2),@p469 decimal(18,2),@p470 nvarchar(4000),@p471 nvarchar(4000),@p472 decimal(18,2),@p473 nvarchar(4000),@p474 nvarchar(4000),@p475 nvarchar(4000),@p476 nvarchar(4000),@p477 int,@p478 nvarchar(4000),@p479 nvarchar(4000),@p480 nvarchar(4000),@p481 nvarchar(4000),@p482 nvarchar(4000),@p483 nvarchar(4000),@p484 nvarchar(4000),@p485 nvarchar(4000),@p486 nvarchar(4000),@p487 nvarchar(4000),@p488 int,@p489 nvarchar(4000),@p490 nvarchar(4000),@p491 nvarchar(4000),@p492 nvarchar(4000),@p493 nvarchar(4000),@p494 int,@p495 nvarchar(4000),@p496 int,@p497 int,@p498 datetime2(7),@p499 datetime2(7),@p500 datetime2(7),@p501 nvarchar(4000),@p502 nvarchar(4000),@p503 nvarchar(4000),@p504 nvarchar(4000),@p505 nvarchar(4000),@p506 nvarchar(4000),@p507 nvarchar(4000),@p508 nvarchar(4000),@p509 nvarchar(4000),@p510 nvarchar(4000),@p511 nvarchar(4000),@p512 nvarchar(4000),@p513 nvarchar(4000),@p514 nvarchar(4000),@p515 datetime2(7),@p516 nvarchar(4000),@p517 nvarchar(4000),@p518 int,@p519 int,@p520 int,@p521 nvarchar(4000),@p522 nvarchar(4000),@p523 nvarchar(4000),@p524 decimal(18,2),@p525 decimal(18,2),@p526 nvarchar(4000),@p527 nvarchar(4000),@p528 decimal(18,2),@p529 nvarchar(4000),@p530 nvarchar(4000),@p531 nvarchar(4000),@p532 nvarchar(4000),@p533 int,@p534 nvarchar(4000),@p535 nvarchar(4000),@p536 nvarchar(4000),@p537 nvarchar(4000),@p538 nvarchar(4000),@p539 nvarchar(4000),@p540 nvarchar(4000),@p541 nvarchar(4000),@p542 nvarchar(4000),@p543 nvarchar(4000),@p544 int,@p545 nvarchar(4000),@p546 nvarchar(4000),@p547 nvarchar(4000),@p548 nvarchar(4000),@p549 nvarchar(4000),@p550 int,@p551 nvarchar(4000),@p552 int,@p553 int,@p554 datetime2(7),@p555 datetime2(7),@p556 datetime2(7),@p557 nvarchar(4000),@p558 nvarchar(4000),@p559 nvarchar(4000),@p560 nvarchar(4000),@p561 nvarchar(4000),@p562 nvarchar(4000),@p563 nvarchar(4000),@p564 nvarchar(4000),@p565 nvarchar(4000),@p566 nvarchar(4000),@p567 nvarchar(4000),@p568 nvarchar(4000),@p569 nvarchar(4000),@p570 nvarchar(4000),@p571 datetime2(7),@p572 nvarchar(4000),@p573 nvarchar(4000),@p574 int,@p575 int,@p576 int,@p577 nvarchar(4000),@p578 nvarchar(4000),@p579 nvarchar(4000),@p580 decimal(18,2),@p581 decimal(18,2),@p582 nvarchar(4000),@p583 nvarchar(4000),@p584 decimal(18,2),@p585 nvarchar(4000),@p586 nvarchar(4000),@p587 nvarchar(4000),@p588 nvarchar(4000),@p589 int,@p590 nvarchar(4000),@p591 nvarchar(4000),@p592 nvarchar(4000),@p593 nvarchar(4000),@p594 nvarchar(4000),@p595 nvarchar(4000),@p596 nvarchar(4000),@p597 nvarchar(4000),@p598 nvarchar(4000),@p599 nvarchar(4000),@p600 int,@p601 nvarchar(4000),@p602 nvarchar(4000),@p603 nvarchar(4000),@p604 nvarchar(4000),@p605 nvarchar(4000),@p606 int,@p607 nvarchar(4000),@p608 int,@p609 int,@p610 datetime2(7),@p611 datetime2(7),@p612 datetime2(7),@p613 nvarchar(4000),@p614 nvarchar(4000),@p615 nvarchar(4000),@p616 nvarchar(4000),@p617 nvarchar(4000),@p618 nvarchar(4000),@p619 nvarchar(4000),@p620 nvarchar(4000),@p621 nvarchar(4000),@p622 nvarchar(4000),@p623 nvarchar(4000),@p624 nvarchar(4000),@p625 nvarchar(4000),@p626 nvarchar(4000),@p627 datetime2(7),@p628 nvarchar(4000),@p629 nvarchar(4000),@p630 int,@p631 int,@p632 int,@p633 nvarchar(4000),@p634 nvarchar(4000),@p635 nvarchar(4000),@p636 nvarchar(4000),@p637 decimal(18,2),@p638 nvarchar(4000),@p639 nvarchar(4000),@p640 decimal(18,2),@p641 nvarchar(4000),@p642 nvarchar(4000),@p643 nvarchar(4000),@p644 nvarchar(4000),@p645 int,@p646 nvarchar(4000),@p647 nvarchar(4000),@p648 nvarchar(4000),@p649 nvarchar(4000),@p650 nvarchar(4000),@p651 nvarchar(4000),@p652 nvarchar(4000),@p653 nvarchar(4000),@p654 nvarchar(4000),@p655 nvarchar(4000),@p656 int,@p657 nvarchar(4000),@p658 nvarchar(4000),@p659 nvarchar(4000),@p660 nvarchar(4000),@p661 nvarchar(4000),@p662 int,@p663 nvarchar(4000),@p664 int,@p665 int,@p666 datetime2(7),@p667 datetime2(7),@p668 datetime2(7),@p669 nvarchar(4000),@p670 nvarchar(4000),@p671 nvarchar(4000),@p672 nvarchar(4000),@p673 nvarchar(4000),@p674 nvarchar(4000),@p675 nvarchar(4000),@p676 nvarchar(4000),@p677 nvarchar(4000),@p678 nvarchar(4000),@p679 nvarchar(4000),@p680 nvarchar(4000),@p681 nvarchar(4000),@p682 nvarchar(4000),@p683 datetime2(7),@p684 nvarchar(4000),@p685 nvarchar(4000),@p686 int,@p687 int,@p688 int,@p689 nvarchar(4000),@p690 nvarchar(4000),@p691 nvarchar(4000),@p692 decimal(18,2),@p693 decimal(18,2),@p694 nvarchar(4000),@p695 nvarchar(4000),@p696 decimal(18,2),@p697 nvarchar(4000),@p698 nvarchar(4000),@p699 nvarchar(4000),@p700 nvarchar(4000),@p701 int,@p702 nvarchar(4000),@p703 nvarchar(4000),@p704 nvarchar(4000),@p705 nvarchar(4000),@p706 nvarchar(4000),@p707 nvarchar(4000),@p708 nvarchar(4000),@p709 nvarchar(4000),@p710 nvarchar(4000),@p711 nvarchar(4000),@p712 int,@p713 nvarchar(4000),@p714 nvarchar(4000),@p715 nvarchar(4000),@p716 nvarchar(4000),@p717 nvarchar(4000),@p718 int,@p719 nvarchar(4000),@p720 int,@p721 int,@p722 datetime2(7),@p723 datetime2(7),@p724 datetime2(7),@p725 nvarchar(4000),@p726 nvarchar(4000),@p727 nvarchar(4000),@p728 nvarchar(4000),@p729 nvarchar(4000),@p730 nvarchar(4000),@p731 nvarchar(4000),@p732 nvarchar(4000),@p733 nvarchar(4000),@p734 nvarchar(4000),@p735 nvarchar(4000),@p736 nvarchar(4000),@p737 nvarchar(4000),@p738 nvarchar(4000),@p739 datetime2(7),@p740 nvarchar(4000),@p741 nvarchar(4000),@p742 int,@p743 int,@p744 int,@p745 nvarchar(4000),@p746 nvarchar(4000),@p747 nvarchar(4000),@p748 nvarchar(4000),@p749 decimal(18,2),@p750 nvarchar(4000),@p751 nvarchar(4000),@p752 decimal(18,2),@p753 nvarchar(4000),@p754 nvarchar(4000),@p755 nvarchar(4000),@p756 nvarchar(4000),@p757 int,@p758 nvarchar(4000),@p759 nvarchar(4000),@p760 nvarchar(4000),@p761 nvarchar(4000),@p762 nvarchar(4000),@p763 nvarchar(4000),@p764 nvarchar(4000),@p765 nvarchar(4000),@p766 nvarchar(4000),@p767 nvarchar(4000),@p768 int,@p769 nvarchar(4000),@p770 nvarchar(4000),@p771 nvarchar(4000),@p772 nvarchar(4000),@p773 nvarchar(4000),@p774 int,@p775 nvarchar(4000),@p776 int,@p777 int,@p778 datetime2(7),@p779 datetime2(7),@p780 datetime2(7),@p781 nvarchar(4000),@p782 nvarchar(4000),@p783 nvarchar(4000),@p784 nvarchar(4000),@p785 nvarchar(4000),@p786 nvarchar(4000),@p787 nvarchar(4000),@p788 nvarchar(4000),@p789 nvarchar(4000),@p790 nvarchar(4000),@p791 nvarchar(4000),@p792 nvarchar(4000),@p793 nvarchar(4000),@p794 nvarchar(4000),@p795 datetime2(7),@p796 nvarchar(4000),@p797 nvarchar(4000),@p798 int,@p799 int,@p800 int,@p801 nvarchar(4000),@p802 nvarchar(4000),@p803 nvarchar(4000),@p804 decimal(18,2),@p805 decimal(18,2),@p806 nvarchar(4000),@p807 nvarchar(4000),@p808 decimal(18,2),@p809 nvarchar(4000),@p810 nvarchar(4000),@p811 nvarchar(4000),@p812 nvarchar(4000),@p813 int,@p814 nvarchar(4000),@p815 nvarchar(4000),@p816 nvarchar(4000),@p817 nvarchar(4000),@p818 nvarchar(4000),@p819 nvarchar(4000),@p820 nvarchar(4000),@p821 nvarchar(4000),@p822 nvarchar(4000),@p823 nvarchar(4000),@p824 int,@p825 nvarchar(4000),@p826 nvarchar(4000),@p827 nvarchar(4000),@p828 nvarchar(4000),@p829 nvarchar(4000),@p830 int,@p831 nvarchar(4000),@p832 int,@p833 int,@p834 datetime2(7),@p835 datetime2(7),@p836 datetime2(7),@p837 nvarchar(4000),@p838 nvarchar(4000),@p839 nvarchar(4000),@p840 nvarchar(4000),@p841 nvarchar(4000),@p842 nvarchar(4000),@p843 nvarchar(4000),@p844 nvarchar(4000),@p845 nvarchar(4000),@p846 nvarchar(4000),@p847 nvarchar(4000),@p848 nvarchar(4000),@p849 nvarchar(4000),@p850 nvarchar(4000),@p851 datetime2(7),@p852 nvarchar(4000),@p853 nvarchar(4000),@p854 int,@p855 int,@p856 int,@p857 nvarchar(4000),@p858 nvarchar(4000),@p859 nvarchar(4000),@p860 decimal(18,2),@p861 decimal(18,2),@p862 nvarchar(4000),@p863 nvarchar(4000),@p864 decimal(18,2),@p865 nvarchar(4000),@p866 nvarchar(4000),@p867 nvarchar(4000),@p868 nvarchar(4000),@p869 int,@p870 nvarchar(4000),@p871 nvarchar(4000),@p872 nvarchar(4000),@p873 nvarchar(4000),@p874 nvarchar(4000),@p875 nvarchar(4000),@p876 nvarchar(4000),@p877 nvarchar(4000),@p878 nvarchar(4000),@p879 nvarchar(4000),@p880 int,@p881 nvarchar(4000),@p882 nvarchar(4000),@p883 nvarchar(4000),@p884 nvarchar(4000),@p885 nvarchar(4000),@p886 int,@p887 nvarchar(4000),@p888 int,@p889 int,@p890 datetime2(7),@p891 datetime2(7),@p892 datetime2(7),@p893 nvarchar(4000),@p894 nvarchar(4000),@p895 nvarchar(4000),@p896 nvarchar(4000),@p897 nvarchar(4000),@p898 nvarchar(4000),@p899 nvarchar(4000),@p900 nvarchar(4000),@p901 nvarchar(4000),@p902 nvarchar(4000),@p903 nvarchar(4000),@p904 nvarchar(4000),@p905 nvarchar(4000),@p906 nvarchar(4000),@p907 datetime2(7),@p908 nvarchar(4000),@p909 nvarchar(4000),@p910 int,@p911 int,@p912 int,@p913 nvarchar(4000),@p914 nvarchar(4000),@p915 nvarchar(4000),@p916 decimal(18,2),@p917 decimal(18,2),@p918 nvarchar(4000),@p919 nvarchar(4000),@p920 decimal(18,2),@p921 nvarchar(4000),@p922 nvarchar(4000),@p923 nvarchar(4000),@p924 nvarchar(4000),@p925 int,@p926 nvarchar(4000),@p927 nvarchar(4000),@p928 nvarchar(4000),@p929 nvarchar(4000),@p930 nvarchar(4000),@p931 nvarchar(4000),@p932 nvarchar(4000),@p933 nvarchar(4000),@p934 nvarchar(4000),@p935 nvarchar(4000),@p936 int,@p937 nvarchar(4000),@p938 nvarchar(4000),@p939 nvarchar(4000),@p940 nvarchar(4000),@p941 nvarchar(4000),@p942 int,@p943 nvarchar(4000),@p944 int,@p945 int,@p946 datetime2(7),@p947 datetime2(7),@p948 datetime2(7),@p949 nvarchar(4000),@p950 nvarchar(4000),@p951 nvarchar(4000),@p952 nvarchar(4000),@p953 nvarchar(4000),@p954 nvarchar(4000),@p955 nvarchar(4000),@p956 nvarchar(4000),@p957 nvarchar(4000),@p958 nvarchar(4000),@p959 nvarchar(4000),@p960 nvarchar(4000),@p961 nvarchar(4000),@p962 nvarchar(4000),@p963 datetime2(7),@p964 nvarchar(4000),@p965 nvarchar(4000),@p966 int,@p967 int,@p968 int,@p969 nvarchar(4000),@p970 nvarchar(4000),@p971 nvarchar(4000),@p972 decimal(18,2),@p973 decimal(18,2),@p974 nvarchar(4000),@p975 nvarchar(4000),@p976 decimal(18,2),@p977 nvarchar(4000),@p978 nvarchar(4000),@p979 nvarchar(4000),@p980 nvarchar(4000),@p981 int,@p982 nvarchar(4000),@p983 nvarchar(4000),@p984 nvarchar(4000),@p985 nvarchar(4000),@p986 nvarchar(4000),@p987 nvarchar(4000),@p988 nvarchar(4000),@p989 nvarchar(4000),@p990 nvarchar(4000),@p991 nvarchar(4000),@p992 int,@p993 nvarchar(4000),@p994 nvarchar(4000),@p995 nvarchar(4000),@p996 nvarchar(4000),@p997 nvarchar(4000),@p998 int,@p999 nvarchar(4000),@p1000 int,@p1001 int,@p1002 datetime2(7),@p1003 datetime2(7),@p1004 datetime2(7),@p1005 nvarchar(4000),@p1006 nvarchar(4000),@p1007 nvarchar(4000),@p1008 nvarchar(4000),@p1009 nvarchar(4000),@p1010 nvarchar(4000),@p1011 nvarchar(4000),@p1012 nvarchar(4000),@p1013 nvarchar(4000),@p1014 nvarchar(4000),@p1015 nvarchar(4000),@p1016 nvarchar(4000),@p1017 nvarchar(4000),@p1018 nvarchar(4000),@p1019 datetime2(7),@p1020 nvarchar(4000),@p1021 nvarchar(4000),@p1022 int,@p1023 int,@p1024 int,@p1025 nvarchar(4000),@p1026 nvarchar(4000),@p1027 nvarchar(4000),@p1028 decimal(18,2),@p1029 decimal(18,2),@p1030 nvarchar(4000),@p1031 nvarchar(4000),@p1032 decimal(18,2),@p1033 nvarchar(4000),@p1034 nvarchar(4000),@p1035 nvarchar(4000),@p1036 nvarchar(4000),@p1037 int,@p1038 nvarchar(4000),@p1039 nvarchar(4000),@p1040 nvarchar(4000),@p1041 nvarchar(4000),@p1042 nvarchar(4000),@p1043 nvarchar(4000),@p1044 nvarchar(4000),@p1045 nvarchar(4000),@p1046 nvarchar(4000),@p1047 nvarchar(4000),@p1048 int,@p1049 nvarchar(4000),@p1050 nvarchar(4000),@p1051 nvarchar(4000),@p1052 nvarchar(4000),@p1053 nvarchar(4000),@p1054 int,@p1055 nvarchar(4000),@p1056 int,@p1057 int,@p1058 datetime2(7),@p1059 datetime2(7),@p1060 datetime2(7),@p1061 nvarchar(4000),@p1062 nvarchar(4000),@p1063 nvarchar(4000),@p1064 nvarchar(4000),@p1065 nvarchar(4000),@p1066 nvarchar(4000),@p1067 nvarchar(4000),@p1068 nvarchar(4000),@p1069 nvarchar(4000),@p1070 nvarchar(4000),@p1071 nvarchar(4000),@p1072 nvarchar(4000),@p1073 nvarchar(4000),@p1074 nvarchar(4000),@p1075 datetime2(7),@p1076 nvarchar(4000),@p1077 nvarchar(4000),@p1078 int,@p1079 int,@p1080 int,@p1081 nvarchar(4000),@p1082 nvarchar(4000),@p1083 nvarchar(4000),@p1084 decimal(18,2),@p1085 decimal(18,2),@p1086 nvarchar(4000),@p1087 nvarchar(4000),@p1088 decimal(18,2),@p1089 nvarchar(4000),@p1090 nvarchar(4000),@p1091 nvarchar(4000),@p1092 nvarchar(4000),@p1093 int,@p1094 nvarchar(4000),@p1095 nvarchar(4000),@p1096 nvarchar(4000),@p1097 nvarchar(4000),@p1098 nvarchar(4000),@p1099 nvarchar(4000),@p1100 nvarchar(4000),@p1101 nvarchar(4000),@p1102 nvarchar(4000),@p1103 nvarchar(4000),@p1104 int,@p1105 nvarchar(4000),@p1106 nvarchar(4000),@p1107 nvarchar(4000),@p1108 nvarchar(4000),@p1109 nvarchar(4000),@p1110 int,@p1111 nvarchar(4000),@p1112 int,@p1113 int,@p1114 datetime2(7),@p1115 datetime2(7),@p1116 datetime2(7),@p1117 nvarchar(4000),@p1118 nvarchar(4000),@p1119 nvarchar(4000),@p1120 nvarchar(4000),@p1121 nvarchar(4000),@p1122 nvarchar(4000),@p1123 nvarchar(4000),@p1124 nvarchar(4000),@p1125 nvarchar(4000),@p1126 nvarchar(4000),@p1127 nvarchar(4000),@p1128 nvarchar(4000),@p1129 nvarchar(4000),@p1130 nvarchar(4000),@p1131 datetime2(7),@p1132 nvarchar(4000),@p1133 nvarchar(4000),@p1134 int,@p1135 int,@p1136 int,@p1137 nvarchar(4000),@p1138 nvarchar(4000),@p1139 nvarchar(4000),@p1140 decimal(18,2),@p1141 decimal(18,2),@p1142 nvarchar(4000),@p1143 nvarchar(4000),@p1144 decimal(18,2),@p1145 nvarchar(4000),@p1146 nvarchar(4000),@p1147 nvarchar(4000),@p1148 nvarchar(4000),@p1149 int,@p1150 nvarchar(4000),@p1151 nvarchar(4000),@p1152 nvarchar(4000),@p1153 nvarchar(4000),@p1154 nvarchar(4000),@p1155 nvarchar(4000),@p1156 nvarchar(4000),@p1157 nvarchar(4000),@p1158 nvarchar(4000),@p1159 nvarchar(4000),@p1160 int,@p1161 nvarchar(4000),@p1162 nvarchar(4000),@p1163 nvarchar(4000),@p1164 nvarchar(4000),@p1165 nvarchar(4000),@p1166 int,@p1167 nvarchar(4000),@p1168 int,@p1169 int,@p1170 datetime2(7),@p1171 datetime2(7),@p1172 datetime2(7),@p1173 nvarchar(4000),@p1174 nvarchar(4000),@p1175 nvarchar(4000),@p1176 nvarchar(4000),@p1177 nvarchar(4000),@p1178 nvarchar(4000),@p1179 nvarchar(4000),@p1180 nvarchar(4000),@p1181 nvarchar(4000),@p1182 nvarchar(4000),@p1183 nvarchar(4000),@p1184 nvarchar(4000),@p1185 nvarchar(4000),@p1186 nvarchar(4000),@p1187 datetime2(7),@p1188 nvarchar(4000),@p1189 nvarchar(4000),@p1190 int,@p1191 int,@p1192 int,@p1193 nvarchar(4000),@p1194 nvarchar(4000),@p1195 nvarchar(4000),@p1196 decimal(18,2),@p1197 decimal(18,2),@p1198 nvarchar(4000),@p1199 nvarchar(4000),@p1200 decimal(18,2),@p1201 nvarchar(4000),@p1202 nvarchar(4000),@p1203 nvarchar(4000),@p1204 nvarchar(4000),@p1205 int,@p1206 nvarchar(4000),@p1207 nvarchar(4000),@p1208 nvarchar(4000),@p1209 nvarchar(4000),@p1210 nvarchar(4000),@p1211 nvarchar(4000),@p1212 nvarchar(4000),@p1213 nvarchar(4000),@p1214 nvarchar(4000),@p1215 nvarchar(4000),@p1216 int,@p1217 nvarchar(4000),@p1218 nvarchar(4000),@p1219 nvarchar(4000),@p1220 nvarchar(4000),@p1221 nvarchar(4000),@p1222 int,@p1223 nvarchar(4000),@p1224 int,@p1225 int,@p1226 datetime2(7),@p1227 datetime2(7),@p1228 datetime2(7),@p1229 nvarchar(4000),@p1230 nvarchar(4000),@p1231 nvarchar(4000),@p1232 nvarchar(4000),@p1233 nvarchar(4000),@p1234 nvarchar(4000),@p1235 nvarchar(4000),@p1236 nvarchar(4000),@p1237 nvarchar(4000),@p1238 nvarchar(4000),@p1239 nvarchar(4000),@p1240 nvarchar(4000),@p1241 nvarchar(4000),@p1242 nvarchar(4000),@p1243 datetime2(7),@p1244 nvarchar(4000),@p1245 nvarchar(4000),@p1246 int,@p1247 int,@p1248 int,@p1249 nvarchar(4000),@p1250 nvarchar(4000),@p1251 nvarchar(4000),@p1252 nvarchar(4000),@p1253 decimal(18,2),@p1254 nvarchar(4000),@p1255 nvarchar(4000),@p1256 decimal(18,2),@p1257 nvarchar(4000),@p1258 nvarchar(4000),@p1259 nvarchar(4000),@p1260 nvarchar(4000),@p1261 int,@p1262 nvarchar(4000),@p1263 nvarchar(4000),@p1264 nvarchar(4000),@p1265 nvarchar(4000),@p1266 nvarchar(4000),@p1267 nvarchar(4000),@p1268 nvarchar(4000),@p1269 nvarchar(4000),@p1270 nvarchar(4000),@p1271 nvarchar(4000),@p1272 int,@p1273 nvarchar(4000),@p1274 nvarchar(4000),@p1275 nvarchar(4000),@p1276 nvarchar(4000),@p1277 nvarchar(4000),@p1278 int,@p1279 nvarchar(4000),@p1280 int,@p1281 int,@p1282 datetime2(7),@p1283 datetime2(7),@p1284 datetime2(7),@p1285 nvarchar(4000),@p1286 nvarchar(4000),@p1287 nvarchar(4000),@p1288 nvarchar(4000),@p1289 nvarchar(4000),@p1290 nvarchar(4000),@p1291 nvarchar(4000),@p1292 nvarchar(4000),@p1293 nvarchar(4000),@p1294 nvarchar(4000),@p1295 nvarchar(4000),@p1296 nvarchar(4000),@p1297 nvarchar(4000),@p1298 nvarchar(4000),@p1299 datetime2(7),@p1300 nvarchar(4000),@p1301 nvarchar(4000),@p1302 int,@p1303 int,@p1304 int,@p1305 nvarchar(4000),@p1306 nvarchar(4000),@p1307 nvarchar(4000),@p1308 nvarchar(4000),@p1309 decimal(18,2),@p1310 nvarchar(4000),@p1311 nvarchar(4000),@p1312 decimal(18,2),@p1313 nvarchar(4000),@p1314 nvarchar(4000),@p1315 nvarchar(4000),@p1316 nvarchar(4000),@p1317 int,@p1318 nvarchar(4000),@p1319 nvarchar(4000),@p1320 nvarchar(4000),@p1321 nvarchar(4000),@p1322 nvarchar(4000),@p1323 nvarchar(4000),@p1324 nvarchar(4000),@p1325 nvarchar(4000),@p1326 nvarchar(4000),@p1327 nvarchar(4000),@p1328 int,@p1329 nvarchar(4000),@p1330 nvarchar(4000),@p1331 nvarchar(4000),@p1332 nvarchar(4000),@p1333 nvarchar(4000),@p1334 int,@p1335 nvarchar(4000),@p1336 int,@p1337 int,@p1338 datetime2(7),@p1339 datetime2(7),@p1340 datetime2(7),@p1341 nvarchar(4000),@p1342 nvarchar(4000),@p1343 nvarchar(4000),@p1344 nvarchar(4000),@p1345 nvarchar(4000),@p1346 nvarchar(4000),@p1347 nvarchar(4000),@p1348 nvarchar(4000),@p1349 nvarchar(4000),@p1350 nvarchar(4000),@p1351 nvarchar(4000),@p1352 nvarchar(4000),@p1353 nvarchar(4000),@p1354 nvarchar(4000),@p1355 datetime2(7),@p1356 nvarchar(4000),@p1357 nvarchar(4000),@p1358 int,@p1359 int,@p1360 int,@p1361 nvarchar(4000),@p1362 nvarchar(4000),@p1363 nvarchar(4000),@p1364 nvarchar(4000),@p1365 decimal(18,2),@p1366 nvarchar(4000),@p1367 nvarchar(4000),@p1368 decimal(18,2),@p1369 nvarchar(4000),@p1370 nvarchar(4000),@p1371 nvarchar(4000),@p1372 nvarchar(4000),@p1373 int,@p1374 nvarchar(4000),@p1375 nvarchar(4000),@p1376 nvarchar(4000),@p1377 nvarchar(4000),@p1378 nvarchar(4000),@p1379 nvarchar(4000),@p1380 nvarchar(4000),@p1381 nvarchar(4000),@p1382 nvarchar(4000),@p1383 nvarchar(4000),@p1384 int,@p1385 nvarchar(4000),@p1386 nvarchar(4000),@p1387 nvarchar(4000),@p1388 nvarchar(4000),@p1389 nvarchar(4000),@p1390 int,@p1391 nvarchar(4000),@p1392 int,@p1393 int,@p1394 datetime2(7),@p1395 datetime2(7),@p1396 datetime2(7),@p1397 nvarchar(4000),@p1398 nvarchar(4000),@p1399 nvarchar(4000),@p1400 nvarchar(4000),@p1401 nvarchar(4000),@p1402 nvarchar(4000),@p1403 nvarchar(4000),@p1404 nvarchar(4000),@p1405 nvarchar(4000),@p1406 nvarchar(4000),@p1407 nvarchar(4000),@p1408 nvarchar(4000),@p1409 nvarchar(4000),@p1410 nvarchar(4000),@p1411 datetime2(7),@p1412 nvarchar(4000),@p1413 nvarchar(4000),@p1414 int,@p1415 int,@p1416 int,@p1417 nvarchar(4000),@p1418 nvarchar(4000),@p1419 nvarchar(4000),@p1420 nvarchar(4000),@p1421 decimal(18,2),@p1422 nvarchar(4000),@p1423 nvarchar(4000),@p1424 decimal(18,2),@p1425 nvarchar(4000),@p1426 nvarchar(4000),@p1427 nvarchar(4000),@p1428 nvarchar(4000),@p1429 int,@p1430 nvarchar(4000),@p1431 nvarchar(4000),@p1432 nvarchar(4000),@p1433 nvarchar(4000),@p1434 nvarchar(4000),@p1435 nvarchar(4000),@p1436 nvarchar(4000),@p1437 nvarchar(4000),@p1438 nvarchar(4000),@p1439 nvarchar(4000),@p1440 int,@p1441 nvarchar(4000),@p1442 nvarchar(4000),@p1443 nvarchar(4000),@p1444 nvarchar(4000),@p1445 nvarchar(4000),@p1446 int,@p1447 nvarchar(4000),@p1448 int,@p1449 int,@p1450 datetime2(7),@p1451 datetime2(7),@p1452 datetime2(7),@p1453 nvarchar(4000),@p1454 nvarchar(4000),@p1455 nvarchar(4000),@p1456 nvarchar(4000),@p1457 nvarchar(4000),@p1458 nvarchar(4000),@p1459 nvarchar(4000),@p1460 nvarchar(4000),@p1461 nvarchar(4000),@p1462 nvarchar(4000),@p1463 nvarchar(4000),@p1464 nvarchar(4000),@p1465 nvarchar(4000),@p1466 nvarchar(4000),@p1467 datetime2(7),@p1468 nvarchar(4000),@p1469 nvarchar(4000),@p1470 int,@p1471 int,@p1472 int,@p1473 nvarchar(4000),@p1474 nvarchar(4000),@p1475 nvarchar(4000),@p1476 decimal(18,2),@p1477 decimal(18,2),@p1478 nvarchar(4000),@p1479 nvarchar(4000),@p1480 decimal(18,2),@p1481 nvarchar(4000),@p1482 nvarchar(4000),@p1483 nvarchar(4000),@p1484 nvarchar(4000),@p1485 int,@p1486 nvarchar(4000),@p1487 nvarchar(4000),@p1488 nvarchar(4000),@p1489 nvarchar(4000),@p1490 nvarchar(4000),@p1491 nvarchar(4000),@p1492 nvarchar(4000),@p1493 nvarchar(4000),@p1494 nvarchar(4000),@p1495 nvarchar(4000),@p1496 int,@p1497 nvarchar(4000),@p1498 nvarchar(4000),@p1499 nvarchar(4000),@p1500 nvarchar(4000),@p1501 nvarchar(4000),@p1502 int,@p1503 nvarchar(4000),@p1504 int,@p1505 int,@p1506 datetime2(7),@p1507 datetime2(7),@p1508 datetime2(7),@p1509 nvarchar(4000),@p1510 nvarchar(4000),@p1511 nvarchar(4000),@p1512 nvarchar(4000),@p1513 nvarchar(4000),@p1514 nvarchar(4000),@p1515 nvarchar(4000),@p1516 nvarchar(4000),@p1517 nvarchar(4000),@p1518 nvarchar(4000),@p1519 nvarchar(4000),@p1520 nvarchar(4000),@p1521 nvarchar(4000),@p1522 nvarchar(4000),@p1523 datetime2(7),@p1524 nvarchar(4000),@p1525 nvarchar(4000),@p1526 int,@p1527 int,@p1528 int,@p1529 nvarchar(4000),@p1530 nvarchar(4000),@p1531 nvarchar(4000),@p1532 decimal(18,2),@p1533 decimal(18,2),@p1534 nvarchar(4000),@p1535 nvarchar(4000),@p1536 decimal(18,2),@p1537 nvarchar(4000),@p1538 nvarchar(4000),@p1539 nvarchar(4000),@p1540 nvarchar(4000),@p1541 int,@p1542 nvarchar(4000),@p1543 nvarchar(4000),@p1544 nvarchar(4000),@p1545 nvarchar(4000),@p1546 nvarchar(4000),@p1547 nvarchar(4000),@p1548 nvarchar(4000),@p1549 nvarchar(4000),@p1550 nvarchar(4000),@p1551 nvarchar(4000),@p1552 int,@p1553 nvarchar(4000),@p1554 nvarchar(4000),@p1555 nvarchar(4000),@p1556 nvarchar(4000),@p1557 nvarchar(4000),@p1558 int,@p1559 nvarchar(4000),@p1560 int,@p1561 int,@p1562 datetime2(7),@p1563 datetime2(7),@p1564 datetime2(7),@p1565 nvarchar(4000),@p1566 nvarchar(4000),@p1567 nvarchar(4000),@p1568 nvarchar(4000),@p1569 nvarchar(4000),@p1570 nvarchar(4000),@p1571 nvarchar(4000),@p1572 nvarchar(4000),@p1573 nvarchar(4000),@p1574 nvarchar(4000),@p1575 nvarchar(4000),@p1576 nvarchar(4000),@p1577 nvarchar(4000),@p1578 nvarchar(4000),@p1579 datetime2(7),@p1580 nvarchar(4000),@p1581 nvarchar(4000),@p1582 int,@p1583 int,@p1584 int,@p1585 nvarchar(4000),@p1586 nvarchar(4000),@p1587 nvarchar(4000),@p1588 decimal(18,2),@p1589 decimal(18,2),@p1590 nvarchar(4000),@p1591 nvarchar(4000),@p1592 decimal(18,2),@p1593 nvarchar(4000),@p1594 nvarchar(4000),@p1595 nvarchar(4000),@p1596 nvarchar(4000),@p1597 int,@p1598 nvarchar(4000),@p1599 nvarchar(4000),@p1600 nvarchar(4000),@p1601 nvarchar(4000),@p1602 nvarchar(4000),@p1603 nvarchar(4000),@p1604 nvarchar(4000),@p1605 nvarchar(4000),@p1606 nvarchar(4000),@p1607 nvarchar(4000),@p1608 int,@p1609 nvarchar(4000),@p1610 nvarchar(4000),@p1611 nvarchar(4000),@p1612 nvarchar(4000),@p1613 nvarchar(4000),@p1614 int,@p1615 nvarchar(4000),@p1616 int,@p1617 int,@p1618 datetime2(7),@p1619 datetime2(7),@p1620 datetime2(7),@p1621 nvarchar(4000),@p1622 nvarchar(4000),@p1623 nvarchar(4000),@p1624 nvarchar(4000),@p1625 nvarchar(4000),@p1626 nvarchar(4000),@p1627 nvarchar(4000),@p1628 nvarchar(4000),@p1629 nvarchar(4000),@p1630 nvarchar(4000),@p1631 nvarchar(4000),@p1632 nvarchar(4000),@p1633 nvarchar(4000),@p1634 nvarchar(4000),@p1635 datetime2(7),@p1636 nvarchar(4000),@p1637 nvarchar(4000),@p1638 int,@p1639 int,@p1640 int,@p1641 nvarchar(4000),@p1642 nvarchar(4000),@p1643 nvarchar(4000),@p1644 decimal(18,2),@p1645 decimal(18,2),@p1646 nvarchar(4000),@p1647 nvarchar(4000),@p1648 decimal(18,2),@p1649 nvarchar(4000),@p1650 nvarchar(4000),@p1651 nvarchar(4000),@p1652 nvarchar(4000),@p1653 int,@p1654 nvarchar(4000),@p1655 nvarchar(4000),@p1656 nvarchar(4000),@p1657 nvarchar(4000),@p1658 nvarchar(4000),@p1659 nvarchar(4000),@p1660 nvarchar(4000),@p1661 nvarchar(4000),@p1662 nvarchar(4000),@p1663 nvarchar(4000),@p1664 int,@p1665 nvarchar(4000),@p1666 nvarchar(4000),@p1667 nvarchar(4000),@p1668 nvarchar(4000),@p1669 nvarchar(4000),@p1670 int,@p1671 nvarchar(4000),@p1672 int,@p1673 int,@p1674 datetime2(7),@p1675 datetime2(7),@p1676 datetime2(7),@p1677 nvarchar(4000),@p1678 nvarchar(4000),@p1679 nvarchar(4000),@p1680 nvarchar(4000),@p1681 nvarchar(4000),@p1682 nvarchar(4000),@p1683 nvarchar(4000),@p1684 nvarchar(4000),@p1685 nvarchar(4000),@p1686 nvarchar(4000),@p1687 nvarchar(4000),@p1688 nvarchar(4000),@p1689 nvarchar(4000),@p1690 nvarchar(4000),@p1691 datetime2(7),@p1692 nvarchar(4000),@p1693 nvarchar(4000),@p1694 int,@p1695 int,@p1696 int,@p1697 nvarchar(4000),@p1698 nvarchar(4000),@p1699 nvarchar(4000),@p1700 decimal(18,2),@p1701 decimal(18,2),@p1702 nvarchar(4000),@p1703 nvarchar(4000),@p1704 decimal(18,2),@p1705 nvarchar(4000),@p1706 nvarchar(4000),@p1707 nvarchar(4000),@p1708 nvarchar(4000),@p1709 int,@p1710 nvarchar(4000),@p1711 nvarchar(4000),@p1712 nvarchar(4000),@p1713 nvarchar(4000),@p1714 nvarchar(4000),@p1715 nvarchar(4000),@p1716 nvarchar(4000),@p1717 nvarchar(4000),@p1718 nvarchar(4000),@p1719 nvarchar(4000),@p1720 int,@p1721 nvarchar(4000),@p1722 nvarchar(4000),@p1723 nvarchar(4000),@p1724 nvarchar(4000),@p1725 nvarchar(4000),@p1726 int,@p1727 nvarchar(4000),@p1728 int,@p1729 int,@p1730 datetime2(7),@p1731 datetime2(7),@p1732 datetime2(7),@p1733 nvarchar(4000),@p1734 nvarchar(4000),@p1735 nvarchar(4000),@p1736 nvarchar(4000),@p1737 nvarchar(4000),@p1738 nvarchar(4000),@p1739 nvarchar(4000),@p1740 nvarchar(4000),@p1741 nvarchar(4000),@p1742 nvarchar(4000),@p1743 nvarchar(4000),@p1744 nvarchar(4000),@p1745 nvarchar(4000),@p1746 nvarchar(4000),@p1747 datetime2(7),@p1748 nvarchar(4000),@p1749 nvarchar(4000),@p1750 int,@p1751 int,@p1752 int,@p1753 nvarchar(4000),@p1754 nvarchar(4000),@p1755 nvarchar(4000),@p1756 decimal(18,2),@p1757 decimal(18,2),@p1758 nvarchar(4000),@p1759 nvarchar(4000),@p1760 decimal(18,2),@p1761 nvarchar(4000),@p1762 nvarchar(4000),@p1763 nvarchar(4000),@p1764 nvarchar(4000),@p1765 int,@p1766 nvarchar(4000),@p1767 nvarchar(4000),@p1768 nvarchar(4000),@p1769 nvarchar(4000),@p1770 nvarchar(4000),@p1771 nvarchar(4000),@p1772 nvarchar(4000),@p1773 nvarchar(4000),@p1774 nvarchar(4000),@p1775 nvarchar(4000),@p1776 int,@p1777 nvarchar(4000),@p1778 nvarchar(4000),@p1779 nvarchar(4000),@p1780 nvarchar(4000),@p1781 nvarchar(4000),@p1782 int,@p1783 nvarchar(4000),@p1784 int,@p1785 int,@p1786 datetime2(7),@p1787 datetime2(7),@p1788 datetime2(7),@p1789 nvarchar(4000),@p1790 nvarchar(4000),@p1791 nvarchar(4000),@p1792 nvarchar(4000),@p1793 nvarchar(4000),@p1794 nvarchar(4000),@p1795 nvarchar(4000),@p1796 nvarchar(4000),@p1797 nvarchar(4000),@p1798 nvarchar(4000),@p1799 nvarchar(4000),@p1800 nvarchar(4000),@p1801 nvarchar(4000),@p1802 nvarchar(4000),@p1803 datetime2(7),@p1804 nvarchar(4000),@p1805 nvarchar(4000),@p1806 int,@p1807 int,@p1808 int,@p1809 nvarchar(4000),@p1810 nvarchar(4000),@p1811 nvarchar(4000),@p1812 decimal(18,2),@p1813 decimal(18,2),@p1814 nvarchar(4000),@p1815 nvarchar(4000),@p1816 decimal(18,2),@p1817 nvarchar(4000),@p1818 nvarchar(4000),@p1819 nvarchar(4000),@p1820 nvarchar(4000),@p1821 int,@p1822 nvarchar(4000),@p1823 nvarchar(4000),@p1824 nvarchar(4000),@p1825 nvarchar(4000),@p1826 nvarchar(4000),@p1827 nvarchar(4000),@p1828 nvarchar(4000),@p1829 nvarchar(4000),@p1830 nvarchar(4000),@p1831 nvarchar(4000),@p1832 int,@p1833 nvarchar(4000),@p1834 nvarchar(4000),@p1835 nvarchar(4000),@p1836 nvarchar(4000),@p1837 nvarchar(4000),@p1838 int,@p1839 nvarchar(4000),@p1840 int,@p1841 int,@p1842 datetime2(7),@p1843 datetime2(7),@p1844 datetime2(7),@p1845 nvarchar(4000),@p1846 nvarchar(4000),@p1847 nvarchar(4000),@p1848 nvarchar(4000),@p1849 nvarchar(4000),@p1850 nvarchar(4000),@p1851 nvarchar(4000),@p1852 nvarchar(4000),@p1853 nvarchar(4000),@p1854 nvarchar(4000),@p1855 nvarchar(4000),@p1856 nvarchar(4000),@p1857 nvarchar(4000),@p1858 nvarchar(4000),@p1859 datetime2(7),@p1860 nvarchar(4000),@p1861 nvarchar(4000),@p1862 int,@p1863 int,@p1864 int,@p1865 nvarchar(4000),@p1866 nvarchar(4000),@p1867 nvarchar(4000),@p1868 decimal(18,2),@p1869 decimal(18,2),@p1870 nvarchar(4000),@p1871 nvarchar(4000),@p1872 decimal(18,2),@p1873 nvarchar(4000),@p1874 nvarchar(4000),@p1875 nvarchar(4000),@p1876 nvarchar(4000),@p1877 int,@p1878 nvarchar(4000),@p1879 nvarchar(4000),@p1880 nvarchar(4000),@p1881 nvarchar(4000),@p1882 nvarchar(4000),@p1883 nvarchar(4000),@p1884 nvarchar(4000),@p1885 nvarchar(4000),@p1886 nvarchar(4000),@p1887 nvarchar(4000),@p1888 int,@p1889 nvarchar(4000),@p1890 nvarchar(4000),@p1891 nvarchar(4000),@p1892 nvarchar(4000),@p1893 nvarchar(4000),@p1894 int,@p1895 nvarchar(4000),@p1896 int,@p1897 int,@p1898 datetime2(7),@p1899 datetime2(7),@p1900 datetime2(7),@p1901 nvarchar(4000),@p1902 nvarchar(4000),@p1903 nvarchar(4000),@p1904 nvarchar(4000),@p1905 nvarchar(4000),@p1906 nvarchar(4000),@p1907 nvarchar(4000),@p1908 nvarchar(4000),@p1909 nvarchar(4000),@p1910 nvarchar(4000),@p1911 nvarchar(4000),@p1912 nvarchar(4000),@p1913 nvarchar(4000),@p1914 nvarchar(4000),@p1915 datetime2(7),@p1916 nvarchar(4000),@p1917 nvarchar(4000),@p1918 int,@p1919 int,@p1920 int,@p1921 nvarchar(4000),@p1922 nvarchar(4000),@p1923 nvarchar(4000),@p1924 nvarchar(4000),@p1925 decimal(18,2),@p1926 nvarchar(4000),@p1927 nvarchar(4000),@p1928 decimal(18,2),@p1929 nvarchar(4000),@p1930 nvarchar(4000),@p1931 nvarchar(4000),@p1932 nvarchar(4000),@p1933 int,@p1934 nvarchar(4000),@p1935 nvarchar(4000),@p1936 nvarchar(4000),@p1937 nvarchar(4000),@p1938 nvarchar(4000),@p1939 nvarchar(4000),@p1940 nvarchar(4000),@p1941 nvarchar(4000),@p1942 nvarchar(4000),@p1943 nvarchar(4000),@p1944 int,@p1945 nvarchar(4000),@p1946 nvarchar(4000),@p1947 nvarchar(4000),@p1948 nvarchar(4000),@p1949 nvarchar(4000),@p1950 int,@p1951 nvarchar(4000),@p1952 int,@p1953 int,@p1954 datetime2(7),@p1955 datetime2(7),@p1956 datetime2(7),@p1957 nvarchar(4000),@p1958 nvarchar(4000),@p1959 nvarchar(4000),@p1960 nvarchar(4000),@p1961 nvarchar(4000),@p1962 nvarchar(4000),@p1963 nvarchar(4000),@p1964 nvarchar(4000),@p1965 nvarchar(4000),@p1966 nvarchar(4000),@p1967 nvarchar(4000),@p1968 nvarchar(4000),@p1969 nvarchar(4000),@p1970 nvarchar(4000),@p1971 datetime2(7),@p1972 nvarchar(4000),@p1973 nvarchar(4000),@p1974 int,@p1975 int,@p1976 int,@p1977 nvarchar(4000),@p1978 nvarchar(4000),@p1979 nvarchar(4000),@p1980 nvarchar(4000),@p1981 decimal(18,2),@p1982 nvarchar(4000),@p1983 nvarchar(4000),@p1984 decimal(18,2),@p1985 nvarchar(4000),@p1986 nvarchar(4000),@p1987 nvarchar(4000),@p1988 nvarchar(4000),@p1989 int,@p1990 nvarchar(4000),@p1991 nvarchar(4000),@p1992 nvarchar(4000),@p1993 nvarchar(4000),@p1994 nvarchar(4000),@p1995 nvarchar(4000),@p1996 nvarchar(4000),@p1997 nvarchar(4000),@p1998 nvarchar(4000),@p1999 nvarchar(4000),@p2000 int,@p2001 nvarchar(4000),@p2002 nvarchar(4000),@p2003 nvarchar(4000),@p2004 nvarchar(4000),@p2005 nvarchar(4000),@p2006 int,@p2007 nvarchar(4000),@p2008 int,@p2009 int,@p2010 datetime2(7),@p2011 datetime2(7),@p2012 datetime2(7),@p2013 nvarchar(4000),@p2014 nvarchar(4000),@p2015 nvarchar(4000),@p2016 nvarchar(4000),@p2017 nvarchar(4000),@p2018 nvarchar(4000),@p2019 nvarchar(4000),@p2020 nvarchar(4000),@p2021 nvarchar(4000),@p2022 nvarchar(4000),@p2023 nvarchar(4000),@p2024 nvarchar(4000),@p2025 nvarchar(4000),@p2026 nvarchar(4000),@p2027 datetime2(7),@p2028 nvarchar(4000),@p2029 nvarchar(4000),@p2030 int,@p2031 int,@p2032 int,@p2033 nvarchar(4000),@p2034 nvarchar(4000),@p2035 nvarchar(4000),@p2036 nvarchar(4000),@p2037 decimal(18,2),@p2038 nvarchar(4000),@p2039 nvarchar(4000),@p2040 decimal(18,2),@p2041 nvarchar(4000),@p2042 nvarchar(4000),@p2043 nvarchar(4000),@p2044 nvarchar(4000),@p2045 int,@p2046 nvarchar(4000),@p2047 nvarchar(4000),@p2048 nvarchar(4000),@p2049 nvarchar(4000),@p2050 nvarchar(4000),@p2051 nvarchar(4000),@p2052 nvarchar(4000),@p2053 nvarchar(4000),@p2054 nvarchar(4000),@p2055 nvarchar(4000),@p2056 int,@p2057 nvarchar(4000),@p2058 nvarchar(4000),@p2059 nvarchar(4000),@p2060 nvarchar(4000),@p2061 nvarchar(4000),@p2062 int,@p2063 nvarchar(4000),@p2064 int,@p2065 int,@p2066 datetime2(7),@p2067 datetime2(7),@p2068 datetime2(7),@p2069 nvarchar(4000),@p2070 nvarchar(4000),@p2071 nvarchar(4000))SET NOCOUNT ON; DECLARE @inserted0 TABLE ([item_id] int, [_Position] [int]); MERGE [raw_data] USING ( VALUES (@p0, @p1, @p2, @p3, @p4, @p5, @p6, @p7, @p8, @p9, @p10, @p11, @p12, @p13, @p14, @p15, @p16, @p17, @p18, @p19, @p20, @p21, @p22, @p23, @p24, @p25, @p26, @p27, @p28, @p29, @p30, @p31, @p32, @p33, @p34, @p35, @p36, @p37, @p38, @p39, @p40, @p41, @p42, @p43, @p44, @p45, @p46, @p47, @p48, @p49, @p50, @p51, @p52, @p53, @p54, @p55, 0), (@p56, @p57, @p58, @p59, @p60, @p61, @p62, @p63, @p64, @p65, @p66, @p67, @p68, @p69, @p70, @p71, @p72, @p73, @p74, @p75, @p76, @p77, @p78, @p79, @p80, @p81, @p82, @p83, @p84, @p85, @p86, @p87, @p88, @p89, @p90, @p91, @p92, @p93, @p94, @p95, @p96, @p97, @p98, @p99, @p100, @p101, @p102, @p103, @p104, @p105, @p106, @p107, @p108, @p109, @p110, @p111, 1), (@p112, @p113, @p114, @p115, @p116, @p117, @p118, @p119, @p120, @p121, @p122, @p123, @p124, @p125, @p126, @p127, @p128, @p129, @p130, @p131, @p132, @p133, @p134, @p135, @p136, @p137, @p138, @p139, @p140, @p141, @p142, @p143, @p144, @p145, @p146, @p147, @p148, @p149, @p150, @p151, @p152, @p153, @p154, @p155, @p156, @p157, @p158, @p159, @p160, @p161, @p162, @p163, @p164, @p165, @p166, @p167, 2), (@p168, @p169, @p170, @p171, @p172, @p173, @p174, @p175, @p176, @p177, @p178, @p179, @p180, @p181, @p182, @p183, @p184, @p185, @p186, @p187, @p188, @p189, @p190, @p191, @p192, @p193, @p194, @p195, @p196, @p197, @p198, @p199, @p200, @p201, @p202, @p203, @p204, @p205, @p206, @p207, @p208, @p209, @p210, @p211, @p212, @p213, @p214, @p215, @p216, @p217, @p218, @p219, @p220, @p221, @p222, @p223, 3), (@p224, @p225, @p226, @p227, @p228, @p229, @p230, @p231, @p232, @p233, @p234, @p235, @p236, @p237, @p238, @p239, @p240, @p241, @p242, @p243, @p244, @p245, @p246, @p247, @p248, @p249, @p250, @p251, @p252, @p253, @p254, @p255, @p256, @p257, @p258, @p259, @p260, @p261, @p262, @p263, @p264, @p265, @p266, @p267, @p268, @p269, @p270, @p271, @p272, @p273, @p274, @p275, @p276, @p277, @p278, @p279, 4), (@p280, @p281, @p282, @p283, @p284, @p285, @p286, @p287, @p288, @p289, @p290, @p291, @p292, @p293, @p294, @p295, @p296, @p297, @p298, @p299, @p300, @p301, @p302, @p303, @p304, @p305, @p306, @p307, @p308, @p309, @p310, @p311, @p312, @p313, @p314, @p315, @p316, @p317, @p318, @p319, @p320, @p321, @p322, @p323, @p324, @p325, @p326, @p327, @p328, @p329, @p330, @p331, @p332, @p333, @p334, @p335, 5), (@p336, @p337, @p338, @p339, @p340, @p341, @p342, @p343, @p344, @p345, @p346, @p347, @p348, @p349, @p350, @p351, @p352, @p353, @p354, @p355, @p356, @p357, @p358, @p359, @p360, @p361, @p362, @p363, @p364, @p365, @p366, @p367, @p368, @p369, @p370, @p371, @p372, @p373, @p374, @p375, @p376, @p377, @p378, @p379, @p380, @p381, @p382, @p383, @p384, @p385, @p386, @p387, @p388, @p389, @p390, @p391, 6), (@p392, @p393, @p394, @p395, @p396, @p397, @p398, @p399, @p400, @p401, @p402, @p403, @p404, @p405, @p406, @p407, @p408, @p409, @p410, @p411, @p412, @p413, @p414, @p415, @p416, @p417, @p418, @p419, @p420, @p421, @p422, @p423, @p424, @p425, @p426, @p427, @p428, @p429, @p430, @p431, @p432, @p433, @p434, @p435, @p436, @p437, @p438, @p439, @p440, @p441, @p442, @p443, @p444, @p445, @p446, @p447, 7), (@p448, @p449, @p450, @p451, @p452, @p453, @p454, @p455, @p456, @p457, @p458, @p459, @p460, @p461, @p462, @p463, @p464, @p465, @p466, @p467, @p468, @p469, @p470, @p471, @p472, @p473, @p474, @p475, @p476, @p477, @p478, @p479, @p480, @p481, @p482, @p483, @p484, @p485, @p486, @p487, @p488, @p489, @p490, @p491, @p492, @p493, @p494, @p495, @p496, @p497, @p498, @p499, @p500, @p501, @p502, @p503, 8), (@p504, @p505, @p506, @p507, @p508, @p509, @p510, @p511, @p512, @p513, @p514, @p515, @p516, @p517, @p518, @p519, @p520, @p521, @p522, @p523, @p524, @p525, @p526, @p527, @p528, @p529, @p530, @p531, @p532, @p533, @p534, @p535, @p536, @p537, @p538, @p539, @p540, @p541, @p542, @p543, @p544, @p545, @p546, @p547, @p548, @p549, @p550, @p551, @p552, @p553, @p554, @p555, @p556, @p557, @p558, @p559, 9), (@p560, @p561, @p562, @p563, @p564, @p565, @p566, @p567, @p568, @p569, @p570, @p571, @p572, @p573, @p574, @p575, @p576, @p577, @p578, @p579, @p580, @p581, @p582, @p583, @p584, @p585, @p586, @p587, @p588, @p589, @p590, @p591, @p592, @p593, @p594, @p595, @p596, @p597, @p598, @p599, @p600, @p601, @p602, @p603, @p604, @p605, @p606, @p607, @p608, @p609, @p610, @p611, @p612, @p613, @p614, @p615, 10), (@p616, @p617, @p618, @p619, @p620, @p621, @p622, @p623, @p624, @p625, @p626, @p627, @p628, @p629, @p630, @p631, @p632, @p633, @p634, @p635, @p636, @p637, @p638, @p639, @p640, @p641, @p642, @p643, @p644, @p645, @p646, @p647, @p648, @p649, @p650, @p651, @p652, @p653, @p654, @p655, @p656, @p657, @p658, @p659, @p660, @p661, @p662, @p663, @p664, @p665, @p666, @p667, @p668, @p669, @p670, @p671, 11), (@p672, @p673, @p674, @p675, @p676, @p677, @p678, @p679, @p680, @p681, @p682, @p683, @p684, @p685, @p686, @p687, @p688, @p689, @p690, @p691, @p692, @p693, @p694, @p695, @p696, @p697, @p698, @p699, @p700, @p701, @p702, @p703, @p704, @p705, @p706, @p707, @p708, @p709, @p710, @p711, @p712, @p713, @p714, @p715, @p716, @p717, @p718, @p719, @p720, @p721, @p722, @p723, @p724, @p725, @p726, @p727, 12), (@p728, @p729, @p730, @p731, @p732, @p733, @p734, @p735, @p736, @p737, @p738, @p739, @p740, @p741, @p742, @p743, @p744, @p745, @p746, @p747, @p748, @p749, @p750, @p751, @p752, @p753, @p754, @p755, @p756, @p757, @p758, @p759, @p760, @p761, @p762, @p763, @p764, @p765, @p766, @p767, @p768, @p769, @p770, @p771, @p772, @p773, @p774, @p775, @p776, @p777, @p778, @p779, @p780, @p781, @p782, @p783, 13), (@p784, @p785, @p786, @p787, @p788, @p789, @p790, @p791, @p792, @p793, @p794, @p795, @p796, @p797, @p798, @p799, @p800, @p801, @p802, @p803, @p804, @p805, @p806, @p807, @p808, @p809, @p810, @p811, @p812, @p813, @p814, @p815, @p816, @p817, @p818, @p819, @p820, @p821, @p822, @p823, @p824, @p825, @p826, @p827, @p828, @p829, @p830, @p831, @p832, @p833, @p834, @p835, @p836, @p837, @p838, @p839, 14), (@p840, @p841, @p842, @p843, @p844, @p845, @p846, @p847, @p848, @p849, @p850, @p851, @p852, @p853, @p854, @p855, @p856, @p857, @p858, @p859, @p860, @p861, @p862, @p863, @p864, @p865, @p866, @p867, @p868, @p869, @p870, @p871, @p872, @p873, @p874, @p875, @p876, @p877, @p878, @p879, @p880, @p881, @p882, @p883, @p884, @p885, @p886, @p887, @p888, @p889, @p890, @p891, @p892, @p893, @p894, @p895, 15), (@p896, @p897, @p898, @p899, @p900, @p901, @p902, @p903, @p904, @p905, @p906, @p907, @p908, @p909, @p910, @p911, @p912, @p913, @p914, @p915, @p916, @p917, @p918, @p919, @p920, @p921, @p922, @p923, @p924, @p925, @p926, @p927, @p928, @p929, @p930, @p931, @p932, @p933, @p934, @p935, @p936, @p937, @p938, @p939, @p940, @p941, @p942, @p943, @p944, @p945, @p946, @p947, @p948, @p949, @p950, @p951, 16), (@p952, @p953, @p954, @p955, @p956, @p957, @p958, @p959, @p960, @p961, @p962, @p963, @p964, @p965, @p966, @p967, @p968, @p969, @p970, @p971, @p972, @p973, @p974, @p975, @p976, @p977, @p978, @p979, @p980, @p981, @p982, @p983, @p984, @p985, @p986, @p987, @p988, @p989, @p990, @p991, @p992, @p993, @p994, @p995, @p996, @p997, @p998, @p999, @p1000, @p1001, @p1002, @p1003, @p1004, @p1005, @p1006, @p1007, 17), (@p1008, @p1009, @p1010, @p1011, @p1012, @p1013, @p1014, @p1015, @p1016, @p1017, @p1018, @p1019, @p1020, @p1021, @p1022, @p1023, @p1024, @p1025, @p1026, @p1027, @p1028, @p1029, @p1030, @p1031, @p1032, @p1033, @p1034, @p1035, @p1036, @p1037, @p1038, @p1039, @p1040, @p1041, @p1042, @p1043, @p1044, @p1045, @p1046, @p1047, @p1048, @p1049, @p1050, @p1051, @p1052, @p1053, @p1054, @p1055, @p1056, @p1057, @p1058, @p1059, @p1060, @p1061, @p1062, @p1063, 18), (@p1064, @p1065, @p1066, @p1067, @p1068, @p1069, @p1070, @p1071, @p1072, @p1073, @p1074, @p1075, @p1076, @p1077, @p1078, @p1079, @p1080, @p1081, @p1082, @p1083, @p1084, @p1085, @p1086, @p1087, @p1088, @p1089, @p1090, @p1091, @p1092, @p1093, @p1094, @p1095, @p1096, @p1097, @p1098, @p1099, @p1100, @p1101, @p1102, @p1103, @p1104, @p1105, @p1106, @p1107, @p1108, @p1109, @p1110, @p1111, @p1112, @p1113, @p1114, @p1115, @p1116, @p1117, @p1118, @p1119, 19), (@p1120, @p1121, @p1122, @p1123, @p1124, @p1125, @p1126, @p1127, @p1128, @p1129, @p1130, @p1131, @p1132, @p1133, @p1134, @p1135, @p1136, @p1137, @p1138, @p1139, @p1140, @p1141, @p1142, @p1143, @p1144, @p1145, @p1146, @p1147, @p1148, @p1149, @p1150, @p1151, @p1152, @p1153, @p1154, @p1155, @p1156, @p1157, @p1158, @p1159, @p1160, @p1161, @p1162, @p1163, @p1164, @p1165, @p1166, @p1167, @p1168, @p1169, @p1170, @p1171, @p1172, @p1173, @p1174, @p1175, 20), (@p1176, @p1177, @p1178, @p1179, @p1180, @p1181, @p1182, @p1183, @p1184, @p1185, @p1186, @p1187, @p1188, @p1189, @p1190, @p1191, @p1192, @p1193, @p1194, @p1195, @p1196, @p1197, @p1198, @p1199, @p1200, @p1201, @p1202, @p1203, @p1204, @p1205, @p1206, @p1207, @p1208, @p1209, @p1210, @p1211, @p1212, @p1213, @p1214, @p1215, @p1216, @p1217, @p1218, @p1219, @p1220, @p1221, @p1222, @p1223, @p1224, @p1225, @p1226, @p1227, @p1228, @p1229, @p1230, @p1231, 21), (@p1232, @p1233, @p1234, @p1235, @p1236, @p1237, @p1238, @p1239, @p1240, @p1241, @p1242, @p1243, @p1244, @p1245, @p1246, @p1247, @p1248, @p1249, @p1250, @p1251, @p1252, @p1253, @p1254, @p1255, @p1256, @p1257, @p1258, @p1259, @p1260, @p1261, @p1262, @p1263, @p1264, @p1265, @p1266, @p1267, @p1268, @p1269, @p1270, @p1271, @p1272, @p1273, @p1274, @p1275, @p1276, @p1277, @p1278, @p1279, @p1280, @p1281, @p1282, @p1283, @p1284, @p1285, @p1286, @p1287, 22), (@p1288, @p1289, @p1290, @p1291, @p1292, @p1293, @p1294, @p1295, @p1296, @p1297, @p1298, @p1299, @p1300, @p1301, @p1302, @p1303, @p1304, @p1305, @p1306, @p1307, @p1308, @p1309, @p1310, @p1311, @p1312, @p1313, @p1314, @p1315, @p1316, @p1317, @p1318, @p1319, @p1320, @p1321, @p1322, @p1323, @p1324, @p1325, @p1326, @p1327, @p1328, @p1329, @p1330, @p1331, @p1332, @p1333, @p1334, @p1335, @p1336, @p1337, @p1338, @p1339, @p1340, @p1341, @p1342, @p1343, 23), (@p1344, @p1345, @p1346, @p1347, @p1348, @p1349, @p1350, @p1351, @p1352, @p1353, @p1354, @p1355, @p1356, @p1357, @p1358, @p1359, @p1360, @p1361, @p1362, @p1363, @p1364, @p1365, @p1366, @p1367, @p1368, @p1369, @p1370, @p1371, @p1372, @p1373, @p1374, @p1375, @p1376, @p1377, @p1378, @p1379, @p1380, @p1381, @p1382, @p1383, @p1384, @p1385, @p1386, @p1387, @p1388, @p1389, @p1390, @p1391, @p1392, @p1393, @p1394, @p1395, @p1396, @p1397, @p1398, @p1399, 24), (@p1400, @p1401, @p1402, @p1403, @p1404, @p1405, @p1406, @p1407, @p1408, @p1409, @p1410, @p1411, @p1412, @p1413, @p1414, @p1415, @p1416, @p1417, @p1418, @p1419, @p1420, @p1421, @p1422, @p1423, @p1424, @p1425, @p1426, @p1427, @p1428, @p1429, @p1430, @p1431, @p1432, @p1433, @p1434, @p1435, @p1436, @p1437, @p1438, @p1439, @p1440, @p1441, @p1442, @p1443, @p1444, @p1445, @p1446, @p1447, @p1448, @p1449, @p1450, @p1451, @p1452, @p1453, @p1454, @p1455, 25), (@p1456, @p1457, @p1458, @p1459, @p1460, @p1461, @p1462, @p1463, @p1464, @p1465, @p1466, @p1467, @p1468, @p1469, @p1470, @p1471, @p1472, @p1473, @p1474, @p1475, @p1476, @p1477, @p1478, @p1479, @p1480, @p1481, @p1482, @p1483, @p1484, @p1485, @p1486, @p1487, @p1488, @p1489, @p1490, @p1491, @p1492, @p1493, @p1494, @p1495, @p1496, @p1497, @p1498, @p1499, @p1500, @p1501, @p1502, @p1503, @p1504, @p1505, @p1506, @p1507, @p1508, @p1509, @p1510, @p1511, 26), (@p1512, @p1513, @p1514, @p1515, @p1516, @p1517, @p1518, @p1519, @p1520, @p1521, @p1522, @p1523, @p1524, @p1525, @p1526, @p1527, @p1528, @p1529, @p1530, @p1531, @p1532, @p1533, @p1534, @p1535, @p1536, @p1537, @p1538, @p1539, @p1540, @p1541, @p1542, @p1543, @p1544, @p1545, @p1546, @p1547, @p1548, @p1549, @p1550, @p1551, @p1552, @p1553, @p1554, @p1555, @p1556, @p1557, @p1558, @p1559, @p1560, @p1561, @p1562, @p1563, @p1564, @p1565, @p1566, @p1567, 27), (@p1568, @p1569, @p1570, @p1571, @p1572, @p1573, @p1574, @p1575, @p1576, @p1577, @p1578, @p1579, @p1580, @p1581, @p1582, @p1583, @p1584, @p1585, @p1586, @p1587, @p1588, @p1589, @p1590, @p1591, @p1592, @p1593, @p1594, @p1595, @p1596, @p1597, @p1598, @p1599, @p1600, @p1601, @p1602, @p1603, @p1604, @p1605, @p1606, @p1607, @p1608, @p1609, @p1610, @p1611, @p1612, @p1613, @p1614, @p1615, @p1616, @p1617, @p1618, @p1619, @p1620, @p1621, @p1622, @p1623, 28), (@p1624, @p1625, @p1626, @p1627, @p1628, @p1629, @p1630, @p1631, @p1632, @p1633, @p1634, @p1635, @p1636, @p1637, @p1638, @p1639, @p1640, @p1641, @p1642, @p1643, @p1644, @p1645, @p1646, @p1647, @p1648, @p1649, @p1650, @p1651, @p1652, @p1653, @p1654, @p1655, @p1656, @p1657, @p1658, @p1659, @p1660, @p1661, @p1662, @p1663, @p1664, @p1665, @p1666, @p1667, @p1668, @p1669, @p1670, @p1671, @p1672, @p1673, @p1674, @p1675, @p1676, @p1677, @p1678, @p1679, 29), (@p1680, @p1681, @p1682, @p1683, @p1684, @p1685, @p1686, @p1687, @p1688, @p1689, @p1690, @p1691, @p1692, @p1693, @p1694, @p1695, @p1696, @p1697, @p1698, @p1699, @p1700, @p1701, @p1702, @p1703, @p1704, @p1705, @p1706, @p1707, @p1708, @p1709, @p1710, @p1711, @p1712, @p1713, @p1714, @p1715, @p1716, @p1717, @p1718, @p1719, @p1720, @p1721, @p1722, @p1723, @p1724, @p1725, @p1726, @p1727, @p1728, @p1729, @p1730, @p1731, @p1732, @p1733, @p1734, @p1735, 30), (@p1736, @p1737, @p1738, @p1739, @p1740, @p1741, @p1742, @p1743, @p1744, @p1745, @p1746, @p1747, @p1748, @p1749, @p1750, @p1751, @p1752, @p1753, @p1754, @p1755, @p1756, @p1757, @p1758, @p1759, @p1760, @p1761, @p1762, @p1763, @p1764, @p1765, @p1766, @p1767, @p1768, @p1769, @p1770, @p1771, @p1772, @p1773, @p1774, @p1775, @p1776, @p1777, @p1778, @p1779, @p1780, @p1781, @p1782, @p1783, @p1784, @p1785, @p1786, @p1787, @p1788, @p1789, @p1790, @p1791, 31), (@p1792, @p1793, @p1794, @p1795, @p1796, @p1797, @p1798, @p1799, @p1800, @p1801, @p1802, @p1803, @p1804, @p1805, @p1806, @p1807, @p1808, @p1809, @p1810, @p1811, @p1812, @p1813, @p1814, @p1815, @p1816, @p1817, @p1818, @p1819, @p1820, @p1821, @p1822, @p1823, @p1824, @p1825, @p1826, @p1827, @p1828, @p1829, @p1830, @p1831, @p1832, @p1833, @p1834, @p1835, @p1836, @p1837, @p1838, @p1839, @p1840, @p1841, @p1842, @p1843, @p1844, @p1845, @p1846, @p1847, 32), (@p1848, @p1849, @p1850, @p1851, @p1852, @p1853, @p1854, @p1855, @p1856, @p1857, @p1858, @p1859, @p1860, @p1861, @p1862, @p1863, @p1864, @p1865, @p1866, @p1867, @p1868, @p1869, @p1870, @p1871, @p1872, @p1873, @p1874, @p1875, @p1876, @p1877, @p1878, @p1879, @p1880, @p1881, @p1882, @p1883, @p1884, @p1885, @p1886, @p1887, @p1888, @p1889, @p1890, @p1891, @p1892, @p1893, @p1894, @p1895, @p1896, @p1897, @p1898, @p1899, @p1900, @p1901, @p1902, @p1903, 33), (@p1904, @p1905, @p1906, @p1907, @p1908, @p1909, @p1910, @p1911, @p1912, @p1913, @p1914, @p1915, @p1916, @p1917, @p1918, @p1919, @p1920, @p1921, @p1922, @p1923, @p1924, @p1925, @p1926, @p1927, @p1928, @p1929, @p1930, @p1931, @p1932, @p1933, @p1934, @p1935, @p1936, @p1937, @p1938, @p1939, @p1940, @p1941, @p1942, @p1943, @p1944, @p1945, @p1946, @p1947, @p1948, @p1949, @p1950, @p1951, @p1952, @p1953, @p1954, @p1955, @p1956, @p1957, @p1958, @p1959, 34), (@p1960, @p1961, @p1962, @p1963, @p1964, @p1965, @p1966, @p1967, @p1968, @p1969, @p1970, @p1971, @p1972, @p1973, @p1974, @p1975, @p1976, @p1977, @p1978, @p1979, @p1980, @p1981, @p1982, @p1983, @p1984, @p1985, @p1986, @p1987, @p1988, @p1989, @p1990, @p1991, @p1992, @p1993, @p1994, @p1995, @p1996, @p1997, @p1998, @p1999, @p2000, @p2001, @p2002, @p2003, @p2004, @p2005, @p2006, @p2007, @p2008, @p2009, @p2010, @p2011, @p2012, @p2013, @p2014, @p2015, 35), (@p2016, @p2017, @p2018, @p2019, @p2020, @p2021, @p2022, @p2023, @p2024, @p2025, @p2026, @p2027, @p2028, @p2029, @p2030, @p2031, @p2032, @p2033, @p2034, @p2035, @p2036, @p2037, @p2038, @p2039, @p2040, @p2041, @p2042, @p2043, @p2044, @p2045, @p2046, @p2047, @p2048, @p2049, @p2050, @p2051, @p2052, @p2053, @p2054, @p2055, @p2056, @p2057, @p2058, @p2059, @p2060, @p2061, @p2062, @p2063, @p2064, @p2065, @p2066, @p2067, @p2068, @p2069, @p2070, @p2071, 36)) AS i ([addressee_cntry_cd], [addressee_city], [addressee_district], [addressee_email], [addressee_full_address], [addressee_home_address], [addressee_name], [addressee_postcode], [addressee_province], [addressee_subdistrict], [addressee_tel], [create_table], [delivery_code], [delivery_recipient_name], [delivery_relation_id], [delivery_status_id], [dest_outlet_id], [dest_outlet_port], [document_number], [item_barcode], [item_cod], [item_gross_weight], [item_height], [item_length], [item_price], [item_width], [lat], [log_id], [long], [outlet_id], [outlet_port], [podUrl], [remark], [scan_cntry_cd], [scan_cntry_postcode], [sender_cntry_cd], [sender_district], [sender_email], [sender_full_address], [sender_home_address], [member_id], [sender_name], [sender_postcode], [sender_province], [sender_subdistrict], [sender_tel], [server_id], [signatureUrl], [state], [status_code], [status_dtm], [timestamp], [transmit_dtm], [user_id], [wckt_id], [wkstn_no], _Position) ON 1=0 WHEN NOT MATCHED THEN INSERT ([addressee_cntry_cd], [addressee_city], [addressee_district], [addressee_email], [addressee_full_address], [addressee_home_address], [addressee_name], [addressee_postcode], [addressee_province], [addressee_subdistrict], [addressee_tel], [create_table], [delivery_code], [delivery_recipient_name], [delivery_relation_id], [delivery_status_id], [dest_outlet_id], [dest_outlet_port], [document_number], [item_barcode], [item_cod], [item_gross_weight], [item_height], [item_length], [item_price], [item_width], [lat], [log_id], [long], [outlet_id], [outlet_port], [podUrl], [remark], [scan_cntry_cd], [scan_cntry_postcode], [sender_cntry_cd], [sender_district], [sender_email], [sender_full_address], [sender_home_address], [member_id], [sender_name], [sender_postcode], [sender_province], [sender_subdistrict], [sender_tel], [server_id], [signatureUrl], [state], [status_code], [status_dtm], [timestamp], [transmit_dtm], [user_id], [wckt_id], [wkstn_no]) VALUES (i.[addressee_cntry_cd], i.[addressee_city], i.[addressee_district], i.[addressee_email], i.[addressee_full_address], i.[addressee_home_address], i.[addressee_name], i.[addressee_postcode], i.[addressee_province], i.[addressee_subdistrict], i.[addressee_tel], i.[create_table], i.[delivery_code], i.[delivery_recipient_name], i.[delivery_relation_id], i.[delivery_status_id], i.[dest_outlet_id], i.[dest_outlet_port], i.[document_number], i.[item_barcode], i.[item_cod], i.[item_gross_weight], i.[item_height], i.[item_length], i.[item_price], i.[item_width], i.[lat], i.[log_id], i.[long], i.[outlet_id], i.[outlet_port], i.[podUrl], i.[remark], i.[scan_cntry_cd], i.[scan_cntry_postcode], i.[sender_cntry_cd], i.[sender_district], i.[sender_email], i.[sender_full_address], i.[sender_home_address], i.[member_id], i.[sender_name], i.[sender_postcode], i.[sender_province], i.[sender_subdistrict], i.[sender_tel], i.[server_id], i.[signatureUrl], i.[state], i.[status_code], i.[status_dtm], i.[timestamp], i.[transmit_dtm], i.[user_id], i.[wckt_id], i.[wkstn_no]) OUTPUT INSERTED.[item_id], i._Position INTO @inserted0;  SELECT [t].[item_id] FROM [raw_data] t INNER JOIN @inserted0 i ON ([t].[item_id] = [i].[item_id]) ORDER BY [i].[_Position];  ",4,4,0,435,5,4
"(@p0 nvarchar(4000),@p1 nvarchar(4000),@p2 nvarchar(4000),@p3 nvarchar(4000),@p4 nvarchar(4000),@p5 nvarchar(4000),@p6 nvarchar(4000),@p7 nvarchar(4000),@p8 nvarchar(4000),@p9 nvarchar(4000),@p10 nvarchar(4000),@p11 datetime2(7),@p12 nvarchar(4000),@p13 nvarchar(4000),@p14 int,@p15 int,@p16 int,@p17 nvarchar(4000),@p18 nvarchar(4000),@p19 nvarchar(4000),@p20 nvarchar(4000),@p21 decimal(18,2),@p22 nvarchar(4000),@p23 nvarchar(4000),@p24 decimal(18,2),@p25 nvarchar(4000),@p26 nvarchar(4000),@p27 nvarchar(4000),@p28 nvarchar(4000),@p29 int,@p30 nvarchar(4000),@p31 nvarchar(4000),@p32 nvarchar(4000),@p33 nvarchar(4000),@p34 nvarchar(4000),@p35 nvarchar(4000),@p36 nvarchar(4000),@p37 nvarchar(4000),@p38 nvarchar(4000),@p39 nvarchar(4000),@p40 int,@p41 nvarchar(4000),@p42 nvarchar(4000),@p43 nvarchar(4000),@p44 nvarchar(4000),@p45 nvarchar(4000),@p46 int,@p47 nvarchar(4000),@p48 int,@p49 int,@p50 datetime2(7),@p51 datetime2(7),@p52 datetime2(7),@p53 nvarchar(4000),@p54 nvarchar(4000),@p55 nvarchar(4000),@p56 nvarchar(4000),@p57 nvarchar(4000),@p58 nvarchar(4000),@p59 nvarchar(4000),@p60 nvarchar(4000),@p61 nvarchar(4000),@p62 nvarchar(4000),@p63 nvarchar(4000),@p64 nvarchar(4000),@p65 nvarchar(4000),@p66 nvarchar(4000),@p67 datetime2(7),@p68 nvarchar(4000),@p69 nvarchar(4000),@p70 int,@p71 int,@p72 int,@p73 nvarchar(4000),@p74 nvarchar(4000),@p75 nvarchar(4000),@p76 nvarchar(4000),@p77 decimal(18,2),@p78 nvarchar(4000),@p79 nvarchar(4000),@p80 decimal(18,2),@p81 nvarchar(4000),@p82 nvarchar(4000),@p83 nvarchar(4000),@p84 nvarchar(4000),@p85 int,@p86 nvarchar(4000),@p87 nvarchar(4000),@p88 nvarchar(4000),@p89 nvarchar(4000),@p90 nvarchar(4000),@p91 nvarchar(4000),@p92 nvarchar(4000),@p93 nvarchar(4000),@p94 nvarchar(4000),@p95 nvarchar(4000),@p96 int,@p97 nvarchar(4000),@p98 nvarchar(4000),@p99 nvarchar(4000),@p100 nvarchar(4000),@p101 nvarchar(4000),@p102 int,@p103 nvarchar(4000),@p104 int,@p105 int,@p106 datetime2(7),@p107 datetime2(7),@p108 datetime2(7),@p109 nvarchar(4000),@p110 nvarchar(4000),@p111 nvarchar(4000),@p112 nvarchar(4000),@p113 nvarchar(4000),@p114 nvarchar(4000),@p115 nvarchar(4000),@p116 nvarchar(4000),@p117 nvarchar(4000),@p118 nvarchar(4000),@p119 nvarchar(4000),@p120 nvarchar(4000),@p121 nvarchar(4000),@p122 nvarchar(4000),@p123 datetime2(7),@p124 nvarchar(4000),@p125 nvarchar(4000),@p126 int,@p127 int,@p128 int,@p129 nvarchar(4000),@p130 nvarchar(4000),@p131 nvarchar(4000),@p132 nvarchar(4000),@p133 decimal(18,2),@p134 nvarchar(4000),@p135 nvarchar(4000),@p136 decimal(18,2),@p137 nvarchar(4000),@p138 nvarchar(4000),@p139 nvarchar(4000),@p140 nvarchar(4000),@p141 int,@p142 nvarchar(4000),@p143 nvarchar(4000),@p144 nvarchar(4000),@p145 nvarchar(4000),@p146 nvarchar(4000),@p147 nvarchar(4000),@p148 nvarchar(4000),@p149 nvarchar(4000),@p150 nvarchar(4000),@p151 nvarchar(4000),@p152 int,@p153 nvarchar(4000),@p154 nvarchar(4000),@p155 nvarchar(4000),@p156 nvarchar(4000),@p157 nvarchar(4000),@p158 int,@p159 nvarchar(4000),@p160 int,@p161 int,@p162 datetime2(7),@p163 datetime2(7),@p164 datetime2(7),@p165 nvarchar(4000),@p166 nvarchar(4000),@p167 nvarchar(4000),@p168 nvarchar(4000),@p169 nvarchar(4000),@p170 nvarchar(4000),@p171 nvarchar(4000),@p172 nvarchar(4000),@p173 nvarchar(4000),@p174 nvarchar(4000),@p175 nvarchar(4000),@p176 nvarchar(4000),@p177 nvarchar(4000),@p178 nvarchar(4000),@p179 datetime2(7),@p180 nvarchar(4000),@p181 nvarchar(4000),@p182 int,@p183 int,@p184 int,@p185 nvarchar(4000),@p186 nvarchar(4000),@p187 nvarchar(4000),@p188 nvarchar(4000),@p189 decimal(18,2),@p190 nvarchar(4000),@p191 nvarchar(4000),@p192 decimal(18,2),@p193 nvarchar(4000),@p194 nvarchar(4000),@p195 nvarchar(4000),@p196 nvarchar(4000),@p197 int,@p198 nvarchar(4000),@p199 nvarchar(4000),@p200 nvarchar(4000),@p201 nvarchar(4000),@p202 nvarchar(4000),@p203 nvarchar(4000),@p204 nvarchar(4000),@p205 nvarchar(4000),@p206 nvarchar(4000),@p207 nvarchar(4000),@p208 int,@p209 nvarchar(4000),@p210 nvarchar(4000),@p211 nvarchar(4000),@p212 nvarchar(4000),@p213 nvarchar(4000),@p214 int,@p215 nvarchar(4000),@p216 int,@p217 int,@p218 datetime2(7),@p219 datetime2(7),@p220 datetime2(7),@p221 nvarchar(4000),@p222 nvarchar(4000),@p223 nvarchar(4000),@p224 nvarchar(4000),@p225 nvarchar(4000),@p226 nvarchar(4000),@p227 nvarchar(4000),@p228 nvarchar(4000),@p229 nvarchar(4000),@p230 nvarchar(4000),@p231 nvarchar(4000),@p232 nvarchar(4000),@p233 nvarchar(4000),@p234 nvarchar(4000),@p235 datetime2(7),@p236 nvarchar(4000),@p237 nvarchar(4000),@p238 int,@p239 int,@p240 int,@p241 nvarchar(4000),@p242 nvarchar(4000),@p243 nvarchar(4000),@p244 nvarchar(4000),@p245 decimal(18,2),@p246 nvarchar(4000),@p247 nvarchar(4000),@p248 decimal(18,2),@p249 nvarchar(4000),@p250 nvarchar(4000),@p251 nvarchar(4000),@p252 nvarchar(4000),@p253 int,@p254 nvarchar(4000),@p255 nvarchar(4000),@p256 nvarchar(4000),@p257 nvarchar(4000),@p258 nvarchar(4000),@p259 nvarchar(4000),@p260 nvarchar(4000),@p261 nvarchar(4000),@p262 nvarchar(4000),@p263 nvarchar(4000),@p264 int,@p265 nvarchar(4000),@p266 nvarchar(4000),@p267 nvarchar(4000),@p268 nvarchar(4000),@p269 nvarchar(4000),@p270 int,@p271 nvarchar(4000),@p272 int,@p273 int,@p274 datetime2(7),@p275 datetime2(7),@p276 datetime2(7),@p277 nvarchar(4000),@p278 nvarchar(4000),@p279 nvarchar(4000),@p280 nvarchar(4000),@p281 nvarchar(4000),@p282 nvarchar(4000),@p283 nvarchar(4000),@p284 nvarchar(4000),@p285 nvarchar(4000),@p286 nvarchar(4000),@p287 nvarchar(4000),@p288 nvarchar(4000),@p289 nvarchar(4000),@p290 nvarchar(4000),@p291 datetime2(7),@p292 nvarchar(4000),@p293 nvarchar(4000),@p294 int,@p295 int,@p296 int,@p297 nvarchar(4000),@p298 nvarchar(4000),@p299 nvarchar(4000),@p300 decimal(18,2),@p301 decimal(18,2),@p302 nvarchar(4000),@p303 nvarchar(4000),@p304 decimal(18,2),@p305 nvarchar(4000),@p306 nvarchar(4000),@p307 nvarchar(4000),@p308 nvarchar(4000),@p309 int,@p310 nvarchar(4000),@p311 nvarchar(4000),@p312 nvarchar(4000),@p313 nvarchar(4000),@p314 nvarchar(4000),@p315 nvarchar(4000),@p316 nvarchar(4000),@p317 nvarchar(4000),@p318 nvarchar(4000),@p319 nvarchar(4000),@p320 int,@p321 nvarchar(4000),@p322 nvarchar(4000),@p323 nvarchar(4000),@p324 nvarchar(4000),@p325 nvarchar(4000),@p326 int,@p327 nvarchar(4000),@p328 int,@p329 int,@p330 datetime2(7),@p331 datetime2(7),@p332 datetime2(7),@p333 nvarchar(4000),@p334 nvarchar(4000),@p335 nvarchar(4000),@p336 nvarchar(4000),@p337 nvarchar(4000),@p338 nvarchar(4000),@p339 nvarchar(4000),@p340 nvarchar(4000),@p341 nvarchar(4000),@p342 nvarchar(4000),@p343 nvarchar(4000),@p344 nvarchar(4000),@p345 nvarchar(4000),@p346 nvarchar(4000),@p347 datetime2(7),@p348 nvarchar(4000),@p349 nvarchar(4000),@p350 int,@p351 int,@p352 int,@p353 nvarchar(4000),@p354 nvarchar(4000),@p355 nvarchar(4000),@p356 decimal(18,2),@p357 decimal(18,2),@p358 nvarchar(4000),@p359 nvarchar(4000),@p360 decimal(18,2),@p361 nvarchar(4000),@p362 nvarchar(4000),@p363 nvarchar(4000),@p364 nvarchar(4000),@p365 int,@p366 nvarchar(4000),@p367 nvarchar(4000),@p368 nvarchar(4000),@p369 nvarchar(4000),@p370 nvarchar(4000),@p371 nvarchar(4000),@p372 nvarchar(4000),@p373 nvarchar(4000),@p374 nvarchar(4000),@p375 nvarchar(4000),@p376 int,@p377 nvarchar(4000),@p378 nvarchar(4000),@p379 nvarchar(4000),@p380 nvarchar(4000),@p381 nvarchar(4000),@p382 int,@p383 nvarchar(4000),@p384 int,@p385 int,@p386 datetime2(7),@p387 datetime2(7),@p388 datetime2(7),@p389 nvarchar(4000),@p390 nvarchar(4000),@p391 nvarchar(4000),@p392 nvarchar(4000),@p393 nvarchar(4000),@p394 nvarchar(4000),@p395 nvarchar(4000),@p396 nvarchar(4000),@p397 nvarchar(4000),@p398 nvarchar(4000),@p399 nvarchar(4000),@p400 nvarchar(4000),@p401 nvarchar(4000),@p402 nvarchar(4000),@p403 datetime2(7),@p404 nvarchar(4000),@p405 nvarchar(4000),@p406 int,@p407 int,@p408 int,@p409 nvarchar(4000),@p410 nvarchar(4000),@p411 nvarchar(4000),@p412 decimal(18,2),@p413 decimal(18,2),@p414 nvarchar(4000),@p415 nvarchar(4000),@p416 decimal(18,2),@p417 nvarchar(4000),@p418 nvarchar(4000),@p419 nvarchar(4000),@p420 nvarchar(4000),@p421 int,@p422 nvarchar(4000),@p423 nvarchar(4000),@p424 nvarchar(4000),@p425 nvarchar(4000),@p426 nvarchar(4000),@p427 nvarchar(4000),@p428 nvarchar(4000),@p429 nvarchar(4000),@p430 nvarchar(4000),@p431 nvarchar(4000),@p432 int,@p433 nvarchar(4000),@p434 nvarchar(4000),@p435 nvarchar(4000),@p436 nvarchar(4000),@p437 nvarchar(4000),@p438 int,@p439 nvarchar(4000),@p440 int,@p441 int,@p442 datetime2(7),@p443 datetime2(7),@p444 datetime2(7),@p445 nvarchar(4000),@p446 nvarchar(4000),@p447 nvarchar(4000),@p448 nvarchar(4000),@p449 nvarchar(4000),@p450 nvarchar(4000),@p451 nvarchar(4000),@p452 nvarchar(4000),@p453 nvarchar(4000),@p454 nvarchar(4000),@p455 nvarchar(4000),@p456 nvarchar(4000),@p457 nvarchar(4000),@p458 nvarchar(4000),@p459 datetime2(7),@p460 nvarchar(4000),@p461 nvarchar(4000),@p462 int,@p463 int,@p464 int,@p465 nvarchar(4000),@p466 nvarchar(4000),@p467 nvarchar(4000),@p468 decimal(18,2),@p469 decimal(18,2),@p470 nvarchar(4000),@p471 nvarchar(4000),@p472 decimal(18,2),@p473 nvarchar(4000),@p474 nvarchar(4000),@p475 nvarchar(4000),@p476 nvarchar(4000),@p477 int,@p478 nvarchar(4000),@p479 nvarchar(4000),@p480 nvarchar(4000),@p481 nvarchar(4000),@p482 nvarchar(4000),@p483 nvarchar(4000),@p484 nvarchar(4000),@p485 nvarchar(4000),@p486 nvarchar(4000),@p487 nvarchar(4000),@p488 int,@p489 nvarchar(4000),@p490 nvarchar(4000),@p491 nvarchar(4000),@p492 nvarchar(4000),@p493 nvarchar(4000),@p494 int,@p495 nvarchar(4000),@p496 int,@p497 int,@p498 datetime2(7),@p499 datetime2(7),@p500 datetime2(7),@p501 nvarchar(4000),@p502 nvarchar(4000),@p503 nvarchar(4000),@p504 nvarchar(4000),@p505 nvarchar(4000),@p506 nvarchar(4000),@p507 nvarchar(4000),@p508 nvarchar(4000),@p509 nvarchar(4000),@p510 nvarchar(4000),@p511 nvarchar(4000),@p512 nvarchar(4000),@p513 nvarchar(4000),@p514 nvarchar(4000),@p515 datetime2(7),@p516 nvarchar(4000),@p517 nvarchar(4000),@p518 int,@p519 int,@p520 int,@p521 nvarchar(4000),@p522 nvarchar(4000),@p523 nvarchar(4000),@p524 decimal(18,2),@p525 decimal(18,2),@p526 nvarchar(4000),@p527 nvarchar(4000),@p528 decimal(18,2),@p529 nvarchar(4000),@p530 nvarchar(4000),@p531 nvarchar(4000),@p532 nvarchar(4000),@p533 int,@p534 nvarchar(4000),@p535 nvarchar(4000),@p536 nvarchar(4000),@p537 nvarchar(4000),@p538 nvarchar(4000),@p539 nvarchar(4000),@p540 nvarchar(4000),@p541 nvarchar(4000),@p542 nvarchar(4000),@p543 nvarchar(4000),@p544 int,@p545 nvarchar(4000),@p546 nvarchar(4000),@p547 nvarchar(4000),@p548 nvarchar(4000),@p549 nvarchar(4000),@p550 int,@p551 nvarchar(4000),@p552 int,@p553 int,@p554 datetime2(7),@p555 datetime2(7),@p556 datetime2(7),@p557 nvarchar(4000),@p558 nvarchar(4000),@p559 nvarchar(4000),@p560 nvarchar(4000),@p561 nvarchar(4000),@p562 nvarchar(4000),@p563 nvarchar(4000),@p564 nvarchar(4000),@p565 nvarchar(4000),@p566 nvarchar(4000),@p567 nvarchar(4000),@p568 nvarchar(4000),@p569 nvarchar(4000),@p570 nvarchar(4000),@p571 datetime2(7),@p572 nvarchar(4000),@p573 nvarchar(4000),@p574 int,@p575 int,@p576 int,@p577 nvarchar(4000),@p578 nvarchar(4000),@p579 nvarchar(4000),@p580 decimal(18,2),@p581 decimal(18,2),@p582 nvarchar(4000),@p583 nvarchar(4000),@p584 decimal(18,2),@p585 nvarchar(4000),@p586 nvarchar(4000),@p587 nvarchar(4000),@p588 nvarchar(4000),@p589 int,@p590 nvarchar(4000),@p591 nvarchar(4000),@p592 nvarchar(4000),@p593 nvarchar(4000),@p594 nvarchar(4000),@p595 nvarchar(4000),@p596 nvarchar(4000),@p597 nvarchar(4000),@p598 nvarchar(4000),@p599 nvarchar(4000),@p600 int,@p601 nvarchar(4000),@p602 nvarchar(4000),@p603 nvarchar(4000),@p604 nvarchar(4000),@p605 nvarchar(4000),@p606 int,@p607 nvarchar(4000),@p608 int,@p609 int,@p610 datetime2(7),@p611 datetime2(7),@p612 datetime2(7),@p613 nvarchar(4000),@p614 nvarchar(4000),@p615 nvarchar(4000),@p616 nvarchar(4000),@p617 nvarchar(4000),@p618 nvarchar(4000),@p619 nvarchar(4000),@p620 nvarchar(4000),@p621 nvarchar(4000),@p622 nvarchar(4000),@p623 nvarchar(4000),@p624 nvarchar(4000),@p625 nvarchar(4000),@p626 nvarchar(4000),@p627 datetime2(7),@p628 nvarchar(4000),@p629 nvarchar(4000),@p630 int,@p631 int,@p632 int,@p633 nvarchar(4000),@p634 nvarchar(4000),@p635 nvarchar(4000),@p636 decimal(18,2),@p637 decimal(18,2),@p638 nvarchar(4000),@p639 nvarchar(4000),@p640 decimal(18,2),@p641 nvarchar(4000),@p642 nvarchar(4000),@p643 nvarchar(4000),@p644 nvarchar(4000),@p645 int,@p646 nvarchar(4000),@p647 nvarchar(4000),@p648 nvarchar(4000),@p649 nvarchar(4000),@p650 nvarchar(4000),@p651 nvarchar(4000),@p652 nvarchar(4000),@p653 nvarchar(4000),@p654 nvarchar(4000),@p655 nvarchar(4000),@p656 int,@p657 nvarchar(4000),@p658 nvarchar(4000),@p659 nvarchar(4000),@p660 nvarchar(4000),@p661 nvarchar(4000),@p662 int,@p663 nvarchar(4000),@p664 int,@p665 int,@p666 datetime2(7),@p667 datetime2(7),@p668 datetime2(7),@p669 nvarchar(4000),@p670 nvarchar(4000),@p671 nvarchar(4000),@p672 nvarchar(4000),@p673 nvarchar(4000),@p674 nvarchar(4000),@p675 nvarchar(4000),@p676 nvarchar(4000),@p677 nvarchar(4000),@p678 nvarchar(4000),@p679 nvarchar(4000),@p680 nvarchar(4000),@p681 nvarchar(4000),@p682 nvarchar(4000),@p683 datetime2(7),@p684 nvarchar(4000),@p685 nvarchar(4000),@p686 int,@p687 int,@p688 int,@p689 nvarchar(4000),@p690 nvarchar(4000),@p691 nvarchar(4000),@p692 nvarchar(4000),@p693 decimal(18,2),@p694 nvarchar(4000),@p695 nvarchar(4000),@p696 decimal(18,2),@p697 nvarchar(4000),@p698 nvarchar(4000),@p699 nvarchar(4000),@p700 nvarchar(4000),@p701 int,@p702 nvarchar(4000),@p703 nvarchar(4000),@p704 nvarchar(4000),@p705 nvarchar(4000),@p706 nvarchar(4000),@p707 nvarchar(4000),@p708 nvarchar(4000),@p709 nvarchar(4000),@p710 nvarchar(4000),@p711 nvarchar(4000),@p712 int,@p713 nvarchar(4000),@p714 nvarchar(4000),@p715 nvarchar(4000),@p716 nvarchar(4000),@p717 nvarchar(4000),@p718 int,@p719 nvarchar(4000),@p720 int,@p721 int,@p722 datetime2(7),@p723 datetime2(7),@p724 datetime2(7),@p725 nvarchar(4000),@p726 nvarchar(4000),@p727 nvarchar(4000),@p728 nvarchar(4000),@p729 nvarchar(4000),@p730 nvarchar(4000),@p731 nvarchar(4000),@p732 nvarchar(4000),@p733 nvarchar(4000),@p734 nvarchar(4000),@p735 nvarchar(4000),@p736 nvarchar(4000),@p737 nvarchar(4000),@p738 nvarchar(4000),@p739 datetime2(7),@p740 nvarchar(4000),@p741 nvarchar(4000),@p742 int,@p743 int,@p744 int,@p745 nvarchar(4000),@p746 nvarchar(4000),@p747 nvarchar(4000),@p748 nvarchar(4000),@p749 decimal(18,2),@p750 nvarchar(4000),@p751 nvarchar(4000),@p752 decimal(18,2),@p753 nvarchar(4000),@p754 nvarchar(4000),@p755 nvarchar(4000),@p756 nvarchar(4000),@p757 int,@p758 nvarchar(4000),@p759 nvarchar(4000),@p760 nvarchar(4000),@p761 nvarchar(4000),@p762 nvarchar(4000),@p763 nvarchar(4000),@p764 nvarchar(4000),@p765 nvarchar(4000),@p766 nvarchar(4000),@p767 nvarchar(4000),@p768 int,@p769 nvarchar(4000),@p770 nvarchar(4000),@p771 nvarchar(4000),@p772 nvarchar(4000),@p773 nvarchar(4000),@p774 int,@p775 nvarchar(4000),@p776 int,@p777 int,@p778 datetime2(7),@p779 datetime2(7),@p780 datetime2(7),@p781 nvarchar(4000),@p782 nvarchar(4000),@p783 nvarchar(4000),@p784 nvarchar(4000),@p785 nvarchar(4000),@p786 nvarchar(4000),@p787 nvarchar(4000),@p788 nvarchar(4000),@p789 nvarchar(4000),@p790 nvarchar(4000),@p791 nvarchar(4000),@p792 nvarchar(4000),@p793 nvarchar(4000),@p794 nvarchar(4000),@p795 datetime2(7),@p796 nvarchar(4000),@p797 nvarchar(4000),@p798 int,@p799 int,@p800 int,@p801 nvarchar(4000),@p802 nvarchar(4000),@p803 nvarchar(4000),@p804 nvarchar(4000),@p805 decimal(18,2),@p806 nvarchar(4000),@p807 nvarchar(4000),@p808 decimal(18,2),@p809 nvarchar(4000),@p810 nvarchar(4000),@p811 nvarchar(4000),@p812 nvarchar(4000),@p813 int,@p814 nvarchar(4000),@p815 nvarchar(4000),@p816 nvarchar(4000),@p817 nvarchar(4000),@p818 nvarchar(4000),@p819 nvarchar(4000),@p820 nvarchar(4000),@p821 nvarchar(4000),@p822 nvarchar(4000),@p823 nvarchar(4000),@p824 int,@p825 nvarchar(4000),@p826 nvarchar(4000),@p827 nvarchar(4000),@p828 nvarchar(4000),@p829 nvarchar(4000),@p830 int,@p831 nvarchar(4000),@p832 int,@p833 int,@p834 datetime2(7),@p835 datetime2(7),@p836 datetime2(7),@p837 nvarchar(4000),@p838 nvarchar(4000),@p839 nvarchar(4000),@p840 nvarchar(4000),@p841 nvarchar(4000),@p842 nvarchar(4000),@p843 nvarchar(4000),@p844 nvarchar(4000),@p845 nvarchar(4000),@p846 nvarchar(4000),@p847 nvarchar(4000),@p848 nvarchar(4000),@p849 nvarchar(4000),@p850 nvarchar(4000),@p851 datetime2(7),@p852 nvarchar(4000),@p853 nvarchar(4000),@p854 int,@p855 int,@p856 int,@p857 nvarchar(4000),@p858 nvarchar(4000),@p859 nvarchar(4000),@p860 nvarchar(4000),@p861 decimal(18,2),@p862 nvarchar(4000),@p863 nvarchar(4000),@p864 decimal(18,2),@p865 nvarchar(4000),@p866 nvarchar(4000),@p867 nvarchar(4000),@p868 nvarchar(4000),@p869 int,@p870 nvarchar(4000),@p871 nvarchar(4000),@p872 nvarchar(4000),@p873 nvarchar(4000),@p874 nvarchar(4000),@p875 nvarchar(4000),@p876 nvarchar(4000),@p877 nvarchar(4000),@p878 nvarchar(4000),@p879 nvarchar(4000),@p880 int,@p881 nvarchar(4000),@p882 nvarchar(4000),@p883 nvarchar(4000),@p884 nvarchar(4000),@p885 nvarchar(4000),@p886 int,@p887 nvarchar(4000),@p888 int,@p889 int,@p890 datetime2(7),@p891 datetime2(7),@p892 datetime2(7),@p893 nvarchar(4000),@p894 nvarchar(4000),@p895 nvarchar(4000),@p896 nvarchar(4000),@p897 nvarchar(4000),@p898 nvarchar(4000),@p899 nvarchar(4000),@p900 nvarchar(4000),@p901 nvarchar(4000),@p902 nvarchar(4000),@p903 nvarchar(4000),@p904 nvarchar(4000),@p905 nvarchar(4000),@p906 nvarchar(4000),@p907 datetime2(7),@p908 nvarchar(4000),@p909 nvarchar(4000),@p910 int,@p911 int,@p912 int,@p913 nvarchar(4000),@p914 nvarchar(4000),@p915 nvarchar(4000),@p916 decimal(18,2),@p917 decimal(18,2),@p918 nvarchar(4000),@p919 nvarchar(4000),@p920 decimal(18,2),@p921 nvarchar(4000),@p922 nvarchar(4000),@p923 nvarchar(4000),@p924 nvarchar(4000),@p925 int,@p926 nvarchar(4000),@p927 nvarchar(4000),@p928 nvarchar(4000),@p929 nvarchar(4000),@p930 nvarchar(4000),@p931 nvarchar(4000),@p932 nvarchar(4000),@p933 nvarchar(4000),@p934 nvarchar(4000),@p935 nvarchar(4000),@p936 int,@p937 nvarchar(4000),@p938 nvarchar(4000),@p939 nvarchar(4000),@p940 nvarchar(4000),@p941 nvarchar(4000),@p942 int,@p943 nvarchar(4000),@p944 int,@p945 int,@p946 datetime2(7),@p947 datetime2(7),@p948 datetime2(7),@p949 nvarchar(4000),@p950 nvarchar(4000),@p951 nvarchar(4000),@p952 nvarchar(4000),@p953 nvarchar(4000),@p954 nvarchar(4000),@p955 nvarchar(4000),@p956 nvarchar(4000),@p957 nvarchar(4000),@p958 nvarchar(4000),@p959 nvarchar(4000),@p960 nvarchar(4000),@p961 nvarchar(4000),@p962 nvarchar(4000),@p963 datetime2(7),@p964 nvarchar(4000),@p965 nvarchar(4000),@p966 int,@p967 int,@p968 int,@p969 nvarchar(4000),@p970 nvarchar(4000),@p971 nvarchar(4000),@p972 nvarchar(4000),@p973 decimal(18,2),@p974 nvarchar(4000),@p975 nvarchar(4000),@p976 decimal(18,2),@p977 nvarchar(4000),@p978 nvarchar(4000),@p979 nvarchar(4000),@p980 nvarchar(4000),@p981 int,@p982 nvarchar(4000),@p983 nvarchar(4000),@p984 nvarchar(4000),@p985 nvarchar(4000),@p986 nvarchar(4000),@p987 nvarchar(4000),@p988 nvarchar(4000),@p989 nvarchar(4000),@p990 nvarchar(4000),@p991 nvarchar(4000),@p992 int,@p993 nvarchar(4000),@p994 nvarchar(4000),@p995 nvarchar(4000),@p996 nvarchar(4000),@p997 nvarchar(4000),@p998 int,@p999 nvarchar(4000),@p1000 int,@p1001 int,@p1002 datetime2(7),@p1003 datetime2(7),@p1004 datetime2(7),@p1005 nvarchar(4000),@p1006 nvarchar(4000),@p1007 nvarchar(4000),@p1008 nvarchar(4000),@p1009 nvarchar(4000),@p1010 nvarchar(4000),@p1011 nvarchar(4000),@p1012 nvarchar(4000),@p1013 nvarchar(4000),@p1014 nvarchar(4000),@p1015 nvarchar(4000),@p1016 nvarchar(4000),@p1017 nvarchar(4000),@p1018 nvarchar(4000),@p1019 datetime2(7),@p1020 nvarchar(4000),@p1021 nvarchar(4000),@p1022 int,@p1023 int,@p1024 int,@p1025 nvarchar(4000),@p1026 nvarchar(4000),@p1027 nvarchar(4000),@p1028 nvarchar(4000),@p1029 decimal(18,2),@p1030 nvarchar(4000),@p1031 nvarchar(4000),@p1032 decimal(18,2),@p1033 nvarchar(4000),@p1034 nvarchar(4000),@p1035 nvarchar(4000),@p1036 nvarchar(4000),@p1037 int,@p1038 nvarchar(4000),@p1039 nvarchar(4000),@p1040 nvarchar(4000),@p1041 nvarchar(4000),@p1042 nvarchar(4000),@p1043 nvarchar(4000),@p1044 nvarchar(4000),@p1045 nvarchar(4000),@p1046 nvarchar(4000),@p1047 nvarchar(4000),@p1048 int,@p1049 nvarchar(4000),@p1050 nvarchar(4000),@p1051 nvarchar(4000),@p1052 nvarchar(4000),@p1053 nvarchar(4000),@p1054 int,@p1055 nvarchar(4000),@p1056 int,@p1057 int,@p1058 datetime2(7),@p1059 datetime2(7),@p1060 datetime2(7),@p1061 nvarchar(4000),@p1062 nvarchar(4000),@p1063 nvarchar(4000),@p1064 nvarchar(4000),@p1065 nvarchar(4000),@p1066 nvarchar(4000),@p1067 nvarchar(4000),@p1068 nvarchar(4000),@p1069 nvarchar(4000),@p1070 nvarchar(4000),@p1071 nvarchar(4000),@p1072 nvarchar(4000),@p1073 nvarchar(4000),@p1074 nvarchar(4000),@p1075 datetime2(7),@p1076 nvarchar(4000),@p1077 nvarchar(4000),@p1078 int,@p1079 int,@p1080 int,@p1081 nvarchar(4000),@p1082 nvarchar(4000),@p1083 nvarchar(4000),@p1084 nvarchar(4000),@p1085 decimal(18,2),@p1086 nvarchar(4000),@p1087 nvarchar(4000),@p1088 decimal(18,2),@p1089 nvarchar(4000),@p1090 nvarchar(4000),@p1091 nvarchar(4000),@p1092 nvarchar(4000),@p1093 int,@p1094 nvarchar(4000),@p1095 nvarchar(4000),@p1096 nvarchar(4000),@p1097 nvarchar(4000),@p1098 nvarchar(4000),@p1099 nvarchar(4000),@p1100 nvarchar(4000),@p1101 nvarchar(4000),@p1102 nvarchar(4000),@p1103 nvarchar(4000),@p1104 int,@p1105 nvarchar(4000),@p1106 nvarchar(4000),@p1107 nvarchar(4000),@p1108 nvarchar(4000),@p1109 nvarchar(4000),@p1110 int,@p1111 nvarchar(4000),@p1112 int,@p1113 int,@p1114 datetime2(7),@p1115 datetime2(7),@p1116 datetime2(7),@p1117 nvarchar(4000),@p1118 nvarchar(4000),@p1119 nvarchar(4000),@p1120 nvarchar(4000),@p1121 nvarchar(4000),@p1122 nvarchar(4000),@p1123 nvarchar(4000),@p1124 nvarchar(4000),@p1125 nvarchar(4000),@p1126 nvarchar(4000),@p1127 nvarchar(4000),@p1128 nvarchar(4000),@p1129 nvarchar(4000),@p1130 nvarchar(4000),@p1131 datetime2(7),@p1132 nvarchar(4000),@p1133 nvarchar(4000),@p1134 int,@p1135 int,@p1136 int,@p1137 nvarchar(4000),@p1138 nvarchar(4000),@p1139 nvarchar(4000),@p1140 nvarchar(4000),@p1141 decimal(18,2),@p1142 nvarchar(4000),@p1143 nvarchar(4000),@p1144 decimal(18,2),@p1145 nvarchar(4000),@p1146 nvarchar(4000),@p1147 nvarchar(4000),@p1148 nvarchar(4000),@p1149 int,@p1150 nvarchar(4000),@p1151 nvarchar(4000),@p1152 nvarchar(4000),@p1153 nvarchar(4000),@p1154 nvarchar(4000),@p1155 nvarchar(4000),@p1156 nvarchar(4000),@p1157 nvarchar(4000),@p1158 nvarchar(4000),@p1159 nvarchar(4000),@p1160 int,@p1161 nvarchar(4000),@p1162 nvarchar(4000),@p1163 nvarchar(4000),@p1164 nvarchar(4000),@p1165 nvarchar(4000),@p1166 int,@p1167 nvarchar(4000),@p1168 int,@p1169 int,@p1170 datetime2(7),@p1171 datetime2(7),@p1172 datetime2(7),@p1173 nvarchar(4000),@p1174 nvarchar(4000),@p1175 nvarchar(4000),@p1176 nvarchar(4000),@p1177 nvarchar(4000),@p1178 nvarchar(4000),@p1179 nvarchar(4000),@p1180 nvarchar(4000),@p1181 nvarchar(4000),@p1182 nvarchar(4000),@p1183 nvarchar(4000),@p1184 nvarchar(4000),@p1185 nvarchar(4000),@p1186 nvarchar(4000),@p1187 datetime2(7),@p1188 nvarchar(4000),@p1189 nvarchar(4000),@p1190 int,@p1191 int,@p1192 int,@p1193 nvarchar(4000),@p1194 nvarchar(4000),@p1195 nvarchar(4000),@p1196 nvarchar(4000),@p1197 decimal(18,2),@p1198 nvarchar(4000),@p1199 nvarchar(4000),@p1200 decimal(18,2),@p1201 nvarchar(4000),@p1202 nvarchar(4000),@p1203 nvarchar(4000),@p1204 nvarchar(4000),@p1205 int,@p1206 nvarchar(4000),@p1207 nvarchar(4000),@p1208 nvarchar(4000),@p1209 nvarchar(4000),@p1210 nvarchar(4000),@p1211 nvarchar(4000),@p1212 nvarchar(4000),@p1213 nvarchar(4000),@p1214 nvarchar(4000),@p1215 nvarchar(4000),@p1216 int,@p1217 nvarchar(4000),@p1218 nvarchar(4000),@p1219 nvarchar(4000),@p1220 nvarchar(4000),@p1221 nvarchar(4000),@p1222 int,@p1223 nvarchar(4000),@p1224 int,@p1225 int,@p1226 datetime2(7),@p1227 datetime2(7),@p1228 datetime2(7),@p1229 nvarchar(4000),@p1230 nvarchar(4000),@p1231 nvarchar(4000),@p1232 nvarchar(4000),@p1233 nvarchar(4000),@p1234 nvarchar(4000),@p1235 nvarchar(4000),@p1236 nvarchar(4000),@p1237 nvarchar(4000),@p1238 nvarchar(4000),@p1239 nvarchar(4000),@p1240 nvarchar(4000),@p1241 nvarchar(4000),@p1242 nvarchar(4000),@p1243 datetime2(7),@p1244 nvarchar(4000),@p1245 nvarchar(4000),@p1246 int,@p1247 int,@p1248 int,@p1249 nvarchar(4000),@p1250 nvarchar(4000),@p1251 nvarchar(4000),@p1252 decimal(18,2),@p1253 decimal(18,2),@p1254 nvarchar(4000),@p1255 nvarchar(4000),@p1256 decimal(18,2),@p1257 nvarchar(4000),@p1258 nvarchar(4000),@p1259 nvarchar(4000),@p1260 nvarchar(4000),@p1261 int,@p1262 nvarchar(4000),@p1263 nvarchar(4000),@p1264 nvarchar(4000),@p1265 nvarchar(4000),@p1266 nvarchar(4000),@p1267 nvarchar(4000),@p1268 nvarchar(4000),@p1269 nvarchar(4000),@p1270 nvarchar(4000),@p1271 nvarchar(4000),@p1272 int,@p1273 nvarchar(4000),@p1274 nvarchar(4000),@p1275 nvarchar(4000),@p1276 nvarchar(4000),@p1277 nvarchar(4000),@p1278 int,@p1279 nvarchar(4000),@p1280 int,@p1281 int,@p1282 datetime2(7),@p1283 datetime2(7),@p1284 datetime2(7),@p1285 nvarchar(4000),@p1286 nvarchar(4000),@p1287 nvarchar(4000),@p1288 nvarchar(4000),@p1289 nvarchar(4000),@p1290 nvarchar(4000),@p1291 nvarchar(4000),@p1292 nvarchar(4000),@p1293 nvarchar(4000),@p1294 nvarchar(4000),@p1295 nvarchar(4000),@p1296 nvarchar(4000),@p1297 nvarchar(4000),@p1298 nvarchar(4000),@p1299 datetime2(7),@p1300 nvarchar(4000),@p1301 nvarchar(4000),@p1302 int,@p1303 int,@p1304 int,@p1305 nvarchar(4000),@p1306 nvarchar(4000),@p1307 nvarchar(4000),@p1308 decimal(18,2),@p1309 decimal(18,2),@p1310 nvarchar(4000),@p1311 nvarchar(4000),@p1312 decimal(18,2),@p1313 nvarchar(4000),@p1314 nvarchar(4000),@p1315 nvarchar(4000),@p1316 nvarchar(4000),@p1317 int,@p1318 nvarchar(4000),@p1319 nvarchar(4000),@p1320 nvarchar(4000),@p1321 nvarchar(4000),@p1322 nvarchar(4000),@p1323 nvarchar(4000),@p1324 nvarchar(4000),@p1325 nvarchar(4000),@p1326 nvarchar(4000),@p1327 nvarchar(4000),@p1328 int,@p1329 nvarchar(4000),@p1330 nvarchar(4000),@p1331 nvarchar(4000),@p1332 nvarchar(4000),@p1333 nvarchar(4000),@p1334 int,@p1335 nvarchar(4000),@p1336 int,@p1337 int,@p1338 datetime2(7),@p1339 datetime2(7),@p1340 datetime2(7),@p1341 nvarchar(4000),@p1342 nvarchar(4000),@p1343 nvarchar(4000),@p1344 nvarchar(4000),@p1345 nvarchar(4000),@p1346 nvarchar(4000),@p1347 nvarchar(4000),@p1348 nvarchar(4000),@p1349 nvarchar(4000),@p1350 nvarchar(4000),@p1351 nvarchar(4000),@p1352 nvarchar(4000),@p1353 nvarchar(4000),@p1354 nvarchar(4000),@p1355 datetime2(7),@p1356 nvarchar(4000),@p1357 nvarchar(4000),@p1358 int,@p1359 int,@p1360 int,@p1361 nvarchar(4000),@p1362 nvarchar(4000),@p1363 nvarchar(4000),@p1364 nvarchar(4000),@p1365 decimal(18,2),@p1366 nvarchar(4000),@p1367 nvarchar(4000),@p1368 decimal(18,2),@p1369 nvarchar(4000),@p1370 nvarchar(4000),@p1371 nvarchar(4000),@p1372 nvarchar(4000),@p1373 int,@p1374 nvarchar(4000),@p1375 nvarchar(4000),@p1376 nvarchar(4000),@p1377 nvarchar(4000),@p1378 nvarchar(4000),@p1379 nvarchar(4000),@p1380 nvarchar(4000),@p1381 nvarchar(4000),@p1382 nvarchar(4000),@p1383 nvarchar(4000),@p1384 int,@p1385 nvarchar(4000),@p1386 nvarchar(4000),@p1387 nvarchar(4000),@p1388 nvarchar(4000),@p1389 nvarchar(4000),@p1390 int,@p1391 nvarchar(4000),@p1392 int,@p1393 int,@p1394 datetime2(7),@p1395 datetime2(7),@p1396 datetime2(7),@p1397 nvarchar(4000),@p1398 nvarchar(4000),@p1399 nvarchar(4000),@p1400 nvarchar(4000),@p1401 nvarchar(4000),@p1402 nvarchar(4000),@p1403 nvarchar(4000),@p1404 nvarchar(4000),@p1405 nvarchar(4000),@p1406 nvarchar(4000),@p1407 nvarchar(4000),@p1408 nvarchar(4000),@p1409 nvarchar(4000),@p1410 nvarchar(4000),@p1411 datetime2(7),@p1412 nvarchar(4000),@p1413 nvarchar(4000),@p1414 int,@p1415 int,@p1416 int,@p1417 nvarchar(4000),@p1418 nvarchar(4000),@p1419 nvarchar(4000),@p1420 decimal(18,2),@p1421 decimal(18,2),@p1422 nvarchar(4000),@p1423 nvarchar(4000),@p1424 decimal(18,2),@p1425 nvarchar(4000),@p1426 nvarchar(4000),@p1427 nvarchar(4000),@p1428 nvarchar(4000),@p1429 int,@p1430 nvarchar(4000),@p1431 nvarchar(4000),@p1432 nvarchar(4000),@p1433 nvarchar(4000),@p1434 nvarchar(4000),@p1435 nvarchar(4000),@p1436 nvarchar(4000),@p1437 nvarchar(4000),@p1438 nvarchar(4000),@p1439 nvarchar(4000),@p1440 int,@p1441 nvarchar(4000),@p1442 nvarchar(4000),@p1443 nvarchar(4000),@p1444 nvarchar(4000),@p1445 nvarchar(4000),@p1446 int,@p1447 nvarchar(4000),@p1448 int,@p1449 int,@p1450 datetime2(7),@p1451 datetime2(7),@p1452 datetime2(7),@p1453 nvarchar(4000),@p1454 nvarchar(4000),@p1455 nvarchar(4000),@p1456 nvarchar(4000),@p1457 nvarchar(4000),@p1458 nvarchar(4000),@p1459 nvarchar(4000),@p1460 nvarchar(4000),@p1461 nvarchar(4000),@p1462 nvarchar(4000),@p1463 nvarchar(4000),@p1464 nvarchar(4000),@p1465 nvarchar(4000),@p1466 nvarchar(4000),@p1467 datetime2(7),@p1468 nvarchar(4000),@p1469 nvarchar(4000),@p1470 int,@p1471 int,@p1472 int,@p1473 nvarchar(4000),@p1474 nvarchar(4000),@p1475 nvarchar(4000),@p1476 nvarchar(4000),@p1477 decimal(18,2),@p1478 nvarchar(4000),@p1479 nvarchar(4000),@p1480 decimal(18,2),@p1481 nvarchar(4000),@p1482 nvarchar(4000),@p1483 nvarchar(4000),@p1484 nvarchar(4000),@p1485 int,@p1486 nvarchar(4000),@p1487 nvarchar(4000),@p1488 nvarchar(4000),@p1489 nvarchar(4000),@p1490 nvarchar(4000),@p1491 nvarchar(4000),@p1492 nvarchar(4000),@p1493 nvarchar(4000),@p1494 nvarchar(4000),@p1495 nvarchar(4000),@p1496 int,@p1497 nvarchar(4000),@p1498 nvarchar(4000),@p1499 nvarchar(4000),@p1500 nvarchar(4000),@p1501 nvarchar(4000),@p1502 int,@p1503 nvarchar(4000),@p1504 int,@p1505 int,@p1506 datetime2(7),@p1507 datetime2(7),@p1508 datetime2(7),@p1509 nvarchar(4000),@p1510 nvarchar(4000),@p1511 nvarchar(4000),@p1512 nvarchar(4000),@p1513 nvarchar(4000),@p1514 nvarchar(4000),@p1515 nvarchar(4000),@p1516 nvarchar(4000),@p1517 nvarchar(4000),@p1518 nvarchar(4000),@p1519 nvarchar(4000),@p1520 nvarchar(4000),@p1521 nvarchar(4000),@p1522 nvarchar(4000),@p1523 datetime2(7),@p1524 nvarchar(4000),@p1525 nvarchar(4000),@p1526 int,@p1527 int,@p1528 int,@p1529 nvarchar(4000),@p1530 nvarchar(4000),@p1531 nvarchar(4000),@p1532 decimal(18,2),@p1533 decimal(18,2),@p1534 nvarchar(4000),@p1535 nvarchar(4000),@p1536 decimal(18,2),@p1537 nvarchar(4000),@p1538 nvarchar(4000),@p1539 nvarchar(4000),@p1540 nvarchar(4000),@p1541 int,@p1542 nvarchar(4000),@p1543 nvarchar(4000),@p1544 nvarchar(4000),@p1545 nvarchar(4000),@p1546 nvarchar(4000),@p1547 nvarchar(4000),@p1548 nvarchar(4000),@p1549 nvarchar(4000),@p1550 nvarchar(4000),@p1551 nvarchar(4000),@p1552 int,@p1553 nvarchar(4000),@p1554 nvarchar(4000),@p1555 nvarchar(4000),@p1556 nvarchar(4000),@p1557 nvarchar(4000),@p1558 int,@p1559 nvarchar(4000),@p1560 int,@p1561 int,@p1562 datetime2(7),@p1563 datetime2(7),@p1564 datetime2(7),@p1565 nvarchar(4000),@p1566 nvarchar(4000),@p1567 nvarchar(4000),@p1568 nvarchar(4000),@p1569 nvarchar(4000),@p1570 nvarchar(4000),@p1571 nvarchar(4000),@p1572 nvarchar(4000),@p1573 nvarchar(4000),@p1574 nvarchar(4000),@p1575 nvarchar(4000),@p1576 nvarchar(4000),@p1577 nvarchar(4000),@p1578 nvarchar(4000),@p1579 datetime2(7),@p1580 nvarchar(4000),@p1581 nvarchar(4000),@p1582 int,@p1583 int,@p1584 int,@p1585 nvarchar(4000),@p1586 nvarchar(4000),@p1587 nvarchar(4000),@p1588 decimal(18,2),@p1589 decimal(18,2),@p1590 nvarchar(4000),@p1591 nvarchar(4000),@p1592 decimal(18,2),@p1593 nvarchar(4000),@p1594 nvarchar(4000),@p1595 nvarchar(4000),@p1596 nvarchar(4000),@p1597 int,@p1598 nvarchar(4000),@p1599 nvarchar(4000),@p1600 nvarchar(4000),@p1601 nvarchar(4000),@p1602 nvarchar(4000),@p1603 nvarchar(4000),@p1604 nvarchar(4000),@p1605 nvarchar(4000),@p1606 nvarchar(4000),@p1607 nvarchar(4000),@p1608 int,@p1609 nvarchar(4000),@p1610 nvarchar(4000),@p1611 nvarchar(4000),@p1612 nvarchar(4000),@p1613 nvarchar(4000),@p1614 int,@p1615 nvarchar(4000),@p1616 int,@p1617 int,@p1618 datetime2(7),@p1619 datetime2(7),@p1620 datetime2(7),@p1621 nvarchar(4000),@p1622 nvarchar(4000),@p1623 nvarchar(4000),@p1624 nvarchar(4000),@p1625 nvarchar(4000),@p1626 nvarchar(4000),@p1627 nvarchar(4000),@p1628 nvarchar(4000),@p1629 nvarchar(4000),@p1630 nvarchar(4000),@p1631 nvarchar(4000),@p1632 nvarchar(4000),@p1633 nvarchar(4000),@p1634 nvarchar(4000),@p1635 datetime2(7),@p1636 nvarchar(4000),@p1637 nvarchar(4000),@p1638 int,@p1639 int,@p1640 int,@p1641 nvarchar(4000),@p1642 nvarchar(4000),@p1643 nvarchar(4000),@p1644 nvarchar(4000),@p1645 decimal(18,2),@p1646 nvarchar(4000),@p1647 nvarchar(4000),@p1648 decimal(18,2),@p1649 nvarchar(4000),@p1650 nvarchar(4000),@p1651 nvarchar(4000),@p1652 nvarchar(4000),@p1653 int,@p1654 nvarchar(4000),@p1655 nvarchar(4000),@p1656 nvarchar(4000),@p1657 nvarchar(4000),@p1658 nvarchar(4000),@p1659 nvarchar(4000),@p1660 nvarchar(4000),@p1661 nvarchar(4000),@p1662 nvarchar(4000),@p1663 nvarchar(4000),@p1664 int,@p1665 nvarchar(4000),@p1666 nvarchar(4000),@p1667 nvarchar(4000),@p1668 nvarchar(4000),@p1669 nvarchar(4000),@p1670 int,@p1671 nvarchar(4000),@p1672 int,@p1673 int,@p1674 datetime2(7),@p1675 datetime2(7),@p1676 datetime2(7),@p1677 nvarchar(4000),@p1678 nvarchar(4000),@p1679 nvarchar(4000),@p1680 nvarchar(4000),@p1681 nvarchar(4000),@p1682 nvarchar(4000),@p1683 nvarchar(4000),@p1684 nvarchar(4000),@p1685 nvarchar(4000),@p1686 nvarchar(4000),@p1687 nvarchar(4000),@p1688 nvarchar(4000),@p1689 nvarchar(4000),@p1690 nvarchar(4000),@p1691 datetime2(7),@p1692 nvarchar(4000),@p1693 nvarchar(4000),@p1694 int,@p1695 int,@p1696 int,@p1697 nvarchar(4000),@p1698 nvarchar(4000),@p1699 nvarchar(4000),@p1700 decimal(18,2),@p1701 decimal(18,2),@p1702 nvarchar(4000),@p1703 nvarchar(4000),@p1704 decimal(18,2),@p1705 nvarchar(4000),@p1706 nvarchar(4000),@p1707 nvarchar(4000),@p1708 nvarchar(4000),@p1709 int,@p1710 nvarchar(4000),@p1711 nvarchar(4000),@p1712 nvarchar(4000),@p1713 nvarchar(4000),@p1714 nvarchar(4000),@p1715 nvarchar(4000),@p1716 nvarchar(4000),@p1717 nvarchar(4000),@p1718 nvarchar(4000),@p1719 nvarchar(4000),@p1720 int,@p1721 nvarchar(4000),@p1722 nvarchar(4000),@p1723 nvarchar(4000),@p1724 nvarchar(4000),@p1725 nvarchar(4000),@p1726 int,@p1727 nvarchar(4000),@p1728 int,@p1729 int,@p1730 datetime2(7),@p1731 datetime2(7),@p1732 datetime2(7),@p1733 nvarchar(4000),@p1734 nvarchar(4000),@p1735 nvarchar(4000),@p1736 nvarchar(4000),@p1737 nvarchar(4000),@p1738 nvarchar(4000),@p1739 nvarchar(4000),@p1740 nvarchar(4000),@p1741 nvarchar(4000),@p1742 nvarchar(4000),@p1743 nvarchar(4000),@p1744 nvarchar(4000),@p1745 nvarchar(4000),@p1746 nvarchar(4000),@p1747 datetime2(7),@p1748 nvarchar(4000),@p1749 nvarchar(4000),@p1750 int,@p1751 int,@p1752 int,@p1753 nvarchar(4000),@p1754 nvarchar(4000),@p1755 nvarchar(4000),@p1756 decimal(18,2),@p1757 decimal(18,2),@p1758 nvarchar(4000),@p1759 nvarchar(4000),@p1760 decimal(18,2),@p1761 nvarchar(4000),@p1762 nvarchar(4000),@p1763 nvarchar(4000),@p1764 nvarchar(4000),@p1765 int,@p1766 nvarchar(4000),@p1767 nvarchar(4000),@p1768 nvarchar(4000),@p1769 nvarchar(4000),@p1770 nvarchar(4000),@p1771 nvarchar(4000),@p1772 nvarchar(4000),@p1773 nvarchar(4000),@p1774 nvarchar(4000),@p1775 nvarchar(4000),@p1776 int,@p1777 nvarchar(4000),@p1778 nvarchar(4000),@p1779 nvarchar(4000),@p1780 nvarchar(4000),@p1781 nvarchar(4000),@p1782 int,@p1783 nvarchar(4000),@p1784 int,@p1785 int,@p1786 datetime2(7),@p1787 datetime2(7),@p1788 datetime2(7),@p1789 nvarchar(4000),@p1790 nvarchar(4000),@p1791 nvarchar(4000),@p1792 nvarchar(4000),@p1793 nvarchar(4000),@p1794 nvarchar(4000),@p1795 nvarchar(4000),@p1796 nvarchar(4000),@p1797 nvarchar(4000),@p1798 nvarchar(4000),@p1799 nvarchar(4000),@p1800 nvarchar(4000),@p1801 nvarchar(4000),@p1802 nvarchar(4000),@p1803 datetime2(7),@p1804 nvarchar(4000),@p1805 nvarchar(4000),@p1806 int,@p1807 int,@p1808 int,@p1809 nvarchar(4000),@p1810 nvarchar(4000),@p1811 nvarchar(4000),@p1812 decimal(18,2),@p1813 decimal(18,2),@p1814 nvarchar(4000),@p1815 nvarchar(4000),@p1816 decimal(18,2),@p1817 nvarchar(4000),@p1818 nvarchar(4000),@p1819 nvarchar(4000),@p1820 nvarchar(4000),@p1821 int,@p1822 nvarchar(4000),@p1823 nvarchar(4000),@p1824 nvarchar(4000),@p1825 nvarchar(4000),@p1826 nvarchar(4000),@p1827 nvarchar(4000),@p1828 nvarchar(4000),@p1829 nvarchar(4000),@p1830 nvarchar(4000),@p1831 nvarchar(4000),@p1832 int,@p1833 nvarchar(4000),@p1834 nvarchar(4000),@p1835 nvarchar(4000),@p1836 nvarchar(4000),@p1837 nvarchar(4000),@p1838 int,@p1839 nvarchar(4000),@p1840 int,@p1841 int,@p1842 datetime2(7),@p1843 datetime2(7),@p1844 datetime2(7),@p1845 nvarchar(4000),@p1846 nvarchar(4000),@p1847 nvarchar(4000),@p1848 nvarchar(4000),@p1849 nvarchar(4000),@p1850 nvarchar(4000),@p1851 nvarchar(4000),@p1852 nvarchar(4000),@p1853 nvarchar(4000),@p1854 nvarchar(4000),@p1855 nvarchar(4000),@p1856 nvarchar(4000),@p1857 nvarchar(4000),@p1858 nvarchar(4000),@p1859 datetime2(7),@p1860 nvarchar(4000),@p1861 nvarchar(4000),@p1862 int,@p1863 int,@p1864 int,@p1865 nvarchar(4000),@p1866 nvarchar(4000),@p1867 nvarchar(4000),@p1868 decimal(18,2),@p1869 decimal(18,2),@p1870 nvarchar(4000),@p1871 nvarchar(4000),@p1872 decimal(18,2),@p1873 nvarchar(4000),@p1874 nvarchar(4000),@p1875 nvarchar(4000),@p1876 nvarchar(4000),@p1877 int,@p1878 nvarchar(4000),@p1879 nvarchar(4000),@p1880 nvarchar(4000),@p1881 nvarchar(4000),@p1882 nvarchar(4000),@p1883 nvarchar(4000),@p1884 nvarchar(4000),@p1885 nvarchar(4000),@p1886 nvarchar(4000),@p1887 nvarchar(4000),@p1888 int,@p1889 nvarchar(4000),@p1890 nvarchar(4000),@p1891 nvarchar(4000),@p1892 nvarchar(4000),@p1893 nvarchar(4000),@p1894 int,@p1895 nvarchar(4000),@p1896 int,@p1897 int,@p1898 datetime2(7),@p1899 datetime2(7),@p1900 datetime2(7),@p1901 nvarchar(4000),@p1902 nvarchar(4000),@p1903 nvarchar(4000),@p1904 nvarchar(4000),@p1905 nvarchar(4000),@p1906 nvarchar(4000),@p1907 nvarchar(4000),@p1908 nvarchar(4000),@p1909 nvarchar(4000),@p1910 nvarchar(4000),@p1911 nvarchar(4000),@p1912 nvarchar(4000),@p1913 nvarchar(4000),@p1914 nvarchar(4000),@p1915 datetime2(7),@p1916 nvarchar(4000),@p1917 nvarchar(4000),@p1918 int,@p1919 int,@p1920 int,@p1921 nvarchar(4000),@p1922 nvarchar(4000),@p1923 nvarchar(4000),@p1924 decimal(18,2),@p1925 decimal(18,2),@p1926 nvarchar(4000),@p1927 nvarchar(4000),@p1928 decimal(18,2),@p1929 nvarchar(4000),@p1930 nvarchar(4000),@p1931 nvarchar(4000),@p1932 nvarchar(4000),@p1933 int,@p1934 nvarchar(4000),@p1935 nvarchar(4000),@p1936 nvarchar(4000),@p1937 nvarchar(4000),@p1938 nvarchar(4000),@p1939 nvarchar(4000),@p1940 nvarchar(4000),@p1941 nvarchar(4000),@p1942 nvarchar(4000),@p1943 nvarchar(4000),@p1944 int,@p1945 nvarchar(4000),@p1946 nvarchar(4000),@p1947 nvarchar(4000),@p1948 nvarchar(4000),@p1949 nvarchar(4000),@p1950 int,@p1951 nvarchar(4000),@p1952 int,@p1953 int,@p1954 datetime2(7),@p1955 datetime2(7),@p1956 datetime2(7),@p1957 nvarchar(4000),@p1958 nvarchar(4000),@p1959 nvarchar(4000),@p1960 nvarchar(4000),@p1961 nvarchar(4000),@p1962 nvarchar(4000),@p1963 nvarchar(4000),@p1964 nvarchar(4000),@p1965 nvarchar(4000),@p1966 nvarchar(4000),@p1967 nvarchar(4000),@p1968 nvarchar(4000),@p1969 nvarchar(4000),@p1970 nvarchar(4000),@p1971 datetime2(7),@p1972 nvarchar(4000),@p1973 nvarchar(4000),@p1974 int,@p1975 int,@p1976 int,@p1977 nvarchar(4000),@p1978 nvarchar(4000),@p1979 nvarchar(4000),@p1980 decimal(18,2),@p1981 decimal(18,2),@p1982 nvarchar(4000),@p1983 nvarchar(4000),@p1984 decimal(18,2),@p1985 nvarchar(4000),@p1986 nvarchar(4000),@p1987 nvarchar(4000),@p1988 nvarchar(4000),@p1989 int,@p1990 nvarchar(4000),@p1991 nvarchar(4000),@p1992 nvarchar(4000),@p1993 nvarchar(4000),@p1994 nvarchar(4000),@p1995 nvarchar(4000),@p1996 nvarchar(4000),@p1997 nvarchar(4000),@p1998 nvarchar(4000),@p1999 nvarchar(4000),@p2000 int,@p2001 nvarchar(4000),@p2002 nvarchar(4000),@p2003 nvarchar(4000),@p2004 nvarchar(4000),@p2005 nvarchar(4000),@p2006 int,@p2007 nvarchar(4000),@p2008 int,@p2009 int,@p2010 datetime2(7),@p2011 datetime2(7),@p2012 datetime2(7),@p2013 nvarchar(4000),@p2014 nvarchar(4000),@p2015 nvarchar(4000),@p2016 nvarchar(4000),@p2017 nvarchar(4000),@p2018 nvarchar(4000),@p2019 nvarchar(4000),@p2020 nvarchar(4000),@p2021 nvarchar(4000),@p2022 nvarchar(4000),@p2023 nvarchar(4000),@p2024 nvarchar(4000),@p2025 nvarchar(4000),@p2026 nvarchar(4000),@p2027 datetime2(7),@p2028 nvarchar(4000),@p2029 nvarchar(4000),@p2030 int,@p2031 int,@p2032 int,@p2033 nvarchar(4000),@p2034 nvarchar(4000),@p2035 nvarchar(4000),@p2036 decimal(18,2),@p2037 decimal(18,2),@p2038 nvarchar(4000),@p2039 nvarchar(4000),@p2040 decimal(18,2),@p2041 nvarchar(4000),@p2042 nvarchar(4000),@p2043 nvarchar(4000),@p2044 nvarchar(4000),@p2045 int,@p2046 nvarchar(4000),@p2047 nvarchar(4000),@p2048 nvarchar(4000),@p2049 nvarchar(4000),@p2050 nvarchar(4000),@p2051 nvarchar(4000),@p2052 nvarchar(4000),@p2053 nvarchar(4000),@p2054 nvarchar(4000),@p2055 nvarchar(4000),@p2056 int,@p2057 nvarchar(4000),@p2058 nvarchar(4000),@p2059 nvarchar(4000),@p2060 nvarchar(4000),@p2061 nvarchar(4000),@p2062 int,@p2063 nvarchar(4000),@p2064 int,@p2065 int,@p2066 datetime2(7),@p2067 datetime2(7),@p2068 datetime2(7),@p2069 nvarchar(4000),@p2070 nvarchar(4000),@p2071 nvarchar(4000))SET NOCOUNT ON; DECLARE @inserted0 TABLE ([item_id] int, [_Position] [int]); MERGE [raw_data] USING ( VALUES (@p0, @p1, @p2, @p3, @p4, @p5, @p6, @p7, @p8, @p9, @p10, @p11, @p12, @p13, @p14, @p15, @p16, @p17, @p18, @p19, @p20, @p21, @p22, @p23, @p24, @p25, @p26, @p27, @p28, @p29, @p30, @p31, @p32, @p33, @p34, @p35, @p36, @p37, @p38, @p39, @p40, @p41, @p42, @p43, @p44, @p45, @p46, @p47, @p48, @p49, @p50, @p51, @p52, @p53, @p54, @p55, 0), (@p56, @p57, @p58, @p59, @p60, @p61, @p62, @p63, @p64, @p65, @p66, @p67, @p68, @p69, @p70, @p71, @p72, @p73, @p74, @p75, @p76, @p77, @p78, @p79, @p80, @p81, @p82, @p83, @p84, @p85, @p86, @p87, @p88, @p89, @p90, @p91, @p92, @p93, @p94, @p95, @p96, @p97, @p98, @p99, @p100, @p101, @p102, @p103, @p104, @p105, @p106, @p107, @p108, @p109, @p110, @p111, 1), (@p112, @p113, @p114, @p115, @p116, @p117, @p118, @p119, @p120, @p121, @p122, @p123, @p124, @p125, @p126, @p127, @p128, @p129, @p130, @p131, @p132, @p133, @p134, @p135, @p136, @p137, @p138, @p139, @p140, @p141, @p142, @p143, @p144, @p145, @p146, @p147, @p148, @p149, @p150, @p151, @p152, @p153, @p154, @p155, @p156, @p157, @p158, @p159, @p160, @p161, @p162, @p163, @p164, @p165, @p166, @p167, 2), (@p168, @p169, @p170, @p171, @p172, @p173, @p174, @p175, @p176, @p177, @p178, @p179, @p180, @p181, @p182, @p183, @p184, @p185, @p186, @p187, @p188, @p189, @p190, @p191, @p192, @p193, @p194, @p195, @p196, @p197, @p198, @p199, @p200, @p201, @p202, @p203, @p204, @p205, @p206, @p207, @p208, @p209, @p210, @p211, @p212, @p213, @p214, @p215, @p216, @p217, @p218, @p219, @p220, @p221, @p222, @p223, 3), (@p224, @p225, @p226, @p227, @p228, @p229, @p230, @p231, @p232, @p233, @p234, @p235, @p236, @p237, @p238, @p239, @p240, @p241, @p242, @p243, @p244, @p245, @p246, @p247, @p248, @p249, @p250, @p251, @p252, @p253, @p254, @p255, @p256, @p257, @p258, @p259, @p260, @p261, @p262, @p263, @p264, @p265, @p266, @p267, @p268, @p269, @p270, @p271, @p272, @p273, @p274, @p275, @p276, @p277, @p278, @p279, 4), (@p280, @p281, @p282, @p283, @p284, @p285, @p286, @p287, @p288, @p289, @p290, @p291, @p292, @p293, @p294, @p295, @p296, @p297, @p298, @p299, @p300, @p301, @p302, @p303, @p304, @p305, @p306, @p307, @p308, @p309, @p310, @p311, @p312, @p313, @p314, @p315, @p316, @p317, @p318, @p319, @p320, @p321, @p322, @p323, @p324, @p325, @p326, @p327, @p328, @p329, @p330, @p331, @p332, @p333, @p334, @p335, 5), (@p336, @p337, @p338, @p339, @p340, @p341, @p342, @p343, @p344, @p345, @p346, @p347, @p348, @p349, @p350, @p351, @p352, @p353, @p354, @p355, @p356, @p357, @p358, @p359, @p360, @p361, @p362, @p363, @p364, @p365, @p366, @p367, @p368, @p369, @p370, @p371, @p372, @p373, @p374, @p375, @p376, @p377, @p378, @p379, @p380, @p381, @p382, @p383, @p384, @p385, @p386, @p387, @p388, @p389, @p390, @p391, 6), (@p392, @p393, @p394, @p395, @p396, @p397, @p398, @p399, @p400, @p401, @p402, @p403, @p404, @p405, @p406, @p407, @p408, @p409, @p410, @p411, @p412, @p413, @p414, @p415, @p416, @p417, @p418, @p419, @p420, @p421, @p422, @p423, @p424, @p425, @p426, @p427, @p428, @p429, @p430, @p431, @p432, @p433, @p434, @p435, @p436, @p437, @p438, @p439, @p440, @p441, @p442, @p443, @p444, @p445, @p446, @p447, 7), (@p448, @p449, @p450, @p451, @p452, @p453, @p454, @p455, @p456, @p457, @p458, @p459, @p460, @p461, @p462, @p463, @p464, @p465, @p466, @p467, @p468, @p469, @p470, @p471, @p472, @p473, @p474, @p475, @p476, @p477, @p478, @p479, @p480, @p481, @p482, @p483, @p484, @p485, @p486, @p487, @p488, @p489, @p490, @p491, @p492, @p493, @p494, @p495, @p496, @p497, @p498, @p499, @p500, @p501, @p502, @p503, 8), (@p504, @p505, @p506, @p507, @p508, @p509, @p510, @p511, @p512, @p513, @p514, @p515, @p516, @p517, @p518, @p519, @p520, @p521, @p522, @p523, @p524, @p525, @p526, @p527, @p528, @p529, @p530, @p531, @p532, @p533, @p534, @p535, @p536, @p537, @p538, @p539, @p540, @p541, @p542, @p543, @p544, @p545, @p546, @p547, @p548, @p549, @p550, @p551, @p552, @p553, @p554, @p555, @p556, @p557, @p558, @p559, 9), (@p560, @p561, @p562, @p563, @p564, @p565, @p566, @p567, @p568, @p569, @p570, @p571, @p572, @p573, @p574, @p575, @p576, @p577, @p578, @p579, @p580, @p581, @p582, @p583, @p584, @p585, @p586, @p587, @p588, @p589, @p590, @p591, @p592, @p593, @p594, @p595, @p596, @p597, @p598, @p599, @p600, @p601, @p602, @p603, @p604, @p605, @p606, @p607, @p608, @p609, @p610, @p611, @p612, @p613, @p614, @p615, 10), (@p616, @p617, @p618, @p619, @p620, @p621, @p622, @p623, @p624, @p625, @p626, @p627, @p628, @p629, @p630, @p631, @p632, @p633, @p634, @p635, @p636, @p637, @p638, @p639, @p640, @p641, @p642, @p643, @p644, @p645, @p646, @p647, @p648, @p649, @p650, @p651, @p652, @p653, @p654, @p655, @p656, @p657, @p658, @p659, @p660, @p661, @p662, @p663, @p664, @p665, @p666, @p667, @p668, @p669, @p670, @p671, 11), (@p672, @p673, @p674, @p675, @p676, @p677, @p678, @p679, @p680, @p681, @p682, @p683, @p684, @p685, @p686, @p687, @p688, @p689, @p690, @p691, @p692, @p693, @p694, @p695, @p696, @p697, @p698, @p699, @p700, @p701, @p702, @p703, @p704, @p705, @p706, @p707, @p708, @p709, @p710, @p711, @p712, @p713, @p714, @p715, @p716, @p717, @p718, @p719, @p720, @p721, @p722, @p723, @p724, @p725, @p726, @p727, 12), (@p728, @p729, @p730, @p731, @p732, @p733, @p734, @p735, @p736, @p737, @p738, @p739, @p740, @p741, @p742, @p743, @p744, @p745, @p746, @p747, @p748, @p749, @p750, @p751, @p752, @p753, @p754, @p755, @p756, @p757, @p758, @p759, @p760, @p761, @p762, @p763, @p764, @p765, @p766, @p767, @p768, @p769, @p770, @p771, @p772, @p773, @p774, @p775, @p776, @p777, @p778, @p779, @p780, @p781, @p782, @p783, 13), (@p784, @p785, @p786, @p787, @p788, @p789, @p790, @p791, @p792, @p793, @p794, @p795, @p796, @p797, @p798, @p799, @p800, @p801, @p802, @p803, @p804, @p805, @p806, @p807, @p808, @p809, @p810, @p811, @p812, @p813, @p814, @p815, @p816, @p817, @p818, @p819, @p820, @p821, @p822, @p823, @p824, @p825, @p826, @p827, @p828, @p829, @p830, @p831, @p832, @p833, @p834, @p835, @p836, @p837, @p838, @p839, 14), (@p840, @p841, @p842, @p843, @p844, @p845, @p846, @p847, @p848, @p849, @p850, @p851, @p852, @p853, @p854, @p855, @p856, @p857, @p858, @p859, @p860, @p861, @p862, @p863, @p864, @p865, @p866, @p867, @p868, @p869, @p870, @p871, @p872, @p873, @p874, @p875, @p876, @p877, @p878, @p879, @p880, @p881, @p882, @p883, @p884, @p885, @p886, @p887, @p888, @p889, @p890, @p891, @p892, @p893, @p894, @p895, 15), (@p896, @p897, @p898, @p899, @p900, @p901, @p902, @p903, @p904, @p905, @p906, @p907, @p908, @p909, @p910, @p911, @p912, @p913, @p914, @p915, @p916, @p917, @p918, @p919, @p920, @p921, @p922, @p923, @p924, @p925, @p926, @p927, @p928, @p929, @p930, @p931, @p932, @p933, @p934, @p935, @p936, @p937, @p938, @p939, @p940, @p941, @p942, @p943, @p944, @p945, @p946, @p947, @p948, @p949, @p950, @p951, 16), (@p952, @p953, @p954, @p955, @p956, @p957, @p958, @p959, @p960, @p961, @p962, @p963, @p964, @p965, @p966, @p967, @p968, @p969, @p970, @p971, @p972, @p973, @p974, @p975, @p976, @p977, @p978, @p979, @p980, @p981, @p982, @p983, @p984, @p985, @p986, @p987, @p988, @p989, @p990, @p991, @p992, @p993, @p994, @p995, @p996, @p997, @p998, @p999, @p1000, @p1001, @p1002, @p1003, @p1004, @p1005, @p1006, @p1007, 17), (@p1008, @p1009, @p1010, @p1011, @p1012, @p1013, @p1014, @p1015, @p1016, @p1017, @p1018, @p1019, @p1020, @p1021, @p1022, @p1023, @p1024, @p1025, @p1026, @p1027, @p1028, @p1029, @p1030, @p1031, @p1032, @p1033, @p1034, @p1035, @p1036, @p1037, @p1038, @p1039, @p1040, @p1041, @p1042, @p1043, @p1044, @p1045, @p1046, @p1047, @p1048, @p1049, @p1050, @p1051, @p1052, @p1053, @p1054, @p1055, @p1056, @p1057, @p1058, @p1059, @p1060, @p1061, @p1062, @p1063, 18), (@p1064, @p1065, @p1066, @p1067, @p1068, @p1069, @p1070, @p1071, @p1072, @p1073, @p1074, @p1075, @p1076, @p1077, @p1078, @p1079, @p1080, @p1081, @p1082, @p1083, @p1084, @p1085, @p1086, @p1087, @p1088, @p1089, @p1090, @p1091, @p1092, @p1093, @p1094, @p1095, @p1096, @p1097, @p1098, @p1099, @p1100, @p1101, @p1102, @p1103, @p1104, @p1105, @p1106, @p1107, @p1108, @p1109, @p1110, @p1111, @p1112, @p1113, @p1114, @p1115, @p1116, @p1117, @p1118, @p1119, 19), (@p1120, @p1121, @p1122, @p1123, @p1124, @p1125, @p1126, @p1127, @p1128, @p1129, @p1130, @p1131, @p1132, @p1133, @p1134, @p1135, @p1136, @p1137, @p1138, @p1139, @p1140, @p1141, @p1142, @p1143, @p1144, @p1145, @p1146, @p1147, @p1148, @p1149, @p1150, @p1151, @p1152, @p1153, @p1154, @p1155, @p1156, @p1157, @p1158, @p1159, @p1160, @p1161, @p1162, @p1163, @p1164, @p1165, @p1166, @p1167, @p1168, @p1169, @p1170, @p1171, @p1172, @p1173, @p1174, @p1175, 20), (@p1176, @p1177, @p1178, @p1179, @p1180, @p1181, @p1182, @p1183, @p1184, @p1185, @p1186, @p1187, @p1188, @p1189, @p1190, @p1191, @p1192, @p1193, @p1194, @p1195, @p1196, @p1197, @p1198, @p1199, @p1200, @p1201, @p1202, @p1203, @p1204, @p1205, @p1206, @p1207, @p1208, @p1209, @p1210, @p1211, @p1212, @p1213, @p1214, @p1215, @p1216, @p1217, @p1218, @p1219, @p1220, @p1221, @p1222, @p1223, @p1224, @p1225, @p1226, @p1227, @p1228, @p1229, @p1230, @p1231, 21), (@p1232, @p1233, @p1234, @p1235, @p1236, @p1237, @p1238, @p1239, @p1240, @p1241, @p1242, @p1243, @p1244, @p1245, @p1246, @p1247, @p1248, @p1249, @p1250, @p1251, @p1252, @p1253, @p1254, @p1255, @p1256, @p1257, @p1258, @p1259, @p1260, @p1261, @p1262, @p1263, @p1264, @p1265, @p1266, @p1267, @p1268, @p1269, @p1270, @p1271, @p1272, @p1273, @p1274, @p1275, @p1276, @p1277, @p1278, @p1279, @p1280, @p1281, @p1282, @p1283, @p1284, @p1285, @p1286, @p1287, 22), (@p1288, @p1289, @p1290, @p1291, @p1292, @p1293, @p1294, @p1295, @p1296, @p1297, @p1298, @p1299, @p1300, @p1301, @p1302, @p1303, @p1304, @p1305, @p1306, @p1307, @p1308, @p1309, @p1310, @p1311, @p1312, @p1313, @p1314, @p1315, @p1316, @p1317, @p1318, @p1319, @p1320, @p1321, @p1322, @p1323, @p1324, @p1325, @p1326, @p1327, @p1328, @p1329, @p1330, @p1331, @p1332, @p1333, @p1334, @p1335, @p1336, @p1337, @p1338, @p1339, @p1340, @p1341, @p1342, @p1343, 23), (@p1344, @p1345, @p1346, @p1347, @p1348, @p1349, @p1350, @p1351, @p1352, @p1353, @p1354, @p1355, @p1356, @p1357, @p1358, @p1359, @p1360, @p1361, @p1362, @p1363, @p1364, @p1365, @p1366, @p1367, @p1368, @p1369, @p1370, @p1371, @p1372, @p1373, @p1374, @p1375, @p1376, @p1377, @p1378, @p1379, @p1380, @p1381, @p1382, @p1383, @p1384, @p1385, @p1386, @p1387, @p1388, @p1389, @p1390, @p1391, @p1392, @p1393, @p1394, @p1395, @p1396, @p1397, @p1398, @p1399, 24), (@p1400, @p1401, @p1402, @p1403, @p1404, @p1405, @p1406, @p1407, @p1408, @p1409, @p1410, @p1411, @p1412, @p1413, @p1414, @p1415, @p1416, @p1417, @p1418, @p1419, @p1420, @p1421, @p1422, @p1423, @p1424, @p1425, @p1426, @p1427, @p1428, @p1429, @p1430, @p1431, @p1432, @p1433, @p1434, @p1435, @p1436, @p1437, @p1438, @p1439, @p1440, @p1441, @p1442, @p1443, @p1444, @p1445, @p1446, @p1447, @p1448, @p1449, @p1450, @p1451, @p1452, @p1453, @p1454, @p1455, 25), (@p1456, @p1457, @p1458, @p1459, @p1460, @p1461, @p1462, @p1463, @p1464, @p1465, @p1466, @p1467, @p1468, @p1469, @p1470, @p1471, @p1472, @p1473, @p1474, @p1475, @p1476, @p1477, @p1478, @p1479, @p1480, @p1481, @p1482, @p1483, @p1484, @p1485, @p1486, @p1487, @p1488, @p1489, @p1490, @p1491, @p1492, @p1493, @p1494, @p1495, @p1496, @p1497, @p1498, @p1499, @p1500, @p1501, @p1502, @p1503, @p1504, @p1505, @p1506, @p1507, @p1508, @p1509, @p1510, @p1511, 26), (@p1512, @p1513, @p1514, @p1515, @p1516, @p1517, @p1518, @p1519, @p1520, @p1521, @p1522, @p1523, @p1524, @p1525, @p1526, @p1527, @p1528, @p1529, @p1530, @p1531, @p1532, @p1533, @p1534, @p1535, @p1536, @p1537, @p1538, @p1539, @p1540, @p1541, @p1542, @p1543, @p1544, @p1545, @p1546, @p1547, @p1548, @p1549, @p1550, @p1551, @p1552, @p1553, @p1554, @p1555, @p1556, @p1557, @p1558, @p1559, @p1560, @p1561, @p1562, @p1563, @p1564, @p1565, @p1566, @p1567, 27), (@p1568, @p1569, @p1570, @p1571, @p1572, @p1573, @p1574, @p1575, @p1576, @p1577, @p1578, @p1579, @p1580, @p1581, @p1582, @p1583, @p1584, @p1585, @p1586, @p1587, @p1588, @p1589, @p1590, @p1591, @p1592, @p1593, @p1594, @p1595, @p1596, @p1597, @p1598, @p1599, @p1600, @p1601, @p1602, @p1603, @p1604, @p1605, @p1606, @p1607, @p1608, @p1609, @p1610, @p1611, @p1612, @p1613, @p1614, @p1615, @p1616, @p1617, @p1618, @p1619, @p1620, @p1621, @p1622, @p1623, 28), (@p1624, @p1625, @p1626, @p1627, @p1628, @p1629, @p1630, @p1631, @p1632, @p1633, @p1634, @p1635, @p1636, @p1637, @p1638, @p1639, @p1640, @p1641, @p1642, @p1643, @p1644, @p1645, @p1646, @p1647, @p1648, @p1649, @p1650, @p1651, @p1652, @p1653, @p1654, @p1655, @p1656, @p1657, @p1658, @p1659, @p1660, @p1661, @p1662, @p1663, @p1664, @p1665, @p1666, @p1667, @p1668, @p1669, @p1670, @p1671, @p1672, @p1673, @p1674, @p1675, @p1676, @p1677, @p1678, @p1679, 29), (@p1680, @p1681, @p1682, @p1683, @p1684, @p1685, @p1686, @p1687, @p1688, @p1689, @p1690, @p1691, @p1692, @p1693, @p1694, @p1695, @p1696, @p1697, @p1698, @p1699, @p1700, @p1701, @p1702, @p1703, @p1704, @p1705, @p1706, @p1707, @p1708, @p1709, @p1710, @p1711, @p1712, @p1713, @p1714, @p1715, @p1716, @p1717, @p1718, @p1719, @p1720, @p1721, @p1722, @p1723, @p1724, @p1725, @p1726, @p1727, @p1728, @p1729, @p1730, @p1731, @p1732, @p1733, @p1734, @p1735, 30), (@p1736, @p1737, @p1738, @p1739, @p1740, @p1741, @p1742, @p1743, @p1744, @p1745, @p1746, @p1747, @p1748, @p1749, @p1750, @p1751, @p1752, @p1753, @p1754, @p1755, @p1756, @p1757, @p1758, @p1759, @p1760, @p1761, @p1762, @p1763, @p1764, @p1765, @p1766, @p1767, @p1768, @p1769, @p1770, @p1771, @p1772, @p1773, @p1774, @p1775, @p1776, @p1777, @p1778, @p1779, @p1780, @p1781, @p1782, @p1783, @p1784, @p1785, @p1786, @p1787, @p1788, @p1789, @p1790, @p1791, 31), (@p1792, @p1793, @p1794, @p1795, @p1796, @p1797, @p1798, @p1799, @p1800, @p1801, @p1802, @p1803, @p1804, @p1805, @p1806, @p1807, @p1808, @p1809, @p1810, @p1811, @p1812, @p1813, @p1814, @p1815, @p1816, @p1817, @p1818, @p1819, @p1820, @p1821, @p1822, @p1823, @p1824, @p1825, @p1826, @p1827, @p1828, @p1829, @p1830, @p1831, @p1832, @p1833, @p1834, @p1835, @p1836, @p1837, @p1838, @p1839, @p1840, @p1841, @p1842, @p1843, @p1844, @p1845, @p1846, @p1847, 32), (@p1848, @p1849, @p1850, @p1851, @p1852, @p1853, @p1854, @p1855, @p1856, @p1857, @p1858, @p1859, @p1860, @p1861, @p1862, @p1863, @p1864, @p1865, @p1866, @p1867, @p1868, @p1869, @p1870, @p1871, @p1872, @p1873, @p1874, @p1875, @p1876, @p1877, @p1878, @p1879, @p1880, @p1881, @p1882, @p1883, @p1884, @p1885, @p1886, @p1887, @p1888, @p1889, @p1890, @p1891, @p1892, @p1893, @p1894, @p1895, @p1896, @p1897, @p1898, @p1899, @p1900, @p1901, @p1902, @p1903, 33), (@p1904, @p1905, @p1906, @p1907, @p1908, @p1909, @p1910, @p1911, @p1912, @p1913, @p1914, @p1915, @p1916, @p1917, @p1918, @p1919, @p1920, @p1921, @p1922, @p1923, @p1924, @p1925, @p1926, @p1927, @p1928, @p1929, @p1930, @p1931, @p1932, @p1933, @p1934, @p1935, @p1936, @p1937, @p1938, @p1939, @p1940, @p1941, @p1942, @p1943, @p1944, @p1945, @p1946, @p1947, @p1948, @p1949, @p1950, @p1951, @p1952, @p1953, @p1954, @p1955, @p1956, @p1957, @p1958, @p1959, 34), (@p1960, @p1961, @p1962, @p1963, @p1964, @p1965, @p1966, @p1967, @p1968, @p1969, @p1970, @p1971, @p1972, @p1973, @p1974, @p1975, @p1976, @p1977, @p1978, @p1979, @p1980, @p1981, @p1982, @p1983, @p1984, @p1985, @p1986, @p1987, @p1988, @p1989, @p1990, @p1991, @p1992, @p1993, @p1994, @p1995, @p1996, @p1997, @p1998, @p1999, @p2000, @p2001, @p2002, @p2003, @p2004, @p2005, @p2006, @p2007, @p2008, @p2009, @p2010, @p2011, @p2012, @p2013, @p2014, @p2015, 35), (@p2016, @p2017, @p2018, @p2019, @p2020, @p2021, @p2022, @p2023, @p2024, @p2025, @p2026, @p2027, @p2028, @p2029, @p2030, @p2031, @p2032, @p2033, @p2034, @p2035, @p2036, @p2037, @p2038, @p2039, @p2040, @p2041, @p2042, @p2043, @p2044, @p2045, @p2046, @p2047, @p2048, @p2049, @p2050, @p2051, @p2052, @p2053, @p2054, @p2055, @p2056, @p2057, @p2058, @p2059, @p2060, @p2061, @p2062, @p2063, @p2064, @p2065, @p2066, @p2067, @p2068, @p2069, @p2070, @p2071, 36)) AS i ([addressee_cntry_cd], [addressee_city], [addressee_district], [addressee_email], [addressee_full_address], [addressee_home_address], [addressee_name], [addressee_postcode], [addressee_province], [addressee_subdistrict], [addressee_tel], [create_table], [delivery_code], [delivery_recipient_name], [delivery_relation_id], [delivery_status_id], [dest_outlet_id], [dest_outlet_port], [document_number], [item_barcode], [item_cod], [item_gross_weight], [item_height], [item_length], [item_price], [item_width], [lat], [log_id], [long], [outlet_id], [outlet_port], [podUrl], [remark], [scan_cntry_cd], [scan_cntry_postcode], [sender_cntry_cd], [sender_district], [sender_email], [sender_full_address], [sender_home_address], [member_id], [sender_name], [sender_postcode], [sender_province], [sender_subdistrict], [sender_tel], [server_id], [signatureUrl], [state], [status_code], [status_dtm], [timestamp], [transmit_dtm], [user_id], [wckt_id], [wkstn_no], _Position) ON 1=0 WHEN NOT MATCHED THEN INSERT ([addressee_cntry_cd], [addressee_city], [addressee_district], [addressee_email], [addressee_full_address], [addressee_home_address], [addressee_name], [addressee_postcode], [addressee_province], [addressee_subdistrict], [addressee_tel], [create_table], [delivery_code], [delivery_recipient_name], [delivery_relation_id], [delivery_status_id], [dest_outlet_id], [dest_outlet_port], [document_number], [item_barcode], [item_cod], [item_gross_weight], [item_height], [item_length], [item_price], [item_width], [lat], [log_id], [long], [outlet_id], [outlet_port], [podUrl], [remark], [scan_cntry_cd], [scan_cntry_postcode], [sender_cntry_cd], [sender_district], [sender_email], [sender_full_address], [sender_home_address], [member_id], [sender_name], [sender_postcode], [sender_province], [sender_subdistrict], [sender_tel], [server_id], [signatureUrl], [state], [status_code], [status_dtm], [timestamp], [transmit_dtm], [user_id], [wckt_id], [wkstn_no]) VALUES (i.[addressee_cntry_cd], i.[addressee_city], i.[addressee_district], i.[addressee_email], i.[addressee_full_address], i.[addressee_home_address], i.[addressee_name], i.[addressee_postcode], i.[addressee_province], i.[addressee_subdistrict], i.[addressee_tel], i.[create_table], i.[delivery_code], i.[delivery_recipient_name], i.[delivery_relation_id], i.[delivery_status_id], i.[dest_outlet_id], i.[dest_outlet_port], i.[document_number], i.[item_barcode], i.[item_cod], i.[item_gross_weight], i.[item_height], i.[item_length], i.[item_price], i.[item_width], i.[lat], i.[log_id], i.[long], i.[outlet_id], i.[outlet_port], i.[podUrl], i.[remark], i.[scan_cntry_cd], i.[scan_cntry_postcode], i.[sender_cntry_cd], i.[sender_district], i.[sender_email], i.[sender_full_address], i.[sender_home_address], i.[member_id], i.[sender_name], i.[sender_postcode], i.[sender_province], i.[sender_subdistrict], i.[sender_tel], i.[server_id], i.[signatureUrl], i.[state], i.[status_code], i.[status_dtm], i.[timestamp], i.[transmit_dtm], i.[user_id], i.[wckt_id], i.[wkstn_no]) OUTPUT INSERTED.[item_id], i._Position INTO @inserted0;  SELECT [t].[item_id] FROM [raw_data] t INNER JOIN @inserted0 i ON ([t].[item_id] = [i].[item_id]) ORDER BY [i].[_Position];  ",4,4,0,448,3,4
"(@p0 nvarchar(4000),@p1 nvarchar(4000),@p2 nvarchar(4000),@p3 nvarchar(4000),@p4 nvarchar(4000),@p5 nvarchar(4000),@p6 nvarchar(4000),@p7 nvarchar(4000),@p8 nvarchar(4000),@p9 nvarchar(4000),@p10 nvarchar(4000),@p11 datetime2(7),@p12 nvarchar(4000),@p13 nvarchar(4000),@p14 int,@p15 int,@p16 int,@p17 nvarchar(4000),@p18 nvarchar(4000),@p19 nvarchar(4000),@p20 nvarchar(4000),@p21 decimal(18,2),@p22 nvarchar(4000),@p23 nvarchar(4000),@p24 decimal(18,2),@p25 nvarchar(4000),@p26 nvarchar(4000),@p27 nvarchar(4000),@p28 nvarchar(4000),@p29 int,@p30 nvarchar(4000),@p31 nvarchar(4000),@p32 nvarchar(4000),@p33 nvarchar(4000),@p34 nvarchar(4000),@p35 nvarchar(4000),@p36 nvarchar(4000),@p37 nvarchar(4000),@p38 nvarchar(4000),@p39 nvarchar(4000),@p40 int,@p41 nvarchar(4000),@p42 nvarchar(4000),@p43 nvarchar(4000),@p44 nvarchar(4000),@p45 nvarchar(4000),@p46 int,@p47 nvarchar(4000),@p48 int,@p49 int,@p50 datetime2(7),@p51 datetime2(7),@p52 datetime2(7),@p53 nvarchar(4000),@p54 nvarchar(4000),@p55 nvarchar(4000),@p56 nvarchar(4000),@p57 nvarchar(4000),@p58 nvarchar(4000),@p59 nvarchar(4000),@p60 nvarchar(4000),@p61 nvarchar(4000),@p62 nvarchar(4000),@p63 nvarchar(4000),@p64 nvarchar(4000),@p65 nvarchar(4000),@p66 nvarchar(4000),@p67 datetime2(7),@p68 nvarchar(4000),@p69 nvarchar(4000),@p70 int,@p71 int,@p72 int,@p73 nvarchar(4000),@p74 nvarchar(4000),@p75 nvarchar(4000),@p76 nvarchar(4000),@p77 decimal(18,2),@p78 nvarchar(4000),@p79 nvarchar(4000),@p80 decimal(18,2),@p81 nvarchar(4000),@p82 nvarchar(4000),@p83 nvarchar(4000),@p84 nvarchar(4000),@p85 int,@p86 nvarchar(4000),@p87 nvarchar(4000),@p88 nvarchar(4000),@p89 nvarchar(4000),@p90 nvarchar(4000),@p91 nvarchar(4000),@p92 nvarchar(4000),@p93 nvarchar(4000),@p94 nvarchar(4000),@p95 nvarchar(4000),@p96 int,@p97 nvarchar(4000),@p98 nvarchar(4000),@p99 nvarchar(4000),@p100 nvarchar(4000),@p101 nvarchar(4000),@p102 int,@p103 nvarchar(4000),@p104 int,@p105 int,@p106 datetime2(7),@p107 datetime2(7),@p108 datetime2(7),@p109 nvarchar(4000),@p110 nvarchar(4000),@p111 nvarchar(4000),@p112 nvarchar(4000),@p113 nvarchar(4000),@p114 nvarchar(4000),@p115 nvarchar(4000),@p116 nvarchar(4000),@p117 nvarchar(4000),@p118 nvarchar(4000),@p119 nvarchar(4000),@p120 nvarchar(4000),@p121 nvarchar(4000),@p122 nvarchar(4000),@p123 datetime2(7),@p124 nvarchar(4000),@p125 nvarchar(4000),@p126 int,@p127 int,@p128 int,@p129 nvarchar(4000),@p130 nvarchar(4000),@p131 nvarchar(4000),@p132 nvarchar(4000),@p133 decimal(18,2),@p134 nvarchar(4000),@p135 nvarchar(4000),@p136 decimal(18,2),@p137 nvarchar(4000),@p138 nvarchar(4000),@p139 nvarchar(4000),@p140 nvarchar(4000),@p141 int,@p142 nvarchar(4000),@p143 nvarchar(4000),@p144 nvarchar(4000),@p145 nvarchar(4000),@p146 nvarchar(4000),@p147 nvarchar(4000),@p148 nvarchar(4000),@p149 nvarchar(4000),@p150 nvarchar(4000),@p151 nvarchar(4000),@p152 int,@p153 nvarchar(4000),@p154 nvarchar(4000),@p155 nvarchar(4000),@p156 nvarchar(4000),@p157 nvarchar(4000),@p158 int,@p159 nvarchar(4000),@p160 int,@p161 int,@p162 datetime2(7),@p163 datetime2(7),@p164 datetime2(7),@p165 nvarchar(4000),@p166 nvarchar(4000),@p167 nvarchar(4000),@p168 nvarchar(4000),@p169 nvarchar(4000),@p170 nvarchar(4000),@p171 nvarchar(4000),@p172 nvarchar(4000),@p173 nvarchar(4000),@p174 nvarchar(4000),@p175 nvarchar(4000),@p176 nvarchar(4000),@p177 nvarchar(4000),@p178 nvarchar(4000),@p179 datetime2(7),@p180 nvarchar(4000),@p181 nvarchar(4000),@p182 int,@p183 int,@p184 int,@p185 nvarchar(4000),@p186 nvarchar(4000),@p187 nvarchar(4000),@p188 nvarchar(4000),@p189 decimal(18,2),@p190 nvarchar(4000),@p191 nvarchar(4000),@p192 decimal(18,2),@p193 nvarchar(4000),@p194 nvarchar(4000),@p195 nvarchar(4000),@p196 nvarchar(4000),@p197 int,@p198 nvarchar(4000),@p199 nvarchar(4000),@p200 nvarchar(4000),@p201 nvarchar(4000),@p202 nvarchar(4000),@p203 nvarchar(4000),@p204 nvarchar(4000),@p205 nvarchar(4000),@p206 nvarchar(4000),@p207 nvarchar(4000),@p208 int,@p209 nvarchar(4000),@p210 nvarchar(4000),@p211 nvarchar(4000),@p212 nvarchar(4000),@p213 nvarchar(4000),@p214 int,@p215 nvarchar(4000),@p216 int,@p217 int,@p218 datetime2(7),@p219 datetime2(7),@p220 datetime2(7),@p221 nvarchar(4000),@p222 nvarchar(4000),@p223 nvarchar(4000),@p224 nvarchar(4000),@p225 nvarchar(4000),@p226 nvarchar(4000),@p227 nvarchar(4000),@p228 nvarchar(4000),@p229 nvarchar(4000),@p230 nvarchar(4000),@p231 nvarchar(4000),@p232 nvarchar(4000),@p233 nvarchar(4000),@p234 nvarchar(4000),@p235 datetime2(7),@p236 nvarchar(4000),@p237 nvarchar(4000),@p238 int,@p239 int,@p240 int,@p241 nvarchar(4000),@p242 nvarchar(4000),@p243 nvarchar(4000),@p244 nvarchar(4000),@p245 decimal(18,2),@p246 nvarchar(4000),@p247 nvarchar(4000),@p248 decimal(18,2),@p249 nvarchar(4000),@p250 nvarchar(4000),@p251 nvarchar(4000),@p252 nvarchar(4000),@p253 int,@p254 nvarchar(4000),@p255 nvarchar(4000),@p256 nvarchar(4000),@p257 nvarchar(4000),@p258 nvarchar(4000),@p259 nvarchar(4000),@p260 nvarchar(4000),@p261 nvarchar(4000),@p262 nvarchar(4000),@p263 nvarchar(4000),@p264 int,@p265 nvarchar(4000),@p266 nvarchar(4000),@p267 nvarchar(4000),@p268 nvarchar(4000),@p269 nvarchar(4000),@p270 int,@p271 nvarchar(4000),@p272 int,@p273 int,@p274 datetime2(7),@p275 datetime2(7),@p276 datetime2(7),@p277 nvarchar(4000),@p278 nvarchar(4000),@p279 nvarchar(4000),@p280 nvarchar(4000),@p281 nvarchar(4000),@p282 nvarchar(4000),@p283 nvarchar(4000),@p284 nvarchar(4000),@p285 nvarchar(4000),@p286 nvarchar(4000),@p287 nvarchar(4000),@p288 nvarchar(4000),@p289 nvarchar(4000),@p290 nvarchar(4000),@p291 datetime2(7),@p292 nvarchar(4000),@p293 nvarchar(4000),@p294 int,@p295 int,@p296 int,@p297 nvarchar(4000),@p298 nvarchar(4000),@p299 nvarchar(4000),@p300 nvarchar(4000),@p301 decimal(18,2),@p302 nvarchar(4000),@p303 nvarchar(4000),@p304 decimal(18,2),@p305 nvarchar(4000),@p306 nvarchar(4000),@p307 nvarchar(4000),@p308 nvarchar(4000),@p309 int,@p310 nvarchar(4000),@p311 nvarchar(4000),@p312 nvarchar(4000),@p313 nvarchar(4000),@p314 nvarchar(4000),@p315 nvarchar(4000),@p316 nvarchar(4000),@p317 nvarchar(4000),@p318 nvarchar(4000),@p319 nvarchar(4000),@p320 int,@p321 nvarchar(4000),@p322 nvarchar(4000),@p323 nvarchar(4000),@p324 nvarchar(4000),@p325 nvarchar(4000),@p326 int,@p327 nvarchar(4000),@p328 int,@p329 int,@p330 datetime2(7),@p331 datetime2(7),@p332 datetime2(7),@p333 nvarchar(4000),@p334 nvarchar(4000),@p335 nvarchar(4000),@p336 nvarchar(4000),@p337 nvarchar(4000),@p338 nvarchar(4000),@p339 nvarchar(4000),@p340 nvarchar(4000),@p341 nvarchar(4000),@p342 nvarchar(4000),@p343 nvarchar(4000),@p344 nvarchar(4000),@p345 nvarchar(4000),@p346 nvarchar(4000),@p347 datetime2(7),@p348 nvarchar(4000),@p349 nvarchar(4000),@p350 int,@p351 int,@p352 int,@p353 nvarchar(4000),@p354 nvarchar(4000),@p355 nvarchar(4000),@p356 nvarchar(4000),@p357 decimal(18,2),@p358 nvarchar(4000),@p359 nvarchar(4000),@p360 decimal(18,2),@p361 nvarchar(4000),@p362 nvarchar(4000),@p363 nvarchar(4000),@p364 nvarchar(4000),@p365 int,@p366 nvarchar(4000),@p367 nvarchar(4000),@p368 nvarchar(4000),@p369 nvarchar(4000),@p370 nvarchar(4000),@p371 nvarchar(4000),@p372 nvarchar(4000),@p373 nvarchar(4000),@p374 nvarchar(4000),@p375 nvarchar(4000),@p376 int,@p377 nvarchar(4000),@p378 nvarchar(4000),@p379 nvarchar(4000),@p380 nvarchar(4000),@p381 nvarchar(4000),@p382 int,@p383 nvarchar(4000),@p384 int,@p385 int,@p386 datetime2(7),@p387 datetime2(7),@p388 datetime2(7),@p389 nvarchar(4000),@p390 nvarchar(4000),@p391 nvarchar(4000),@p392 nvarchar(4000),@p393 nvarchar(4000),@p394 nvarchar(4000),@p395 nvarchar(4000),@p396 nvarchar(4000),@p397 nvarchar(4000),@p398 nvarchar(4000),@p399 nvarchar(4000),@p400 nvarchar(4000),@p401 nvarchar(4000),@p402 nvarchar(4000),@p403 datetime2(7),@p404 nvarchar(4000),@p405 nvarchar(4000),@p406 int,@p407 int,@p408 int,@p409 nvarchar(4000),@p410 nvarchar(4000),@p411 nvarchar(4000),@p412 nvarchar(4000),@p413 decimal(18,2),@p414 nvarchar(4000),@p415 nvarchar(4000),@p416 decimal(18,2),@p417 nvarchar(4000),@p418 nvarchar(4000),@p419 nvarchar(4000),@p420 nvarchar(4000),@p421 int,@p422 nvarchar(4000),@p423 nvarchar(4000),@p424 nvarchar(4000),@p425 nvarchar(4000),@p426 nvarchar(4000),@p427 nvarchar(4000),@p428 nvarchar(4000),@p429 nvarchar(4000),@p430 nvarchar(4000),@p431 nvarchar(4000),@p432 int,@p433 nvarchar(4000),@p434 nvarchar(4000),@p435 nvarchar(4000),@p436 nvarchar(4000),@p437 nvarchar(4000),@p438 int,@p439 nvarchar(4000),@p440 int,@p441 int,@p442 datetime2(7),@p443 datetime2(7),@p444 datetime2(7),@p445 nvarchar(4000),@p446 nvarchar(4000),@p447 nvarchar(4000),@p448 nvarchar(4000),@p449 nvarchar(4000),@p450 nvarchar(4000),@p451 nvarchar(4000),@p452 nvarchar(4000),@p453 nvarchar(4000),@p454 nvarchar(4000),@p455 nvarchar(4000),@p456 nvarchar(4000),@p457 nvarchar(4000),@p458 nvarchar(4000),@p459 datetime2(7),@p460 nvarchar(4000),@p461 nvarchar(4000),@p462 int,@p463 int,@p464 int,@p465 nvarchar(4000),@p466 nvarchar(4000),@p467 nvarchar(4000),@p468 nvarchar(4000),@p469 decimal(18,2),@p470 nvarchar(4000),@p471 nvarchar(4000),@p472 decimal(18,2),@p473 nvarchar(4000),@p474 nvarchar(4000),@p475 nvarchar(4000),@p476 nvarchar(4000),@p477 int,@p478 nvarchar(4000),@p479 nvarchar(4000),@p480 nvarchar(4000),@p481 nvarchar(4000),@p482 nvarchar(4000),@p483 nvarchar(4000),@p484 nvarchar(4000),@p485 nvarchar(4000),@p486 nvarchar(4000),@p487 nvarchar(4000),@p488 int,@p489 nvarchar(4000),@p490 nvarchar(4000),@p491 nvarchar(4000),@p492 nvarchar(4000),@p493 nvarchar(4000),@p494 int,@p495 nvarchar(4000),@p496 int,@p497 int,@p498 datetime2(7),@p499 datetime2(7),@p500 datetime2(7),@p501 nvarchar(4000),@p502 nvarchar(4000),@p503 nvarchar(4000),@p504 nvarchar(4000),@p505 nvarchar(4000),@p506 nvarchar(4000),@p507 nvarchar(4000),@p508 nvarchar(4000),@p509 nvarchar(4000),@p510 nvarchar(4000),@p511 nvarchar(4000),@p512 nvarchar(4000),@p513 nvarchar(4000),@p514 nvarchar(4000),@p515 datetime2(7),@p516 nvarchar(4000),@p517 nvarchar(4000),@p518 int,@p519 int,@p520 int,@p521 nvarchar(4000),@p522 nvarchar(4000),@p523 nvarchar(4000),@p524 nvarchar(4000),@p525 decimal(18,2),@p526 nvarchar(4000),@p527 nvarchar(4000),@p528 decimal(18,2),@p529 nvarchar(4000),@p530 nvarchar(4000),@p531 nvarchar(4000),@p532 nvarchar(4000),@p533 int,@p534 nvarchar(4000),@p535 nvarchar(4000),@p536 nvarchar(4000),@p537 nvarchar(4000),@p538 nvarchar(4000),@p539 nvarchar(4000),@p540 nvarchar(4000),@p541 nvarchar(4000),@p542 nvarchar(4000),@p543 nvarchar(4000),@p544 int,@p545 nvarchar(4000),@p546 nvarchar(4000),@p547 nvarchar(4000),@p548 nvarchar(4000),@p549 nvarchar(4000),@p550 int,@p551 nvarchar(4000),@p552 int,@p553 int,@p554 datetime2(7),@p555 datetime2(7),@p556 datetime2(7),@p557 nvarchar(4000),@p558 nvarchar(4000),@p559 nvarchar(4000),@p560 nvarchar(4000),@p561 nvarchar(4000),@p562 nvarchar(4000),@p563 nvarchar(4000),@p564 nvarchar(4000),@p565 nvarchar(4000),@p566 nvarchar(4000),@p567 nvarchar(4000),@p568 nvarchar(4000),@p569 nvarchar(4000),@p570 nvarchar(4000),@p571 datetime2(7),@p572 nvarchar(4000),@p573 nvarchar(4000),@p574 int,@p575 int,@p576 int,@p577 nvarchar(4000),@p578 nvarchar(4000),@p579 nvarchar(4000),@p580 nvarchar(4000),@p581 decimal(18,2),@p582 nvarchar(4000),@p583 nvarchar(4000),@p584 decimal(18,2),@p585 nvarchar(4000),@p586 nvarchar(4000),@p587 nvarchar(4000),@p588 nvarchar(4000),@p589 int,@p590 nvarchar(4000),@p591 nvarchar(4000),@p592 nvarchar(4000),@p593 nvarchar(4000),@p594 nvarchar(4000),@p595 nvarchar(4000),@p596 nvarchar(4000),@p597 nvarchar(4000),@p598 nvarchar(4000),@p599 nvarchar(4000),@p600 int,@p601 nvarchar(4000),@p602 nvarchar(4000),@p603 nvarchar(4000),@p604 nvarchar(4000),@p605 nvarchar(4000),@p606 int,@p607 nvarchar(4000),@p608 int,@p609 int,@p610 datetime2(7),@p611 datetime2(7),@p612 datetime2(7),@p613 nvarchar(4000),@p614 nvarchar(4000),@p615 nvarchar(4000),@p616 nvarchar(4000),@p617 nvarchar(4000),@p618 nvarchar(4000),@p619 nvarchar(4000),@p620 nvarchar(4000),@p621 nvarchar(4000),@p622 nvarchar(4000),@p623 nvarchar(4000),@p624 nvarchar(4000),@p625 nvarchar(4000),@p626 nvarchar(4000),@p627 datetime2(7),@p628 nvarchar(4000),@p629 nvarchar(4000),@p630 int,@p631 int,@p632 int,@p633 nvarchar(4000),@p634 nvarchar(4000),@p635 nvarchar(4000),@p636 nvarchar(4000),@p637 decimal(18,2),@p638 nvarchar(4000),@p639 nvarchar(4000),@p640 decimal(18,2),@p641 nvarchar(4000),@p642 nvarchar(4000),@p643 nvarchar(4000),@p644 nvarchar(4000),@p645 int,@p646 nvarchar(4000),@p647 nvarchar(4000),@p648 nvarchar(4000),@p649 nvarchar(4000),@p650 nvarchar(4000),@p651 nvarchar(4000),@p652 nvarchar(4000),@p653 nvarchar(4000),@p654 nvarchar(4000),@p655 nvarchar(4000),@p656 int,@p657 nvarchar(4000),@p658 nvarchar(4000),@p659 nvarchar(4000),@p660 nvarchar(4000),@p661 nvarchar(4000),@p662 int,@p663 nvarchar(4000),@p664 int,@p665 int,@p666 datetime2(7),@p667 datetime2(7),@p668 datetime2(7),@p669 nvarchar(4000),@p670 nvarchar(4000),@p671 nvarchar(4000),@p672 nvarchar(4000),@p673 nvarchar(4000),@p674 nvarchar(4000),@p675 nvarchar(4000),@p676 nvarchar(4000),@p677 nvarchar(4000),@p678 nvarchar(4000),@p679 nvarchar(4000),@p680 nvarchar(4000),@p681 nvarchar(4000),@p682 nvarchar(4000),@p683 datetime2(7),@p684 nvarchar(4000),@p685 nvarchar(4000),@p686 int,@p687 int,@p688 int,@p689 nvarchar(4000),@p690 nvarchar(4000),@p691 nvarchar(4000),@p692 nvarchar(4000),@p693 decimal(18,2),@p694 nvarchar(4000),@p695 nvarchar(4000),@p696 decimal(18,2),@p697 nvarchar(4000),@p698 nvarchar(4000),@p699 nvarchar(4000),@p700 nvarchar(4000),@p701 int,@p702 nvarchar(4000),@p703 nvarchar(4000),@p704 nvarchar(4000),@p705 nvarchar(4000),@p706 nvarchar(4000),@p707 nvarchar(4000),@p708 nvarchar(4000),@p709 nvarchar(4000),@p710 nvarchar(4000),@p711 nvarchar(4000),@p712 int,@p713 nvarchar(4000),@p714 nvarchar(4000),@p715 nvarchar(4000),@p716 nvarchar(4000),@p717 nvarchar(4000),@p718 int,@p719 nvarchar(4000),@p720 int,@p721 int,@p722 datetime2(7),@p723 datetime2(7),@p724 datetime2(7),@p725 nvarchar(4000),@p726 nvarchar(4000),@p727 nvarchar(4000),@p728 nvarchar(4000),@p729 nvarchar(4000),@p730 nvarchar(4000),@p731 nvarchar(4000),@p732 nvarchar(4000),@p733 nvarchar(4000),@p734 nvarchar(4000),@p735 nvarchar(4000),@p736 nvarchar(4000),@p737 nvarchar(4000),@p738 nvarchar(4000),@p739 datetime2(7),@p740 nvarchar(4000),@p741 nvarchar(4000),@p742 int,@p743 int,@p744 int,@p745 nvarchar(4000),@p746 nvarchar(4000),@p747 nvarchar(4000),@p748 nvarchar(4000),@p749 decimal(18,2),@p750 nvarchar(4000),@p751 nvarchar(4000),@p752 decimal(18,2),@p753 nvarchar(4000),@p754 nvarchar(4000),@p755 nvarchar(4000),@p756 nvarchar(4000),@p757 int,@p758 nvarchar(4000),@p759 nvarchar(4000),@p760 nvarchar(4000),@p761 nvarchar(4000),@p762 nvarchar(4000),@p763 nvarchar(4000),@p764 nvarchar(4000),@p765 nvarchar(4000),@p766 nvarchar(4000),@p767 nvarchar(4000),@p768 int,@p769 nvarchar(4000),@p770 nvarchar(4000),@p771 nvarchar(4000),@p772 nvarchar(4000),@p773 nvarchar(4000),@p774 int,@p775 nvarchar(4000),@p776 int,@p777 int,@p778 datetime2(7),@p779 datetime2(7),@p780 datetime2(7),@p781 nvarchar(4000),@p782 nvarchar(4000),@p783 nvarchar(4000),@p784 nvarchar(4000),@p785 nvarchar(4000),@p786 nvarchar(4000),@p787 nvarchar(4000),@p788 nvarchar(4000),@p789 nvarchar(4000),@p790 nvarchar(4000),@p791 nvarchar(4000),@p792 nvarchar(4000),@p793 nvarchar(4000),@p794 nvarchar(4000),@p795 datetime2(7),@p796 nvarchar(4000),@p797 nvarchar(4000),@p798 int,@p799 int,@p800 int,@p801 nvarchar(4000),@p802 nvarchar(4000),@p803 nvarchar(4000),@p804 nvarchar(4000),@p805 decimal(18,2),@p806 nvarchar(4000),@p807 nvarchar(4000),@p808 decimal(18,2),@p809 nvarchar(4000),@p810 nvarchar(4000),@p811 nvarchar(4000),@p812 nvarchar(4000),@p813 int,@p814 nvarchar(4000),@p815 nvarchar(4000),@p816 nvarchar(4000),@p817 nvarchar(4000),@p818 nvarchar(4000),@p819 nvarchar(4000),@p820 nvarchar(4000),@p821 nvarchar(4000),@p822 nvarchar(4000),@p823 nvarchar(4000),@p824 int,@p825 nvarchar(4000),@p826 nvarchar(4000),@p827 nvarchar(4000),@p828 nvarchar(4000),@p829 nvarchar(4000),@p830 int,@p831 nvarchar(4000),@p832 int,@p833 int,@p834 datetime2(7),@p835 datetime2(7),@p836 datetime2(7),@p837 nvarchar(4000),@p838 nvarchar(4000),@p839 nvarchar(4000),@p840 nvarchar(4000),@p841 nvarchar(4000),@p842 nvarchar(4000),@p843 nvarchar(4000),@p844 nvarchar(4000),@p845 nvarchar(4000),@p846 nvarchar(4000),@p847 nvarchar(4000),@p848 nvarchar(4000),@p849 nvarchar(4000),@p850 nvarchar(4000),@p851 datetime2(7),@p852 nvarchar(4000),@p853 nvarchar(4000),@p854 int,@p855 int,@p856 int,@p857 nvarchar(4000),@p858 nvarchar(4000),@p859 nvarchar(4000),@p860 nvarchar(4000),@p861 decimal(18,2),@p862 nvarchar(4000),@p863 nvarchar(4000),@p864 decimal(18,2),@p865 nvarchar(4000),@p866 nvarchar(4000),@p867 nvarchar(4000),@p868 nvarchar(4000),@p869 int,@p870 nvarchar(4000),@p871 nvarchar(4000),@p872 nvarchar(4000),@p873 nvarchar(4000),@p874 nvarchar(4000),@p875 nvarchar(4000),@p876 nvarchar(4000),@p877 nvarchar(4000),@p878 nvarchar(4000),@p879 nvarchar(4000),@p880 int,@p881 nvarchar(4000),@p882 nvarchar(4000),@p883 nvarchar(4000),@p884 nvarchar(4000),@p885 nvarchar(4000),@p886 int,@p887 nvarchar(4000),@p888 int,@p889 int,@p890 datetime2(7),@p891 datetime2(7),@p892 datetime2(7),@p893 nvarchar(4000),@p894 nvarchar(4000),@p895 nvarchar(4000),@p896 nvarchar(4000),@p897 nvarchar(4000),@p898 nvarchar(4000),@p899 nvarchar(4000),@p900 nvarchar(4000),@p901 nvarchar(4000),@p902 nvarchar(4000),@p903 nvarchar(4000),@p904 nvarchar(4000),@p905 nvarchar(4000),@p906 nvarchar(4000),@p907 datetime2(7),@p908 nvarchar(4000),@p909 nvarchar(4000),@p910 int,@p911 int,@p912 int,@p913 nvarchar(4000),@p914 nvarchar(4000),@p915 nvarchar(4000),@p916 nvarchar(4000),@p917 decimal(18,2),@p918 nvarchar(4000),@p919 nvarchar(4000),@p920 decimal(18,2),@p921 nvarchar(4000),@p922 nvarchar(4000),@p923 nvarchar(4000),@p924 nvarchar(4000),@p925 int,@p926 nvarchar(4000),@p927 nvarchar(4000),@p928 nvarchar(4000),@p929 nvarchar(4000),@p930 nvarchar(4000),@p931 nvarchar(4000),@p932 nvarchar(4000),@p933 nvarchar(4000),@p934 nvarchar(4000),@p935 nvarchar(4000),@p936 int,@p937 nvarchar(4000),@p938 nvarchar(4000),@p939 nvarchar(4000),@p940 nvarchar(4000),@p941 nvarchar(4000),@p942 int,@p943 nvarchar(4000),@p944 int,@p945 int,@p946 datetime2(7),@p947 datetime2(7),@p948 datetime2(7),@p949 nvarchar(4000),@p950 nvarchar(4000),@p951 nvarchar(4000),@p952 nvarchar(4000),@p953 nvarchar(4000),@p954 nvarchar(4000),@p955 nvarchar(4000),@p956 nvarchar(4000),@p957 nvarchar(4000),@p958 nvarchar(4000),@p959 nvarchar(4000),@p960 nvarchar(4000),@p961 nvarchar(4000),@p962 nvarchar(4000),@p963 datetime2(7),@p964 nvarchar(4000),@p965 nvarchar(4000),@p966 int,@p967 int,@p968 int,@p969 nvarchar(4000),@p970 nvarchar(4000),@p971 nvarchar(4000),@p972 nvarchar(4000),@p973 decimal(18,2),@p974 nvarchar(4000),@p975 nvarchar(4000),@p976 decimal(18,2),@p977 nvarchar(4000),@p978 nvarchar(4000),@p979 nvarchar(4000),@p980 nvarchar(4000),@p981 int,@p982 nvarchar(4000),@p983 nvarchar(4000),@p984 nvarchar(4000),@p985 nvarchar(4000),@p986 nvarchar(4000),@p987 nvarchar(4000),@p988 nvarchar(4000),@p989 nvarchar(4000),@p990 nvarchar(4000),@p991 nvarchar(4000),@p992 int,@p993 nvarchar(4000),@p994 nvarchar(4000),@p995 nvarchar(4000),@p996 nvarchar(4000),@p997 nvarchar(4000),@p998 int,@p999 nvarchar(4000),@p1000 int,@p1001 int,@p1002 datetime2(7),@p1003 datetime2(7),@p1004 datetime2(7),@p1005 nvarchar(4000),@p1006 nvarchar(4000),@p1007 nvarchar(4000),@p1008 nvarchar(4000),@p1009 nvarchar(4000),@p1010 nvarchar(4000),@p1011 nvarchar(4000),@p1012 nvarchar(4000),@p1013 nvarchar(4000),@p1014 nvarchar(4000),@p1015 nvarchar(4000),@p1016 nvarchar(4000),@p1017 nvarchar(4000),@p1018 nvarchar(4000),@p1019 datetime2(7),@p1020 nvarchar(4000),@p1021 nvarchar(4000),@p1022 int,@p1023 int,@p1024 int,@p1025 nvarchar(4000),@p1026 nvarchar(4000),@p1027 nvarchar(4000),@p1028 nvarchar(4000),@p1029 decimal(18,2),@p1030 nvarchar(4000),@p1031 nvarchar(4000),@p1032 decimal(18,2),@p1033 nvarchar(4000),@p1034 nvarchar(4000),@p1035 nvarchar(4000),@p1036 nvarchar(4000),@p1037 int,@p1038 nvarchar(4000),@p1039 nvarchar(4000),@p1040 nvarchar(4000),@p1041 nvarchar(4000),@p1042 nvarchar(4000),@p1043 nvarchar(4000),@p1044 nvarchar(4000),@p1045 nvarchar(4000),@p1046 nvarchar(4000),@p1047 nvarchar(4000),@p1048 int,@p1049 nvarchar(4000),@p1050 nvarchar(4000),@p1051 nvarchar(4000),@p1052 nvarchar(4000),@p1053 nvarchar(4000),@p1054 int,@p1055 nvarchar(4000),@p1056 int,@p1057 int,@p1058 datetime2(7),@p1059 datetime2(7),@p1060 datetime2(7),@p1061 nvarchar(4000),@p1062 nvarchar(4000),@p1063 nvarchar(4000),@p1064 nvarchar(4000),@p1065 nvarchar(4000),@p1066 nvarchar(4000),@p1067 nvarchar(4000),@p1068 nvarchar(4000),@p1069 nvarchar(4000),@p1070 nvarchar(4000),@p1071 nvarchar(4000),@p1072 nvarchar(4000),@p1073 nvarchar(4000),@p1074 nvarchar(4000),@p1075 datetime2(7),@p1076 nvarchar(4000),@p1077 nvarchar(4000),@p1078 int,@p1079 int,@p1080 int,@p1081 nvarchar(4000),@p1082 nvarchar(4000),@p1083 nvarchar(4000),@p1084 decimal(18,2),@p1085 decimal(18,2),@p1086 nvarchar(4000),@p1087 nvarchar(4000),@p1088 decimal(18,2),@p1089 nvarchar(4000),@p1090 nvarchar(4000),@p1091 nvarchar(4000),@p1092 nvarchar(4000),@p1093 int,@p1094 nvarchar(4000),@p1095 nvarchar(4000),@p1096 nvarchar(4000),@p1097 nvarchar(4000),@p1098 nvarchar(4000),@p1099 nvarchar(4000),@p1100 nvarchar(4000),@p1101 nvarchar(4000),@p1102 nvarchar(4000),@p1103 nvarchar(4000),@p1104 int,@p1105 nvarchar(4000),@p1106 nvarchar(4000),@p1107 nvarchar(4000),@p1108 nvarchar(4000),@p1109 nvarchar(4000),@p1110 int,@p1111 nvarchar(4000),@p1112 int,@p1113 int,@p1114 datetime2(7),@p1115 datetime2(7),@p1116 datetime2(7),@p1117 nvarchar(4000),@p1118 nvarchar(4000),@p1119 nvarchar(4000),@p1120 nvarchar(4000),@p1121 nvarchar(4000),@p1122 nvarchar(4000),@p1123 nvarchar(4000),@p1124 nvarchar(4000),@p1125 nvarchar(4000),@p1126 nvarchar(4000),@p1127 nvarchar(4000),@p1128 nvarchar(4000),@p1129 nvarchar(4000),@p1130 nvarchar(4000),@p1131 datetime2(7),@p1132 nvarchar(4000),@p1133 nvarchar(4000),@p1134 int,@p1135 int,@p1136 int,@p1137 nvarchar(4000),@p1138 nvarchar(4000),@p1139 nvarchar(4000),@p1140 nvarchar(4000),@p1141 decimal(18,2),@p1142 nvarchar(4000),@p1143 nvarchar(4000),@p1144 decimal(18,2),@p1145 nvarchar(4000),@p1146 nvarchar(4000),@p1147 nvarchar(4000),@p1148 nvarchar(4000),@p1149 int,@p1150 nvarchar(4000),@p1151 nvarchar(4000),@p1152 nvarchar(4000),@p1153 nvarchar(4000),@p1154 nvarchar(4000),@p1155 nvarchar(4000),@p1156 nvarchar(4000),@p1157 nvarchar(4000),@p1158 nvarchar(4000),@p1159 nvarchar(4000),@p1160 int,@p1161 nvarchar(4000),@p1162 nvarchar(4000),@p1163 nvarchar(4000),@p1164 nvarchar(4000),@p1165 nvarchar(4000),@p1166 int,@p1167 nvarchar(4000),@p1168 int,@p1169 int,@p1170 datetime2(7),@p1171 datetime2(7),@p1172 datetime2(7),@p1173 nvarchar(4000),@p1174 nvarchar(4000),@p1175 nvarchar(4000),@p1176 nvarchar(4000),@p1177 nvarchar(4000),@p1178 nvarchar(4000),@p1179 nvarchar(4000),@p1180 nvarchar(4000),@p1181 nvarchar(4000),@p1182 nvarchar(4000),@p1183 nvarchar(4000),@p1184 nvarchar(4000),@p1185 nvarchar(4000),@p1186 nvarchar(4000),@p1187 datetime2(7),@p1188 nvarchar(4000),@p1189 nvarchar(4000),@p1190 int,@p1191 int,@p1192 int,@p1193 nvarchar(4000),@p1194 nvarchar(4000),@p1195 nvarchar(4000),@p1196 nvarchar(4000),@p1197 decimal(18,2),@p1198 nvarchar(4000),@p1199 nvarchar(4000),@p1200 decimal(18,2),@p1201 nvarchar(4000),@p1202 nvarchar(4000),@p1203 nvarchar(4000),@p1204 nvarchar(4000),@p1205 int,@p1206 nvarchar(4000),@p1207 nvarchar(4000),@p1208 nvarchar(4000),@p1209 nvarchar(4000),@p1210 nvarchar(4000),@p1211 nvarchar(4000),@p1212 nvarchar(4000),@p1213 nvarchar(4000),@p1214 nvarchar(4000),@p1215 nvarchar(4000),@p1216 int,@p1217 nvarchar(4000),@p1218 nvarchar(4000),@p1219 nvarchar(4000),@p1220 nvarchar(4000),@p1221 nvarchar(4000),@p1222 int,@p1223 nvarchar(4000),@p1224 int,@p1225 int,@p1226 datetime2(7),@p1227 datetime2(7),@p1228 datetime2(7),@p1229 nvarchar(4000),@p1230 nvarchar(4000),@p1231 nvarchar(4000),@p1232 nvarchar(4000),@p1233 nvarchar(4000),@p1234 nvarchar(4000),@p1235 nvarchar(4000),@p1236 nvarchar(4000),@p1237 nvarchar(4000),@p1238 nvarchar(4000),@p1239 nvarchar(4000),@p1240 nvarchar(4000),@p1241 nvarchar(4000),@p1242 nvarchar(4000),@p1243 datetime2(7),@p1244 nvarchar(4000),@p1245 nvarchar(4000),@p1246 int,@p1247 int,@p1248 int,@p1249 nvarchar(4000),@p1250 nvarchar(4000),@p1251 nvarchar(4000),@p1252 nvarchar(4000),@p1253 decimal(18,2),@p1254 nvarchar(4000),@p1255 nvarchar(4000),@p1256 decimal(18,2),@p1257 nvarchar(4000),@p1258 nvarchar(4000),@p1259 nvarchar(4000),@p1260 nvarchar(4000),@p1261 int,@p1262 nvarchar(4000),@p1263 nvarchar(4000),@p1264 nvarchar(4000),@p1265 nvarchar(4000),@p1266 nvarchar(4000),@p1267 nvarchar(4000),@p1268 nvarchar(4000),@p1269 nvarchar(4000),@p1270 nvarchar(4000),@p1271 nvarchar(4000),@p1272 int,@p1273 nvarchar(4000),@p1274 nvarchar(4000),@p1275 nvarchar(4000),@p1276 nvarchar(4000),@p1277 nvarchar(4000),@p1278 int,@p1279 nvarchar(4000),@p1280 int,@p1281 int,@p1282 datetime2(7),@p1283 datetime2(7),@p1284 datetime2(7),@p1285 nvarchar(4000),@p1286 nvarchar(4000),@p1287 nvarchar(4000),@p1288 nvarchar(4000),@p1289 nvarchar(4000),@p1290 nvarchar(4000),@p1291 nvarchar(4000),@p1292 nvarchar(4000),@p1293 nvarchar(4000),@p1294 nvarchar(4000),@p1295 nvarchar(4000),@p1296 nvarchar(4000),@p1297 nvarchar(4000),@p1298 nvarchar(4000),@p1299 datetime2(7),@p1300 nvarchar(4000),@p1301 nvarchar(4000),@p1302 int,@p1303 int,@p1304 int,@p1305 nvarchar(4000),@p1306 nvarchar(4000),@p1307 nvarchar(4000),@p1308 nvarchar(4000),@p1309 decimal(18,2),@p1310 nvarchar(4000),@p1311 nvarchar(4000),@p1312 decimal(18,2),@p1313 nvarchar(4000),@p1314 nvarchar(4000),@p1315 nvarchar(4000),@p1316 nvarchar(4000),@p1317 int,@p1318 nvarchar(4000),@p1319 nvarchar(4000),@p1320 nvarchar(4000),@p1321 nvarchar(4000),@p1322 nvarchar(4000),@p1323 nvarchar(4000),@p1324 nvarchar(4000),@p1325 nvarchar(4000),@p1326 nvarchar(4000),@p1327 nvarchar(4000),@p1328 int,@p1329 nvarchar(4000),@p1330 nvarchar(4000),@p1331 nvarchar(4000),@p1332 nvarchar(4000),@p1333 nvarchar(4000),@p1334 int,@p1335 nvarchar(4000),@p1336 int,@p1337 int,@p1338 datetime2(7),@p1339 datetime2(7),@p1340 datetime2(7),@p1341 nvarchar(4000),@p1342 nvarchar(4000),@p1343 nvarchar(4000),@p1344 nvarchar(4000),@p1345 nvarchar(4000),@p1346 nvarchar(4000),@p1347 nvarchar(4000),@p1348 nvarchar(4000),@p1349 nvarchar(4000),@p1350 nvarchar(4000),@p1351 nvarchar(4000),@p1352 nvarchar(4000),@p1353 nvarchar(4000),@p1354 nvarchar(4000),@p1355 datetime2(7),@p1356 nvarchar(4000),@p1357 nvarchar(4000),@p1358 int,@p1359 int,@p1360 int,@p1361 nvarchar(4000),@p1362 nvarchar(4000),@p1363 nvarchar(4000),@p1364 nvarchar(4000),@p1365 decimal(18,2),@p1366 nvarchar(4000),@p1367 nvarchar(4000),@p1368 decimal(18,2),@p1369 nvarchar(4000),@p1370 nvarchar(4000),@p1371 nvarchar(4000),@p1372 nvarchar(4000),@p1373 int,@p1374 nvarchar(4000),@p1375 nvarchar(4000),@p1376 nvarchar(4000),@p1377 nvarchar(4000),@p1378 nvarchar(4000),@p1379 nvarchar(4000),@p1380 nvarchar(4000),@p1381 nvarchar(4000),@p1382 nvarchar(4000),@p1383 nvarchar(4000),@p1384 int,@p1385 nvarchar(4000),@p1386 nvarchar(4000),@p1387 nvarchar(4000),@p1388 nvarchar(4000),@p1389 nvarchar(4000),@p1390 int,@p1391 nvarchar(4000),@p1392 int,@p1393 int,@p1394 datetime2(7),@p1395 datetime2(7),@p1396 datetime2(7),@p1397 nvarchar(4000),@p1398 nvarchar(4000),@p1399 nvarchar(4000),@p1400 nvarchar(4000),@p1401 nvarchar(4000),@p1402 nvarchar(4000),@p1403 nvarchar(4000),@p1404 nvarchar(4000),@p1405 nvarchar(4000),@p1406 nvarchar(4000),@p1407 nvarchar(4000),@p1408 nvarchar(4000),@p1409 nvarchar(4000),@p1410 nvarchar(4000),@p1411 datetime2(7),@p1412 nvarchar(4000),@p1413 nvarchar(4000),@p1414 int,@p1415 int,@p1416 int,@p1417 nvarchar(4000),@p1418 nvarchar(4000),@p1419 nvarchar(4000),@p1420 nvarchar(4000),@p1421 decimal(18,2),@p1422 nvarchar(4000),@p1423 nvarchar(4000),@p1424 decimal(18,2),@p1425 nvarchar(4000),@p1426 nvarchar(4000),@p1427 nvarchar(4000),@p1428 nvarchar(4000),@p1429 int,@p1430 nvarchar(4000),@p1431 nvarchar(4000),@p1432 nvarchar(4000),@p1433 nvarchar(4000),@p1434 nvarchar(4000),@p1435 nvarchar(4000),@p1436 nvarchar(4000),@p1437 nvarchar(4000),@p1438 nvarchar(4000),@p1439 nvarchar(4000),@p1440 int,@p1441 nvarchar(4000),@p1442 nvarchar(4000),@p1443 nvarchar(4000),@p1444 nvarchar(4000),@p1445 nvarchar(4000),@p1446 int,@p1447 nvarchar(4000),@p1448 int,@p1449 int,@p1450 datetime2(7),@p1451 datetime2(7),@p1452 datetime2(7),@p1453 nvarchar(4000),@p1454 nvarchar(4000),@p1455 nvarchar(4000),@p1456 nvarchar(4000),@p1457 nvarchar(4000),@p1458 nvarchar(4000),@p1459 nvarchar(4000),@p1460 nvarchar(4000),@p1461 nvarchar(4000),@p1462 nvarchar(4000),@p1463 nvarchar(4000),@p1464 nvarchar(4000),@p1465 nvarchar(4000),@p1466 nvarchar(4000),@p1467 datetime2(7),@p1468 nvarchar(4000),@p1469 nvarchar(4000),@p1470 int,@p1471 int,@p1472 int,@p1473 nvarchar(4000),@p1474 nvarchar(4000),@p1475 nvarchar(4000),@p1476 nvarchar(4000),@p1477 decimal(18,2),@p1478 nvarchar(4000),@p1479 nvarchar(4000),@p1480 decimal(18,2),@p1481 nvarchar(4000),@p1482 nvarchar(4000),@p1483 nvarchar(4000),@p1484 nvarchar(4000),@p1485 int,@p1486 nvarchar(4000),@p1487 nvarchar(4000),@p1488 nvarchar(4000),@p1489 nvarchar(4000),@p1490 nvarchar(4000),@p1491 nvarchar(4000),@p1492 nvarchar(4000),@p1493 nvarchar(4000),@p1494 nvarchar(4000),@p1495 nvarchar(4000),@p1496 int,@p1497 nvarchar(4000),@p1498 nvarchar(4000),@p1499 nvarchar(4000),@p1500 nvarchar(4000),@p1501 nvarchar(4000),@p1502 int,@p1503 nvarchar(4000),@p1504 int,@p1505 int,@p1506 datetime2(7),@p1507 datetime2(7),@p1508 datetime2(7),@p1509 nvarchar(4000),@p1510 nvarchar(4000),@p1511 nvarchar(4000),@p1512 nvarchar(4000),@p1513 nvarchar(4000),@p1514 nvarchar(4000),@p1515 nvarchar(4000),@p1516 nvarchar(4000),@p1517 nvarchar(4000),@p1518 nvarchar(4000),@p1519 nvarchar(4000),@p1520 nvarchar(4000),@p1521 nvarchar(4000),@p1522 nvarchar(4000),@p1523 datetime2(7),@p1524 nvarchar(4000),@p1525 nvarchar(4000),@p1526 int,@p1527 int,@p1528 int,@p1529 nvarchar(4000),@p1530 nvarchar(4000),@p1531 nvarchar(4000),@p1532 nvarchar(4000),@p1533 decimal(18,2),@p1534 nvarchar(4000),@p1535 nvarchar(4000),@p1536 decimal(18,2),@p1537 nvarchar(4000),@p1538 nvarchar(4000),@p1539 nvarchar(4000),@p1540 nvarchar(4000),@p1541 int,@p1542 nvarchar(4000),@p1543 nvarchar(4000),@p1544 nvarchar(4000),@p1545 nvarchar(4000),@p1546 nvarchar(4000),@p1547 nvarchar(4000),@p1548 nvarchar(4000),@p1549 nvarchar(4000),@p1550 nvarchar(4000),@p1551 nvarchar(4000),@p1552 int,@p1553 nvarchar(4000),@p1554 nvarchar(4000),@p1555 nvarchar(4000),@p1556 nvarchar(4000),@p1557 nvarchar(4000),@p1558 int,@p1559 nvarchar(4000),@p1560 int,@p1561 int,@p1562 datetime2(7),@p1563 datetime2(7),@p1564 datetime2(7),@p1565 nvarchar(4000),@p1566 nvarchar(4000),@p1567 nvarchar(4000),@p1568 nvarchar(4000),@p1569 nvarchar(4000),@p1570 nvarchar(4000),@p1571 nvarchar(4000),@p1572 nvarchar(4000),@p1573 nvarchar(4000),@p1574 nvarchar(4000),@p1575 nvarchar(4000),@p1576 nvarchar(4000),@p1577 nvarchar(4000),@p1578 nvarchar(4000),@p1579 datetime2(7),@p1580 nvarchar(4000),@p1581 nvarchar(4000),@p1582 int,@p1583 int,@p1584 int,@p1585 nvarchar(4000),@p1586 nvarchar(4000),@p1587 nvarchar(4000),@p1588 decimal(18,2),@p1589 decimal(18,2),@p1590 nvarchar(4000),@p1591 nvarchar(4000),@p1592 decimal(18,2),@p1593 nvarchar(4000),@p1594 nvarchar(4000),@p1595 nvarchar(4000),@p1596 nvarchar(4000),@p1597 int,@p1598 nvarchar(4000),@p1599 nvarchar(4000),@p1600 nvarchar(4000),@p1601 nvarchar(4000),@p1602 nvarchar(4000),@p1603 nvarchar(4000),@p1604 nvarchar(4000),@p1605 nvarchar(4000),@p1606 nvarchar(4000),@p1607 nvarchar(4000),@p1608 int,@p1609 nvarchar(4000),@p1610 nvarchar(4000),@p1611 nvarchar(4000),@p1612 nvarchar(4000),@p1613 nvarchar(4000),@p1614 int,@p1615 nvarchar(4000),@p1616 int,@p1617 int,@p1618 datetime2(7),@p1619 datetime2(7),@p1620 datetime2(7),@p1621 nvarchar(4000),@p1622 nvarchar(4000),@p1623 nvarchar(4000),@p1624 nvarchar(4000),@p1625 nvarchar(4000),@p1626 nvarchar(4000),@p1627 nvarchar(4000),@p1628 nvarchar(4000),@p1629 nvarchar(4000),@p1630 nvarchar(4000),@p1631 nvarchar(4000),@p1632 nvarchar(4000),@p1633 nvarchar(4000),@p1634 nvarchar(4000),@p1635 datetime2(7),@p1636 nvarchar(4000),@p1637 nvarchar(4000),@p1638 int,@p1639 int,@p1640 int,@p1641 nvarchar(4000),@p1642 nvarchar(4000),@p1643 nvarchar(4000),@p1644 decimal(18,2),@p1645 decimal(18,2),@p1646 nvarchar(4000),@p1647 nvarchar(4000),@p1648 decimal(18,2),@p1649 nvarchar(4000),@p1650 nvarchar(4000),@p1651 nvarchar(4000),@p1652 nvarchar(4000),@p1653 int,@p1654 nvarchar(4000),@p1655 nvarchar(4000),@p1656 nvarchar(4000),@p1657 nvarchar(4000),@p1658 nvarchar(4000),@p1659 nvarchar(4000),@p1660 nvarchar(4000),@p1661 nvarchar(4000),@p1662 nvarchar(4000),@p1663 nvarchar(4000),@p1664 int,@p1665 nvarchar(4000),@p1666 nvarchar(4000),@p1667 nvarchar(4000),@p1668 nvarchar(4000),@p1669 nvarchar(4000),@p1670 int,@p1671 nvarchar(4000),@p1672 int,@p1673 int,@p1674 datetime2(7),@p1675 datetime2(7),@p1676 datetime2(7),@p1677 nvarchar(4000),@p1678 nvarchar(4000),@p1679 nvarchar(4000),@p1680 nvarchar(4000),@p1681 nvarchar(4000),@p1682 nvarchar(4000),@p1683 nvarchar(4000),@p1684 nvarchar(4000),@p1685 nvarchar(4000),@p1686 nvarchar(4000),@p1687 nvarchar(4000),@p1688 nvarchar(4000),@p1689 nvarchar(4000),@p1690 nvarchar(4000),@p1691 datetime2(7),@p1692 nvarchar(4000),@p1693 nvarchar(4000),@p1694 int,@p1695 int,@p1696 int,@p1697 nvarchar(4000),@p1698 nvarchar(4000),@p1699 nvarchar(4000),@p1700 nvarchar(4000),@p1701 decimal(18,2),@p1702 nvarchar(4000),@p1703 nvarchar(4000),@p1704 decimal(18,2),@p1705 nvarchar(4000),@p1706 nvarchar(4000),@p1707 nvarchar(4000),@p1708 nvarchar(4000),@p1709 int,@p1710 nvarchar(4000),@p1711 nvarchar(4000),@p1712 nvarchar(4000),@p1713 nvarchar(4000),@p1714 nvarchar(4000),@p1715 nvarchar(4000),@p1716 nvarchar(4000),@p1717 nvarchar(4000),@p1718 nvarchar(4000),@p1719 nvarchar(4000),@p1720 int,@p1721 nvarchar(4000),@p1722 nvarchar(4000),@p1723 nvarchar(4000),@p1724 nvarchar(4000),@p1725 nvarchar(4000),@p1726 int,@p1727 nvarchar(4000),@p1728 int,@p1729 int,@p1730 datetime2(7),@p1731 datetime2(7),@p1732 datetime2(7),@p1733 nvarchar(4000),@p1734 nvarchar(4000),@p1735 nvarchar(4000),@p1736 nvarchar(4000),@p1737 nvarchar(4000),@p1738 nvarchar(4000),@p1739 nvarchar(4000),@p1740 nvarchar(4000),@p1741 nvarchar(4000),@p1742 nvarchar(4000),@p1743 nvarchar(4000),@p1744 nvarchar(4000),@p1745 nvarchar(4000),@p1746 nvarchar(4000),@p1747 datetime2(7),@p1748 nvarchar(4000),@p1749 nvarchar(4000),@p1750 int,@p1751 int,@p1752 int,@p1753 nvarchar(4000),@p1754 nvarchar(4000),@p1755 nvarchar(4000),@p1756 decimal(18,2),@p1757 decimal(18,2),@p1758 nvarchar(4000),@p1759 nvarchar(4000),@p1760 decimal(18,2),@p1761 nvarchar(4000),@p1762 nvarchar(4000),@p1763 nvarchar(4000),@p1764 nvarchar(4000),@p1765 int,@p1766 nvarchar(4000),@p1767 nvarchar(4000),@p1768 nvarchar(4000),@p1769 nvarchar(4000),@p1770 nvarchar(4000),@p1771 nvarchar(4000),@p1772 nvarchar(4000),@p1773 nvarchar(4000),@p1774 nvarchar(4000),@p1775 nvarchar(4000),@p1776 int,@p1777 nvarchar(4000),@p1778 nvarchar(4000),@p1779 nvarchar(4000),@p1780 nvarchar(4000),@p1781 nvarchar(4000),@p1782 int,@p1783 nvarchar(4000),@p1784 int,@p1785 int,@p1786 datetime2(7),@p1787 datetime2(7),@p1788 datetime2(7),@p1789 nvarchar(4000),@p1790 nvarchar(4000),@p1791 nvarchar(4000),@p1792 nvarchar(4000),@p1793 nvarchar(4000),@p1794 nvarchar(4000),@p1795 nvarchar(4000),@p1796 nvarchar(4000),@p1797 nvarchar(4000),@p1798 nvarchar(4000),@p1799 nvarchar(4000),@p1800 nvarchar(4000),@p1801 nvarchar(4000),@p1802 nvarchar(4000),@p1803 datetime2(7),@p1804 nvarchar(4000),@p1805 nvarchar(4000),@p1806 int,@p1807 int,@p1808 int,@p1809 nvarchar(4000),@p1810 nvarchar(4000),@p1811 nvarchar(4000),@p1812 decimal(18,2),@p1813 decimal(18,2),@p1814 nvarchar(4000),@p1815 nvarchar(4000),@p1816 decimal(18,2),@p1817 nvarchar(4000),@p1818 nvarchar(4000),@p1819 nvarchar(4000),@p1820 nvarchar(4000),@p1821 int,@p1822 nvarchar(4000),@p1823 nvarchar(4000),@p1824 nvarchar(4000),@p1825 nvarchar(4000),@p1826 nvarchar(4000),@p1827 nvarchar(4000),@p1828 nvarchar(4000),@p1829 nvarchar(4000),@p1830 nvarchar(4000),@p1831 nvarchar(4000),@p1832 int,@p1833 nvarchar(4000),@p1834 nvarchar(4000),@p1835 nvarchar(4000),@p1836 nvarchar(4000),@p1837 nvarchar(4000),@p1838 int,@p1839 nvarchar(4000),@p1840 int,@p1841 int,@p1842 datetime2(7),@p1843 datetime2(7),@p1844 datetime2(7),@p1845 nvarchar(4000),@p1846 nvarchar(4000),@p1847 nvarchar(4000),@p1848 nvarchar(4000),@p1849 nvarchar(4000),@p1850 nvarchar(4000),@p1851 nvarchar(4000),@p1852 nvarchar(4000),@p1853 nvarchar(4000),@p1854 nvarchar(4000),@p1855 nvarchar(4000),@p1856 nvarchar(4000),@p1857 nvarchar(4000),@p1858 nvarchar(4000),@p1859 datetime2(7),@p1860 nvarchar(4000),@p1861 nvarchar(4000),@p1862 int,@p1863 int,@p1864 int,@p1865 nvarchar(4000),@p1866 nvarchar(4000),@p1867 nvarchar(4000),@p1868 decimal(18,2),@p1869 decimal(18,2),@p1870 nvarchar(4000),@p1871 nvarchar(4000),@p1872 decimal(18,2),@p1873 nvarchar(4000),@p1874 nvarchar(4000),@p1875 nvarchar(4000),@p1876 nvarchar(4000),@p1877 int,@p1878 nvarchar(4000),@p1879 nvarchar(4000),@p1880 nvarchar(4000),@p1881 nvarchar(4000),@p1882 nvarchar(4000),@p1883 nvarchar(4000),@p1884 nvarchar(4000),@p1885 nvarchar(4000),@p1886 nvarchar(4000),@p1887 nvarchar(4000),@p1888 int,@p1889 nvarchar(4000),@p1890 nvarchar(4000),@p1891 nvarchar(4000),@p1892 nvarchar(4000),@p1893 nvarchar(4000),@p1894 int,@p1895 nvarchar(4000),@p1896 int,@p1897 int,@p1898 datetime2(7),@p1899 datetime2(7),@p1900 datetime2(7),@p1901 nvarchar(4000),@p1902 nvarchar(4000),@p1903 nvarchar(4000),@p1904 nvarchar(4000),@p1905 nvarchar(4000),@p1906 nvarchar(4000),@p1907 nvarchar(4000),@p1908 nvarchar(4000),@p1909 nvarchar(4000),@p1910 nvarchar(4000),@p1911 nvarchar(4000),@p1912 nvarchar(4000),@p1913 nvarchar(4000),@p1914 nvarchar(4000),@p1915 datetime2(7),@p1916 nvarchar(4000),@p1917 nvarchar(4000),@p1918 int,@p1919 int,@p1920 int,@p1921 nvarchar(4000),@p1922 nvarchar(4000),@p1923 nvarchar(4000),@p1924 decimal(18,2),@p1925 decimal(18,2),@p1926 nvarchar(4000),@p1927 nvarchar(4000),@p1928 decimal(18,2),@p1929 nvarchar(4000),@p1930 nvarchar(4000),@p1931 nvarchar(4000),@p1932 nvarchar(4000),@p1933 int,@p1934 nvarchar(4000),@p1935 nvarchar(4000),@p1936 nvarchar(4000),@p1937 nvarchar(4000),@p1938 nvarchar(4000),@p1939 nvarchar(4000),@p1940 nvarchar(4000),@p1941 nvarchar(4000),@p1942 nvarchar(4000),@p1943 nvarchar(4000),@p1944 int,@p1945 nvarchar(4000),@p1946 nvarchar(4000),@p1947 nvarchar(4000),@p1948 nvarchar(4000),@p1949 nvarchar(4000),@p1950 int,@p1951 nvarchar(4000),@p1952 int,@p1953 int,@p1954 datetime2(7),@p1955 datetime2(7),@p1956 datetime2(7),@p1957 nvarchar(4000),@p1958 nvarchar(4000),@p1959 nvarchar(4000),@p1960 nvarchar(4000),@p1961 nvarchar(4000),@p1962 nvarchar(4000),@p1963 nvarchar(4000),@p1964 nvarchar(4000),@p1965 nvarchar(4000),@p1966 nvarchar(4000),@p1967 nvarchar(4000),@p1968 nvarchar(4000),@p1969 nvarchar(4000),@p1970 nvarchar(4000),@p1971 datetime2(7),@p1972 nvarchar(4000),@p1973 nvarchar(4000),@p1974 int,@p1975 int,@p1976 int,@p1977 nvarchar(4000),@p1978 nvarchar(4000),@p1979 nvarchar(4000),@p1980 decimal(18,2),@p1981 decimal(18,2),@p1982 nvarchar(4000),@p1983 nvarchar(4000),@p1984 decimal(18,2),@p1985 nvarchar(4000),@p1986 nvarchar(4000),@p1987 nvarchar(4000),@p1988 nvarchar(4000),@p1989 int,@p1990 nvarchar(4000),@p1991 nvarchar(4000),@p1992 nvarchar(4000),@p1993 nvarchar(4000),@p1994 nvarchar(4000),@p1995 nvarchar(4000),@p1996 nvarchar(4000),@p1997 nvarchar(4000),@p1998 nvarchar(4000),@p1999 nvarchar(4000),@p2000 int,@p2001 nvarchar(4000),@p2002 nvarchar(4000),@p2003 nvarchar(4000),@p2004 nvarchar(4000),@p2005 nvarchar(4000),@p2006 int,@p2007 nvarchar(4000),@p2008 int,@p2009 int,@p2010 datetime2(7),@p2011 datetime2(7),@p2012 datetime2(7),@p2013 nvarchar(4000),@p2014 nvarchar(4000),@p2015 nvarchar(4000),@p2016 nvarchar(4000),@p2017 nvarchar(4000),@p2018 nvarchar(4000),@p2019 nvarchar(4000),@p2020 nvarchar(4000),@p2021 nvarchar(4000),@p2022 nvarchar(4000),@p2023 nvarchar(4000),@p2024 nvarchar(4000),@p2025 nvarchar(4000),@p2026 nvarchar(4000),@p2027 datetime2(7),@p2028 nvarchar(4000),@p2029 nvarchar(4000),@p2030 int,@p2031 int,@p2032 int,@p2033 nvarchar(4000),@p2034 nvarchar(4000),@p2035 nvarchar(4000),@p2036 decimal(18,2),@p2037 decimal(18,2),@p2038 nvarchar(4000),@p2039 nvarchar(4000),@p2040 decimal(18,2),@p2041 nvarchar(4000),@p2042 nvarchar(4000),@p2043 nvarchar(4000),@p2044 nvarchar(4000),@p2045 int,@p2046 nvarchar(4000),@p2047 nvarchar(4000),@p2048 nvarchar(4000),@p2049 nvarchar(4000),@p2050 nvarchar(4000),@p2051 nvarchar(4000),@p2052 nvarchar(4000),@p2053 nvarchar(4000),@p2054 nvarchar(4000),@p2055 nvarchar(4000),@p2056 int,@p2057 nvarchar(4000),@p2058 nvarchar(4000),@p2059 nvarchar(4000),@p2060 nvarchar(4000),@p2061 nvarchar(4000),@p2062 int,@p2063 nvarchar(4000),@p2064 int,@p2065 int,@p2066 datetime2(7),@p2067 datetime2(7),@p2068 datetime2(7),@p2069 nvarchar(4000),@p2070 nvarchar(4000),@p2071 nvarchar(4000))SET NOCOUNT ON; DECLARE @inserted0 TABLE ([item_id] int, [_Position] [int]); MERGE [raw_data] USING ( VALUES (@p0, @p1, @p2, @p3, @p4, @p5, @p6, @p7, @p8, @p9, @p10, @p11, @p12, @p13, @p14, @p15, @p16, @p17, @p18, @p19, @p20, @p21, @p22, @p23, @p24, @p25, @p26, @p27, @p28, @p29, @p30, @p31, @p32, @p33, @p34, @p35, @p36, @p37, @p38, @p39, @p40, @p41, @p42, @p43, @p44, @p45, @p46, @p47, @p48, @p49, @p50, @p51, @p52, @p53, @p54, @p55, 0), (@p56, @p57, @p58, @p59, @p60, @p61, @p62, @p63, @p64, @p65, @p66, @p67, @p68, @p69, @p70, @p71, @p72, @p73, @p74, @p75, @p76, @p77, @p78, @p79, @p80, @p81, @p82, @p83, @p84, @p85, @p86, @p87, @p88, @p89, @p90, @p91, @p92, @p93, @p94, @p95, @p96, @p97, @p98, @p99, @p100, @p101, @p102, @p103, @p104, @p105, @p106, @p107, @p108, @p109, @p110, @p111, 1), (@p112, @p113, @p114, @p115, @p116, @p117, @p118, @p119, @p120, @p121, @p122, @p123, @p124, @p125, @p126, @p127, @p128, @p129, @p130, @p131, @p132, @p133, @p134, @p135, @p136, @p137, @p138, @p139, @p140, @p141, @p142, @p143, @p144, @p145, @p146, @p147, @p148, @p149, @p150, @p151, @p152, @p153, @p154, @p155, @p156, @p157, @p158, @p159, @p160, @p161, @p162, @p163, @p164, @p165, @p166, @p167, 2), (@p168, @p169, @p170, @p171, @p172, @p173, @p174, @p175, @p176, @p177, @p178, @p179, @p180, @p181, @p182, @p183, @p184, @p185, @p186, @p187, @p188, @p189, @p190, @p191, @p192, @p193, @p194, @p195, @p196, @p197, @p198, @p199, @p200, @p201, @p202, @p203, @p204, @p205, @p206, @p207, @p208, @p209, @p210, @p211, @p212, @p213, @p214, @p215, @p216, @p217, @p218, @p219, @p220, @p221, @p222, @p223, 3), (@p224, @p225, @p226, @p227, @p228, @p229, @p230, @p231, @p232, @p233, @p234, @p235, @p236, @p237, @p238, @p239, @p240, @p241, @p242, @p243, @p244, @p245, @p246, @p247, @p248, @p249, @p250, @p251, @p252, @p253, @p254, @p255, @p256, @p257, @p258, @p259, @p260, @p261, @p262, @p263, @p264, @p265, @p266, @p267, @p268, @p269, @p270, @p271, @p272, @p273, @p274, @p275, @p276, @p277, @p278, @p279, 4), (@p280, @p281, @p282, @p283, @p284, @p285, @p286, @p287, @p288, @p289, @p290, @p291, @p292, @p293, @p294, @p295, @p296, @p297, @p298, @p299, @p300, @p301, @p302, @p303, @p304, @p305, @p306, @p307, @p308, @p309, @p310, @p311, @p312, @p313, @p314, @p315, @p316, @p317, @p318, @p319, @p320, @p321, @p322, @p323, @p324, @p325, @p326, @p327, @p328, @p329, @p330, @p331, @p332, @p333, @p334, @p335, 5), (@p336, @p337, @p338, @p339, @p340, @p341, @p342, @p343, @p344, @p345, @p346, @p347, @p348, @p349, @p350, @p351, @p352, @p353, @p354, @p355, @p356, @p357, @p358, @p359, @p360, @p361, @p362, @p363, @p364, @p365, @p366, @p367, @p368, @p369, @p370, @p371, @p372, @p373, @p374, @p375, @p376, @p377, @p378, @p379, @p380, @p381, @p382, @p383, @p384, @p385, @p386, @p387, @p388, @p389, @p390, @p391, 6), (@p392, @p393, @p394, @p395, @p396, @p397, @p398, @p399, @p400, @p401, @p402, @p403, @p404, @p405, @p406, @p407, @p408, @p409, @p410, @p411, @p412, @p413, @p414, @p415, @p416, @p417, @p418, @p419, @p420, @p421, @p422, @p423, @p424, @p425, @p426, @p427, @p428, @p429, @p430, @p431, @p432, @p433, @p434, @p435, @p436, @p437, @p438, @p439, @p440, @p441, @p442, @p443, @p444, @p445, @p446, @p447, 7), (@p448, @p449, @p450, @p451, @p452, @p453, @p454, @p455, @p456, @p457, @p458, @p459, @p460, @p461, @p462, @p463, @p464, @p465, @p466, @p467, @p468, @p469, @p470, @p471, @p472, @p473, @p474, @p475, @p476, @p477, @p478, @p479, @p480, @p481, @p482, @p483, @p484, @p485, @p486, @p487, @p488, @p489, @p490, @p491, @p492, @p493, @p494, @p495, @p496, @p497, @p498, @p499, @p500, @p501, @p502, @p503, 8), (@p504, @p505, @p506, @p507, @p508, @p509, @p510, @p511, @p512, @p513, @p514, @p515, @p516, @p517, @p518, @p519, @p520, @p521, @p522, @p523, @p524, @p525, @p526, @p527, @p528, @p529, @p530, @p531, @p532, @p533, @p534, @p535, @p536, @p537, @p538, @p539, @p540, @p541, @p542, @p543, @p544, @p545, @p546, @p547, @p548, @p549, @p550, @p551, @p552, @p553, @p554, @p555, @p556, @p557, @p558, @p559, 9), (@p560, @p561, @p562, @p563, @p564, @p565, @p566, @p567, @p568, @p569, @p570, @p571, @p572, @p573, @p574, @p575, @p576, @p577, @p578, @p579, @p580, @p581, @p582, @p583, @p584, @p585, @p586, @p587, @p588, @p589, @p590, @p591, @p592, @p593, @p594, @p595, @p596, @p597, @p598, @p599, @p600, @p601, @p602, @p603, @p604, @p605, @p606, @p607, @p608, @p609, @p610, @p611, @p612, @p613, @p614, @p615, 10), (@p616, @p617, @p618, @p619, @p620, @p621, @p622, @p623, @p624, @p625, @p626, @p627, @p628, @p629, @p630, @p631, @p632, @p633, @p634, @p635, @p636, @p637, @p638, @p639, @p640, @p641, @p642, @p643, @p644, @p645, @p646, @p647, @p648, @p649, @p650, @p651, @p652, @p653, @p654, @p655, @p656, @p657, @p658, @p659, @p660, @p661, @p662, @p663, @p664, @p665, @p666, @p667, @p668, @p669, @p670, @p671, 11), (@p672, @p673, @p674, @p675, @p676, @p677, @p678, @p679, @p680, @p681, @p682, @p683, @p684, @p685, @p686, @p687, @p688, @p689, @p690, @p691, @p692, @p693, @p694, @p695, @p696, @p697, @p698, @p699, @p700, @p701, @p702, @p703, @p704, @p705, @p706, @p707, @p708, @p709, @p710, @p711, @p712, @p713, @p714, @p715, @p716, @p717, @p718, @p719, @p720, @p721, @p722, @p723, @p724, @p725, @p726, @p727, 12), (@p728, @p729, @p730, @p731, @p732, @p733, @p734, @p735, @p736, @p737, @p738, @p739, @p740, @p741, @p742, @p743, @p744, @p745, @p746, @p747, @p748, @p749, @p750, @p751, @p752, @p753, @p754, @p755, @p756, @p757, @p758, @p759, @p760, @p761, @p762, @p763, @p764, @p765, @p766, @p767, @p768, @p769, @p770, @p771, @p772, @p773, @p774, @p775, @p776, @p777, @p778, @p779, @p780, @p781, @p782, @p783, 13), (@p784, @p785, @p786, @p787, @p788, @p789, @p790, @p791, @p792, @p793, @p794, @p795, @p796, @p797, @p798, @p799, @p800, @p801, @p802, @p803, @p804, @p805, @p806, @p807, @p808, @p809, @p810, @p811, @p812, @p813, @p814, @p815, @p816, @p817, @p818, @p819, @p820, @p821, @p822, @p823, @p824, @p825, @p826, @p827, @p828, @p829, @p830, @p831, @p832, @p833, @p834, @p835, @p836, @p837, @p838, @p839, 14), (@p840, @p841, @p842, @p843, @p844, @p845, @p846, @p847, @p848, @p849, @p850, @p851, @p852, @p853, @p854, @p855, @p856, @p857, @p858, @p859, @p860, @p861, @p862, @p863, @p864, @p865, @p866, @p867, @p868, @p869, @p870, @p871, @p872, @p873, @p874, @p875, @p876, @p877, @p878, @p879, @p880, @p881, @p882, @p883, @p884, @p885, @p886, @p887, @p888, @p889, @p890, @p891, @p892, @p893, @p894, @p895, 15), (@p896, @p897, @p898, @p899, @p900, @p901, @p902, @p903, @p904, @p905, @p906, @p907, @p908, @p909, @p910, @p911, @p912, @p913, @p914, @p915, @p916, @p917, @p918, @p919, @p920, @p921, @p922, @p923, @p924, @p925, @p926, @p927, @p928, @p929, @p930, @p931, @p932, @p933, @p934, @p935, @p936, @p937, @p938, @p939, @p940, @p941, @p942, @p943, @p944, @p945, @p946, @p947, @p948, @p949, @p950, @p951, 16), (@p952, @p953, @p954, @p955, @p956, @p957, @p958, @p959, @p960, @p961, @p962, @p963, @p964, @p965, @p966, @p967, @p968, @p969, @p970, @p971, @p972, @p973, @p974, @p975, @p976, @p977, @p978, @p979, @p980, @p981, @p982, @p983, @p984, @p985, @p986, @p987, @p988, @p989, @p990, @p991, @p992, @p993, @p994, @p995, @p996, @p997, @p998, @p999, @p1000, @p1001, @p1002, @p1003, @p1004, @p1005, @p1006, @p1007, 17), (@p1008, @p1009, @p1010, @p1011, @p1012, @p1013, @p1014, @p1015, @p1016, @p1017, @p1018, @p1019, @p1020, @p1021, @p1022, @p1023, @p1024, @p1025, @p1026, @p1027, @p1028, @p1029, @p1030, @p1031, @p1032, @p1033, @p1034, @p1035, @p1036, @p1037, @p1038, @p1039, @p1040, @p1041, @p1042, @p1043, @p1044, @p1045, @p1046, @p1047, @p1048, @p1049, @p1050, @p1051, @p1052, @p1053, @p1054, @p1055, @p1056, @p1057, @p1058, @p1059, @p1060, @p1061, @p1062, @p1063, 18), (@p1064, @p1065, @p1066, @p1067, @p1068, @p1069, @p1070, @p1071, @p1072, @p1073, @p1074, @p1075, @p1076, @p1077, @p1078, @p1079, @p1080, @p1081, @p1082, @p1083, @p1084, @p1085, @p1086, @p1087, @p1088, @p1089, @p1090, @p1091, @p1092, @p1093, @p1094, @p1095, @p1096, @p1097, @p1098, @p1099, @p1100, @p1101, @p1102, @p1103, @p1104, @p1105, @p1106, @p1107, @p1108, @p1109, @p1110, @p1111, @p1112, @p1113, @p1114, @p1115, @p1116, @p1117, @p1118, @p1119, 19), (@p1120, @p1121, @p1122, @p1123, @p1124, @p1125, @p1126, @p1127, @p1128, @p1129, @p1130, @p1131, @p1132, @p1133, @p1134, @p1135, @p1136, @p1137, @p1138, @p1139, @p1140, @p1141, @p1142, @p1143, @p1144, @p1145, @p1146, @p1147, @p1148, @p1149, @p1150, @p1151, @p1152, @p1153, @p1154, @p1155, @p1156, @p1157, @p1158, @p1159, @p1160, @p1161, @p1162, @p1163, @p1164, @p1165, @p1166, @p1167, @p1168, @p1169, @p1170, @p1171, @p1172, @p1173, @p1174, @p1175, 20), (@p1176, @p1177, @p1178, @p1179, @p1180, @p1181, @p1182, @p1183, @p1184, @p1185, @p1186, @p1187, @p1188, @p1189, @p1190, @p1191, @p1192, @p1193, @p1194, @p1195, @p1196, @p1197, @p1198, @p1199, @p1200, @p1201, @p1202, @p1203, @p1204, @p1205, @p1206, @p1207, @p1208, @p1209, @p1210, @p1211, @p1212, @p1213, @p1214, @p1215, @p1216, @p1217, @p1218, @p1219, @p1220, @p1221, @p1222, @p1223, @p1224, @p1225, @p1226, @p1227, @p1228, @p1229, @p1230, @p1231, 21), (@p1232, @p1233, @p1234, @p1235, @p1236, @p1237, @p1238, @p1239, @p1240, @p1241, @p1242, @p1243, @p1244, @p1245, @p1246, @p1247, @p1248, @p1249, @p1250, @p1251, @p1252, @p1253, @p1254, @p1255, @p1256, @p1257, @p1258, @p1259, @p1260, @p1261, @p1262, @p1263, @p1264, @p1265, @p1266, @p1267, @p1268, @p1269, @p1270, @p1271, @p1272, @p1273, @p1274, @p1275, @p1276, @p1277, @p1278, @p1279, @p1280, @p1281, @p1282, @p1283, @p1284, @p1285, @p1286, @p1287, 22), (@p1288, @p1289, @p1290, @p1291, @p1292, @p1293, @p1294, @p1295, @p1296, @p1297, @p1298, @p1299, @p1300, @p1301, @p1302, @p1303, @p1304, @p1305, @p1306, @p1307, @p1308, @p1309, @p1310, @p1311, @p1312, @p1313, @p1314, @p1315, @p1316, @p1317, @p1318, @p1319, @p1320, @p1321, @p1322, @p1323, @p1324, @p1325, @p1326, @p1327, @p1328, @p1329, @p1330, @p1331, @p1332, @p1333, @p1334, @p1335, @p1336, @p1337, @p1338, @p1339, @p1340, @p1341, @p1342, @p1343, 23), (@p1344, @p1345, @p1346, @p1347, @p1348, @p1349, @p1350, @p1351, @p1352, @p1353, @p1354, @p1355, @p1356, @p1357, @p1358, @p1359, @p1360, @p1361, @p1362, @p1363, @p1364, @p1365, @p1366, @p1367, @p1368, @p1369, @p1370, @p1371, @p1372, @p1373, @p1374, @p1375, @p1376, @p1377, @p1378, @p1379, @p1380, @p1381, @p1382, @p1383, @p1384, @p1385, @p1386, @p1387, @p1388, @p1389, @p1390, @p1391, @p1392, @p1393, @p1394, @p1395, @p1396, @p1397, @p1398, @p1399, 24), (@p1400, @p1401, @p1402, @p1403, @p1404, @p1405, @p1406, @p1407, @p1408, @p1409, @p1410, @p1411, @p1412, @p1413, @p1414, @p1415, @p1416, @p1417, @p1418, @p1419, @p1420, @p1421, @p1422, @p1423, @p1424, @p1425, @p1426, @p1427, @p1428, @p1429, @p1430, @p1431, @p1432, @p1433, @p1434, @p1435, @p1436, @p1437, @p1438, @p1439, @p1440, @p1441, @p1442, @p1443, @p1444, @p1445, @p1446, @p1447, @p1448, @p1449, @p1450, @p1451, @p1452, @p1453, @p1454, @p1455, 25), (@p1456, @p1457, @p1458, @p1459, @p1460, @p1461, @p1462, @p1463, @p1464, @p1465, @p1466, @p1467, @p1468, @p1469, @p1470, @p1471, @p1472, @p1473, @p1474, @p1475, @p1476, @p1477, @p1478, @p1479, @p1480, @p1481, @p1482, @p1483, @p1484, @p1485, @p1486, @p1487, @p1488, @p1489, @p1490, @p1491, @p1492, @p1493, @p1494, @p1495, @p1496, @p1497, @p1498, @p1499, @p1500, @p1501, @p1502, @p1503, @p1504, @p1505, @p1506, @p1507, @p1508, @p1509, @p1510, @p1511, 26), (@p1512, @p1513, @p1514, @p1515, @p1516, @p1517, @p1518, @p1519, @p1520, @p1521, @p1522, @p1523, @p1524, @p1525, @p1526, @p1527, @p1528, @p1529, @p1530, @p1531, @p1532, @p1533, @p1534, @p1535, @p1536, @p1537, @p1538, @p1539, @p1540, @p1541, @p1542, @p1543, @p1544, @p1545, @p1546, @p1547, @p1548, @p1549, @p1550, @p1551, @p1552, @p1553, @p1554, @p1555, @p1556, @p1557, @p1558, @p1559, @p1560, @p1561, @p1562, @p1563, @p1564, @p1565, @p1566, @p1567, 27), (@p1568, @p1569, @p1570, @p1571, @p1572, @p1573, @p1574, @p1575, @p1576, @p1577, @p1578, @p1579, @p1580, @p1581, @p1582, @p1583, @p1584, @p1585, @p1586, @p1587, @p1588, @p1589, @p1590, @p1591, @p1592, @p1593, @p1594, @p1595, @p1596, @p1597, @p1598, @p1599, @p1600, @p1601, @p1602, @p1603, @p1604, @p1605, @p1606, @p1607, @p1608, @p1609, @p1610, @p1611, @p1612, @p1613, @p1614, @p1615, @p1616, @p1617, @p1618, @p1619, @p1620, @p1621, @p1622, @p1623, 28), (@p1624, @p1625, @p1626, @p1627, @p1628, @p1629, @p1630, @p1631, @p1632, @p1633, @p1634, @p1635, @p1636, @p1637, @p1638, @p1639, @p1640, @p1641, @p1642, @p1643, @p1644, @p1645, @p1646, @p1647, @p1648, @p1649, @p1650, @p1651, @p1652, @p1653, @p1654, @p1655, @p1656, @p1657, @p1658, @p1659, @p1660, @p1661, @p1662, @p1663, @p1664, @p1665, @p1666, @p1667, @p1668, @p1669, @p1670, @p1671, @p1672, @p1673, @p1674, @p1675, @p1676, @p1677, @p1678, @p1679, 29), (@p1680, @p1681, @p1682, @p1683, @p1684, @p1685, @p1686, @p1687, @p1688, @p1689, @p1690, @p1691, @p1692, @p1693, @p1694, @p1695, @p1696, @p1697, @p1698, @p1699, @p1700, @p1701, @p1702, @p1703, @p1704, @p1705, @p1706, @p1707, @p1708, @p1709, @p1710, @p1711, @p1712, @p1713, @p1714, @p1715, @p1716, @p1717, @p1718, @p1719, @p1720, @p1721, @p1722, @p1723, @p1724, @p1725, @p1726, @p1727, @p1728, @p1729, @p1730, @p1731, @p1732, @p1733, @p1734, @p1735, 30), (@p1736, @p1737, @p1738, @p1739, @p1740, @p1741, @p1742, @p1743, @p1744, @p1745, @p1746, @p1747, @p1748, @p1749, @p1750, @p1751, @p1752, @p1753, @p1754, @p1755, @p1756, @p1757, @p1758, @p1759, @p1760, @p1761, @p1762, @p1763, @p1764, @p1765, @p1766, @p1767, @p1768, @p1769, @p1770, @p1771, @p1772, @p1773, @p1774, @p1775, @p1776, @p1777, @p1778, @p1779, @p1780, @p1781, @p1782, @p1783, @p1784, @p1785, @p1786, @p1787, @p1788, @p1789, @p1790, @p1791, 31), (@p1792, @p1793, @p1794, @p1795, @p1796, @p1797, @p1798, @p1799, @p1800, @p1801, @p1802, @p1803, @p1804, @p1805, @p1806, @p1807, @p1808, @p1809, @p1810, @p1811, @p1812, @p1813, @p1814, @p1815, @p1816, @p1817, @p1818, @p1819, @p1820, @p1821, @p1822, @p1823, @p1824, @p1825, @p1826, @p1827, @p1828, @p1829, @p1830, @p1831, @p1832, @p1833, @p1834, @p1835, @p1836, @p1837, @p1838, @p1839, @p1840, @p1841, @p1842, @p1843, @p1844, @p1845, @p1846, @p1847, 32), (@p1848, @p1849, @p1850, @p1851, @p1852, @p1853, @p1854, @p1855, @p1856, @p1857, @p1858, @p1859, @p1860, @p1861, @p1862, @p1863, @p1864, @p1865, @p1866, @p1867, @p1868, @p1869, @p1870, @p1871, @p1872, @p1873, @p1874, @p1875, @p1876, @p1877, @p1878, @p1879, @p1880, @p1881, @p1882, @p1883, @p1884, @p1885, @p1886, @p1887, @p1888, @p1889, @p1890, @p1891, @p1892, @p1893, @p1894, @p1895, @p1896, @p1897, @p1898, @p1899, @p1900, @p1901, @p1902, @p1903, 33), (@p1904, @p1905, @p1906, @p1907, @p1908, @p1909, @p1910, @p1911, @p1912, @p1913, @p1914, @p1915, @p1916, @p1917, @p1918, @p1919, @p1920, @p1921, @p1922, @p1923, @p1924, @p1925, @p1926, @p1927, @p1928, @p1929, @p1930, @p1931, @p1932, @p1933, @p1934, @p1935, @p1936, @p1937, @p1938, @p1939, @p1940, @p1941, @p1942, @p1943, @p1944, @p1945, @p1946, @p1947, @p1948, @p1949, @p1950, @p1951, @p1952, @p1953, @p1954, @p1955, @p1956, @p1957, @p1958, @p1959, 34), (@p1960, @p1961, @p1962, @p1963, @p1964, @p1965, @p1966, @p1967, @p1968, @p1969, @p1970, @p1971, @p1972, @p1973, @p1974, @p1975, @p1976, @p1977, @p1978, @p1979, @p1980, @p1981, @p1982, @p1983, @p1984, @p1985, @p1986, @p1987, @p1988, @p1989, @p1990, @p1991, @p1992, @p1993, @p1994, @p1995, @p1996, @p1997, @p1998, @p1999, @p2000, @p2001, @p2002, @p2003, @p2004, @p2005, @p2006, @p2007, @p2008, @p2009, @p2010, @p2011, @p2012, @p2013, @p2014, @p2015, 35), (@p2016, @p2017, @p2018, @p2019, @p2020, @p2021, @p2022, @p2023, @p2024, @p2025, @p2026, @p2027, @p2028, @p2029, @p2030, @p2031, @p2032, @p2033, @p2034, @p2035, @p2036, @p2037, @p2038, @p2039, @p2040, @p2041, @p2042, @p2043, @p2044, @p2045, @p2046, @p2047, @p2048, @p2049, @p2050, @p2051, @p2052, @p2053, @p2054, @p2055, @p2056, @p2057, @p2058, @p2059, @p2060, @p2061, @p2062, @p2063, @p2064, @p2065, @p2066, @p2067, @p2068, @p2069, @p2070, @p2071, 36)) AS i ([addressee_cntry_cd], [addressee_city], [addressee_district], [addressee_email], [addressee_full_address], [addressee_home_address], [addressee_name], [addressee_postcode], [addressee_province], [addressee_subdistrict], [addressee_tel], [create_table], [delivery_code], [delivery_recipient_name], [delivery_relation_id], [delivery_status_id], [dest_outlet_id], [dest_outlet_port], [document_number], [item_barcode], [item_cod], [item_gross_weight], [item_height], [item_length], [item_price], [item_width], [lat], [log_id], [long], [outlet_id], [outlet_port], [podUrl], [remark], [scan_cntry_cd], [scan_cntry_postcode], [sender_cntry_cd], [sender_district], [sender_email], [sender_full_address], [sender_home_address], [member_id], [sender_name], [sender_postcode], [sender_province], [sender_subdistrict], [sender_tel], [server_id], [signatureUrl], [state], [status_code], [status_dtm], [timestamp], [transmit_dtm], [user_id], [wckt_id], [wkstn_no], _Position) ON 1=0 WHEN NOT MATCHED THEN INSERT ([addressee_cntry_cd], [addressee_city], [addressee_district], [addressee_email], [addressee_full_address], [addressee_home_address], [addressee_name], [addressee_postcode], [addressee_province], [addressee_subdistrict], [addressee_tel], [create_table], [delivery_code], [delivery_recipient_name], [delivery_relation_id], [delivery_status_id], [dest_outlet_id], [dest_outlet_port], [document_number], [item_barcode], [item_cod], [item_gross_weight], [item_height], [item_length], [item_price], [item_width], [lat], [log_id], [long], [outlet_id], [outlet_port], [podUrl], [remark], [scan_cntry_cd], [scan_cntry_postcode], [sender_cntry_cd], [sender_district], [sender_email], [sender_full_address], [sender_home_address], [member_id], [sender_name], [sender_postcode], [sender_province], [sender_subdistrict], [sender_tel], [server_id], [signatureUrl], [state], [status_code], [status_dtm], [timestamp], [transmit_dtm], [user_id], [wckt_id], [wkstn_no]) VALUES (i.[addressee_cntry_cd], i.[addressee_city], i.[addressee_district], i.[addressee_email], i.[addressee_full_address], i.[addressee_home_address], i.[addressee_name], i.[addressee_postcode], i.[addressee_province], i.[addressee_subdistrict], i.[addressee_tel], i.[create_table], i.[delivery_code], i.[delivery_recipient_name], i.[delivery_relation_id], i.[delivery_status_id], i.[dest_outlet_id], i.[dest_outlet_port], i.[document_number], i.[item_barcode], i.[item_cod], i.[item_gross_weight], i.[item_height], i.[item_length], i.[item_price], i.[item_width], i.[lat], i.[log_id], i.[long], i.[outlet_id], i.[outlet_port], i.[podUrl], i.[remark], i.[scan_cntry_cd], i.[scan_cntry_postcode], i.[sender_cntry_cd], i.[sender_district], i.[sender_email], i.[sender_full_address], i.[sender_home_address], i.[member_id], i.[sender_name], i.[sender_postcode], i.[sender_province], i.[sender_subdistrict], i.[sender_tel], i.[server_id], i.[signatureUrl], i.[state], i.[status_code], i.[status_dtm], i.[timestamp], i.[transmit_dtm], i.[user_id], i.[wckt_id], i.[wkstn_no]) OUTPUT INSERTED.[item_id], i._Position INTO @inserted0;  SELECT [t].[item_id] FROM [raw_data] t INNER JOIN @inserted0 i ON ([t].[item_id] = [i].[item_id]) ORDER BY [i].[_Position];  ",4,4,0,440,4,4
"(@p0 nvarchar(4000),@p1 nvarchar(4000),@p2 nvarchar(4000),@p3 nvarchar(4000),@p4 nvarchar(4000),@p5 nvarchar(4000),@p6 nvarchar(4000),@p7 nvarchar(4000),@p8 nvarchar(4000),@p9 nvarchar(4000),@p10 nvarchar(4000),@p11 datetime2(7),@p12 nvarchar(4000),@p13 nvarchar(4000),@p14 int,@p15 int,@p16 int,@p17 nvarchar(4000),@p18 nvarchar(4000),@p19 nvarchar(4000),@p20 decimal(18,2),@p21 decimal(18,2),@p22 nvarchar(4000),@p23 nvarchar(4000),@p24 decimal(18,2),@p25 nvarchar(4000),@p26 nvarchar(4000),@p27 nvarchar(4000),@p28 nvarchar(4000),@p29 int,@p30 nvarchar(4000),@p31 nvarchar(4000),@p32 nvarchar(4000),@p33 nvarchar(4000),@p34 nvarchar(4000),@p35 nvarchar(4000),@p36 nvarchar(4000),@p37 nvarchar(4000),@p38 nvarchar(4000),@p39 nvarchar(4000),@p40 int,@p41 nvarchar(4000),@p42 nvarchar(4000),@p43 nvarchar(4000),@p44 nvarchar(4000),@p45 nvarchar(4000),@p46 int,@p47 nvarchar(4000),@p48 int,@p49 int,@p50 datetime2(7),@p51 datetime2(7),@p52 datetime2(7),@p53 nvarchar(4000),@p54 nvarchar(4000),@p55 nvarchar(4000),@p56 nvarchar(4000),@p57 nvarchar(4000),@p58 nvarchar(4000),@p59 nvarchar(4000),@p60 nvarchar(4000),@p61 nvarchar(4000),@p62 nvarchar(4000),@p63 nvarchar(4000),@p64 nvarchar(4000),@p65 nvarchar(4000),@p66 nvarchar(4000),@p67 datetime2(7),@p68 nvarchar(4000),@p69 nvarchar(4000),@p70 int,@p71 int,@p72 int,@p73 nvarchar(4000),@p74 nvarchar(4000),@p75 nvarchar(4000),@p76 decimal(18,2),@p77 decimal(18,2),@p78 nvarchar(4000),@p79 nvarchar(4000),@p80 decimal(18,2),@p81 nvarchar(4000),@p82 nvarchar(4000),@p83 nvarchar(4000),@p84 nvarchar(4000),@p85 int,@p86 nvarchar(4000),@p87 nvarchar(4000),@p88 nvarchar(4000),@p89 nvarchar(4000),@p90 nvarchar(4000),@p91 nvarchar(4000),@p92 nvarchar(4000),@p93 nvarchar(4000),@p94 nvarchar(4000),@p95 nvarchar(4000),@p96 int,@p97 nvarchar(4000),@p98 nvarchar(4000),@p99 nvarchar(4000),@p100 nvarchar(4000),@p101 nvarchar(4000),@p102 int,@p103 nvarchar(4000),@p104 int,@p105 int,@p106 datetime2(7),@p107 datetime2(7),@p108 datetime2(7),@p109 nvarchar(4000),@p110 nvarchar(4000),@p111 nvarchar(4000),@p112 nvarchar(4000),@p113 nvarchar(4000),@p114 nvarchar(4000),@p115 nvarchar(4000),@p116 nvarchar(4000),@p117 nvarchar(4000),@p118 nvarchar(4000),@p119 nvarchar(4000),@p120 nvarchar(4000),@p121 nvarchar(4000),@p122 nvarchar(4000),@p123 datetime2(7),@p124 nvarchar(4000),@p125 nvarchar(4000),@p126 int,@p127 int,@p128 int,@p129 nvarchar(4000),@p130 nvarchar(4000),@p131 nvarchar(4000),@p132 decimal(18,2),@p133 decimal(18,2),@p134 nvarchar(4000),@p135 nvarchar(4000),@p136 decimal(18,2),@p137 nvarchar(4000),@p138 nvarchar(4000),@p139 nvarchar(4000),@p140 nvarchar(4000),@p141 int,@p142 nvarchar(4000),@p143 nvarchar(4000),@p144 nvarchar(4000),@p145 nvarchar(4000),@p146 nvarchar(4000),@p147 nvarchar(4000),@p148 nvarchar(4000),@p149 nvarchar(4000),@p150 nvarchar(4000),@p151 nvarchar(4000),@p152 int,@p153 nvarchar(4000),@p154 nvarchar(4000),@p155 nvarchar(4000),@p156 nvarchar(4000),@p157 nvarchar(4000),@p158 int,@p159 nvarchar(4000),@p160 int,@p161 int,@p162 datetime2(7),@p163 datetime2(7),@p164 datetime2(7),@p165 nvarchar(4000),@p166 nvarchar(4000),@p167 nvarchar(4000),@p168 nvarchar(4000),@p169 nvarchar(4000),@p170 nvarchar(4000),@p171 nvarchar(4000),@p172 nvarchar(4000),@p173 nvarchar(4000),@p174 nvarchar(4000),@p175 nvarchar(4000),@p176 nvarchar(4000),@p177 nvarchar(4000),@p178 nvarchar(4000),@p179 datetime2(7),@p180 nvarchar(4000),@p181 nvarchar(4000),@p182 int,@p183 int,@p184 int,@p185 nvarchar(4000),@p186 nvarchar(4000),@p187 nvarchar(4000),@p188 decimal(18,2),@p189 decimal(18,2),@p190 nvarchar(4000),@p191 nvarchar(4000),@p192 decimal(18,2),@p193 nvarchar(4000),@p194 nvarchar(4000),@p195 nvarchar(4000),@p196 nvarchar(4000),@p197 int,@p198 nvarchar(4000),@p199 nvarchar(4000),@p200 nvarchar(4000),@p201 nvarchar(4000),@p202 nvarchar(4000),@p203 nvarchar(4000),@p204 nvarchar(4000),@p205 nvarchar(4000),@p206 nvarchar(4000),@p207 nvarchar(4000),@p208 int,@p209 nvarchar(4000),@p210 nvarchar(4000),@p211 nvarchar(4000),@p212 nvarchar(4000),@p213 nvarchar(4000),@p214 int,@p215 nvarchar(4000),@p216 int,@p217 int,@p218 datetime2(7),@p219 datetime2(7),@p220 datetime2(7),@p221 nvarchar(4000),@p222 nvarchar(4000),@p223 nvarchar(4000),@p224 nvarchar(4000),@p225 nvarchar(4000),@p226 nvarchar(4000),@p227 nvarchar(4000),@p228 nvarchar(4000),@p229 nvarchar(4000),@p230 nvarchar(4000),@p231 nvarchar(4000),@p232 nvarchar(4000),@p233 nvarchar(4000),@p234 nvarchar(4000),@p235 datetime2(7),@p236 nvarchar(4000),@p237 nvarchar(4000),@p238 int,@p239 int,@p240 int,@p241 nvarchar(4000),@p242 nvarchar(4000),@p243 nvarchar(4000),@p244 decimal(18,2),@p245 decimal(18,2),@p246 nvarchar(4000),@p247 nvarchar(4000),@p248 decimal(18,2),@p249 nvarchar(4000),@p250 nvarchar(4000),@p251 nvarchar(4000),@p252 nvarchar(4000),@p253 int,@p254 nvarchar(4000),@p255 nvarchar(4000),@p256 nvarchar(4000),@p257 nvarchar(4000),@p258 nvarchar(4000),@p259 nvarchar(4000),@p260 nvarchar(4000),@p261 nvarchar(4000),@p262 nvarchar(4000),@p263 nvarchar(4000),@p264 int,@p265 nvarchar(4000),@p266 nvarchar(4000),@p267 nvarchar(4000),@p268 nvarchar(4000),@p269 nvarchar(4000),@p270 int,@p271 nvarchar(4000),@p272 int,@p273 int,@p274 datetime2(7),@p275 datetime2(7),@p276 datetime2(7),@p277 nvarchar(4000),@p278 nvarchar(4000),@p279 nvarchar(4000),@p280 nvarchar(4000),@p281 nvarchar(4000),@p282 nvarchar(4000),@p283 nvarchar(4000),@p284 nvarchar(4000),@p285 nvarchar(4000),@p286 nvarchar(4000),@p287 nvarchar(4000),@p288 nvarchar(4000),@p289 nvarchar(4000),@p290 nvarchar(4000),@p291 datetime2(7),@p292 nvarchar(4000),@p293 nvarchar(4000),@p294 int,@p295 int,@p296 int,@p297 nvarchar(4000),@p298 nvarchar(4000),@p299 nvarchar(4000),@p300 decimal(18,2),@p301 decimal(18,2),@p302 nvarchar(4000),@p303 nvarchar(4000),@p304 decimal(18,2),@p305 nvarchar(4000),@p306 nvarchar(4000),@p307 nvarchar(4000),@p308 nvarchar(4000),@p309 int,@p310 nvarchar(4000),@p311 nvarchar(4000),@p312 nvarchar(4000),@p313 nvarchar(4000),@p314 nvarchar(4000),@p315 nvarchar(4000),@p316 nvarchar(4000),@p317 nvarchar(4000),@p318 nvarchar(4000),@p319 nvarchar(4000),@p320 int,@p321 nvarchar(4000),@p322 nvarchar(4000),@p323 nvarchar(4000),@p324 nvarchar(4000),@p325 nvarchar(4000),@p326 int,@p327 nvarchar(4000),@p328 int,@p329 int,@p330 datetime2(7),@p331 datetime2(7),@p332 datetime2(7),@p333 nvarchar(4000),@p334 nvarchar(4000),@p335 nvarchar(4000),@p336 nvarchar(4000),@p337 nvarchar(4000),@p338 nvarchar(4000),@p339 nvarchar(4000),@p340 nvarchar(4000),@p341 nvarchar(4000),@p342 nvarchar(4000),@p343 nvarchar(4000),@p344 nvarchar(4000),@p345 nvarchar(4000),@p346 nvarchar(4000),@p347 datetime2(7),@p348 nvarchar(4000),@p349 nvarchar(4000),@p350 int,@p351 int,@p352 int,@p353 nvarchar(4000),@p354 nvarchar(4000),@p355 nvarchar(4000),@p356 decimal(18,2),@p357 decimal(18,2),@p358 nvarchar(4000),@p359 nvarchar(4000),@p360 decimal(18,2),@p361 nvarchar(4000),@p362 nvarchar(4000),@p363 nvarchar(4000),@p364 nvarchar(4000),@p365 int,@p366 nvarchar(4000),@p367 nvarchar(4000),@p368 nvarchar(4000),@p369 nvarchar(4000),@p370 nvarchar(4000),@p371 nvarchar(4000),@p372 nvarchar(4000),@p373 nvarchar(4000),@p374 nvarchar(4000),@p375 nvarchar(4000),@p376 int,@p377 nvarchar(4000),@p378 nvarchar(4000),@p379 nvarchar(4000),@p380 nvarchar(4000),@p381 nvarchar(4000),@p382 int,@p383 nvarchar(4000),@p384 int,@p385 int,@p386 datetime2(7),@p387 datetime2(7),@p388 datetime2(7),@p389 nvarchar(4000),@p390 nvarchar(4000),@p391 nvarchar(4000),@p392 nvarchar(4000),@p393 nvarchar(4000),@p394 nvarchar(4000),@p395 nvarchar(4000),@p396 nvarchar(4000),@p397 nvarchar(4000),@p398 nvarchar(4000),@p399 nvarchar(4000),@p400 nvarchar(4000),@p401 nvarchar(4000),@p402 nvarchar(4000),@p403 datetime2(7),@p404 nvarchar(4000),@p405 nvarchar(4000),@p406 int,@p407 int,@p408 int,@p409 nvarchar(4000),@p410 nvarchar(4000),@p411 nvarchar(4000),@p412 decimal(18,2),@p413 decimal(18,2),@p414 nvarchar(4000),@p415 nvarchar(4000),@p416 decimal(18,2),@p417 nvarchar(4000),@p418 nvarchar(4000),@p419 nvarchar(4000),@p420 nvarchar(4000),@p421 int,@p422 nvarchar(4000),@p423 nvarchar(4000),@p424 nvarchar(4000),@p425 nvarchar(4000),@p426 nvarchar(4000),@p427 nvarchar(4000),@p428 nvarchar(4000),@p429 nvarchar(4000),@p430 nvarchar(4000),@p431 nvarchar(4000),@p432 int,@p433 nvarchar(4000),@p434 nvarchar(4000),@p435 nvarchar(4000),@p436 nvarchar(4000),@p437 nvarchar(4000),@p438 int,@p439 nvarchar(4000),@p440 int,@p441 int,@p442 datetime2(7),@p443 datetime2(7),@p444 datetime2(7),@p445 nvarchar(4000),@p446 nvarchar(4000),@p447 nvarchar(4000),@p448 nvarchar(4000),@p449 nvarchar(4000),@p450 nvarchar(4000),@p451 nvarchar(4000),@p452 nvarchar(4000),@p453 nvarchar(4000),@p454 nvarchar(4000),@p455 nvarchar(4000),@p456 nvarchar(4000),@p457 nvarchar(4000),@p458 nvarchar(4000),@p459 datetime2(7),@p460 nvarchar(4000),@p461 nvarchar(4000),@p462 int,@p463 int,@p464 int,@p465 nvarchar(4000),@p466 nvarchar(4000),@p467 nvarchar(4000),@p468 decimal(18,2),@p469 decimal(18,2),@p470 nvarchar(4000),@p471 nvarchar(4000),@p472 decimal(18,2),@p473 nvarchar(4000),@p474 nvarchar(4000),@p475 nvarchar(4000),@p476 nvarchar(4000),@p477 int,@p478 nvarchar(4000),@p479 nvarchar(4000),@p480 nvarchar(4000),@p481 nvarchar(4000),@p482 nvarchar(4000),@p483 nvarchar(4000),@p484 nvarchar(4000),@p485 nvarchar(4000),@p486 nvarchar(4000),@p487 nvarchar(4000),@p488 int,@p489 nvarchar(4000),@p490 nvarchar(4000),@p491 nvarchar(4000),@p492 nvarchar(4000),@p493 nvarchar(4000),@p494 int,@p495 nvarchar(4000),@p496 int,@p497 int,@p498 datetime2(7),@p499 datetime2(7),@p500 datetime2(7),@p501 nvarchar(4000),@p502 nvarchar(4000),@p503 nvarchar(4000),@p504 nvarchar(4000),@p505 nvarchar(4000),@p506 nvarchar(4000),@p507 nvarchar(4000),@p508 nvarchar(4000),@p509 nvarchar(4000),@p510 nvarchar(4000),@p511 nvarchar(4000),@p512 nvarchar(4000),@p513 nvarchar(4000),@p514 nvarchar(4000),@p515 datetime2(7),@p516 nvarchar(4000),@p517 nvarchar(4000),@p518 int,@p519 int,@p520 int,@p521 nvarchar(4000),@p522 nvarchar(4000),@p523 nvarchar(4000),@p524 decimal(18,2),@p525 decimal(18,2),@p526 nvarchar(4000),@p527 nvarchar(4000),@p528 decimal(18,2),@p529 nvarchar(4000),@p530 nvarchar(4000),@p531 nvarchar(4000),@p532 nvarchar(4000),@p533 int,@p534 nvarchar(4000),@p535 nvarchar(4000),@p536 nvarchar(4000),@p537 nvarchar(4000),@p538 nvarchar(4000),@p539 nvarchar(4000),@p540 nvarchar(4000),@p541 nvarchar(4000),@p542 nvarchar(4000),@p543 nvarchar(4000),@p544 int,@p545 nvarchar(4000),@p546 nvarchar(4000),@p547 nvarchar(4000),@p548 nvarchar(4000),@p549 nvarchar(4000),@p550 int,@p551 nvarchar(4000),@p552 int,@p553 int,@p554 datetime2(7),@p555 datetime2(7),@p556 datetime2(7),@p557 nvarchar(4000),@p558 nvarchar(4000),@p559 nvarchar(4000),@p560 nvarchar(4000),@p561 nvarchar(4000),@p562 nvarchar(4000),@p563 nvarchar(4000),@p564 nvarchar(4000),@p565 nvarchar(4000),@p566 nvarchar(4000),@p567 nvarchar(4000),@p568 nvarchar(4000),@p569 nvarchar(4000),@p570 nvarchar(4000),@p571 datetime2(7),@p572 nvarchar(4000),@p573 nvarchar(4000),@p574 int,@p575 int,@p576 int,@p577 nvarchar(4000),@p578 nvarchar(4000),@p579 nvarchar(4000),@p580 decimal(18,2),@p581 decimal(18,2),@p582 nvarchar(4000),@p583 nvarchar(4000),@p584 decimal(18,2),@p585 nvarchar(4000),@p586 nvarchar(4000),@p587 nvarchar(4000),@p588 nvarchar(4000),@p589 int,@p590 nvarchar(4000),@p591 nvarchar(4000),@p592 nvarchar(4000),@p593 nvarchar(4000),@p594 nvarchar(4000),@p595 nvarchar(4000),@p596 nvarchar(4000),@p597 nvarchar(4000),@p598 nvarchar(4000),@p599 nvarchar(4000),@p600 int,@p601 nvarchar(4000),@p602 nvarchar(4000),@p603 nvarchar(4000),@p604 nvarchar(4000),@p605 nvarchar(4000),@p606 int,@p607 nvarchar(4000),@p608 int,@p609 int,@p610 datetime2(7),@p611 datetime2(7),@p612 datetime2(7),@p613 nvarchar(4000),@p614 nvarchar(4000),@p615 nvarchar(4000),@p616 nvarchar(4000),@p617 nvarchar(4000),@p618 nvarchar(4000),@p619 nvarchar(4000),@p620 nvarchar(4000),@p621 nvarchar(4000),@p622 nvarchar(4000),@p623 nvarchar(4000),@p624 nvarchar(4000),@p625 nvarchar(4000),@p626 nvarchar(4000),@p627 datetime2(7),@p628 nvarchar(4000),@p629 nvarchar(4000),@p630 int,@p631 int,@p632 int,@p633 nvarchar(4000),@p634 nvarchar(4000),@p635 nvarchar(4000),@p636 decimal(18,2),@p637 decimal(18,2),@p638 nvarchar(4000),@p639 nvarchar(4000),@p640 decimal(18,2),@p641 nvarchar(4000),@p642 nvarchar(4000),@p643 nvarchar(4000),@p644 nvarchar(4000),@p645 int,@p646 nvarchar(4000),@p647 nvarchar(4000),@p648 nvarchar(4000),@p649 nvarchar(4000),@p650 nvarchar(4000),@p651 nvarchar(4000),@p652 nvarchar(4000),@p653 nvarchar(4000),@p654 nvarchar(4000),@p655 nvarchar(4000),@p656 int,@p657 nvarchar(4000),@p658 nvarchar(4000),@p659 nvarchar(4000),@p660 nvarchar(4000),@p661 nvarchar(4000),@p662 int,@p663 nvarchar(4000),@p664 int,@p665 int,@p666 datetime2(7),@p667 datetime2(7),@p668 datetime2(7),@p669 nvarchar(4000),@p670 nvarchar(4000),@p671 nvarchar(4000),@p672 nvarchar(4000),@p673 nvarchar(4000),@p674 nvarchar(4000),@p675 nvarchar(4000),@p676 nvarchar(4000),@p677 nvarchar(4000),@p678 nvarchar(4000),@p679 nvarchar(4000),@p680 nvarchar(4000),@p681 nvarchar(4000),@p682 nvarchar(4000),@p683 datetime2(7),@p684 nvarchar(4000),@p685 nvarchar(4000),@p686 int,@p687 int,@p688 int,@p689 nvarchar(4000),@p690 nvarchar(4000),@p691 nvarchar(4000),@p692 decimal(18,2),@p693 decimal(18,2),@p694 nvarchar(4000),@p695 nvarchar(4000),@p696 decimal(18,2),@p697 nvarchar(4000),@p698 nvarchar(4000),@p699 nvarchar(4000),@p700 nvarchar(4000),@p701 int,@p702 nvarchar(4000),@p703 nvarchar(4000),@p704 nvarchar(4000),@p705 nvarchar(4000),@p706 nvarchar(4000),@p707 nvarchar(4000),@p708 nvarchar(4000),@p709 nvarchar(4000),@p710 nvarchar(4000),@p711 nvarchar(4000),@p712 int,@p713 nvarchar(4000),@p714 nvarchar(4000),@p715 nvarchar(4000),@p716 nvarchar(4000),@p717 nvarchar(4000),@p718 int,@p719 nvarchar(4000),@p720 int,@p721 int,@p722 datetime2(7),@p723 datetime2(7),@p724 datetime2(7),@p725 nvarchar(4000),@p726 nvarchar(4000),@p727 nvarchar(4000),@p728 nvarchar(4000),@p729 nvarchar(4000),@p730 nvarchar(4000),@p731 nvarchar(4000),@p732 nvarchar(4000),@p733 nvarchar(4000),@p734 nvarchar(4000),@p735 nvarchar(4000),@p736 nvarchar(4000),@p737 nvarchar(4000),@p738 nvarchar(4000),@p739 datetime2(7),@p740 nvarchar(4000),@p741 nvarchar(4000),@p742 int,@p743 int,@p744 int,@p745 nvarchar(4000),@p746 nvarchar(4000),@p747 nvarchar(4000),@p748 decimal(18,2),@p749 decimal(18,2),@p750 nvarchar(4000),@p751 nvarchar(4000),@p752 decimal(18,2),@p753 nvarchar(4000),@p754 nvarchar(4000),@p755 nvarchar(4000),@p756 nvarchar(4000),@p757 int,@p758 nvarchar(4000),@p759 nvarchar(4000),@p760 nvarchar(4000),@p761 nvarchar(4000),@p762 nvarchar(4000),@p763 nvarchar(4000),@p764 nvarchar(4000),@p765 nvarchar(4000),@p766 nvarchar(4000),@p767 nvarchar(4000),@p768 int,@p769 nvarchar(4000),@p770 nvarchar(4000),@p771 nvarchar(4000),@p772 nvarchar(4000),@p773 nvarchar(4000),@p774 int,@p775 nvarchar(4000),@p776 int,@p777 int,@p778 datetime2(7),@p779 datetime2(7),@p780 datetime2(7),@p781 nvarchar(4000),@p782 nvarchar(4000),@p783 nvarchar(4000),@p784 nvarchar(4000),@p785 nvarchar(4000),@p786 nvarchar(4000),@p787 nvarchar(4000),@p788 nvarchar(4000),@p789 nvarchar(4000),@p790 nvarchar(4000),@p791 nvarchar(4000),@p792 nvarchar(4000),@p793 nvarchar(4000),@p794 nvarchar(4000),@p795 datetime2(7),@p796 nvarchar(4000),@p797 nvarchar(4000),@p798 int,@p799 int,@p800 int,@p801 nvarchar(4000),@p802 nvarchar(4000),@p803 nvarchar(4000),@p804 decimal(18,2),@p805 decimal(18,2),@p806 nvarchar(4000),@p807 nvarchar(4000),@p808 decimal(18,2),@p809 nvarchar(4000),@p810 nvarchar(4000),@p811 nvarchar(4000),@p812 nvarchar(4000),@p813 int,@p814 nvarchar(4000),@p815 nvarchar(4000),@p816 nvarchar(4000),@p817 nvarchar(4000),@p818 nvarchar(4000),@p819 nvarchar(4000),@p820 nvarchar(4000),@p821 nvarchar(4000),@p822 nvarchar(4000),@p823 nvarchar(4000),@p824 int,@p825 nvarchar(4000),@p826 nvarchar(4000),@p827 nvarchar(4000),@p828 nvarchar(4000),@p829 nvarchar(4000),@p830 int,@p831 nvarchar(4000),@p832 int,@p833 int,@p834 datetime2(7),@p835 datetime2(7),@p836 datetime2(7),@p837 nvarchar(4000),@p838 nvarchar(4000),@p839 nvarchar(4000),@p840 nvarchar(4000),@p841 nvarchar(4000),@p842 nvarchar(4000),@p843 nvarchar(4000),@p844 nvarchar(4000),@p845 nvarchar(4000),@p846 nvarchar(4000),@p847 nvarchar(4000),@p848 nvarchar(4000),@p849 nvarchar(4000),@p850 nvarchar(4000),@p851 datetime2(7),@p852 nvarchar(4000),@p853 nvarchar(4000),@p854 int,@p855 int,@p856 int,@p857 nvarchar(4000),@p858 nvarchar(4000),@p859 nvarchar(4000),@p860 decimal(18,2),@p861 decimal(18,2),@p862 nvarchar(4000),@p863 nvarchar(4000),@p864 decimal(18,2),@p865 nvarchar(4000),@p866 nvarchar(4000),@p867 nvarchar(4000),@p868 nvarchar(4000),@p869 int,@p870 nvarchar(4000),@p871 nvarchar(4000),@p872 nvarchar(4000),@p873 nvarchar(4000),@p874 nvarchar(4000),@p875 nvarchar(4000),@p876 nvarchar(4000),@p877 nvarchar(4000),@p878 nvarchar(4000),@p879 nvarchar(4000),@p880 int,@p881 nvarchar(4000),@p882 nvarchar(4000),@p883 nvarchar(4000),@p884 nvarchar(4000),@p885 nvarchar(4000),@p886 int,@p887 nvarchar(4000),@p888 int,@p889 int,@p890 datetime2(7),@p891 datetime2(7),@p892 datetime2(7),@p893 nvarchar(4000),@p894 nvarchar(4000),@p895 nvarchar(4000),@p896 nvarchar(4000),@p897 nvarchar(4000),@p898 nvarchar(4000),@p899 nvarchar(4000),@p900 nvarchar(4000),@p901 nvarchar(4000),@p902 nvarchar(4000),@p903 nvarchar(4000),@p904 nvarchar(4000),@p905 nvarchar(4000),@p906 nvarchar(4000),@p907 datetime2(7),@p908 nvarchar(4000),@p909 nvarchar(4000),@p910 int,@p911 int,@p912 int,@p913 nvarchar(4000),@p914 nvarchar(4000),@p915 nvarchar(4000),@p916 decimal(18,2),@p917 decimal(18,2),@p918 nvarchar(4000),@p919 nvarchar(4000),@p920 decimal(18,2),@p921 nvarchar(4000),@p922 nvarchar(4000),@p923 nvarchar(4000),@p924 nvarchar(4000),@p925 int,@p926 nvarchar(4000),@p927 nvarchar(4000),@p928 nvarchar(4000),@p929 nvarchar(4000),@p930 nvarchar(4000),@p931 nvarchar(4000),@p932 nvarchar(4000),@p933 nvarchar(4000),@p934 nvarchar(4000),@p935 nvarchar(4000),@p936 int,@p937 nvarchar(4000),@p938 nvarchar(4000),@p939 nvarchar(4000),@p940 nvarchar(4000),@p941 nvarchar(4000),@p942 int,@p943 nvarchar(4000),@p944 int,@p945 int,@p946 datetime2(7),@p947 datetime2(7),@p948 datetime2(7),@p949 nvarchar(4000),@p950 nvarchar(4000),@p951 nvarchar(4000),@p952 nvarchar(4000),@p953 nvarchar(4000),@p954 nvarchar(4000),@p955 nvarchar(4000),@p956 nvarchar(4000),@p957 nvarchar(4000),@p958 nvarchar(4000),@p959 nvarchar(4000),@p960 nvarchar(4000),@p961 nvarchar(4000),@p962 nvarchar(4000),@p963 datetime2(7),@p964 nvarchar(4000),@p965 nvarchar(4000),@p966 int,@p967 int,@p968 int,@p969 nvarchar(4000),@p970 nvarchar(4000),@p971 nvarchar(4000),@p972 decimal(18,2),@p973 decimal(18,2),@p974 nvarchar(4000),@p975 nvarchar(4000),@p976 decimal(18,2),@p977 nvarchar(4000),@p978 nvarchar(4000),@p979 nvarchar(4000),@p980 nvarchar(4000),@p981 int,@p982 nvarchar(4000),@p983 nvarchar(4000),@p984 nvarchar(4000),@p985 nvarchar(4000),@p986 nvarchar(4000),@p987 nvarchar(4000),@p988 nvarchar(4000),@p989 nvarchar(4000),@p990 nvarchar(4000),@p991 nvarchar(4000),@p992 int,@p993 nvarchar(4000),@p994 nvarchar(4000),@p995 nvarchar(4000),@p996 nvarchar(4000),@p997 nvarchar(4000),@p998 int,@p999 nvarchar(4000),@p1000 int,@p1001 int,@p1002 datetime2(7),@p1003 datetime2(7),@p1004 datetime2(7),@p1005 nvarchar(4000),@p1006 nvarchar(4000),@p1007 nvarchar(4000),@p1008 nvarchar(4000),@p1009 nvarchar(4000),@p1010 nvarchar(4000),@p1011 nvarchar(4000),@p1012 nvarchar(4000),@p1013 nvarchar(4000),@p1014 nvarchar(4000),@p1015 nvarchar(4000),@p1016 nvarchar(4000),@p1017 nvarchar(4000),@p1018 nvarchar(4000),@p1019 datetime2(7),@p1020 nvarchar(4000),@p1021 nvarchar(4000),@p1022 int,@p1023 int,@p1024 int,@p1025 nvarchar(4000),@p1026 nvarchar(4000),@p1027 nvarchar(4000),@p1028 decimal(18,2),@p1029 decimal(18,2),@p1030 nvarchar(4000),@p1031 nvarchar(4000),@p1032 decimal(18,2),@p1033 nvarchar(4000),@p1034 nvarchar(4000),@p1035 nvarchar(4000),@p1036 nvarchar(4000),@p1037 int,@p1038 nvarchar(4000),@p1039 nvarchar(4000),@p1040 nvarchar(4000),@p1041 nvarchar(4000),@p1042 nvarchar(4000),@p1043 nvarchar(4000),@p1044 nvarchar(4000),@p1045 nvarchar(4000),@p1046 nvarchar(4000),@p1047 nvarchar(4000),@p1048 int,@p1049 nvarchar(4000),@p1050 nvarchar(4000),@p1051 nvarchar(4000),@p1052 nvarchar(4000),@p1053 nvarchar(4000),@p1054 int,@p1055 nvarchar(4000),@p1056 int,@p1057 int,@p1058 datetime2(7),@p1059 datetime2(7),@p1060 datetime2(7),@p1061 nvarchar(4000),@p1062 nvarchar(4000),@p1063 nvarchar(4000),@p1064 nvarchar(4000),@p1065 nvarchar(4000),@p1066 nvarchar(4000),@p1067 nvarchar(4000),@p1068 nvarchar(4000),@p1069 nvarchar(4000),@p1070 nvarchar(4000),@p1071 nvarchar(4000),@p1072 nvarchar(4000),@p1073 nvarchar(4000),@p1074 nvarchar(4000),@p1075 datetime2(7),@p1076 nvarchar(4000),@p1077 nvarchar(4000),@p1078 int,@p1079 int,@p1080 int,@p1081 nvarchar(4000),@p1082 nvarchar(4000),@p1083 nvarchar(4000),@p1084 decimal(18,2),@p1085 decimal(18,2),@p1086 nvarchar(4000),@p1087 nvarchar(4000),@p1088 decimal(18,2),@p1089 nvarchar(4000),@p1090 nvarchar(4000),@p1091 nvarchar(4000),@p1092 nvarchar(4000),@p1093 int,@p1094 nvarchar(4000),@p1095 nvarchar(4000),@p1096 nvarchar(4000),@p1097 nvarchar(4000),@p1098 nvarchar(4000),@p1099 nvarchar(4000),@p1100 nvarchar(4000),@p1101 nvarchar(4000),@p1102 nvarchar(4000),@p1103 nvarchar(4000),@p1104 int,@p1105 nvarchar(4000),@p1106 nvarchar(4000),@p1107 nvarchar(4000),@p1108 nvarchar(4000),@p1109 nvarchar(4000),@p1110 int,@p1111 nvarchar(4000),@p1112 int,@p1113 int,@p1114 datetime2(7),@p1115 datetime2(7),@p1116 datetime2(7),@p1117 nvarchar(4000),@p1118 nvarchar(4000),@p1119 nvarchar(4000),@p1120 nvarchar(4000),@p1121 nvarchar(4000),@p1122 nvarchar(4000),@p1123 nvarchar(4000),@p1124 nvarchar(4000),@p1125 nvarchar(4000),@p1126 nvarchar(4000),@p1127 nvarchar(4000),@p1128 nvarchar(4000),@p1129 nvarchar(4000),@p1130 nvarchar(4000),@p1131 datetime2(7),@p1132 nvarchar(4000),@p1133 nvarchar(4000),@p1134 int,@p1135 int,@p1136 int,@p1137 nvarchar(4000),@p1138 nvarchar(4000),@p1139 nvarchar(4000),@p1140 decimal(18,2),@p1141 decimal(18,2),@p1142 nvarchar(4000),@p1143 nvarchar(4000),@p1144 decimal(18,2),@p1145 nvarchar(4000),@p1146 nvarchar(4000),@p1147 nvarchar(4000),@p1148 nvarchar(4000),@p1149 int,@p1150 nvarchar(4000),@p1151 nvarchar(4000),@p1152 nvarchar(4000),@p1153 nvarchar(4000),@p1154 nvarchar(4000),@p1155 nvarchar(4000),@p1156 nvarchar(4000),@p1157 nvarchar(4000),@p1158 nvarchar(4000),@p1159 nvarchar(4000),@p1160 int,@p1161 nvarchar(4000),@p1162 nvarchar(4000),@p1163 nvarchar(4000),@p1164 nvarchar(4000),@p1165 nvarchar(4000),@p1166 int,@p1167 nvarchar(4000),@p1168 int,@p1169 int,@p1170 datetime2(7),@p1171 datetime2(7),@p1172 datetime2(7),@p1173 nvarchar(4000),@p1174 nvarchar(4000),@p1175 nvarchar(4000),@p1176 nvarchar(4000),@p1177 nvarchar(4000),@p1178 nvarchar(4000),@p1179 nvarchar(4000),@p1180 nvarchar(4000),@p1181 nvarchar(4000),@p1182 nvarchar(4000),@p1183 nvarchar(4000),@p1184 nvarchar(4000),@p1185 nvarchar(4000),@p1186 nvarchar(4000),@p1187 datetime2(7),@p1188 nvarchar(4000),@p1189 nvarchar(4000),@p1190 int,@p1191 int,@p1192 int,@p1193 nvarchar(4000),@p1194 nvarchar(4000),@p1195 nvarchar(4000),@p1196 decimal(18,2),@p1197 decimal(18,2),@p1198 nvarchar(4000),@p1199 nvarchar(4000),@p1200 decimal(18,2),@p1201 nvarchar(4000),@p1202 nvarchar(4000),@p1203 nvarchar(4000),@p1204 nvarchar(4000),@p1205 int,@p1206 nvarchar(4000),@p1207 nvarchar(4000),@p1208 nvarchar(4000),@p1209 nvarchar(4000),@p1210 nvarchar(4000),@p1211 nvarchar(4000),@p1212 nvarchar(4000),@p1213 nvarchar(4000),@p1214 nvarchar(4000),@p1215 nvarchar(4000),@p1216 int,@p1217 nvarchar(4000),@p1218 nvarchar(4000),@p1219 nvarchar(4000),@p1220 nvarchar(4000),@p1221 nvarchar(4000),@p1222 int,@p1223 nvarchar(4000),@p1224 int,@p1225 int,@p1226 datetime2(7),@p1227 datetime2(7),@p1228 datetime2(7),@p1229 nvarchar(4000),@p1230 nvarchar(4000),@p1231 nvarchar(4000),@p1232 nvarchar(4000),@p1233 nvarchar(4000),@p1234 nvarchar(4000),@p1235 nvarchar(4000),@p1236 nvarchar(4000),@p1237 nvarchar(4000),@p1238 nvarchar(4000),@p1239 nvarchar(4000),@p1240 nvarchar(4000),@p1241 nvarchar(4000),@p1242 nvarchar(4000),@p1243 datetime2(7),@p1244 nvarchar(4000),@p1245 nvarchar(4000),@p1246 int,@p1247 int,@p1248 int,@p1249 nvarchar(4000),@p1250 nvarchar(4000),@p1251 nvarchar(4000),@p1252 decimal(18,2),@p1253 decimal(18,2),@p1254 nvarchar(4000),@p1255 nvarchar(4000),@p1256 decimal(18,2),@p1257 nvarchar(4000),@p1258 nvarchar(4000),@p1259 nvarchar(4000),@p1260 nvarchar(4000),@p1261 int,@p1262 nvarchar(4000),@p1263 nvarchar(4000),@p1264 nvarchar(4000),@p1265 nvarchar(4000),@p1266 nvarchar(4000),@p1267 nvarchar(4000),@p1268 nvarchar(4000),@p1269 nvarchar(4000),@p1270 nvarchar(4000),@p1271 nvarchar(4000),@p1272 int,@p1273 nvarchar(4000),@p1274 nvarchar(4000),@p1275 nvarchar(4000),@p1276 nvarchar(4000),@p1277 nvarchar(4000),@p1278 int,@p1279 nvarchar(4000),@p1280 int,@p1281 int,@p1282 datetime2(7),@p1283 datetime2(7),@p1284 datetime2(7),@p1285 nvarchar(4000),@p1286 nvarchar(4000),@p1287 nvarchar(4000),@p1288 nvarchar(4000),@p1289 nvarchar(4000),@p1290 nvarchar(4000),@p1291 nvarchar(4000),@p1292 nvarchar(4000),@p1293 nvarchar(4000),@p1294 nvarchar(4000),@p1295 nvarchar(4000),@p1296 nvarchar(4000),@p1297 nvarchar(4000),@p1298 nvarchar(4000),@p1299 datetime2(7),@p1300 nvarchar(4000),@p1301 nvarchar(4000),@p1302 int,@p1303 int,@p1304 int,@p1305 nvarchar(4000),@p1306 nvarchar(4000),@p1307 nvarchar(4000),@p1308 decimal(18,2),@p1309 decimal(18,2),@p1310 nvarchar(4000),@p1311 nvarchar(4000),@p1312 decimal(18,2),@p1313 nvarchar(4000),@p1314 nvarchar(4000),@p1315 nvarchar(4000),@p1316 nvarchar(4000),@p1317 int,@p1318 nvarchar(4000),@p1319 nvarchar(4000),@p1320 nvarchar(4000),@p1321 nvarchar(4000),@p1322 nvarchar(4000),@p1323 nvarchar(4000),@p1324 nvarchar(4000),@p1325 nvarchar(4000),@p1326 nvarchar(4000),@p1327 nvarchar(4000),@p1328 int,@p1329 nvarchar(4000),@p1330 nvarchar(4000),@p1331 nvarchar(4000),@p1332 nvarchar(4000),@p1333 nvarchar(4000),@p1334 int,@p1335 nvarchar(4000),@p1336 int,@p1337 int,@p1338 datetime2(7),@p1339 datetime2(7),@p1340 datetime2(7),@p1341 nvarchar(4000),@p1342 nvarchar(4000),@p1343 nvarchar(4000),@p1344 nvarchar(4000),@p1345 nvarchar(4000),@p1346 nvarchar(4000),@p1347 nvarchar(4000),@p1348 nvarchar(4000),@p1349 nvarchar(4000),@p1350 nvarchar(4000),@p1351 nvarchar(4000),@p1352 nvarchar(4000),@p1353 nvarchar(4000),@p1354 nvarchar(4000),@p1355 datetime2(7),@p1356 nvarchar(4000),@p1357 nvarchar(4000),@p1358 int,@p1359 int,@p1360 int,@p1361 nvarchar(4000),@p1362 nvarchar(4000),@p1363 nvarchar(4000),@p1364 nvarchar(4000),@p1365 decimal(18,2),@p1366 nvarchar(4000),@p1367 nvarchar(4000),@p1368 decimal(18,2),@p1369 nvarchar(4000),@p1370 nvarchar(4000),@p1371 nvarchar(4000),@p1372 nvarchar(4000),@p1373 int,@p1374 nvarchar(4000),@p1375 nvarchar(4000),@p1376 nvarchar(4000),@p1377 nvarchar(4000),@p1378 nvarchar(4000),@p1379 nvarchar(4000),@p1380 nvarchar(4000),@p1381 nvarchar(4000),@p1382 nvarchar(4000),@p1383 nvarchar(4000),@p1384 int,@p1385 nvarchar(4000),@p1386 nvarchar(4000),@p1387 nvarchar(4000),@p1388 nvarchar(4000),@p1389 nvarchar(4000),@p1390 int,@p1391 nvarchar(4000),@p1392 int,@p1393 int,@p1394 datetime2(7),@p1395 datetime2(7),@p1396 datetime2(7),@p1397 nvarchar(4000),@p1398 nvarchar(4000),@p1399 nvarchar(4000),@p1400 nvarchar(4000),@p1401 nvarchar(4000),@p1402 nvarchar(4000),@p1403 nvarchar(4000),@p1404 nvarchar(4000),@p1405 nvarchar(4000),@p1406 nvarchar(4000),@p1407 nvarchar(4000),@p1408 nvarchar(4000),@p1409 nvarchar(4000),@p1410 nvarchar(4000),@p1411 datetime2(7),@p1412 nvarchar(4000),@p1413 nvarchar(4000),@p1414 int,@p1415 int,@p1416 int,@p1417 nvarchar(4000),@p1418 nvarchar(4000),@p1419 nvarchar(4000),@p1420 nvarchar(4000),@p1421 decimal(18,2),@p1422 nvarchar(4000),@p1423 nvarchar(4000),@p1424 decimal(18,2),@p1425 nvarchar(4000),@p1426 nvarchar(4000),@p1427 nvarchar(4000),@p1428 nvarchar(4000),@p1429 int,@p1430 nvarchar(4000),@p1431 nvarchar(4000),@p1432 nvarchar(4000),@p1433 nvarchar(4000),@p1434 nvarchar(4000),@p1435 nvarchar(4000),@p1436 nvarchar(4000),@p1437 nvarchar(4000),@p1438 nvarchar(4000),@p1439 nvarchar(4000),@p1440 int,@p1441 nvarchar(4000),@p1442 nvarchar(4000),@p1443 nvarchar(4000),@p1444 nvarchar(4000),@p1445 nvarchar(4000),@p1446 int,@p1447 nvarchar(4000),@p1448 int,@p1449 int,@p1450 datetime2(7),@p1451 datetime2(7),@p1452 datetime2(7),@p1453 nvarchar(4000),@p1454 nvarchar(4000),@p1455 nvarchar(4000),@p1456 nvarchar(4000),@p1457 nvarchar(4000),@p1458 nvarchar(4000),@p1459 nvarchar(4000),@p1460 nvarchar(4000),@p1461 nvarchar(4000),@p1462 nvarchar(4000),@p1463 nvarchar(4000),@p1464 nvarchar(4000),@p1465 nvarchar(4000),@p1466 nvarchar(4000),@p1467 datetime2(7),@p1468 nvarchar(4000),@p1469 nvarchar(4000),@p1470 int,@p1471 int,@p1472 int,@p1473 nvarchar(4000),@p1474 nvarchar(4000),@p1475 nvarchar(4000),@p1476 nvarchar(4000),@p1477 decimal(18,2),@p1478 nvarchar(4000),@p1479 nvarchar(4000),@p1480 decimal(18,2),@p1481 nvarchar(4000),@p1482 nvarchar(4000),@p1483 nvarchar(4000),@p1484 nvarchar(4000),@p1485 int,@p1486 nvarchar(4000),@p1487 nvarchar(4000),@p1488 nvarchar(4000),@p1489 nvarchar(4000),@p1490 nvarchar(4000),@p1491 nvarchar(4000),@p1492 nvarchar(4000),@p1493 nvarchar(4000),@p1494 nvarchar(4000),@p1495 nvarchar(4000),@p1496 int,@p1497 nvarchar(4000),@p1498 nvarchar(4000),@p1499 nvarchar(4000),@p1500 nvarchar(4000),@p1501 nvarchar(4000),@p1502 int,@p1503 nvarchar(4000),@p1504 int,@p1505 int,@p1506 datetime2(7),@p1507 datetime2(7),@p1508 datetime2(7),@p1509 nvarchar(4000),@p1510 nvarchar(4000),@p1511 nvarchar(4000),@p1512 nvarchar(4000),@p1513 nvarchar(4000),@p1514 nvarchar(4000),@p1515 nvarchar(4000),@p1516 nvarchar(4000),@p1517 nvarchar(4000),@p1518 nvarchar(4000),@p1519 nvarchar(4000),@p1520 nvarchar(4000),@p1521 nvarchar(4000),@p1522 nvarchar(4000),@p1523 datetime2(7),@p1524 nvarchar(4000),@p1525 nvarchar(4000),@p1526 int,@p1527 int,@p1528 int,@p1529 nvarchar(4000),@p1530 nvarchar(4000),@p1531 nvarchar(4000),@p1532 nvarchar(4000),@p1533 decimal(18,2),@p1534 nvarchar(4000),@p1535 nvarchar(4000),@p1536 decimal(18,2),@p1537 nvarchar(4000),@p1538 nvarchar(4000),@p1539 nvarchar(4000),@p1540 nvarchar(4000),@p1541 int,@p1542 nvarchar(4000),@p1543 nvarchar(4000),@p1544 nvarchar(4000),@p1545 nvarchar(4000),@p1546 nvarchar(4000),@p1547 nvarchar(4000),@p1548 nvarchar(4000),@p1549 nvarchar(4000),@p1550 nvarchar(4000),@p1551 nvarchar(4000),@p1552 int,@p1553 nvarchar(4000),@p1554 nvarchar(4000),@p1555 nvarchar(4000),@p1556 nvarchar(4000),@p1557 nvarchar(4000),@p1558 int,@p1559 nvarchar(4000),@p1560 int,@p1561 int,@p1562 datetime2(7),@p1563 datetime2(7),@p1564 datetime2(7),@p1565 nvarchar(4000),@p1566 nvarchar(4000),@p1567 nvarchar(4000),@p1568 nvarchar(4000),@p1569 nvarchar(4000),@p1570 nvarchar(4000),@p1571 nvarchar(4000),@p1572 nvarchar(4000),@p1573 nvarchar(4000),@p1574 nvarchar(4000),@p1575 nvarchar(4000),@p1576 nvarchar(4000),@p1577 nvarchar(4000),@p1578 nvarchar(4000),@p1579 datetime2(7),@p1580 nvarchar(4000),@p1581 nvarchar(4000),@p1582 int,@p1583 int,@p1584 int,@p1585 nvarchar(4000),@p1586 nvarchar(4000),@p1587 nvarchar(4000),@p1588 decimal(18,2),@p1589 decimal(18,2),@p1590 nvarchar(4000),@p1591 nvarchar(4000),@p1592 decimal(18,2),@p1593 nvarchar(4000),@p1594 nvarchar(4000),@p1595 nvarchar(4000),@p1596 nvarchar(4000),@p1597 int,@p1598 nvarchar(4000),@p1599 nvarchar(4000),@p1600 nvarchar(4000),@p1601 nvarchar(4000),@p1602 nvarchar(4000),@p1603 nvarchar(4000),@p1604 nvarchar(4000),@p1605 nvarchar(4000),@p1606 nvarchar(4000),@p1607 nvarchar(4000),@p1608 int,@p1609 nvarchar(4000),@p1610 nvarchar(4000),@p1611 nvarchar(4000),@p1612 nvarchar(4000),@p1613 nvarchar(4000),@p1614 int,@p1615 nvarchar(4000),@p1616 int,@p1617 int,@p1618 datetime2(7),@p1619 datetime2(7),@p1620 datetime2(7),@p1621 nvarchar(4000),@p1622 nvarchar(4000),@p1623 nvarchar(4000),@p1624 nvarchar(4000),@p1625 nvarchar(4000),@p1626 nvarchar(4000),@p1627 nvarchar(4000),@p1628 nvarchar(4000),@p1629 nvarchar(4000),@p1630 nvarchar(4000),@p1631 nvarchar(4000),@p1632 nvarchar(4000),@p1633 nvarchar(4000),@p1634 nvarchar(4000),@p1635 datetime2(7),@p1636 nvarchar(4000),@p1637 nvarchar(4000),@p1638 int,@p1639 int,@p1640 int,@p1641 nvarchar(4000),@p1642 nvarchar(4000),@p1643 nvarchar(4000),@p1644 decimal(18,2),@p1645 decimal(18,2),@p1646 nvarchar(4000),@p1647 nvarchar(4000),@p1648 decimal(18,2),@p1649 nvarchar(4000),@p1650 nvarchar(4000),@p1651 nvarchar(4000),@p1652 nvarchar(4000),@p1653 int,@p1654 nvarchar(4000),@p1655 nvarchar(4000),@p1656 nvarchar(4000),@p1657 nvarchar(4000),@p1658 nvarchar(4000),@p1659 nvarchar(4000),@p1660 nvarchar(4000),@p1661 nvarchar(4000),@p1662 nvarchar(4000),@p1663 nvarchar(4000),@p1664 int,@p1665 nvarchar(4000),@p1666 nvarchar(4000),@p1667 nvarchar(4000),@p1668 nvarchar(4000),@p1669 nvarchar(4000),@p1670 int,@p1671 nvarchar(4000),@p1672 int,@p1673 int,@p1674 datetime2(7),@p1675 datetime2(7),@p1676 datetime2(7),@p1677 nvarchar(4000),@p1678 nvarchar(4000),@p1679 nvarchar(4000),@p1680 nvarchar(4000),@p1681 nvarchar(4000),@p1682 nvarchar(4000),@p1683 nvarchar(4000),@p1684 nvarchar(4000),@p1685 nvarchar(4000),@p1686 nvarchar(4000),@p1687 nvarchar(4000),@p1688 nvarchar(4000),@p1689 nvarchar(4000),@p1690 nvarchar(4000),@p1691 datetime2(7),@p1692 nvarchar(4000),@p1693 nvarchar(4000),@p1694 int,@p1695 int,@p1696 int,@p1697 nvarchar(4000),@p1698 nvarchar(4000),@p1699 nvarchar(4000),@p1700 decimal(18,2),@p1701 decimal(18,2),@p1702 nvarchar(4000),@p1703 nvarchar(4000),@p1704 decimal(18,2),@p1705 nvarchar(4000),@p1706 nvarchar(4000),@p1707 nvarchar(4000),@p1708 nvarchar(4000),@p1709 int,@p1710 nvarchar(4000),@p1711 nvarchar(4000),@p1712 nvarchar(4000),@p1713 nvarchar(4000),@p1714 nvarchar(4000),@p1715 nvarchar(4000),@p1716 nvarchar(4000),@p1717 nvarchar(4000),@p1718 nvarchar(4000),@p1719 nvarchar(4000),@p1720 int,@p1721 nvarchar(4000),@p1722 nvarchar(4000),@p1723 nvarchar(4000),@p1724 nvarchar(4000),@p1725 nvarchar(4000),@p1726 int,@p1727 nvarchar(4000),@p1728 int,@p1729 int,@p1730 datetime2(7),@p1731 datetime2(7),@p1732 datetime2(7),@p1733 nvarchar(4000),@p1734 nvarchar(4000),@p1735 nvarchar(4000),@p1736 nvarchar(4000),@p1737 nvarchar(4000),@p1738 nvarchar(4000),@p1739 nvarchar(4000),@p1740 nvarchar(4000),@p1741 nvarchar(4000),@p1742 nvarchar(4000),@p1743 nvarchar(4000),@p1744 nvarchar(4000),@p1745 nvarchar(4000),@p1746 nvarchar(4000),@p1747 datetime2(7),@p1748 nvarchar(4000),@p1749 nvarchar(4000),@p1750 int,@p1751 int,@p1752 int,@p1753 nvarchar(4000),@p1754 nvarchar(4000),@p1755 nvarchar(4000),@p1756 decimal(18,2),@p1757 decimal(18,2),@p1758 nvarchar(4000),@p1759 nvarchar(4000),@p1760 decimal(18,2),@p1761 nvarchar(4000),@p1762 nvarchar(4000),@p1763 nvarchar(4000),@p1764 nvarchar(4000),@p1765 int,@p1766 nvarchar(4000),@p1767 nvarchar(4000),@p1768 nvarchar(4000),@p1769 nvarchar(4000),@p1770 nvarchar(4000),@p1771 nvarchar(4000),@p1772 nvarchar(4000),@p1773 nvarchar(4000),@p1774 nvarchar(4000),@p1775 nvarchar(4000),@p1776 int,@p1777 nvarchar(4000),@p1778 nvarchar(4000),@p1779 nvarchar(4000),@p1780 nvarchar(4000),@p1781 nvarchar(4000),@p1782 int,@p1783 nvarchar(4000),@p1784 int,@p1785 int,@p1786 datetime2(7),@p1787 datetime2(7),@p1788 datetime2(7),@p1789 nvarchar(4000),@p1790 nvarchar(4000),@p1791 nvarchar(4000),@p1792 nvarchar(4000),@p1793 nvarchar(4000),@p1794 nvarchar(4000),@p1795 nvarchar(4000),@p1796 nvarchar(4000),@p1797 nvarchar(4000),@p1798 nvarchar(4000),@p1799 nvarchar(4000),@p1800 nvarchar(4000),@p1801 nvarchar(4000),@p1802 nvarchar(4000),@p1803 datetime2(7),@p1804 nvarchar(4000),@p1805 nvarchar(4000),@p1806 int,@p1807 int,@p1808 int,@p1809 nvarchar(4000),@p1810 nvarchar(4000),@p1811 nvarchar(4000),@p1812 decimal(18,2),@p1813 decimal(18,2),@p1814 nvarchar(4000),@p1815 nvarchar(4000),@p1816 decimal(18,2),@p1817 nvarchar(4000),@p1818 nvarchar(4000),@p1819 nvarchar(4000),@p1820 nvarchar(4000),@p1821 int,@p1822 nvarchar(4000),@p1823 nvarchar(4000),@p1824 nvarchar(4000),@p1825 nvarchar(4000),@p1826 nvarchar(4000),@p1827 nvarchar(4000),@p1828 nvarchar(4000),@p1829 nvarchar(4000),@p1830 nvarchar(4000),@p1831 nvarchar(4000),@p1832 int,@p1833 nvarchar(4000),@p1834 nvarchar(4000),@p1835 nvarchar(4000),@p1836 nvarchar(4000),@p1837 nvarchar(4000),@p1838 int,@p1839 nvarchar(4000),@p1840 int,@p1841 int,@p1842 datetime2(7),@p1843 datetime2(7),@p1844 datetime2(7),@p1845 nvarchar(4000),@p1846 nvarchar(4000),@p1847 nvarchar(4000),@p1848 nvarchar(4000),@p1849 nvarchar(4000),@p1850 nvarchar(4000),@p1851 nvarchar(4000),@p1852 nvarchar(4000),@p1853 nvarchar(4000),@p1854 nvarchar(4000),@p1855 nvarchar(4000),@p1856 nvarchar(4000),@p1857 nvarchar(4000),@p1858 nvarchar(4000),@p1859 datetime2(7),@p1860 nvarchar(4000),@p1861 nvarchar(4000),@p1862 int,@p1863 int,@p1864 int,@p1865 nvarchar(4000),@p1866 nvarchar(4000),@p1867 nvarchar(4000),@p1868 decimal(18,2),@p1869 decimal(18,2),@p1870 nvarchar(4000),@p1871 nvarchar(4000),@p1872 decimal(18,2),@p1873 nvarchar(4000),@p1874 nvarchar(4000),@p1875 nvarchar(4000),@p1876 nvarchar(4000),@p1877 int,@p1878 nvarchar(4000),@p1879 nvarchar(4000),@p1880 nvarchar(4000),@p1881 nvarchar(4000),@p1882 nvarchar(4000),@p1883 nvarchar(4000),@p1884 nvarchar(4000),@p1885 nvarchar(4000),@p1886 nvarchar(4000),@p1887 nvarchar(4000),@p1888 int,@p1889 nvarchar(4000),@p1890 nvarchar(4000),@p1891 nvarchar(4000),@p1892 nvarchar(4000),@p1893 nvarchar(4000),@p1894 int,@p1895 nvarchar(4000),@p1896 int,@p1897 int,@p1898 datetime2(7),@p1899 datetime2(7),@p1900 datetime2(7),@p1901 nvarchar(4000),@p1902 nvarchar(4000),@p1903 nvarchar(4000),@p1904 nvarchar(4000),@p1905 nvarchar(4000),@p1906 nvarchar(4000),@p1907 nvarchar(4000),@p1908 nvarchar(4000),@p1909 nvarchar(4000),@p1910 nvarchar(4000),@p1911 nvarchar(4000),@p1912 nvarchar(4000),@p1913 nvarchar(4000),@p1914 nvarchar(4000),@p1915 datetime2(7),@p1916 nvarchar(4000),@p1917 nvarchar(4000),@p1918 int,@p1919 int,@p1920 int,@p1921 nvarchar(4000),@p1922 nvarchar(4000),@p1923 nvarchar(4000),@p1924 decimal(18,2),@p1925 decimal(18,2),@p1926 nvarchar(4000),@p1927 nvarchar(4000),@p1928 decimal(18,2),@p1929 nvarchar(4000),@p1930 nvarchar(4000),@p1931 nvarchar(4000),@p1932 nvarchar(4000),@p1933 int,@p1934 nvarchar(4000),@p1935 nvarchar(4000),@p1936 nvarchar(4000),@p1937 nvarchar(4000),@p1938 nvarchar(4000),@p1939 nvarchar(4000),@p1940 nvarchar(4000),@p1941 nvarchar(4000),@p1942 nvarchar(4000),@p1943 nvarchar(4000),@p1944 int,@p1945 nvarchar(4000),@p1946 nvarchar(4000),@p1947 nvarchar(4000),@p1948 nvarchar(4000),@p1949 nvarchar(4000),@p1950 int,@p1951 nvarchar(4000),@p1952 int,@p1953 int,@p1954 datetime2(7),@p1955 datetime2(7),@p1956 datetime2(7),@p1957 nvarchar(4000),@p1958 nvarchar(4000),@p1959 nvarchar(4000),@p1960 nvarchar(4000),@p1961 nvarchar(4000),@p1962 nvarchar(4000),@p1963 nvarchar(4000),@p1964 nvarchar(4000),@p1965 nvarchar(4000),@p1966 nvarchar(4000),@p1967 nvarchar(4000),@p1968 nvarchar(4000),@p1969 nvarchar(4000),@p1970 nvarchar(4000),@p1971 datetime2(7),@p1972 nvarchar(4000),@p1973 nvarchar(4000),@p1974 int,@p1975 int,@p1976 int,@p1977 nvarchar(4000),@p1978 nvarchar(4000),@p1979 nvarchar(4000),@p1980 decimal(18,2),@p1981 decimal(18,2),@p1982 nvarchar(4000),@p1983 nvarchar(4000),@p1984 decimal(18,2),@p1985 nvarchar(4000),@p1986 nvarchar(4000),@p1987 nvarchar(4000),@p1988 nvarchar(4000),@p1989 int,@p1990 nvarchar(4000),@p1991 nvarchar(4000),@p1992 nvarchar(4000),@p1993 nvarchar(4000),@p1994 nvarchar(4000),@p1995 nvarchar(4000),@p1996 nvarchar(4000),@p1997 nvarchar(4000),@p1998 nvarchar(4000),@p1999 nvarchar(4000),@p2000 int,@p2001 nvarchar(4000),@p2002 nvarchar(4000),@p2003 nvarchar(4000),@p2004 nvarchar(4000),@p2005 nvarchar(4000),@p2006 int,@p2007 nvarchar(4000),@p2008 int,@p2009 int,@p2010 datetime2(7),@p2011 datetime2(7),@p2012 datetime2(7),@p2013 nvarchar(4000),@p2014 nvarchar(4000),@p2015 nvarchar(4000),@p2016 nvarchar(4000),@p2017 nvarchar(4000),@p2018 nvarchar(4000),@p2019 nvarchar(4000),@p2020 nvarchar(4000),@p2021 nvarchar(4000),@p2022 nvarchar(4000),@p2023 nvarchar(4000),@p2024 nvarchar(4000),@p2025 nvarchar(4000),@p2026 nvarchar(4000),@p2027 datetime2(7),@p2028 nvarchar(4000),@p2029 nvarchar(4000),@p2030 int,@p2031 int,@p2032 int,@p2033 nvarchar(4000),@p2034 nvarchar(4000),@p2035 nvarchar(4000),@p2036 decimal(18,2),@p2037 decimal(18,2),@p2038 nvarchar(4000),@p2039 nvarchar(4000),@p2040 decimal(18,2),@p2041 nvarchar(4000),@p2042 nvarchar(4000),@p2043 nvarchar(4000),@p2044 nvarchar(4000),@p2045 int,@p2046 nvarchar(4000),@p2047 nvarchar(4000),@p2048 nvarchar(4000),@p2049 nvarchar(4000),@p2050 nvarchar(4000),@p2051 nvarchar(4000),@p2052 nvarchar(4000),@p2053 nvarchar(4000),@p2054 nvarchar(4000),@p2055 nvarchar(4000),@p2056 int,@p2057 nvarchar(4000),@p2058 nvarchar(4000),@p2059 nvarchar(4000),@p2060 nvarchar(4000),@p2061 nvarchar(4000),@p2062 int,@p2063 nvarchar(4000),@p2064 int,@p2065 int,@p2066 datetime2(7),@p2067 datetime2(7),@p2068 datetime2(7),@p2069 nvarchar(4000),@p2070 nvarchar(4000),@p2071 nvarchar(4000))SET NOCOUNT ON; DECLARE @inserted0 TABLE ([item_id] int, [_Position] [int]); MERGE [raw_data] USING ( VALUES (@p0, @p1, @p2, @p3, @p4, @p5, @p6, @p7, @p8, @p9, @p10, @p11, @p12, @p13, @p14, @p15, @p16, @p17, @p18, @p19, @p20, @p21, @p22, @p23, @p24, @p25, @p26, @p27, @p28, @p29, @p30, @p31, @p32, @p33, @p34, @p35, @p36, @p37, @p38, @p39, @p40, @p41, @p42, @p43, @p44, @p45, @p46, @p47, @p48, @p49, @p50, @p51, @p52, @p53, @p54, @p55, 0), (@p56, @p57, @p58, @p59, @p60, @p61, @p62, @p63, @p64, @p65, @p66, @p67, @p68, @p69, @p70, @p71, @p72, @p73, @p74, @p75, @p76, @p77, @p78, @p79, @p80, @p81, @p82, @p83, @p84, @p85, @p86, @p87, @p88, @p89, @p90, @p91, @p92, @p93, @p94, @p95, @p96, @p97, @p98, @p99, @p100, @p101, @p102, @p103, @p104, @p105, @p106, @p107, @p108, @p109, @p110, @p111, 1), (@p112, @p113, @p114, @p115, @p116, @p117, @p118, @p119, @p120, @p121, @p122, @p123, @p124, @p125, @p126, @p127, @p128, @p129, @p130, @p131, @p132, @p133, @p134, @p135, @p136, @p137, @p138, @p139, @p140, @p141, @p142, @p143, @p144, @p145, @p146, @p147, @p148, @p149, @p150, @p151, @p152, @p153, @p154, @p155, @p156, @p157, @p158, @p159, @p160, @p161, @p162, @p163, @p164, @p165, @p166, @p167, 2), (@p168, @p169, @p170, @p171, @p172, @p173, @p174, @p175, @p176, @p177, @p178, @p179, @p180, @p181, @p182, @p183, @p184, @p185, @p186, @p187, @p188, @p189, @p190, @p191, @p192, @p193, @p194, @p195, @p196, @p197, @p198, @p199, @p200, @p201, @p202, @p203, @p204, @p205, @p206, @p207, @p208, @p209, @p210, @p211, @p212, @p213, @p214, @p215, @p216, @p217, @p218, @p219, @p220, @p221, @p222, @p223, 3), (@p224, @p225, @p226, @p227, @p228, @p229, @p230, @p231, @p232, @p233, @p234, @p235, @p236, @p237, @p238, @p239, @p240, @p241, @p242, @p243, @p244, @p245, @p246, @p247, @p248, @p249, @p250, @p251, @p252, @p253, @p254, @p255, @p256, @p257, @p258, @p259, @p260, @p261, @p262, @p263, @p264, @p265, @p266, @p267, @p268, @p269, @p270, @p271, @p272, @p273, @p274, @p275, @p276, @p277, @p278, @p279, 4), (@p280, @p281, @p282, @p283, @p284, @p285, @p286, @p287, @p288, @p289, @p290, @p291, @p292, @p293, @p294, @p295, @p296, @p297, @p298, @p299, @p300, @p301, @p302, @p303, @p304, @p305, @p306, @p307, @p308, @p309, @p310, @p311, @p312, @p313, @p314, @p315, @p316, @p317, @p318, @p319, @p320, @p321, @p322, @p323, @p324, @p325, @p326, @p327, @p328, @p329, @p330, @p331, @p332, @p333, @p334, @p335, 5), (@p336, @p337, @p338, @p339, @p340, @p341, @p342, @p343, @p344, @p345, @p346, @p347, @p348, @p349, @p350, @p351, @p352, @p353, @p354, @p355, @p356, @p357, @p358, @p359, @p360, @p361, @p362, @p363, @p364, @p365, @p366, @p367, @p368, @p369, @p370, @p371, @p372, @p373, @p374, @p375, @p376, @p377, @p378, @p379, @p380, @p381, @p382, @p383, @p384, @p385, @p386, @p387, @p388, @p389, @p390, @p391, 6), (@p392, @p393, @p394, @p395, @p396, @p397, @p398, @p399, @p400, @p401, @p402, @p403, @p404, @p405, @p406, @p407, @p408, @p409, @p410, @p411, @p412, @p413, @p414, @p415, @p416, @p417, @p418, @p419, @p420, @p421, @p422, @p423, @p424, @p425, @p426, @p427, @p428, @p429, @p430, @p431, @p432, @p433, @p434, @p435, @p436, @p437, @p438, @p439, @p440, @p441, @p442, @p443, @p444, @p445, @p446, @p447, 7), (@p448, @p449, @p450, @p451, @p452, @p453, @p454, @p455, @p456, @p457, @p458, @p459, @p460, @p461, @p462, @p463, @p464, @p465, @p466, @p467, @p468, @p469, @p470, @p471, @p472, @p473, @p474, @p475, @p476, @p477, @p478, @p479, @p480, @p481, @p482, @p483, @p484, @p485, @p486, @p487, @p488, @p489, @p490, @p491, @p492, @p493, @p494, @p495, @p496, @p497, @p498, @p499, @p500, @p501, @p502, @p503, 8), (@p504, @p505, @p506, @p507, @p508, @p509, @p510, @p511, @p512, @p513, @p514, @p515, @p516, @p517, @p518, @p519, @p520, @p521, @p522, @p523, @p524, @p525, @p526, @p527, @p528, @p529, @p530, @p531, @p532, @p533, @p534, @p535, @p536, @p537, @p538, @p539, @p540, @p541, @p542, @p543, @p544, @p545, @p546, @p547, @p548, @p549, @p550, @p551, @p552, @p553, @p554, @p555, @p556, @p557, @p558, @p559, 9), (@p560, @p561, @p562, @p563, @p564, @p565, @p566, @p567, @p568, @p569, @p570, @p571, @p572, @p573, @p574, @p575, @p576, @p577, @p578, @p579, @p580, @p581, @p582, @p583, @p584, @p585, @p586, @p587, @p588, @p589, @p590, @p591, @p592, @p593, @p594, @p595, @p596, @p597, @p598, @p599, @p600, @p601, @p602, @p603, @p604, @p605, @p606, @p607, @p608, @p609, @p610, @p611, @p612, @p613, @p614, @p615, 10), (@p616, @p617, @p618, @p619, @p620, @p621, @p622, @p623, @p624, @p625, @p626, @p627, @p628, @p629, @p630, @p631, @p632, @p633, @p634, @p635, @p636, @p637, @p638, @p639, @p640, @p641, @p642, @p643, @p644, @p645, @p646, @p647, @p648, @p649, @p650, @p651, @p652, @p653, @p654, @p655, @p656, @p657, @p658, @p659, @p660, @p661, @p662, @p663, @p664, @p665, @p666, @p667, @p668, @p669, @p670, @p671, 11), (@p672, @p673, @p674, @p675, @p676, @p677, @p678, @p679, @p680, @p681, @p682, @p683, @p684, @p685, @p686, @p687, @p688, @p689, @p690, @p691, @p692, @p693, @p694, @p695, @p696, @p697, @p698, @p699, @p700, @p701, @p702, @p703, @p704, @p705, @p706, @p707, @p708, @p709, @p710, @p711, @p712, @p713, @p714, @p715, @p716, @p717, @p718, @p719, @p720, @p721, @p722, @p723, @p724, @p725, @p726, @p727, 12), (@p728, @p729, @p730, @p731, @p732, @p733, @p734, @p735, @p736, @p737, @p738, @p739, @p740, @p741, @p742, @p743, @p744, @p745, @p746, @p747, @p748, @p749, @p750, @p751, @p752, @p753, @p754, @p755, @p756, @p757, @p758, @p759, @p760, @p761, @p762, @p763, @p764, @p765, @p766, @p767, @p768, @p769, @p770, @p771, @p772, @p773, @p774, @p775, @p776, @p777, @p778, @p779, @p780, @p781, @p782, @p783, 13), (@p784, @p785, @p786, @p787, @p788, @p789, @p790, @p791, @p792, @p793, @p794, @p795, @p796, @p797, @p798, @p799, @p800, @p801, @p802, @p803, @p804, @p805, @p806, @p807, @p808, @p809, @p810, @p811, @p812, @p813, @p814, @p815, @p816, @p817, @p818, @p819, @p820, @p821, @p822, @p823, @p824, @p825, @p826, @p827, @p828, @p829, @p830, @p831, @p832, @p833, @p834, @p835, @p836, @p837, @p838, @p839, 14), (@p840, @p841, @p842, @p843, @p844, @p845, @p846, @p847, @p848, @p849, @p850, @p851, @p852, @p853, @p854, @p855, @p856, @p857, @p858, @p859, @p860, @p861, @p862, @p863, @p864, @p865, @p866, @p867, @p868, @p869, @p870, @p871, @p872, @p873, @p874, @p875, @p876, @p877, @p878, @p879, @p880, @p881, @p882, @p883, @p884, @p885, @p886, @p887, @p888, @p889, @p890, @p891, @p892, @p893, @p894, @p895, 15), (@p896, @p897, @p898, @p899, @p900, @p901, @p902, @p903, @p904, @p905, @p906, @p907, @p908, @p909, @p910, @p911, @p912, @p913, @p914, @p915, @p916, @p917, @p918, @p919, @p920, @p921, @p922, @p923, @p924, @p925, @p926, @p927, @p928, @p929, @p930, @p931, @p932, @p933, @p934, @p935, @p936, @p937, @p938, @p939, @p940, @p941, @p942, @p943, @p944, @p945, @p946, @p947, @p948, @p949, @p950, @p951, 16), (@p952, @p953, @p954, @p955, @p956, @p957, @p958, @p959, @p960, @p961, @p962, @p963, @p964, @p965, @p966, @p967, @p968, @p969, @p970, @p971, @p972, @p973, @p974, @p975, @p976, @p977, @p978, @p979, @p980, @p981, @p982, @p983, @p984, @p985, @p986, @p987, @p988, @p989, @p990, @p991, @p992, @p993, @p994, @p995, @p996, @p997, @p998, @p999, @p1000, @p1001, @p1002, @p1003, @p1004, @p1005, @p1006, @p1007, 17), (@p1008, @p1009, @p1010, @p1011, @p1012, @p1013, @p1014, @p1015, @p1016, @p1017, @p1018, @p1019, @p1020, @p1021, @p1022, @p1023, @p1024, @p1025, @p1026, @p1027, @p1028, @p1029, @p1030, @p1031, @p1032, @p1033, @p1034, @p1035, @p1036, @p1037, @p1038, @p1039, @p1040, @p1041, @p1042, @p1043, @p1044, @p1045, @p1046, @p1047, @p1048, @p1049, @p1050, @p1051, @p1052, @p1053, @p1054, @p1055, @p1056, @p1057, @p1058, @p1059, @p1060, @p1061, @p1062, @p1063, 18), (@p1064, @p1065, @p1066, @p1067, @p1068, @p1069, @p1070, @p1071, @p1072, @p1073, @p1074, @p1075, @p1076, @p1077, @p1078, @p1079, @p1080, @p1081, @p1082, @p1083, @p1084, @p1085, @p1086, @p1087, @p1088, @p1089, @p1090, @p1091, @p1092, @p1093, @p1094, @p1095, @p1096, @p1097, @p1098, @p1099, @p1100, @p1101, @p1102, @p1103, @p1104, @p1105, @p1106, @p1107, @p1108, @p1109, @p1110, @p1111, @p1112, @p1113, @p1114, @p1115, @p1116, @p1117, @p1118, @p1119, 19), (@p1120, @p1121, @p1122, @p1123, @p1124, @p1125, @p1126, @p1127, @p1128, @p1129, @p1130, @p1131, @p1132, @p1133, @p1134, @p1135, @p1136, @p1137, @p1138, @p1139, @p1140, @p1141, @p1142, @p1143, @p1144, @p1145, @p1146, @p1147, @p1148, @p1149, @p1150, @p1151, @p1152, @p1153, @p1154, @p1155, @p1156, @p1157, @p1158, @p1159, @p1160, @p1161, @p1162, @p1163, @p1164, @p1165, @p1166, @p1167, @p1168, @p1169, @p1170, @p1171, @p1172, @p1173, @p1174, @p1175, 20), (@p1176, @p1177, @p1178, @p1179, @p1180, @p1181, @p1182, @p1183, @p1184, @p1185, @p1186, @p1187, @p1188, @p1189, @p1190, @p1191, @p1192, @p1193, @p1194, @p1195, @p1196, @p1197, @p1198, @p1199, @p1200, @p1201, @p1202, @p1203, @p1204, @p1205, @p1206, @p1207, @p1208, @p1209, @p1210, @p1211, @p1212, @p1213, @p1214, @p1215, @p1216, @p1217, @p1218, @p1219, @p1220, @p1221, @p1222, @p1223, @p1224, @p1225, @p1226, @p1227, @p1228, @p1229, @p1230, @p1231, 21), (@p1232, @p1233, @p1234, @p1235, @p1236, @p1237, @p1238, @p1239, @p1240, @p1241, @p1242, @p1243, @p1244, @p1245, @p1246, @p1247, @p1248, @p1249, @p1250, @p1251, @p1252, @p1253, @p1254, @p1255, @p1256, @p1257, @p1258, @p1259, @p1260, @p1261, @p1262, @p1263, @p1264, @p1265, @p1266, @p1267, @p1268, @p1269, @p1270, @p1271, @p1272, @p1273, @p1274, @p1275, @p1276, @p1277, @p1278, @p1279, @p1280, @p1281, @p1282, @p1283, @p1284, @p1285, @p1286, @p1287, 22), (@p1288, @p1289, @p1290, @p1291, @p1292, @p1293, @p1294, @p1295, @p1296, @p1297, @p1298, @p1299, @p1300, @p1301, @p1302, @p1303, @p1304, @p1305, @p1306, @p1307, @p1308, @p1309, @p1310, @p1311, @p1312, @p1313, @p1314, @p1315, @p1316, @p1317, @p1318, @p1319, @p1320, @p1321, @p1322, @p1323, @p1324, @p1325, @p1326, @p1327, @p1328, @p1329, @p1330, @p1331, @p1332, @p1333, @p1334, @p1335, @p1336, @p1337, @p1338, @p1339, @p1340, @p1341, @p1342, @p1343, 23), (@p1344, @p1345, @p1346, @p1347, @p1348, @p1349, @p1350, @p1351, @p1352, @p1353, @p1354, @p1355, @p1356, @p1357, @p1358, @p1359, @p1360, @p1361, @p1362, @p1363, @p1364, @p1365, @p1366, @p1367, @p1368, @p1369, @p1370, @p1371, @p1372, @p1373, @p1374, @p1375, @p1376, @p1377, @p1378, @p1379, @p1380, @p1381, @p1382, @p1383, @p1384, @p1385, @p1386, @p1387, @p1388, @p1389, @p1390, @p1391, @p1392, @p1393, @p1394, @p1395, @p1396, @p1397, @p1398, @p1399, 24), (@p1400, @p1401, @p1402, @p1403, @p1404, @p1405, @p1406, @p1407, @p1408, @p1409, @p1410, @p1411, @p1412, @p1413, @p1414, @p1415, @p1416, @p1417, @p1418, @p1419, @p1420, @p1421, @p1422, @p1423, @p1424, @p1425, @p1426, @p1427, @p1428, @p1429, @p1430, @p1431, @p1432, @p1433, @p1434, @p1435, @p1436, @p1437, @p1438, @p1439, @p1440, @p1441, @p1442, @p1443, @p1444, @p1445, @p1446, @p1447, @p1448, @p1449, @p1450, @p1451, @p1452, @p1453, @p1454, @p1455, 25), (@p1456, @p1457, @p1458, @p1459, @p1460, @p1461, @p1462, @p1463, @p1464, @p1465, @p1466, @p1467, @p1468, @p1469, @p1470, @p1471, @p1472, @p1473, @p1474, @p1475, @p1476, @p1477, @p1478, @p1479, @p1480, @p1481, @p1482, @p1483, @p1484, @p1485, @p1486, @p1487, @p1488, @p1489, @p1490, @p1491, @p1492, @p1493, @p1494, @p1495, @p1496, @p1497, @p1498, @p1499, @p1500, @p1501, @p1502, @p1503, @p1504, @p1505, @p1506, @p1507, @p1508, @p1509, @p1510, @p1511, 26), (@p1512, @p1513, @p1514, @p1515, @p1516, @p1517, @p1518, @p1519, @p1520, @p1521, @p1522, @p1523, @p1524, @p1525, @p1526, @p1527, @p1528, @p1529, @p1530, @p1531, @p1532, @p1533, @p1534, @p1535, @p1536, @p1537, @p1538, @p1539, @p1540, @p1541, @p1542, @p1543, @p1544, @p1545, @p1546, @p1547, @p1548, @p1549, @p1550, @p1551, @p1552, @p1553, @p1554, @p1555, @p1556, @p1557, @p1558, @p1559, @p1560, @p1561, @p1562, @p1563, @p1564, @p1565, @p1566, @p1567, 27), (@p1568, @p1569, @p1570, @p1571, @p1572, @p1573, @p1574, @p1575, @p1576, @p1577, @p1578, @p1579, @p1580, @p1581, @p1582, @p1583, @p1584, @p1585, @p1586, @p1587, @p1588, @p1589, @p1590, @p1591, @p1592, @p1593, @p1594, @p1595, @p1596, @p1597, @p1598, @p1599, @p1600, @p1601, @p1602, @p1603, @p1604, @p1605, @p1606, @p1607, @p1608, @p1609, @p1610, @p1611, @p1612, @p1613, @p1614, @p1615, @p1616, @p1617, @p1618, @p1619, @p1620, @p1621, @p1622, @p1623, 28), (@p1624, @p1625, @p1626, @p1627, @p1628, @p1629, @p1630, @p1631, @p1632, @p1633, @p1634, @p1635, @p1636, @p1637, @p1638, @p1639, @p1640, @p1641, @p1642, @p1643, @p1644, @p1645, @p1646, @p1647, @p1648, @p1649, @p1650, @p1651, @p1652, @p1653, @p1654, @p1655, @p1656, @p1657, @p1658, @p1659, @p1660, @p1661, @p1662, @p1663, @p1664, @p1665, @p1666, @p1667, @p1668, @p1669, @p1670, @p1671, @p1672, @p1673, @p1674, @p1675, @p1676, @p1677, @p1678, @p1679, 29), (@p1680, @p1681, @p1682, @p1683, @p1684, @p1685, @p1686, @p1687, @p1688, @p1689, @p1690, @p1691, @p1692, @p1693, @p1694, @p1695, @p1696, @p1697, @p1698, @p1699, @p1700, @p1701, @p1702, @p1703, @p1704, @p1705, @p1706, @p1707, @p1708, @p1709, @p1710, @p1711, @p1712, @p1713, @p1714, @p1715, @p1716, @p1717, @p1718, @p1719, @p1720, @p1721, @p1722, @p1723, @p1724, @p1725, @p1726, @p1727, @p1728, @p1729, @p1730, @p1731, @p1732, @p1733, @p1734, @p1735, 30), (@p1736, @p1737, @p1738, @p1739, @p1740, @p1741, @p1742, @p1743, @p1744, @p1745, @p1746, @p1747, @p1748, @p1749, @p1750, @p1751, @p1752, @p1753, @p1754, @p1755, @p1756, @p1757, @p1758, @p1759, @p1760, @p1761, @p1762, @p1763, @p1764, @p1765, @p1766, @p1767, @p1768, @p1769, @p1770, @p1771, @p1772, @p1773, @p1774, @p1775, @p1776, @p1777, @p1778, @p1779, @p1780, @p1781, @p1782, @p1783, @p1784, @p1785, @p1786, @p1787, @p1788, @p1789, @p1790, @p1791, 31), (@p1792, @p1793, @p1794, @p1795, @p1796, @p1797, @p1798, @p1799, @p1800, @p1801, @p1802, @p1803, @p1804, @p1805, @p1806, @p1807, @p1808, @p1809, @p1810, @p1811, @p1812, @p1813, @p1814, @p1815, @p1816, @p1817, @p1818, @p1819, @p1820, @p1821, @p1822, @p1823, @p1824, @p1825, @p1826, @p1827, @p1828, @p1829, @p1830, @p1831, @p1832, @p1833, @p1834, @p1835, @p1836, @p1837, @p1838, @p1839, @p1840, @p1841, @p1842, @p1843, @p1844, @p1845, @p1846, @p1847, 32), (@p1848, @p1849, @p1850, @p1851, @p1852, @p1853, @p1854, @p1855, @p1856, @p1857, @p1858, @p1859, @p1860, @p1861, @p1862, @p1863, @p1864, @p1865, @p1866, @p1867, @p1868, @p1869, @p1870, @p1871, @p1872, @p1873, @p1874, @p1875, @p1876, @p1877, @p1878, @p1879, @p1880, @p1881, @p1882, @p1883, @p1884, @p1885, @p1886, @p1887, @p1888, @p1889, @p1890, @p1891, @p1892, @p1893, @p1894, @p1895, @p1896, @p1897, @p1898, @p1899, @p1900, @p1901, @p1902, @p1903, 33), (@p1904, @p1905, @p1906, @p1907, @p1908, @p1909, @p1910, @p1911, @p1912, @p1913, @p1914, @p1915, @p1916, @p1917, @p1918, @p1919, @p1920, @p1921, @p1922, @p1923, @p1924, @p1925, @p1926, @p1927, @p1928, @p1929, @p1930, @p1931, @p1932, @p1933, @p1934, @p1935, @p1936, @p1937, @p1938, @p1939, @p1940, @p1941, @p1942, @p1943, @p1944, @p1945, @p1946, @p1947, @p1948, @p1949, @p1950, @p1951, @p1952, @p1953, @p1954, @p1955, @p1956, @p1957, @p1958, @p1959, 34), (@p1960, @p1961, @p1962, @p1963, @p1964, @p1965, @p1966, @p1967, @p1968, @p1969, @p1970, @p1971, @p1972, @p1973, @p1974, @p1975, @p1976, @p1977, @p1978, @p1979, @p1980, @p1981, @p1982, @p1983, @p1984, @p1985, @p1986, @p1987, @p1988, @p1989, @p1990, @p1991, @p1992, @p1993, @p1994, @p1995, @p1996, @p1997, @p1998, @p1999, @p2000, @p2001, @p2002, @p2003, @p2004, @p2005, @p2006, @p2007, @p2008, @p2009, @p2010, @p2011, @p2012, @p2013, @p2014, @p2015, 35), (@p2016, @p2017, @p2018, @p2019, @p2020, @p2021, @p2022, @p2023, @p2024, @p2025, @p2026, @p2027, @p2028, @p2029, @p2030, @p2031, @p2032, @p2033, @p2034, @p2035, @p2036, @p2037, @p2038, @p2039, @p2040, @p2041, @p2042, @p2043, @p2044, @p2045, @p2046, @p2047, @p2048, @p2049, @p2050, @p2051, @p2052, @p2053, @p2054, @p2055, @p2056, @p2057, @p2058, @p2059, @p2060, @p2061, @p2062, @p2063, @p2064, @p2065, @p2066, @p2067, @p2068, @p2069, @p2070, @p2071, 36)) AS i ([addressee_cntry_cd], [addressee_city], [addressee_district], [addressee_email], [addressee_full_address], [addressee_home_address], [addressee_name], [addressee_postcode], [addressee_province], [addressee_subdistrict], [addressee_tel], [create_table], [delivery_code], [delivery_recipient_name], [delivery_relation_id], [delivery_status_id], [dest_outlet_id], [dest_outlet_port], [document_number], [item_barcode], [item_cod], [item_gross_weight], [item_height], [item_length], [item_price], [item_width], [lat], [log_id], [long], [outlet_id], [outlet_port], [podUrl], [remark], [scan_cntry_cd], [scan_cntry_postcode], [sender_cntry_cd], [sender_district], [sender_email], [sender_full_address], [sender_home_address], [member_id], [sender_name], [sender_postcode], [sender_province], [sender_subdistrict], [sender_tel], [server_id], [signatureUrl], [state], [status_code], [status_dtm], [timestamp], [transmit_dtm], [user_id], [wckt_id], [wkstn_no], _Position) ON 1=0 WHEN NOT MATCHED THEN INSERT ([addressee_cntry_cd], [addressee_city], [addressee_district], [addressee_email], [addressee_full_address], [addressee_home_address], [addressee_name], [addressee_postcode], [addressee_province], [addressee_subdistrict], [addressee_tel], [create_table], [delivery_code], [delivery_recipient_name], [delivery_relation_id], [delivery_status_id], [dest_outlet_id], [dest_outlet_port], [document_number], [item_barcode], [item_cod], [item_gross_weight], [item_height], [item_length], [item_price], [item_width], [lat], [log_id], [long], [outlet_id], [outlet_port], [podUrl], [remark], [scan_cntry_cd], [scan_cntry_postcode], [sender_cntry_cd], [sender_district], [sender_email], [sender_full_address], [sender_home_address], [member_id], [sender_name], [sender_postcode], [sender_province], [sender_subdistrict], [sender_tel], [server_id], [signatureUrl], [state], [status_code], [status_dtm], [timestamp], [transmit_dtm], [user_id], [wckt_id], [wkstn_no]) VALUES (i.[addressee_cntry_cd], i.[addressee_city], i.[addressee_district], i.[addressee_email], i.[addressee_full_address], i.[addressee_home_address], i.[addressee_name], i.[addressee_postcode], i.[addressee_province], i.[addressee_subdistrict], i.[addressee_tel], i.[create_table], i.[delivery_code], i.[delivery_recipient_name], i.[delivery_relation_id], i.[delivery_status_id], i.[dest_outlet_id], i.[dest_outlet_port], i.[document_number], i.[item_barcode], i.[item_cod], i.[item_gross_weight], i.[item_height], i.[item_length], i.[item_price], i.[item_width], i.[lat], i.[log_id], i.[long], i.[outlet_id], i.[outlet_port], i.[podUrl], i.[remark], i.[scan_cntry_cd], i.[scan_cntry_postcode], i.[sender_cntry_cd], i.[sender_district], i.[sender_email], i.[sender_full_address], i.[sender_home_address], i.[member_id], i.[sender_name], i.[sender_postcode], i.[sender_province], i.[sender_subdistrict], i.[sender_tel], i.[server_id], i.[signatureUrl], i.[state], i.[status_code], i.[status_dtm], i.[timestamp], i.[transmit_dtm], i.[user_id], i.[wckt_id], i.[wkstn_no]) OUTPUT INSERTED.[item_id], i._Position INTO @inserted0;  SELECT [t].[item_id] FROM [raw_data] t INNER JOIN @inserted0 i ON ([t].[item_id] = [i].[item_id]) ORDER BY [i].[_Position];  ",4,4,0,438,2,4
"(@p0 nvarchar(4000),@p1 nvarchar(4000),@p2 nvarchar(4000),@p3 nvarchar(4000),@p4 nvarchar(4000),@p5 nvarchar(4000),@p6 nvarchar(4000),@p7 nvarchar(4000),@p8 nvarchar(4000),@p9 nvarchar(4000),@p10 nvarchar(4000),@p11 datetime2(7),@p12 nvarchar(4000),@p13 nvarchar(4000),@p14 int,@p15 int,@p16 int,@p17 nvarchar(4000),@p18 nvarchar(4000),@p19 nvarchar(4000),@p20 nvarchar(4000),@p21 decimal(18,2),@p22 nvarchar(4000),@p23 nvarchar(4000),@p24 decimal(18,2),@p25 nvarchar(4000),@p26 nvarchar(4000),@p27 nvarchar(4000),@p28 nvarchar(4000),@p29 int,@p30 nvarchar(4000),@p31 nvarchar(4000),@p32 nvarchar(4000),@p33 nvarchar(4000),@p34 nvarchar(4000),@p35 nvarchar(4000),@p36 nvarchar(4000),@p37 nvarchar(4000),@p38 nvarchar(4000),@p39 nvarchar(4000),@p40 int,@p41 nvarchar(4000),@p42 nvarchar(4000),@p43 nvarchar(4000),@p44 nvarchar(4000),@p45 nvarchar(4000),@p46 int,@p47 nvarchar(4000),@p48 int,@p49 int,@p50 datetime2(7),@p51 datetime2(7),@p52 datetime2(7),@p53 nvarchar(4000),@p54 nvarchar(4000),@p55 nvarchar(4000),@p56 nvarchar(4000),@p57 nvarchar(4000),@p58 nvarchar(4000),@p59 nvarchar(4000),@p60 nvarchar(4000),@p61 nvarchar(4000),@p62 nvarchar(4000),@p63 nvarchar(4000),@p64 nvarchar(4000),@p65 nvarchar(4000),@p66 nvarchar(4000),@p67 datetime2(7),@p68 nvarchar(4000),@p69 nvarchar(4000),@p70 int,@p71 int,@p72 int,@p73 nvarchar(4000),@p74 nvarchar(4000),@p75 nvarchar(4000),@p76 decimal(18,2),@p77 decimal(18,2),@p78 nvarchar(4000),@p79 nvarchar(4000),@p80 decimal(18,2),@p81 nvarchar(4000),@p82 nvarchar(4000),@p83 nvarchar(4000),@p84 nvarchar(4000),@p85 int,@p86 nvarchar(4000),@p87 nvarchar(4000),@p88 nvarchar(4000),@p89 nvarchar(4000),@p90 nvarchar(4000),@p91 nvarchar(4000),@p92 nvarchar(4000),@p93 nvarchar(4000),@p94 nvarchar(4000),@p95 nvarchar(4000),@p96 int,@p97 nvarchar(4000),@p98 nvarchar(4000),@p99 nvarchar(4000),@p100 nvarchar(4000),@p101 nvarchar(4000),@p102 int,@p103 nvarchar(4000),@p104 int,@p105 int,@p106 datetime2(7),@p107 datetime2(7),@p108 datetime2(7),@p109 nvarchar(4000),@p110 nvarchar(4000),@p111 nvarchar(4000),@p112 nvarchar(4000),@p113 nvarchar(4000),@p114 nvarchar(4000),@p115 nvarchar(4000),@p116 nvarchar(4000),@p117 nvarchar(4000),@p118 nvarchar(4000),@p119 nvarchar(4000),@p120 nvarchar(4000),@p121 nvarchar(4000),@p122 nvarchar(4000),@p123 datetime2(7),@p124 nvarchar(4000),@p125 nvarchar(4000),@p126 int,@p127 int,@p128 int,@p129 nvarchar(4000),@p130 nvarchar(4000),@p131 nvarchar(4000),@p132 decimal(18,2),@p133 decimal(18,2),@p134 nvarchar(4000),@p135 nvarchar(4000),@p136 decimal(18,2),@p137 nvarchar(4000),@p138 nvarchar(4000),@p139 nvarchar(4000),@p140 nvarchar(4000),@p141 int,@p142 nvarchar(4000),@p143 nvarchar(4000),@p144 nvarchar(4000),@p145 nvarchar(4000),@p146 nvarchar(4000),@p147 nvarchar(4000),@p148 nvarchar(4000),@p149 nvarchar(4000),@p150 nvarchar(4000),@p151 nvarchar(4000),@p152 int,@p153 nvarchar(4000),@p154 nvarchar(4000),@p155 nvarchar(4000),@p156 nvarchar(4000),@p157 nvarchar(4000),@p158 int,@p159 nvarchar(4000),@p160 int,@p161 int,@p162 datetime2(7),@p163 datetime2(7),@p164 datetime2(7),@p165 nvarchar(4000),@p166 nvarchar(4000),@p167 nvarchar(4000),@p168 nvarchar(4000),@p169 nvarchar(4000),@p170 nvarchar(4000),@p171 nvarchar(4000),@p172 nvarchar(4000),@p173 nvarchar(4000),@p174 nvarchar(4000),@p175 nvarchar(4000),@p176 nvarchar(4000),@p177 nvarchar(4000),@p178 nvarchar(4000),@p179 datetime2(7),@p180 nvarchar(4000),@p181 nvarchar(4000),@p182 int,@p183 int,@p184 int,@p185 nvarchar(4000),@p186 nvarchar(4000),@p187 nvarchar(4000),@p188 decimal(18,2),@p189 decimal(18,2),@p190 nvarchar(4000),@p191 nvarchar(4000),@p192 decimal(18,2),@p193 nvarchar(4000),@p194 nvarchar(4000),@p195 nvarchar(4000),@p196 nvarchar(4000),@p197 int,@p198 nvarchar(4000),@p199 nvarchar(4000),@p200 nvarchar(4000),@p201 nvarchar(4000),@p202 nvarchar(4000),@p203 nvarchar(4000),@p204 nvarchar(4000),@p205 nvarchar(4000),@p206 nvarchar(4000),@p207 nvarchar(4000),@p208 int,@p209 nvarchar(4000),@p210 nvarchar(4000),@p211 nvarchar(4000),@p212 nvarchar(4000),@p213 nvarchar(4000),@p214 int,@p215 nvarchar(4000),@p216 int,@p217 int,@p218 datetime2(7),@p219 datetime2(7),@p220 datetime2(7),@p221 nvarchar(4000),@p222 nvarchar(4000),@p223 nvarchar(4000),@p224 nvarchar(4000),@p225 nvarchar(4000),@p226 nvarchar(4000),@p227 nvarchar(4000),@p228 nvarchar(4000),@p229 nvarchar(4000),@p230 nvarchar(4000),@p231 nvarchar(4000),@p232 nvarchar(4000),@p233 nvarchar(4000),@p234 nvarchar(4000),@p235 datetime2(7),@p236 nvarchar(4000),@p237 nvarchar(4000),@p238 int,@p239 int,@p240 int,@p241 nvarchar(4000),@p242 nvarchar(4000),@p243 nvarchar(4000),@p244 decimal(18,2),@p245 decimal(18,2),@p246 nvarchar(4000),@p247 nvarchar(4000),@p248 decimal(18,2),@p249 nvarchar(4000),@p250 nvarchar(4000),@p251 nvarchar(4000),@p252 nvarchar(4000),@p253 int,@p254 nvarchar(4000),@p255 nvarchar(4000),@p256 nvarchar(4000),@p257 nvarchar(4000),@p258 nvarchar(4000),@p259 nvarchar(4000),@p260 nvarchar(4000),@p261 nvarchar(4000),@p262 nvarchar(4000),@p263 nvarchar(4000),@p264 int,@p265 nvarchar(4000),@p266 nvarchar(4000),@p267 nvarchar(4000),@p268 nvarchar(4000),@p269 nvarchar(4000),@p270 int,@p271 nvarchar(4000),@p272 int,@p273 int,@p274 datetime2(7),@p275 datetime2(7),@p276 datetime2(7),@p277 nvarchar(4000),@p278 nvarchar(4000),@p279 nvarchar(4000),@p280 nvarchar(4000),@p281 nvarchar(4000),@p282 nvarchar(4000),@p283 nvarchar(4000),@p284 nvarchar(4000),@p285 nvarchar(4000),@p286 nvarchar(4000),@p287 nvarchar(4000),@p288 nvarchar(4000),@p289 nvarchar(4000),@p290 nvarchar(4000),@p291 datetime2(7),@p292 nvarchar(4000),@p293 nvarchar(4000),@p294 int,@p295 int,@p296 int,@p297 nvarchar(4000),@p298 nvarchar(4000),@p299 nvarchar(4000),@p300 decimal(18,2),@p301 decimal(18,2),@p302 nvarchar(4000),@p303 nvarchar(4000),@p304 decimal(18,2),@p305 nvarchar(4000),@p306 nvarchar(4000),@p307 nvarchar(4000),@p308 nvarchar(4000),@p309 int,@p310 nvarchar(4000),@p311 nvarchar(4000),@p312 nvarchar(4000),@p313 nvarchar(4000),@p314 nvarchar(4000),@p315 nvarchar(4000),@p316 nvarchar(4000),@p317 nvarchar(4000),@p318 nvarchar(4000),@p319 nvarchar(4000),@p320 int,@p321 nvarchar(4000),@p322 nvarchar(4000),@p323 nvarchar(4000),@p324 nvarchar(4000),@p325 nvarchar(4000),@p326 int,@p327 nvarchar(4000),@p328 int,@p329 int,@p330 datetime2(7),@p331 datetime2(7),@p332 datetime2(7),@p333 nvarchar(4000),@p334 nvarchar(4000),@p335 nvarchar(4000),@p336 nvarchar(4000),@p337 nvarchar(4000),@p338 nvarchar(4000),@p339 nvarchar(4000),@p340 nvarchar(4000),@p341 nvarchar(4000),@p342 nvarchar(4000),@p343 nvarchar(4000),@p344 nvarchar(4000),@p345 nvarchar(4000),@p346 nvarchar(4000),@p347 datetime2(7),@p348 nvarchar(4000),@p349 nvarchar(4000),@p350 int,@p351 int,@p352 int,@p353 nvarchar(4000),@p354 nvarchar(4000),@p355 nvarchar(4000),@p356 decimal(18,2),@p357 decimal(18,2),@p358 nvarchar(4000),@p359 nvarchar(4000),@p360 decimal(18,2),@p361 nvarchar(4000),@p362 nvarchar(4000),@p363 nvarchar(4000),@p364 nvarchar(4000),@p365 int,@p366 nvarchar(4000),@p367 nvarchar(4000),@p368 nvarchar(4000),@p369 nvarchar(4000),@p370 nvarchar(4000),@p371 nvarchar(4000),@p372 nvarchar(4000),@p373 nvarchar(4000),@p374 nvarchar(4000),@p375 nvarchar(4000),@p376 int,@p377 nvarchar(4000),@p378 nvarchar(4000),@p379 nvarchar(4000),@p380 nvarchar(4000),@p381 nvarchar(4000),@p382 int,@p383 nvarchar(4000),@p384 int,@p385 int,@p386 datetime2(7),@p387 datetime2(7),@p388 datetime2(7),@p389 nvarchar(4000),@p390 nvarchar(4000),@p391 nvarchar(4000),@p392 nvarchar(4000),@p393 nvarchar(4000),@p394 nvarchar(4000),@p395 nvarchar(4000),@p396 nvarchar(4000),@p397 nvarchar(4000),@p398 nvarchar(4000),@p399 nvarchar(4000),@p400 nvarchar(4000),@p401 nvarchar(4000),@p402 nvarchar(4000),@p403 datetime2(7),@p404 nvarchar(4000),@p405 nvarchar(4000),@p406 int,@p407 int,@p408 int,@p409 nvarchar(4000),@p410 nvarchar(4000),@p411 nvarchar(4000),@p412 decimal(18,2),@p413 decimal(18,2),@p414 nvarchar(4000),@p415 nvarchar(4000),@p416 decimal(18,2),@p417 nvarchar(4000),@p418 nvarchar(4000),@p419 nvarchar(4000),@p420 nvarchar(4000),@p421 int,@p422 nvarchar(4000),@p423 nvarchar(4000),@p424 nvarchar(4000),@p425 nvarchar(4000),@p426 nvarchar(4000),@p427 nvarchar(4000),@p428 nvarchar(4000),@p429 nvarchar(4000),@p430 nvarchar(4000),@p431 nvarchar(4000),@p432 int,@p433 nvarchar(4000),@p434 nvarchar(4000),@p435 nvarchar(4000),@p436 nvarchar(4000),@p437 nvarchar(4000),@p438 int,@p439 nvarchar(4000),@p440 int,@p441 int,@p442 datetime2(7),@p443 datetime2(7),@p444 datetime2(7),@p445 nvarchar(4000),@p446 nvarchar(4000),@p447 nvarchar(4000),@p448 nvarchar(4000),@p449 nvarchar(4000),@p450 nvarchar(4000),@p451 nvarchar(4000),@p452 nvarchar(4000),@p453 nvarchar(4000),@p454 nvarchar(4000),@p455 nvarchar(4000),@p456 nvarchar(4000),@p457 nvarchar(4000),@p458 nvarchar(4000),@p459 datetime2(7),@p460 nvarchar(4000),@p461 nvarchar(4000),@p462 int,@p463 int,@p464 int,@p465 nvarchar(4000),@p466 nvarchar(4000),@p467 nvarchar(4000),@p468 decimal(18,2),@p469 decimal(18,2),@p470 nvarchar(4000),@p471 nvarchar(4000),@p472 decimal(18,2),@p473 nvarchar(4000),@p474 nvarchar(4000),@p475 nvarchar(4000),@p476 nvarchar(4000),@p477 int,@p478 nvarchar(4000),@p479 nvarchar(4000),@p480 nvarchar(4000),@p481 nvarchar(4000),@p482 nvarchar(4000),@p483 nvarchar(4000),@p484 nvarchar(4000),@p485 nvarchar(4000),@p486 nvarchar(4000),@p487 nvarchar(4000),@p488 int,@p489 nvarchar(4000),@p490 nvarchar(4000),@p491 nvarchar(4000),@p492 nvarchar(4000),@p493 nvarchar(4000),@p494 int,@p495 nvarchar(4000),@p496 int,@p497 int,@p498 datetime2(7),@p499 datetime2(7),@p500 datetime2(7),@p501 nvarchar(4000),@p502 nvarchar(4000),@p503 nvarchar(4000),@p504 nvarchar(4000),@p505 nvarchar(4000),@p506 nvarchar(4000),@p507 nvarchar(4000),@p508 nvarchar(4000),@p509 nvarchar(4000),@p510 nvarchar(4000),@p511 nvarchar(4000),@p512 nvarchar(4000),@p513 nvarchar(4000),@p514 nvarchar(4000),@p515 datetime2(7),@p516 nvarchar(4000),@p517 nvarchar(4000),@p518 int,@p519 int,@p520 int,@p521 nvarchar(4000),@p522 nvarchar(4000),@p523 nvarchar(4000),@p524 decimal(18,2),@p525 decimal(18,2),@p526 nvarchar(4000),@p527 nvarchar(4000),@p528 decimal(18,2),@p529 nvarchar(4000),@p530 nvarchar(4000),@p531 nvarchar(4000),@p532 nvarchar(4000),@p533 int,@p534 nvarchar(4000),@p535 nvarchar(4000),@p536 nvarchar(4000),@p537 nvarchar(4000),@p538 nvarchar(4000),@p539 nvarchar(4000),@p540 nvarchar(4000),@p541 nvarchar(4000),@p542 nvarchar(4000),@p543 nvarchar(4000),@p544 int,@p545 nvarchar(4000),@p546 nvarchar(4000),@p547 nvarchar(4000),@p548 nvarchar(4000),@p549 nvarchar(4000),@p550 int,@p551 nvarchar(4000),@p552 int,@p553 int,@p554 datetime2(7),@p555 datetime2(7),@p556 datetime2(7),@p557 nvarchar(4000),@p558 nvarchar(4000),@p559 nvarchar(4000),@p560 nvarchar(4000),@p561 nvarchar(4000),@p562 nvarchar(4000),@p563 nvarchar(4000),@p564 nvarchar(4000),@p565 nvarchar(4000),@p566 nvarchar(4000),@p567 nvarchar(4000),@p568 nvarchar(4000),@p569 nvarchar(4000),@p570 nvarchar(4000),@p571 datetime2(7),@p572 nvarchar(4000),@p573 nvarchar(4000),@p574 int,@p575 int,@p576 int,@p577 nvarchar(4000),@p578 nvarchar(4000),@p579 nvarchar(4000),@p580 decimal(18,2),@p581 decimal(18,2),@p582 nvarchar(4000),@p583 nvarchar(4000),@p584 decimal(18,2),@p585 nvarchar(4000),@p586 nvarchar(4000),@p587 nvarchar(4000),@p588 nvarchar(4000),@p589 int,@p590 nvarchar(4000),@p591 nvarchar(4000),@p592 nvarchar(4000),@p593 nvarchar(4000),@p594 nvarchar(4000),@p595 nvarchar(4000),@p596 nvarchar(4000),@p597 nvarchar(4000),@p598 nvarchar(4000),@p599 nvarchar(4000),@p600 int,@p601 nvarchar(4000),@p602 nvarchar(4000),@p603 nvarchar(4000),@p604 nvarchar(4000),@p605 nvarchar(4000),@p606 int,@p607 nvarchar(4000),@p608 int,@p609 int,@p610 datetime2(7),@p611 datetime2(7),@p612 datetime2(7),@p613 nvarchar(4000),@p614 nvarchar(4000),@p615 nvarchar(4000),@p616 nvarchar(4000),@p617 nvarchar(4000),@p618 nvarchar(4000),@p619 nvarchar(4000),@p620 nvarchar(4000),@p621 nvarchar(4000),@p622 nvarchar(4000),@p623 nvarchar(4000),@p624 nvarchar(4000),@p625 nvarchar(4000),@p626 nvarchar(4000),@p627 datetime2(7),@p628 nvarchar(4000),@p629 nvarchar(4000),@p630 int,@p631 int,@p632 int,@p633 nvarchar(4000),@p634 nvarchar(4000),@p635 nvarchar(4000),@p636 decimal(18,2),@p637 decimal(18,2),@p638 nvarchar(4000),@p639 nvarchar(4000),@p640 decimal(18,2),@p641 nvarchar(4000),@p642 nvarchar(4000),@p643 nvarchar(4000),@p644 nvarchar(4000),@p645 int,@p646 nvarchar(4000),@p647 nvarchar(4000),@p648 nvarchar(4000),@p649 nvarchar(4000),@p650 nvarchar(4000),@p651 nvarchar(4000),@p652 nvarchar(4000),@p653 nvarchar(4000),@p654 nvarchar(4000),@p655 nvarchar(4000),@p656 int,@p657 nvarchar(4000),@p658 nvarchar(4000),@p659 nvarchar(4000),@p660 nvarchar(4000),@p661 nvarchar(4000),@p662 int,@p663 nvarchar(4000),@p664 int,@p665 int,@p666 datetime2(7),@p667 datetime2(7),@p668 datetime2(7),@p669 nvarchar(4000),@p670 nvarchar(4000),@p671 nvarchar(4000),@p672 nvarchar(4000),@p673 nvarchar(4000),@p674 nvarchar(4000),@p675 nvarchar(4000),@p676 nvarchar(4000),@p677 nvarchar(4000),@p678 nvarchar(4000),@p679 nvarchar(4000),@p680 nvarchar(4000),@p681 nvarchar(4000),@p682 nvarchar(4000),@p683 datetime2(7),@p684 nvarchar(4000),@p685 nvarchar(4000),@p686 int,@p687 int,@p688 int,@p689 nvarchar(4000),@p690 nvarchar(4000),@p691 nvarchar(4000),@p692 decimal(18,2),@p693 decimal(18,2),@p694 nvarchar(4000),@p695 nvarchar(4000),@p696 decimal(18,2),@p697 nvarchar(4000),@p698 nvarchar(4000),@p699 nvarchar(4000),@p700 nvarchar(4000),@p701 int,@p702 nvarchar(4000),@p703 nvarchar(4000),@p704 nvarchar(4000),@p705 nvarchar(4000),@p706 nvarchar(4000),@p707 nvarchar(4000),@p708 nvarchar(4000),@p709 nvarchar(4000),@p710 nvarchar(4000),@p711 nvarchar(4000),@p712 int,@p713 nvarchar(4000),@p714 nvarchar(4000),@p715 nvarchar(4000),@p716 nvarchar(4000),@p717 nvarchar(4000),@p718 int,@p719 nvarchar(4000),@p720 int,@p721 int,@p722 datetime2(7),@p723 datetime2(7),@p724 datetime2(7),@p725 nvarchar(4000),@p726 nvarchar(4000),@p727 nvarchar(4000),@p728 nvarchar(4000),@p729 nvarchar(4000),@p730 nvarchar(4000),@p731 nvarchar(4000),@p732 nvarchar(4000),@p733 nvarchar(4000),@p734 nvarchar(4000),@p735 nvarchar(4000),@p736 nvarchar(4000),@p737 nvarchar(4000),@p738 nvarchar(4000),@p739 datetime2(7),@p740 nvarchar(4000),@p741 nvarchar(4000),@p742 int,@p743 int,@p744 int,@p745 nvarchar(4000),@p746 nvarchar(4000),@p747 nvarchar(4000),@p748 decimal(18,2),@p749 decimal(18,2),@p750 nvarchar(4000),@p751 nvarchar(4000),@p752 decimal(18,2),@p753 nvarchar(4000),@p754 nvarchar(4000),@p755 nvarchar(4000),@p756 nvarchar(4000),@p757 int,@p758 nvarchar(4000),@p759 nvarchar(4000),@p760 nvarchar(4000),@p761 nvarchar(4000),@p762 nvarchar(4000),@p763 nvarchar(4000),@p764 nvarchar(4000),@p765 nvarchar(4000),@p766 nvarchar(4000),@p767 nvarchar(4000),@p768 int,@p769 nvarchar(4000),@p770 nvarchar(4000),@p771 nvarchar(4000),@p772 nvarchar(4000),@p773 nvarchar(4000),@p774 int,@p775 nvarchar(4000),@p776 int,@p777 int,@p778 datetime2(7),@p779 datetime2(7),@p780 datetime2(7),@p781 nvarchar(4000),@p782 nvarchar(4000),@p783 nvarchar(4000),@p784 nvarchar(4000),@p785 nvarchar(4000),@p786 nvarchar(4000),@p787 nvarchar(4000),@p788 nvarchar(4000),@p789 nvarchar(4000),@p790 nvarchar(4000),@p791 nvarchar(4000),@p792 nvarchar(4000),@p793 nvarchar(4000),@p794 nvarchar(4000),@p795 datetime2(7),@p796 nvarchar(4000),@p797 nvarchar(4000),@p798 int,@p799 int,@p800 int,@p801 nvarchar(4000),@p802 nvarchar(4000),@p803 nvarchar(4000),@p804 decimal(18,2),@p805 decimal(18,2),@p806 nvarchar(4000),@p807 nvarchar(4000),@p808 decimal(18,2),@p809 nvarchar(4000),@p810 nvarchar(4000),@p811 nvarchar(4000),@p812 nvarchar(4000),@p813 int,@p814 nvarchar(4000),@p815 nvarchar(4000),@p816 nvarchar(4000),@p817 nvarchar(4000),@p818 nvarchar(4000),@p819 nvarchar(4000),@p820 nvarchar(4000),@p821 nvarchar(4000),@p822 nvarchar(4000),@p823 nvarchar(4000),@p824 int,@p825 nvarchar(4000),@p826 nvarchar(4000),@p827 nvarchar(4000),@p828 nvarchar(4000),@p829 nvarchar(4000),@p830 int,@p831 nvarchar(4000),@p832 int,@p833 int,@p834 datetime2(7),@p835 datetime2(7),@p836 datetime2(7),@p837 nvarchar(4000),@p838 nvarchar(4000),@p839 nvarchar(4000),@p840 nvarchar(4000),@p841 nvarchar(4000),@p842 nvarchar(4000),@p843 nvarchar(4000),@p844 nvarchar(4000),@p845 nvarchar(4000),@p846 nvarchar(4000),@p847 nvarchar(4000),@p848 nvarchar(4000),@p849 nvarchar(4000),@p850 nvarchar(4000),@p851 datetime2(7),@p852 nvarchar(4000),@p853 nvarchar(4000),@p854 int,@p855 int,@p856 int,@p857 nvarchar(4000),@p858 nvarchar(4000),@p859 nvarchar(4000),@p860 decimal(18,2),@p861 decimal(18,2),@p862 nvarchar(4000),@p863 nvarchar(4000),@p864 decimal(18,2),@p865 nvarchar(4000),@p866 nvarchar(4000),@p867 nvarchar(4000),@p868 nvarchar(4000),@p869 int,@p870 nvarchar(4000),@p871 nvarchar(4000),@p872 nvarchar(4000),@p873 nvarchar(4000),@p874 nvarchar(4000),@p875 nvarchar(4000),@p876 nvarchar(4000),@p877 nvarchar(4000),@p878 nvarchar(4000),@p879 nvarchar(4000),@p880 int,@p881 nvarchar(4000),@p882 nvarchar(4000),@p883 nvarchar(4000),@p884 nvarchar(4000),@p885 nvarchar(4000),@p886 int,@p887 nvarchar(4000),@p888 int,@p889 int,@p890 datetime2(7),@p891 datetime2(7),@p892 datetime2(7),@p893 nvarchar(4000),@p894 nvarchar(4000),@p895 nvarchar(4000),@p896 nvarchar(4000),@p897 nvarchar(4000),@p898 nvarchar(4000),@p899 nvarchar(4000),@p900 nvarchar(4000),@p901 nvarchar(4000),@p902 nvarchar(4000),@p903 nvarchar(4000),@p904 nvarchar(4000),@p905 nvarchar(4000),@p906 nvarchar(4000),@p907 datetime2(7),@p908 nvarchar(4000),@p909 nvarchar(4000),@p910 int,@p911 int,@p912 int,@p913 nvarchar(4000),@p914 nvarchar(4000),@p915 nvarchar(4000),@p916 decimal(18,2),@p917 decimal(18,2),@p918 nvarchar(4000),@p919 nvarchar(4000),@p920 decimal(18,2),@p921 nvarchar(4000),@p922 nvarchar(4000),@p923 nvarchar(4000),@p924 nvarchar(4000),@p925 int,@p926 nvarchar(4000),@p927 nvarchar(4000),@p928 nvarchar(4000),@p929 nvarchar(4000),@p930 nvarchar(4000),@p931 nvarchar(4000),@p932 nvarchar(4000),@p933 nvarchar(4000),@p934 nvarchar(4000),@p935 nvarchar(4000),@p936 int,@p937 nvarchar(4000),@p938 nvarchar(4000),@p939 nvarchar(4000),@p940 nvarchar(4000),@p941 nvarchar(4000),@p942 int,@p943 nvarchar(4000),@p944 int,@p945 int,@p946 datetime2(7),@p947 datetime2(7),@p948 datetime2(7),@p949 nvarchar(4000),@p950 nvarchar(4000),@p951 nvarchar(4000),@p952 nvarchar(4000),@p953 nvarchar(4000),@p954 nvarchar(4000),@p955 nvarchar(4000),@p956 nvarchar(4000),@p957 nvarchar(4000),@p958 nvarchar(4000),@p959 nvarchar(4000),@p960 nvarchar(4000),@p961 nvarchar(4000),@p962 nvarchar(4000),@p963 datetime2(7),@p964 nvarchar(4000),@p965 nvarchar(4000),@p966 int,@p967 int,@p968 int,@p969 nvarchar(4000),@p970 nvarchar(4000),@p971 nvarchar(4000),@p972 decimal(18,2),@p973 decimal(18,2),@p974 nvarchar(4000),@p975 nvarchar(4000),@p976 decimal(18,2),@p977 nvarchar(4000),@p978 nvarchar(4000),@p979 nvarchar(4000),@p980 nvarchar(4000),@p981 int,@p982 nvarchar(4000),@p983 nvarchar(4000),@p984 nvarchar(4000),@p985 nvarchar(4000),@p986 nvarchar(4000),@p987 nvarchar(4000),@p988 nvarchar(4000),@p989 nvarchar(4000),@p990 nvarchar(4000),@p991 nvarchar(4000),@p992 int,@p993 nvarchar(4000),@p994 nvarchar(4000),@p995 nvarchar(4000),@p996 nvarchar(4000),@p997 nvarchar(4000),@p998 int,@p999 nvarchar(4000),@p1000 int,@p1001 int,@p1002 datetime2(7),@p1003 datetime2(7),@p1004 datetime2(7),@p1005 nvarchar(4000),@p1006 nvarchar(4000),@p1007 nvarchar(4000),@p1008 nvarchar(4000),@p1009 nvarchar(4000),@p1010 nvarchar(4000),@p1011 nvarchar(4000),@p1012 nvarchar(4000),@p1013 nvarchar(4000),@p1014 nvarchar(4000),@p1015 nvarchar(4000),@p1016 nvarchar(4000),@p1017 nvarchar(4000),@p1018 nvarchar(4000),@p1019 datetime2(7),@p1020 nvarchar(4000),@p1021 nvarchar(4000),@p1022 int,@p1023 int,@p1024 int,@p1025 nvarchar(4000),@p1026 nvarchar(4000),@p1027 nvarchar(4000),@p1028 decimal(18,2),@p1029 decimal(18,2),@p1030 nvarchar(4000),@p1031 nvarchar(4000),@p1032 decimal(18,2),@p1033 nvarchar(4000),@p1034 nvarchar(4000),@p1035 nvarchar(4000),@p1036 nvarchar(4000),@p1037 int,@p1038 nvarchar(4000),@p1039 nvarchar(4000),@p1040 nvarchar(4000),@p1041 nvarchar(4000),@p1042 nvarchar(4000),@p1043 nvarchar(4000),@p1044 nvarchar(4000),@p1045 nvarchar(4000),@p1046 nvarchar(4000),@p1047 nvarchar(4000),@p1048 int,@p1049 nvarchar(4000),@p1050 nvarchar(4000),@p1051 nvarchar(4000),@p1052 nvarchar(4000),@p1053 nvarchar(4000),@p1054 int,@p1055 nvarchar(4000),@p1056 int,@p1057 int,@p1058 datetime2(7),@p1059 datetime2(7),@p1060 datetime2(7),@p1061 nvarchar(4000),@p1062 nvarchar(4000),@p1063 nvarchar(4000),@p1064 nvarchar(4000),@p1065 nvarchar(4000),@p1066 nvarchar(4000),@p1067 nvarchar(4000),@p1068 nvarchar(4000),@p1069 nvarchar(4000),@p1070 nvarchar(4000),@p1071 nvarchar(4000),@p1072 nvarchar(4000),@p1073 nvarchar(4000),@p1074 nvarchar(4000),@p1075 datetime2(7),@p1076 nvarchar(4000),@p1077 nvarchar(4000),@p1078 int,@p1079 int,@p1080 int,@p1081 nvarchar(4000),@p1082 nvarchar(4000),@p1083 nvarchar(4000),@p1084 decimal(18,2),@p1085 decimal(18,2),@p1086 nvarchar(4000),@p1087 nvarchar(4000),@p1088 decimal(18,2),@p1089 nvarchar(4000),@p1090 nvarchar(4000),@p1091 nvarchar(4000),@p1092 nvarchar(4000),@p1093 int,@p1094 nvarchar(4000),@p1095 nvarchar(4000),@p1096 nvarchar(4000),@p1097 nvarchar(4000),@p1098 nvarchar(4000),@p1099 nvarchar(4000),@p1100 nvarchar(4000),@p1101 nvarchar(4000),@p1102 nvarchar(4000),@p1103 nvarchar(4000),@p1104 int,@p1105 nvarchar(4000),@p1106 nvarchar(4000),@p1107 nvarchar(4000),@p1108 nvarchar(4000),@p1109 nvarchar(4000),@p1110 int,@p1111 nvarchar(4000),@p1112 int,@p1113 int,@p1114 datetime2(7),@p1115 datetime2(7),@p1116 datetime2(7),@p1117 nvarchar(4000),@p1118 nvarchar(4000),@p1119 nvarchar(4000),@p1120 nvarchar(4000),@p1121 nvarchar(4000),@p1122 nvarchar(4000),@p1123 nvarchar(4000),@p1124 nvarchar(4000),@p1125 nvarchar(4000),@p1126 nvarchar(4000),@p1127 nvarchar(4000),@p1128 nvarchar(4000),@p1129 nvarchar(4000),@p1130 nvarchar(4000),@p1131 datetime2(7),@p1132 nvarchar(4000),@p1133 nvarchar(4000),@p1134 int,@p1135 int,@p1136 int,@p1137 nvarchar(4000),@p1138 nvarchar(4000),@p1139 nvarchar(4000),@p1140 decimal(18,2),@p1141 decimal(18,2),@p1142 nvarchar(4000),@p1143 nvarchar(4000),@p1144 decimal(18,2),@p1145 nvarchar(4000),@p1146 nvarchar(4000),@p1147 nvarchar(4000),@p1148 nvarchar(4000),@p1149 int,@p1150 nvarchar(4000),@p1151 nvarchar(4000),@p1152 nvarchar(4000),@p1153 nvarchar(4000),@p1154 nvarchar(4000),@p1155 nvarchar(4000),@p1156 nvarchar(4000),@p1157 nvarchar(4000),@p1158 nvarchar(4000),@p1159 nvarchar(4000),@p1160 int,@p1161 nvarchar(4000),@p1162 nvarchar(4000),@p1163 nvarchar(4000),@p1164 nvarchar(4000),@p1165 nvarchar(4000),@p1166 int,@p1167 nvarchar(4000),@p1168 int,@p1169 int,@p1170 datetime2(7),@p1171 datetime2(7),@p1172 datetime2(7),@p1173 nvarchar(4000),@p1174 nvarchar(4000),@p1175 nvarchar(4000),@p1176 nvarchar(4000),@p1177 nvarchar(4000),@p1178 nvarchar(4000),@p1179 nvarchar(4000),@p1180 nvarchar(4000),@p1181 nvarchar(4000),@p1182 nvarchar(4000),@p1183 nvarchar(4000),@p1184 nvarchar(4000),@p1185 nvarchar(4000),@p1186 nvarchar(4000),@p1187 datetime2(7),@p1188 nvarchar(4000),@p1189 nvarchar(4000),@p1190 int,@p1191 int,@p1192 int,@p1193 nvarchar(4000),@p1194 nvarchar(4000),@p1195 nvarchar(4000),@p1196 decimal(18,2),@p1197 decimal(18,2),@p1198 nvarchar(4000),@p1199 nvarchar(4000),@p1200 decimal(18,2),@p1201 nvarchar(4000),@p1202 nvarchar(4000),@p1203 nvarchar(4000),@p1204 nvarchar(4000),@p1205 int,@p1206 nvarchar(4000),@p1207 nvarchar(4000),@p1208 nvarchar(4000),@p1209 nvarchar(4000),@p1210 nvarchar(4000),@p1211 nvarchar(4000),@p1212 nvarchar(4000),@p1213 nvarchar(4000),@p1214 nvarchar(4000),@p1215 nvarchar(4000),@p1216 int,@p1217 nvarchar(4000),@p1218 nvarchar(4000),@p1219 nvarchar(4000),@p1220 nvarchar(4000),@p1221 nvarchar(4000),@p1222 int,@p1223 nvarchar(4000),@p1224 int,@p1225 int,@p1226 datetime2(7),@p1227 datetime2(7),@p1228 datetime2(7),@p1229 nvarchar(4000),@p1230 nvarchar(4000),@p1231 nvarchar(4000),@p1232 nvarchar(4000),@p1233 nvarchar(4000),@p1234 nvarchar(4000),@p1235 nvarchar(4000),@p1236 nvarchar(4000),@p1237 nvarchar(4000),@p1238 nvarchar(4000),@p1239 nvarchar(4000),@p1240 nvarchar(4000),@p1241 nvarchar(4000),@p1242 nvarchar(4000),@p1243 datetime2(7),@p1244 nvarchar(4000),@p1245 nvarchar(4000),@p1246 int,@p1247 int,@p1248 int,@p1249 nvarchar(4000),@p1250 nvarchar(4000),@p1251 nvarchar(4000),@p1252 decimal(18,2),@p1253 decimal(18,2),@p1254 nvarchar(4000),@p1255 nvarchar(4000),@p1256 decimal(18,2),@p1257 nvarchar(4000),@p1258 nvarchar(4000),@p1259 nvarchar(4000),@p1260 nvarchar(4000),@p1261 int,@p1262 nvarchar(4000),@p1263 nvarchar(4000),@p1264 nvarchar(4000),@p1265 nvarchar(4000),@p1266 nvarchar(4000),@p1267 nvarchar(4000),@p1268 nvarchar(4000),@p1269 nvarchar(4000),@p1270 nvarchar(4000),@p1271 nvarchar(4000),@p1272 int,@p1273 nvarchar(4000),@p1274 nvarchar(4000),@p1275 nvarchar(4000),@p1276 nvarchar(4000),@p1277 nvarchar(4000),@p1278 int,@p1279 nvarchar(4000),@p1280 int,@p1281 int,@p1282 datetime2(7),@p1283 datetime2(7),@p1284 datetime2(7),@p1285 nvarchar(4000),@p1286 nvarchar(4000),@p1287 nvarchar(4000),@p1288 nvarchar(4000),@p1289 nvarchar(4000),@p1290 nvarchar(4000),@p1291 nvarchar(4000),@p1292 nvarchar(4000),@p1293 nvarchar(4000),@p1294 nvarchar(4000),@p1295 nvarchar(4000),@p1296 nvarchar(4000),@p1297 nvarchar(4000),@p1298 nvarchar(4000),@p1299 datetime2(7),@p1300 nvarchar(4000),@p1301 nvarchar(4000),@p1302 int,@p1303 int,@p1304 int,@p1305 nvarchar(4000),@p1306 nvarchar(4000),@p1307 nvarchar(4000),@p1308 decimal(18,2),@p1309 decimal(18,2),@p1310 nvarchar(4000),@p1311 nvarchar(4000),@p1312 decimal(18,2),@p1313 nvarchar(4000),@p1314 nvarchar(4000),@p1315 nvarchar(4000),@p1316 nvarchar(4000),@p1317 int,@p1318 nvarchar(4000),@p1319 nvarchar(4000),@p1320 nvarchar(4000),@p1321 nvarchar(4000),@p1322 nvarchar(4000),@p1323 nvarchar(4000),@p1324 nvarchar(4000),@p1325 nvarchar(4000),@p1326 nvarchar(4000),@p1327 nvarchar(4000),@p1328 int,@p1329 nvarchar(4000),@p1330 nvarchar(4000),@p1331 nvarchar(4000),@p1332 nvarchar(4000),@p1333 nvarchar(4000),@p1334 int,@p1335 nvarchar(4000),@p1336 int,@p1337 int,@p1338 datetime2(7),@p1339 datetime2(7),@p1340 datetime2(7),@p1341 nvarchar(4000),@p1342 nvarchar(4000),@p1343 nvarchar(4000),@p1344 nvarchar(4000),@p1345 nvarchar(4000),@p1346 nvarchar(4000),@p1347 nvarchar(4000),@p1348 nvarchar(4000),@p1349 nvarchar(4000),@p1350 nvarchar(4000),@p1351 nvarchar(4000),@p1352 nvarchar(4000),@p1353 nvarchar(4000),@p1354 nvarchar(4000),@p1355 datetime2(7),@p1356 nvarchar(4000),@p1357 nvarchar(4000),@p1358 int,@p1359 int,@p1360 int,@p1361 nvarchar(4000),@p1362 nvarchar(4000),@p1363 nvarchar(4000),@p1364 decimal(18,2),@p1365 decimal(18,2),@p1366 nvarchar(4000),@p1367 nvarchar(4000),@p1368 decimal(18,2),@p1369 nvarchar(4000),@p1370 nvarchar(4000),@p1371 nvarchar(4000),@p1372 nvarchar(4000),@p1373 int,@p1374 nvarchar(4000),@p1375 nvarchar(4000),@p1376 nvarchar(4000),@p1377 nvarchar(4000),@p1378 nvarchar(4000),@p1379 nvarchar(4000),@p1380 nvarchar(4000),@p1381 nvarchar(4000),@p1382 nvarchar(4000),@p1383 nvarchar(4000),@p1384 int,@p1385 nvarchar(4000),@p1386 nvarchar(4000),@p1387 nvarchar(4000),@p1388 nvarchar(4000),@p1389 nvarchar(4000),@p1390 int,@p1391 nvarchar(4000),@p1392 int,@p1393 int,@p1394 datetime2(7),@p1395 datetime2(7),@p1396 datetime2(7),@p1397 nvarchar(4000),@p1398 nvarchar(4000),@p1399 nvarchar(4000),@p1400 nvarchar(4000),@p1401 nvarchar(4000),@p1402 nvarchar(4000),@p1403 nvarchar(4000),@p1404 nvarchar(4000),@p1405 nvarchar(4000),@p1406 nvarchar(4000),@p1407 nvarchar(4000),@p1408 nvarchar(4000),@p1409 nvarchar(4000),@p1410 nvarchar(4000),@p1411 datetime2(7),@p1412 nvarchar(4000),@p1413 nvarchar(4000),@p1414 int,@p1415 int,@p1416 int,@p1417 nvarchar(4000),@p1418 nvarchar(4000),@p1419 nvarchar(4000),@p1420 decimal(18,2),@p1421 decimal(18,2),@p1422 nvarchar(4000),@p1423 nvarchar(4000),@p1424 decimal(18,2),@p1425 nvarchar(4000),@p1426 nvarchar(4000),@p1427 nvarchar(4000),@p1428 nvarchar(4000),@p1429 int,@p1430 nvarchar(4000),@p1431 nvarchar(4000),@p1432 nvarchar(4000),@p1433 nvarchar(4000),@p1434 nvarchar(4000),@p1435 nvarchar(4000),@p1436 nvarchar(4000),@p1437 nvarchar(4000),@p1438 nvarchar(4000),@p1439 nvarchar(4000),@p1440 int,@p1441 nvarchar(4000),@p1442 nvarchar(4000),@p1443 nvarchar(4000),@p1444 nvarchar(4000),@p1445 nvarchar(4000),@p1446 int,@p1447 nvarchar(4000),@p1448 int,@p1449 int,@p1450 datetime2(7),@p1451 datetime2(7),@p1452 datetime2(7),@p1453 nvarchar(4000),@p1454 nvarchar(4000),@p1455 nvarchar(4000),@p1456 nvarchar(4000),@p1457 nvarchar(4000),@p1458 nvarchar(4000),@p1459 nvarchar(4000),@p1460 nvarchar(4000),@p1461 nvarchar(4000),@p1462 nvarchar(4000),@p1463 nvarchar(4000),@p1464 nvarchar(4000),@p1465 nvarchar(4000),@p1466 nvarchar(4000),@p1467 datetime2(7),@p1468 nvarchar(4000),@p1469 nvarchar(4000),@p1470 int,@p1471 int,@p1472 int,@p1473 nvarchar(4000),@p1474 nvarchar(4000),@p1475 nvarchar(4000),@p1476 decimal(18,2),@p1477 decimal(18,2),@p1478 nvarchar(4000),@p1479 nvarchar(4000),@p1480 decimal(18,2),@p1481 nvarchar(4000),@p1482 nvarchar(4000),@p1483 nvarchar(4000),@p1484 nvarchar(4000),@p1485 int,@p1486 nvarchar(4000),@p1487 nvarchar(4000),@p1488 nvarchar(4000),@p1489 nvarchar(4000),@p1490 nvarchar(4000),@p1491 nvarchar(4000),@p1492 nvarchar(4000),@p1493 nvarchar(4000),@p1494 nvarchar(4000),@p1495 nvarchar(4000),@p1496 int,@p1497 nvarchar(4000),@p1498 nvarchar(4000),@p1499 nvarchar(4000),@p1500 nvarchar(4000),@p1501 nvarchar(4000),@p1502 int,@p1503 nvarchar(4000),@p1504 int,@p1505 int,@p1506 datetime2(7),@p1507 datetime2(7),@p1508 datetime2(7),@p1509 nvarchar(4000),@p1510 nvarchar(4000),@p1511 nvarchar(4000),@p1512 nvarchar(4000),@p1513 nvarchar(4000),@p1514 nvarchar(4000),@p1515 nvarchar(4000),@p1516 nvarchar(4000),@p1517 nvarchar(4000),@p1518 nvarchar(4000),@p1519 nvarchar(4000),@p1520 nvarchar(4000),@p1521 nvarchar(4000),@p1522 nvarchar(4000),@p1523 datetime2(7),@p1524 nvarchar(4000),@p1525 nvarchar(4000),@p1526 int,@p1527 int,@p1528 int,@p1529 nvarchar(4000),@p1530 nvarchar(4000),@p1531 nvarchar(4000),@p1532 decimal(18,2),@p1533 decimal(18,2),@p1534 nvarchar(4000),@p1535 nvarchar(4000),@p1536 decimal(18,2),@p1537 nvarchar(4000),@p1538 nvarchar(4000),@p1539 nvarchar(4000),@p1540 nvarchar(4000),@p1541 int,@p1542 nvarchar(4000),@p1543 nvarchar(4000),@p1544 nvarchar(4000),@p1545 nvarchar(4000),@p1546 nvarchar(4000),@p1547 nvarchar(4000),@p1548 nvarchar(4000),@p1549 nvarchar(4000),@p1550 nvarchar(4000),@p1551 nvarchar(4000),@p1552 int,@p1553 nvarchar(4000),@p1554 nvarchar(4000),@p1555 nvarchar(4000),@p1556 nvarchar(4000),@p1557 nvarchar(4000),@p1558 int,@p1559 nvarchar(4000),@p1560 int,@p1561 int,@p1562 datetime2(7),@p1563 datetime2(7),@p1564 datetime2(7),@p1565 nvarchar(4000),@p1566 nvarchar(4000),@p1567 nvarchar(4000),@p1568 nvarchar(4000),@p1569 nvarchar(4000),@p1570 nvarchar(4000),@p1571 nvarchar(4000),@p1572 nvarchar(4000),@p1573 nvarchar(4000),@p1574 nvarchar(4000),@p1575 nvarchar(4000),@p1576 nvarchar(4000),@p1577 nvarchar(4000),@p1578 nvarchar(4000),@p1579 datetime2(7),@p1580 nvarchar(4000),@p1581 nvarchar(4000),@p1582 int,@p1583 int,@p1584 int,@p1585 nvarchar(4000),@p1586 nvarchar(4000),@p1587 nvarchar(4000),@p1588 decimal(18,2),@p1589 decimal(18,2),@p1590 nvarchar(4000),@p1591 nvarchar(4000),@p1592 decimal(18,2),@p1593 nvarchar(4000),@p1594 nvarchar(4000),@p1595 nvarchar(4000),@p1596 nvarchar(4000),@p1597 int,@p1598 nvarchar(4000),@p1599 nvarchar(4000),@p1600 nvarchar(4000),@p1601 nvarchar(4000),@p1602 nvarchar(4000),@p1603 nvarchar(4000),@p1604 nvarchar(4000),@p1605 nvarchar(4000),@p1606 nvarchar(4000),@p1607 nvarchar(4000),@p1608 int,@p1609 nvarchar(4000),@p1610 nvarchar(4000),@p1611 nvarchar(4000),@p1612 nvarchar(4000),@p1613 nvarchar(4000),@p1614 int,@p1615 nvarchar(4000),@p1616 int,@p1617 int,@p1618 datetime2(7),@p1619 datetime2(7),@p1620 datetime2(7),@p1621 nvarchar(4000),@p1622 nvarchar(4000),@p1623 nvarchar(4000),@p1624 nvarchar(4000),@p1625 nvarchar(4000),@p1626 nvarchar(4000),@p1627 nvarchar(4000),@p1628 nvarchar(4000),@p1629 nvarchar(4000),@p1630 nvarchar(4000),@p1631 nvarchar(4000),@p1632 nvarchar(4000),@p1633 nvarchar(4000),@p1634 nvarchar(4000),@p1635 datetime2(7),@p1636 nvarchar(4000),@p1637 nvarchar(4000),@p1638 int,@p1639 int,@p1640 int,@p1641 nvarchar(4000),@p1642 nvarchar(4000),@p1643 nvarchar(4000),@p1644 decimal(18,2),@p1645 decimal(18,2),@p1646 nvarchar(4000),@p1647 nvarchar(4000),@p1648 decimal(18,2),@p1649 nvarchar(4000),@p1650 nvarchar(4000),@p1651 nvarchar(4000),@p1652 nvarchar(4000),@p1653 int,@p1654 nvarchar(4000),@p1655 nvarchar(4000),@p1656 nvarchar(4000),@p1657 nvarchar(4000),@p1658 nvarchar(4000),@p1659 nvarchar(4000),@p1660 nvarchar(4000),@p1661 nvarchar(4000),@p1662 nvarchar(4000),@p1663 nvarchar(4000),@p1664 int,@p1665 nvarchar(4000),@p1666 nvarchar(4000),@p1667 nvarchar(4000),@p1668 nvarchar(4000),@p1669 nvarchar(4000),@p1670 int,@p1671 nvarchar(4000),@p1672 int,@p1673 int,@p1674 datetime2(7),@p1675 datetime2(7),@p1676 datetime2(7),@p1677 nvarchar(4000),@p1678 nvarchar(4000),@p1679 nvarchar(4000),@p1680 nvarchar(4000),@p1681 nvarchar(4000),@p1682 nvarchar(4000),@p1683 nvarchar(4000),@p1684 nvarchar(4000),@p1685 nvarchar(4000),@p1686 nvarchar(4000),@p1687 nvarchar(4000),@p1688 nvarchar(4000),@p1689 nvarchar(4000),@p1690 nvarchar(4000),@p1691 datetime2(7),@p1692 nvarchar(4000),@p1693 nvarchar(4000),@p1694 int,@p1695 int,@p1696 int,@p1697 nvarchar(4000),@p1698 nvarchar(4000),@p1699 nvarchar(4000),@p1700 decimal(18,2),@p1701 decimal(18,2),@p1702 nvarchar(4000),@p1703 nvarchar(4000),@p1704 decimal(18,2),@p1705 nvarchar(4000),@p1706 nvarchar(4000),@p1707 nvarchar(4000),@p1708 nvarchar(4000),@p1709 int,@p1710 nvarchar(4000),@p1711 nvarchar(4000),@p1712 nvarchar(4000),@p1713 nvarchar(4000),@p1714 nvarchar(4000),@p1715 nvarchar(4000),@p1716 nvarchar(4000),@p1717 nvarchar(4000),@p1718 nvarchar(4000),@p1719 nvarchar(4000),@p1720 int,@p1721 nvarchar(4000),@p1722 nvarchar(4000),@p1723 nvarchar(4000),@p1724 nvarchar(4000),@p1725 nvarchar(4000),@p1726 int,@p1727 nvarchar(4000),@p1728 int,@p1729 int,@p1730 datetime2(7),@p1731 datetime2(7),@p1732 datetime2(7),@p1733 nvarchar(4000),@p1734 nvarchar(4000),@p1735 nvarchar(4000),@p1736 nvarchar(4000),@p1737 nvarchar(4000),@p1738 nvarchar(4000),@p1739 nvarchar(4000),@p1740 nvarchar(4000),@p1741 nvarchar(4000),@p1742 nvarchar(4000),@p1743 nvarchar(4000),@p1744 nvarchar(4000),@p1745 nvarchar(4000),@p1746 nvarchar(4000),@p1747 datetime2(7),@p1748 nvarchar(4000),@p1749 nvarchar(4000),@p1750 int,@p1751 int,@p1752 int,@p1753 nvarchar(4000),@p1754 nvarchar(4000),@p1755 nvarchar(4000),@p1756 nvarchar(4000),@p1757 decimal(18,2),@p1758 nvarchar(4000),@p1759 nvarchar(4000),@p1760 decimal(18,2),@p1761 nvarchar(4000),@p1762 nvarchar(4000),@p1763 nvarchar(4000),@p1764 nvarchar(4000),@p1765 int,@p1766 nvarchar(4000),@p1767 nvarchar(4000),@p1768 nvarchar(4000),@p1769 nvarchar(4000),@p1770 nvarchar(4000),@p1771 nvarchar(4000),@p1772 nvarchar(4000),@p1773 nvarchar(4000),@p1774 nvarchar(4000),@p1775 nvarchar(4000),@p1776 int,@p1777 nvarchar(4000),@p1778 nvarchar(4000),@p1779 nvarchar(4000),@p1780 nvarchar(4000),@p1781 nvarchar(4000),@p1782 int,@p1783 nvarchar(4000),@p1784 int,@p1785 int,@p1786 datetime2(7),@p1787 datetime2(7),@p1788 datetime2(7),@p1789 nvarchar(4000),@p1790 nvarchar(4000),@p1791 nvarchar(4000),@p1792 nvarchar(4000),@p1793 nvarchar(4000),@p1794 nvarchar(4000),@p1795 nvarchar(4000),@p1796 nvarchar(4000),@p1797 nvarchar(4000),@p1798 nvarchar(4000),@p1799 nvarchar(4000),@p1800 nvarchar(4000),@p1801 nvarchar(4000),@p1802 nvarchar(4000),@p1803 datetime2(7),@p1804 nvarchar(4000),@p1805 nvarchar(4000),@p1806 int,@p1807 int,@p1808 int,@p1809 nvarchar(4000),@p1810 nvarchar(4000),@p1811 nvarchar(4000),@p1812 nvarchar(4000),@p1813 decimal(18,2),@p1814 nvarchar(4000),@p1815 nvarchar(4000),@p1816 decimal(18,2),@p1817 nvarchar(4000),@p1818 nvarchar(4000),@p1819 nvarchar(4000),@p1820 nvarchar(4000),@p1821 int,@p1822 nvarchar(4000),@p1823 nvarchar(4000),@p1824 nvarchar(4000),@p1825 nvarchar(4000),@p1826 nvarchar(4000),@p1827 nvarchar(4000),@p1828 nvarchar(4000),@p1829 nvarchar(4000),@p1830 nvarchar(4000),@p1831 nvarchar(4000),@p1832 int,@p1833 nvarchar(4000),@p1834 nvarchar(4000),@p1835 nvarchar(4000),@p1836 nvarchar(4000),@p1837 nvarchar(4000),@p1838 int,@p1839 nvarchar(4000),@p1840 int,@p1841 int,@p1842 datetime2(7),@p1843 datetime2(7),@p1844 datetime2(7),@p1845 nvarchar(4000),@p1846 nvarchar(4000),@p1847 nvarchar(4000),@p1848 nvarchar(4000),@p1849 nvarchar(4000),@p1850 nvarchar(4000),@p1851 nvarchar(4000),@p1852 nvarchar(4000),@p1853 nvarchar(4000),@p1854 nvarchar(4000),@p1855 nvarchar(4000),@p1856 nvarchar(4000),@p1857 nvarchar(4000),@p1858 nvarchar(4000),@p1859 datetime2(7),@p1860 nvarchar(4000),@p1861 nvarchar(4000),@p1862 int,@p1863 int,@p1864 int,@p1865 nvarchar(4000),@p1866 nvarchar(4000),@p1867 nvarchar(4000),@p1868 nvarchar(4000),@p1869 decimal(18,2),@p1870 nvarchar(4000),@p1871 nvarchar(4000),@p1872 decimal(18,2),@p1873 nvarchar(4000),@p1874 nvarchar(4000),@p1875 nvarchar(4000),@p1876 nvarchar(4000),@p1877 int,@p1878 nvarchar(4000),@p1879 nvarchar(4000),@p1880 nvarchar(4000),@p1881 nvarchar(4000),@p1882 nvarchar(4000),@p1883 nvarchar(4000),@p1884 nvarchar(4000),@p1885 nvarchar(4000),@p1886 nvarchar(4000),@p1887 nvarchar(4000),@p1888 int,@p1889 nvarchar(4000),@p1890 nvarchar(4000),@p1891 nvarchar(4000),@p1892 nvarchar(4000),@p1893 nvarchar(4000),@p1894 int,@p1895 nvarchar(4000),@p1896 int,@p1897 int,@p1898 datetime2(7),@p1899 datetime2(7),@p1900 datetime2(7),@p1901 nvarchar(4000),@p1902 nvarchar(4000),@p1903 nvarchar(4000),@p1904 nvarchar(4000),@p1905 nvarchar(4000),@p1906 nvarchar(4000),@p1907 nvarchar(4000),@p1908 nvarchar(4000),@p1909 nvarchar(4000),@p1910 nvarchar(4000),@p1911 nvarchar(4000),@p1912 nvarchar(4000),@p1913 nvarchar(4000),@p1914 nvarchar(4000),@p1915 datetime2(7),@p1916 nvarchar(4000),@p1917 nvarchar(4000),@p1918 int,@p1919 int,@p1920 int,@p1921 nvarchar(4000),@p1922 nvarchar(4000),@p1923 nvarchar(4000),@p1924 nvarchar(4000),@p1925 decimal(18,2),@p1926 nvarchar(4000),@p1927 nvarchar(4000),@p1928 decimal(18,2),@p1929 nvarchar(4000),@p1930 nvarchar(4000),@p1931 nvarchar(4000),@p1932 nvarchar(4000),@p1933 int,@p1934 nvarchar(4000),@p1935 nvarchar(4000),@p1936 nvarchar(4000),@p1937 nvarchar(4000),@p1938 nvarchar(4000),@p1939 nvarchar(4000),@p1940 nvarchar(4000),@p1941 nvarchar(4000),@p1942 nvarchar(4000),@p1943 nvarchar(4000),@p1944 int,@p1945 nvarchar(4000),@p1946 nvarchar(4000),@p1947 nvarchar(4000),@p1948 nvarchar(4000),@p1949 nvarchar(4000),@p1950 int,@p1951 nvarchar(4000),@p1952 int,@p1953 int,@p1954 datetime2(7),@p1955 datetime2(7),@p1956 datetime2(7),@p1957 nvarchar(4000),@p1958 nvarchar(4000),@p1959 nvarchar(4000),@p1960 nvarchar(4000),@p1961 nvarchar(4000),@p1962 nvarchar(4000),@p1963 nvarchar(4000),@p1964 nvarchar(4000),@p1965 nvarchar(4000),@p1966 nvarchar(4000),@p1967 nvarchar(4000),@p1968 nvarchar(4000),@p1969 nvarchar(4000),@p1970 nvarchar(4000),@p1971 datetime2(7),@p1972 nvarchar(4000),@p1973 nvarchar(4000),@p1974 int,@p1975 int,@p1976 int,@p1977 nvarchar(4000),@p1978 nvarchar(4000),@p1979 nvarchar(4000),@p1980 nvarchar(4000),@p1981 decimal(18,2),@p1982 nvarchar(4000),@p1983 nvarchar(4000),@p1984 decimal(18,2),@p1985 nvarchar(4000),@p1986 nvarchar(4000),@p1987 nvarchar(4000),@p1988 nvarchar(4000),@p1989 int,@p1990 nvarchar(4000),@p1991 nvarchar(4000),@p1992 nvarchar(4000),@p1993 nvarchar(4000),@p1994 nvarchar(4000),@p1995 nvarchar(4000),@p1996 nvarchar(4000),@p1997 nvarchar(4000),@p1998 nvarchar(4000),@p1999 nvarchar(4000),@p2000 int,@p2001 nvarchar(4000),@p2002 nvarchar(4000),@p2003 nvarchar(4000),@p2004 nvarchar(4000),@p2005 nvarchar(4000),@p2006 int,@p2007 nvarchar(4000),@p2008 int,@p2009 int,@p2010 datetime2(7),@p2011 datetime2(7),@p2012 datetime2(7),@p2013 nvarchar(4000),@p2014 nvarchar(4000),@p2015 nvarchar(4000),@p2016 nvarchar(4000),@p2017 nvarchar(4000),@p2018 nvarchar(4000),@p2019 nvarchar(4000),@p2020 nvarchar(4000),@p2021 nvarchar(4000),@p2022 nvarchar(4000),@p2023 nvarchar(4000),@p2024 nvarchar(4000),@p2025 nvarchar(4000),@p2026 nvarchar(4000),@p2027 datetime2(7),@p2028 nvarchar(4000),@p2029 nvarchar(4000),@p2030 int,@p2031 int,@p2032 int,@p2033 nvarchar(4000),@p2034 nvarchar(4000),@p2035 nvarchar(4000),@p2036 nvarchar(4000),@p2037 decimal(18,2),@p2038 nvarchar(4000),@p2039 nvarchar(4000),@p2040 decimal(18,2),@p2041 nvarchar(4000),@p2042 nvarchar(4000),@p2043 nvarchar(4000),@p2044 nvarchar(4000),@p2045 int,@p2046 nvarchar(4000),@p2047 nvarchar(4000),@p2048 nvarchar(4000),@p2049 nvarchar(4000),@p2050 nvarchar(4000),@p2051 nvarchar(4000),@p2052 nvarchar(4000),@p2053 nvarchar(4000),@p2054 nvarchar(4000),@p2055 nvarchar(4000),@p2056 int,@p2057 nvarchar(4000),@p2058 nvarchar(4000),@p2059 nvarchar(4000),@p2060 nvarchar(4000),@p2061 nvarchar(4000),@p2062 int,@p2063 nvarchar(4000),@p2064 int,@p2065 int,@p2066 datetime2(7),@p2067 datetime2(7),@p2068 datetime2(7),@p2069 nvarchar(4000),@p2070 nvarchar(4000),@p2071 nvarchar(4000))SET NOCOUNT ON; DECLARE @inserted0 TABLE ([item_id] int, [_Position] [int]); MERGE [raw_data] USING ( VALUES (@p0, @p1, @p2, @p3, @p4, @p5, @p6, @p7, @p8, @p9, @p10, @p11, @p12, @p13, @p14, @p15, @p16, @p17, @p18, @p19, @p20, @p21, @p22, @p23, @p24, @p25, @p26, @p27, @p28, @p29, @p30, @p31, @p32, @p33, @p34, @p35, @p36, @p37, @p38, @p39, @p40, @p41, @p42, @p43, @p44, @p45, @p46, @p47, @p48, @p49, @p50, @p51, @p52, @p53, @p54, @p55, 0), (@p56, @p57, @p58, @p59, @p60, @p61, @p62, @p63, @p64, @p65, @p66, @p67, @p68, @p69, @p70, @p71, @p72, @p73, @p74, @p75, @p76, @p77, @p78, @p79, @p80, @p81, @p82, @p83, @p84, @p85, @p86, @p87, @p88, @p89, @p90, @p91, @p92, @p93, @p94, @p95, @p96, @p97, @p98, @p99, @p100, @p101, @p102, @p103, @p104, @p105, @p106, @p107, @p108, @p109, @p110, @p111, 1), (@p112, @p113, @p114, @p115, @p116, @p117, @p118, @p119, @p120, @p121, @p122, @p123, @p124, @p125, @p126, @p127, @p128, @p129, @p130, @p131, @p132, @p133, @p134, @p135, @p136, @p137, @p138, @p139, @p140, @p141, @p142, @p143, @p144, @p145, @p146, @p147, @p148, @p149, @p150, @p151, @p152, @p153, @p154, @p155, @p156, @p157, @p158, @p159, @p160, @p161, @p162, @p163, @p164, @p165, @p166, @p167, 2), (@p168, @p169, @p170, @p171, @p172, @p173, @p174, @p175, @p176, @p177, @p178, @p179, @p180, @p181, @p182, @p183, @p184, @p185, @p186, @p187, @p188, @p189, @p190, @p191, @p192, @p193, @p194, @p195, @p196, @p197, @p198, @p199, @p200, @p201, @p202, @p203, @p204, @p205, @p206, @p207, @p208, @p209, @p210, @p211, @p212, @p213, @p214, @p215, @p216, @p217, @p218, @p219, @p220, @p221, @p222, @p223, 3), (@p224, @p225, @p226, @p227, @p228, @p229, @p230, @p231, @p232, @p233, @p234, @p235, @p236, @p237, @p238, @p239, @p240, @p241, @p242, @p243, @p244, @p245, @p246, @p247, @p248, @p249, @p250, @p251, @p252, @p253, @p254, @p255, @p256, @p257, @p258, @p259, @p260, @p261, @p262, @p263, @p264, @p265, @p266, @p267, @p268, @p269, @p270, @p271, @p272, @p273, @p274, @p275, @p276, @p277, @p278, @p279, 4), (@p280, @p281, @p282, @p283, @p284, @p285, @p286, @p287, @p288, @p289, @p290, @p291, @p292, @p293, @p294, @p295, @p296, @p297, @p298, @p299, @p300, @p301, @p302, @p303, @p304, @p305, @p306, @p307, @p308, @p309, @p310, @p311, @p312, @p313, @p314, @p315, @p316, @p317, @p318, @p319, @p320, @p321, @p322, @p323, @p324, @p325, @p326, @p327, @p328, @p329, @p330, @p331, @p332, @p333, @p334, @p335, 5), (@p336, @p337, @p338, @p339, @p340, @p341, @p342, @p343, @p344, @p345, @p346, @p347, @p348, @p349, @p350, @p351, @p352, @p353, @p354, @p355, @p356, @p357, @p358, @p359, @p360, @p361, @p362, @p363, @p364, @p365, @p366, @p367, @p368, @p369, @p370, @p371, @p372, @p373, @p374, @p375, @p376, @p377, @p378, @p379, @p380, @p381, @p382, @p383, @p384, @p385, @p386, @p387, @p388, @p389, @p390, @p391, 6), (@p392, @p393, @p394, @p395, @p396, @p397, @p398, @p399, @p400, @p401, @p402, @p403, @p404, @p405, @p406, @p407, @p408, @p409, @p410, @p411, @p412, @p413, @p414, @p415, @p416, @p417, @p418, @p419, @p420, @p421, @p422, @p423, @p424, @p425, @p426, @p427, @p428, @p429, @p430, @p431, @p432, @p433, @p434, @p435, @p436, @p437, @p438, @p439, @p440, @p441, @p442, @p443, @p444, @p445, @p446, @p447, 7), (@p448, @p449, @p450, @p451, @p452, @p453, @p454, @p455, @p456, @p457, @p458, @p459, @p460, @p461, @p462, @p463, @p464, @p465, @p466, @p467, @p468, @p469, @p470, @p471, @p472, @p473, @p474, @p475, @p476, @p477, @p478, @p479, @p480, @p481, @p482, @p483, @p484, @p485, @p486, @p487, @p488, @p489, @p490, @p491, @p492, @p493, @p494, @p495, @p496, @p497, @p498, @p499, @p500, @p501, @p502, @p503, 8), (@p504, @p505, @p506, @p507, @p508, @p509, @p510, @p511, @p512, @p513, @p514, @p515, @p516, @p517, @p518, @p519, @p520, @p521, @p522, @p523, @p524, @p525, @p526, @p527, @p528, @p529, @p530, @p531, @p532, @p533, @p534, @p535, @p536, @p537, @p538, @p539, @p540, @p541, @p542, @p543, @p544, @p545, @p546, @p547, @p548, @p549, @p550, @p551, @p552, @p553, @p554, @p555, @p556, @p557, @p558, @p559, 9), (@p560, @p561, @p562, @p563, @p564, @p565, @p566, @p567, @p568, @p569, @p570, @p571, @p572, @p573, @p574, @p575, @p576, @p577, @p578, @p579, @p580, @p581, @p582, @p583, @p584, @p585, @p586, @p587, @p588, @p589, @p590, @p591, @p592, @p593, @p594, @p595, @p596, @p597, @p598, @p599, @p600, @p601, @p602, @p603, @p604, @p605, @p606, @p607, @p608, @p609, @p610, @p611, @p612, @p613, @p614, @p615, 10), (@p616, @p617, @p618, @p619, @p620, @p621, @p622, @p623, @p624, @p625, @p626, @p627, @p628, @p629, @p630, @p631, @p632, @p633, @p634, @p635, @p636, @p637, @p638, @p639, @p640, @p641, @p642, @p643, @p644, @p645, @p646, @p647, @p648, @p649, @p650, @p651, @p652, @p653, @p654, @p655, @p656, @p657, @p658, @p659, @p660, @p661, @p662, @p663, @p664, @p665, @p666, @p667, @p668, @p669, @p670, @p671, 11), (@p672, @p673, @p674, @p675, @p676, @p677, @p678, @p679, @p680, @p681, @p682, @p683, @p684, @p685, @p686, @p687, @p688, @p689, @p690, @p691, @p692, @p693, @p694, @p695, @p696, @p697, @p698, @p699, @p700, @p701, @p702, @p703, @p704, @p705, @p706, @p707, @p708, @p709, @p710, @p711, @p712, @p713, @p714, @p715, @p716, @p717, @p718, @p719, @p720, @p721, @p722, @p723, @p724, @p725, @p726, @p727, 12), (@p728, @p729, @p730, @p731, @p732, @p733, @p734, @p735, @p736, @p737, @p738, @p739, @p740, @p741, @p742, @p743, @p744, @p745, @p746, @p747, @p748, @p749, @p750, @p751, @p752, @p753, @p754, @p755, @p756, @p757, @p758, @p759, @p760, @p761, @p762, @p763, @p764, @p765, @p766, @p767, @p768, @p769, @p770, @p771, @p772, @p773, @p774, @p775, @p776, @p777, @p778, @p779, @p780, @p781, @p782, @p783, 13), (@p784, @p785, @p786, @p787, @p788, @p789, @p790, @p791, @p792, @p793, @p794, @p795, @p796, @p797, @p798, @p799, @p800, @p801, @p802, @p803, @p804, @p805, @p806, @p807, @p808, @p809, @p810, @p811, @p812, @p813, @p814, @p815, @p816, @p817, @p818, @p819, @p820, @p821, @p822, @p823, @p824, @p825, @p826, @p827, @p828, @p829, @p830, @p831, @p832, @p833, @p834, @p835, @p836, @p837, @p838, @p839, 14), (@p840, @p841, @p842, @p843, @p844, @p845, @p846, @p847, @p848, @p849, @p850, @p851, @p852, @p853, @p854, @p855, @p856, @p857, @p858, @p859, @p860, @p861, @p862, @p863, @p864, @p865, @p866, @p867, @p868, @p869, @p870, @p871, @p872, @p873, @p874, @p875, @p876, @p877, @p878, @p879, @p880, @p881, @p882, @p883, @p884, @p885, @p886, @p887, @p888, @p889, @p890, @p891, @p892, @p893, @p894, @p895, 15), (@p896, @p897, @p898, @p899, @p900, @p901, @p902, @p903, @p904, @p905, @p906, @p907, @p908, @p909, @p910, @p911, @p912, @p913, @p914, @p915, @p916, @p917, @p918, @p919, @p920, @p921, @p922, @p923, @p924, @p925, @p926, @p927, @p928, @p929, @p930, @p931, @p932, @p933, @p934, @p935, @p936, @p937, @p938, @p939, @p940, @p941, @p942, @p943, @p944, @p945, @p946, @p947, @p948, @p949, @p950, @p951, 16), (@p952, @p953, @p954, @p955, @p956, @p957, @p958, @p959, @p960, @p961, @p962, @p963, @p964, @p965, @p966, @p967, @p968, @p969, @p970, @p971, @p972, @p973, @p974, @p975, @p976, @p977, @p978, @p979, @p980, @p981, @p982, @p983, @p984, @p985, @p986, @p987, @p988, @p989, @p990, @p991, @p992, @p993, @p994, @p995, @p996, @p997, @p998, @p999, @p1000, @p1001, @p1002, @p1003, @p1004, @p1005, @p1006, @p1007, 17), (@p1008, @p1009, @p1010, @p1011, @p1012, @p1013, @p1014, @p1015, @p1016, @p1017, @p1018, @p1019, @p1020, @p1021, @p1022, @p1023, @p1024, @p1025, @p1026, @p1027, @p1028, @p1029, @p1030, @p1031, @p1032, @p1033, @p1034, @p1035, @p1036, @p1037, @p1038, @p1039, @p1040, @p1041, @p1042, @p1043, @p1044, @p1045, @p1046, @p1047, @p1048, @p1049, @p1050, @p1051, @p1052, @p1053, @p1054, @p1055, @p1056, @p1057, @p1058, @p1059, @p1060, @p1061, @p1062, @p1063, 18), (@p1064, @p1065, @p1066, @p1067, @p1068, @p1069, @p1070, @p1071, @p1072, @p1073, @p1074, @p1075, @p1076, @p1077, @p1078, @p1079, @p1080, @p1081, @p1082, @p1083, @p1084, @p1085, @p1086, @p1087, @p1088, @p1089, @p1090, @p1091, @p1092, @p1093, @p1094, @p1095, @p1096, @p1097, @p1098, @p1099, @p1100, @p1101, @p1102, @p1103, @p1104, @p1105, @p1106, @p1107, @p1108, @p1109, @p1110, @p1111, @p1112, @p1113, @p1114, @p1115, @p1116, @p1117, @p1118, @p1119, 19), (@p1120, @p1121, @p1122, @p1123, @p1124, @p1125, @p1126, @p1127, @p1128, @p1129, @p1130, @p1131, @p1132, @p1133, @p1134, @p1135, @p1136, @p1137, @p1138, @p1139, @p1140, @p1141, @p1142, @p1143, @p1144, @p1145, @p1146, @p1147, @p1148, @p1149, @p1150, @p1151, @p1152, @p1153, @p1154, @p1155, @p1156, @p1157, @p1158, @p1159, @p1160, @p1161, @p1162, @p1163, @p1164, @p1165, @p1166, @p1167, @p1168, @p1169, @p1170, @p1171, @p1172, @p1173, @p1174, @p1175, 20), (@p1176, @p1177, @p1178, @p1179, @p1180, @p1181, @p1182, @p1183, @p1184, @p1185, @p1186, @p1187, @p1188, @p1189, @p1190, @p1191, @p1192, @p1193, @p1194, @p1195, @p1196, @p1197, @p1198, @p1199, @p1200, @p1201, @p1202, @p1203, @p1204, @p1205, @p1206, @p1207, @p1208, @p1209, @p1210, @p1211, @p1212, @p1213, @p1214, @p1215, @p1216, @p1217, @p1218, @p1219, @p1220, @p1221, @p1222, @p1223, @p1224, @p1225, @p1226, @p1227, @p1228, @p1229, @p1230, @p1231, 21), (@p1232, @p1233, @p1234, @p1235, @p1236, @p1237, @p1238, @p1239, @p1240, @p1241, @p1242, @p1243, @p1244, @p1245, @p1246, @p1247, @p1248, @p1249, @p1250, @p1251, @p1252, @p1253, @p1254, @p1255, @p1256, @p1257, @p1258, @p1259, @p1260, @p1261, @p1262, @p1263, @p1264, @p1265, @p1266, @p1267, @p1268, @p1269, @p1270, @p1271, @p1272, @p1273, @p1274, @p1275, @p1276, @p1277, @p1278, @p1279, @p1280, @p1281, @p1282, @p1283, @p1284, @p1285, @p1286, @p1287, 22), (@p1288, @p1289, @p1290, @p1291, @p1292, @p1293, @p1294, @p1295, @p1296, @p1297, @p1298, @p1299, @p1300, @p1301, @p1302, @p1303, @p1304, @p1305, @p1306, @p1307, @p1308, @p1309, @p1310, @p1311, @p1312, @p1313, @p1314, @p1315, @p1316, @p1317, @p1318, @p1319, @p1320, @p1321, @p1322, @p1323, @p1324, @p1325, @p1326, @p1327, @p1328, @p1329, @p1330, @p1331, @p1332, @p1333, @p1334, @p1335, @p1336, @p1337, @p1338, @p1339, @p1340, @p1341, @p1342, @p1343, 23), (@p1344, @p1345, @p1346, @p1347, @p1348, @p1349, @p1350, @p1351, @p1352, @p1353, @p1354, @p1355, @p1356, @p1357, @p1358, @p1359, @p1360, @p1361, @p1362, @p1363, @p1364, @p1365, @p1366, @p1367, @p1368, @p1369, @p1370, @p1371, @p1372, @p1373, @p1374, @p1375, @p1376, @p1377, @p1378, @p1379, @p1380, @p1381, @p1382, @p1383, @p1384, @p1385, @p1386, @p1387, @p1388, @p1389, @p1390, @p1391, @p1392, @p1393, @p1394, @p1395, @p1396, @p1397, @p1398, @p1399, 24), (@p1400, @p1401, @p1402, @p1403, @p1404, @p1405, @p1406, @p1407, @p1408, @p1409, @p1410, @p1411, @p1412, @p1413, @p1414, @p1415, @p1416, @p1417, @p1418, @p1419, @p1420, @p1421, @p1422, @p1423, @p1424, @p1425, @p1426, @p1427, @p1428, @p1429, @p1430, @p1431, @p1432, @p1433, @p1434, @p1435, @p1436, @p1437, @p1438, @p1439, @p1440, @p1441, @p1442, @p1443, @p1444, @p1445, @p1446, @p1447, @p1448, @p1449, @p1450, @p1451, @p1452, @p1453, @p1454, @p1455, 25), (@p1456, @p1457, @p1458, @p1459, @p1460, @p1461, @p1462, @p1463, @p1464, @p1465, @p1466, @p1467, @p1468, @p1469, @p1470, @p1471, @p1472, @p1473, @p1474, @p1475, @p1476, @p1477, @p1478, @p1479, @p1480, @p1481, @p1482, @p1483, @p1484, @p1485, @p1486, @p1487, @p1488, @p1489, @p1490, @p1491, @p1492, @p1493, @p1494, @p1495, @p1496, @p1497, @p1498, @p1499, @p1500, @p1501, @p1502, @p1503, @p1504, @p1505, @p1506, @p1507, @p1508, @p1509, @p1510, @p1511, 26), (@p1512, @p1513, @p1514, @p1515, @p1516, @p1517, @p1518, @p1519, @p1520, @p1521, @p1522, @p1523, @p1524, @p1525, @p1526, @p1527, @p1528, @p1529, @p1530, @p1531, @p1532, @p1533, @p1534, @p1535, @p1536, @p1537, @p1538, @p1539, @p1540, @p1541, @p1542, @p1543, @p1544, @p1545, @p1546, @p1547, @p1548, @p1549, @p1550, @p1551, @p1552, @p1553, @p1554, @p1555, @p1556, @p1557, @p1558, @p1559, @p1560, @p1561, @p1562, @p1563, @p1564, @p1565, @p1566, @p1567, 27), (@p1568, @p1569, @p1570, @p1571, @p1572, @p1573, @p1574, @p1575, @p1576, @p1577, @p1578, @p1579, @p1580, @p1581, @p1582, @p1583, @p1584, @p1585, @p1586, @p1587, @p1588, @p1589, @p1590, @p1591, @p1592, @p1593, @p1594, @p1595, @p1596, @p1597, @p1598, @p1599, @p1600, @p1601, @p1602, @p1603, @p1604, @p1605, @p1606, @p1607, @p1608, @p1609, @p1610, @p1611, @p1612, @p1613, @p1614, @p1615, @p1616, @p1617, @p1618, @p1619, @p1620, @p1621, @p1622, @p1623, 28), (@p1624, @p1625, @p1626, @p1627, @p1628, @p1629, @p1630, @p1631, @p1632, @p1633, @p1634, @p1635, @p1636, @p1637, @p1638, @p1639, @p1640, @p1641, @p1642, @p1643, @p1644, @p1645, @p1646, @p1647, @p1648, @p1649, @p1650, @p1651, @p1652, @p1653, @p1654, @p1655, @p1656, @p1657, @p1658, @p1659, @p1660, @p1661, @p1662, @p1663, @p1664, @p1665, @p1666, @p1667, @p1668, @p1669, @p1670, @p1671, @p1672, @p1673, @p1674, @p1675, @p1676, @p1677, @p1678, @p1679, 29), (@p1680, @p1681, @p1682, @p1683, @p1684, @p1685, @p1686, @p1687, @p1688, @p1689, @p1690, @p1691, @p1692, @p1693, @p1694, @p1695, @p1696, @p1697, @p1698, @p1699, @p1700, @p1701, @p1702, @p1703, @p1704, @p1705, @p1706, @p1707, @p1708, @p1709, @p1710, @p1711, @p1712, @p1713, @p1714, @p1715, @p1716, @p1717, @p1718, @p1719, @p1720, @p1721, @p1722, @p1723, @p1724, @p1725, @p1726, @p1727, @p1728, @p1729, @p1730, @p1731, @p1732, @p1733, @p1734, @p1735, 30), (@p1736, @p1737, @p1738, @p1739, @p1740, @p1741, @p1742, @p1743, @p1744, @p1745, @p1746, @p1747, @p1748, @p1749, @p1750, @p1751, @p1752, @p1753, @p1754, @p1755, @p1756, @p1757, @p1758, @p1759, @p1760, @p1761, @p1762, @p1763, @p1764, @p1765, @p1766, @p1767, @p1768, @p1769, @p1770, @p1771, @p1772, @p1773, @p1774, @p1775, @p1776, @p1777, @p1778, @p1779, @p1780, @p1781, @p1782, @p1783, @p1784, @p1785, @p1786, @p1787, @p1788, @p1789, @p1790, @p1791, 31), (@p1792, @p1793, @p1794, @p1795, @p1796, @p1797, @p1798, @p1799, @p1800, @p1801, @p1802, @p1803, @p1804, @p1805, @p1806, @p1807, @p1808, @p1809, @p1810, @p1811, @p1812, @p1813, @p1814, @p1815, @p1816, @p1817, @p1818, @p1819, @p1820, @p1821, @p1822, @p1823, @p1824, @p1825, @p1826, @p1827, @p1828, @p1829, @p1830, @p1831, @p1832, @p1833, @p1834, @p1835, @p1836, @p1837, @p1838, @p1839, @p1840, @p1841, @p1842, @p1843, @p1844, @p1845, @p1846, @p1847, 32), (@p1848, @p1849, @p1850, @p1851, @p1852, @p1853, @p1854, @p1855, @p1856, @p1857, @p1858, @p1859, @p1860, @p1861, @p1862, @p1863, @p1864, @p1865, @p1866, @p1867, @p1868, @p1869, @p1870, @p1871, @p1872, @p1873, @p1874, @p1875, @p1876, @p1877, @p1878, @p1879, @p1880, @p1881, @p1882, @p1883, @p1884, @p1885, @p1886, @p1887, @p1888, @p1889, @p1890, @p1891, @p1892, @p1893, @p1894, @p1895, @p1896, @p1897, @p1898, @p1899, @p1900, @p1901, @p1902, @p1903, 33), (@p1904, @p1905, @p1906, @p1907, @p1908, @p1909, @p1910, @p1911, @p1912, @p1913, @p1914, @p1915, @p1916, @p1917, @p1918, @p1919, @p1920, @p1921, @p1922, @p1923, @p1924, @p1925, @p1926, @p1927, @p1928, @p1929, @p1930, @p1931, @p1932, @p1933, @p1934, @p1935, @p1936, @p1937, @p1938, @p1939, @p1940, @p1941, @p1942, @p1943, @p1944, @p1945, @p1946, @p1947, @p1948, @p1949, @p1950, @p1951, @p1952, @p1953, @p1954, @p1955, @p1956, @p1957, @p1958, @p1959, 34), (@p1960, @p1961, @p1962, @p1963, @p1964, @p1965, @p1966, @p1967, @p1968, @p1969, @p1970, @p1971, @p1972, @p1973, @p1974, @p1975, @p1976, @p1977, @p1978, @p1979, @p1980, @p1981, @p1982, @p1983, @p1984, @p1985, @p1986, @p1987, @p1988, @p1989, @p1990, @p1991, @p1992, @p1993, @p1994, @p1995, @p1996, @p1997, @p1998, @p1999, @p2000, @p2001, @p2002, @p2003, @p2004, @p2005, @p2006, @p2007, @p2008, @p2009, @p2010, @p2011, @p2012, @p2013, @p2014, @p2015, 35), (@p2016, @p2017, @p2018, @p2019, @p2020, @p2021, @p2022, @p2023, @p2024, @p2025, @p2026, @p2027, @p2028, @p2029, @p2030, @p2031, @p2032, @p2033, @p2034, @p2035, @p2036, @p2037, @p2038, @p2039, @p2040, @p2041, @p2042, @p2043, @p2044, @p2045, @p2046, @p2047, @p2048, @p2049, @p2050, @p2051, @p2052, @p2053, @p2054, @p2055, @p2056, @p2057, @p2058, @p2059, @p2060, @p2061, @p2062, @p2063, @p2064, @p2065, @p2066, @p2067, @p2068, @p2069, @p2070, @p2071, 36)) AS i ([addressee_cntry_cd], [addressee_city], [addressee_district], [addressee_email], [addressee_full_address], [addressee_home_address], [addressee_name], [addressee_postcode], [addressee_province], [addressee_subdistrict], [addressee_tel], [create_table], [delivery_code], [delivery_recipient_name], [delivery_relation_id], [delivery_status_id], [dest_outlet_id], [dest_outlet_port], [document_number], [item_barcode], [item_cod], [item_gross_weight], [item_height], [item_length], [item_price], [item_width], [lat], [log_id], [long], [outlet_id], [outlet_port], [podUrl], [remark], [scan_cntry_cd], [scan_cntry_postcode], [sender_cntry_cd], [sender_district], [sender_email], [sender_full_address], [sender_home_address], [member_id], [sender_name], [sender_postcode], [sender_province], [sender_subdistrict], [sender_tel], [server_id], [signatureUrl], [state], [status_code], [status_dtm], [timestamp], [transmit_dtm], [user_id], [wckt_id], [wkstn_no], _Position) ON 1=0 WHEN NOT MATCHED THEN INSERT ([addressee_cntry_cd], [addressee_city], [addressee_district], [addressee_email], [addressee_full_address], [addressee_home_address], [addressee_name], [addressee_postcode], [addressee_province], [addressee_subdistrict], [addressee_tel], [create_table], [delivery_code], [delivery_recipient_name], [delivery_relation_id], [delivery_status_id], [dest_outlet_id], [dest_outlet_port], [document_number], [item_barcode], [item_cod], [item_gross_weight], [item_height], [item_length], [item_price], [item_width], [lat], [log_id], [long], [outlet_id], [outlet_port], [podUrl], [remark], [scan_cntry_cd], [scan_cntry_postcode], [sender_cntry_cd], [sender_district], [sender_email], [sender_full_address], [sender_home_address], [member_id], [sender_name], [sender_postcode], [sender_province], [sender_subdistrict], [sender_tel], [server_id], [signatureUrl], [state], [status_code], [status_dtm], [timestamp], [transmit_dtm], [user_id], [wckt_id], [wkstn_no]) VALUES (i.[addressee_cntry_cd], i.[addressee_city], i.[addressee_district], i.[addressee_email], i.[addressee_full_address], i.[addressee_home_address], i.[addressee_name], i.[addressee_postcode], i.[addressee_province], i.[addressee_subdistrict], i.[addressee_tel], i.[create_table], i.[delivery_code], i.[delivery_recipient_name], i.[delivery_relation_id], i.[delivery_status_id], i.[dest_outlet_id], i.[dest_outlet_port], i.[document_number], i.[item_barcode], i.[item_cod], i.[item_gross_weight], i.[item_height], i.[item_length], i.[item_price], i.[item_width], i.[lat], i.[log_id], i.[long], i.[outlet_id], i.[outlet_port], i.[podUrl], i.[remark], i.[scan_cntry_cd], i.[scan_cntry_postcode], i.[sender_cntry_cd], i.[sender_district], i.[sender_email], i.[sender_full_address], i.[sender_home_address], i.[member_id], i.[sender_name], i.[sender_postcode], i.[sender_province], i.[sender_subdistrict], i.[sender_tel], i.[server_id], i.[signatureUrl], i.[state], i.[status_code], i.[status_dtm], i.[timestamp], i.[transmit_dtm], i.[user_id], i.[wckt_id], i.[wkstn_no]) OUTPUT INSERTED.[item_id], i._Position INTO @inserted0;  SELECT [t].[item_id] FROM [raw_data] t INNER JOIN @inserted0 i ON ([t].[item_id] = [i].[item_id]) ORDER BY [i].[_Position];  ",4,4,0,440,7,4
"(@p0 nvarchar(4000),@p1 nvarchar(4000),@p2 nvarchar(4000),@p3 nvarchar(4000),@p4 nvarchar(4000),@p5 nvarchar(4000),@p6 nvarchar(4000),@p7 nvarchar(4000),@p8 nvarchar(4000),@p9 nvarchar(4000),@p10 nvarchar(4000),@p11 datetime2(7),@p12 nvarchar(4000),@p13 nvarchar(4000),@p14 int,@p15 int,@p16 int,@p17 nvarchar(4000),@p18 nvarchar(4000),@p19 nvarchar(4000),@p20 nvarchar(4000),@p21 decimal(18,2),@p22 nvarchar(4000),@p23 nvarchar(4000),@p24 decimal(18,2),@p25 nvarchar(4000),@p26 nvarchar(4000),@p27 nvarchar(4000),@p28 nvarchar(4000),@p29 int,@p30 nvarchar(4000),@p31 nvarchar(4000),@p32 nvarchar(4000),@p33 nvarchar(4000),@p34 nvarchar(4000),@p35 nvarchar(4000),@p36 nvarchar(4000),@p37 nvarchar(4000),@p38 nvarchar(4000),@p39 nvarchar(4000),@p40 int,@p41 nvarchar(4000),@p42 nvarchar(4000),@p43 nvarchar(4000),@p44 nvarchar(4000),@p45 nvarchar(4000),@p46 int,@p47 nvarchar(4000),@p48 int,@p49 int,@p50 datetime2(7),@p51 datetime2(7),@p52 datetime2(7),@p53 nvarchar(4000),@p54 nvarchar(4000),@p55 nvarchar(4000),@p56 nvarchar(4000),@p57 nvarchar(4000),@p58 nvarchar(4000),@p59 nvarchar(4000),@p60 nvarchar(4000),@p61 nvarchar(4000),@p62 nvarchar(4000),@p63 nvarchar(4000),@p64 nvarchar(4000),@p65 nvarchar(4000),@p66 nvarchar(4000),@p67 datetime2(7),@p68 nvarchar(4000),@p69 nvarchar(4000),@p70 int,@p71 int,@p72 int,@p73 nvarchar(4000),@p74 nvarchar(4000),@p75 nvarchar(4000),@p76 nvarchar(4000),@p77 decimal(18,2),@p78 nvarchar(4000),@p79 nvarchar(4000),@p80 decimal(18,2),@p81 nvarchar(4000),@p82 nvarchar(4000),@p83 nvarchar(4000),@p84 nvarchar(4000),@p85 int,@p86 nvarchar(4000),@p87 nvarchar(4000),@p88 nvarchar(4000),@p89 nvarchar(4000),@p90 nvarchar(4000),@p91 nvarchar(4000),@p92 nvarchar(4000),@p93 nvarchar(4000),@p94 nvarchar(4000),@p95 nvarchar(4000),@p96 int,@p97 nvarchar(4000),@p98 nvarchar(4000),@p99 nvarchar(4000),@p100 nvarchar(4000),@p101 nvarchar(4000),@p102 int,@p103 nvarchar(4000),@p104 int,@p105 int,@p106 datetime2(7),@p107 datetime2(7),@p108 datetime2(7),@p109 nvarchar(4000),@p110 nvarchar(4000),@p111 nvarchar(4000),@p112 nvarchar(4000),@p113 nvarchar(4000),@p114 nvarchar(4000),@p115 nvarchar(4000),@p116 nvarchar(4000),@p117 nvarchar(4000),@p118 nvarchar(4000),@p119 nvarchar(4000),@p120 nvarchar(4000),@p121 nvarchar(4000),@p122 nvarchar(4000),@p123 datetime2(7),@p124 nvarchar(4000),@p125 nvarchar(4000),@p126 int,@p127 int,@p128 int,@p129 nvarchar(4000),@p130 nvarchar(4000),@p131 nvarchar(4000),@p132 nvarchar(4000),@p133 decimal(18,2),@p134 nvarchar(4000),@p135 nvarchar(4000),@p136 decimal(18,2),@p137 nvarchar(4000),@p138 nvarchar(4000),@p139 nvarchar(4000),@p140 nvarchar(4000),@p141 int,@p142 nvarchar(4000),@p143 nvarchar(4000),@p144 nvarchar(4000),@p145 nvarchar(4000),@p146 nvarchar(4000),@p147 nvarchar(4000),@p148 nvarchar(4000),@p149 nvarchar(4000),@p150 nvarchar(4000),@p151 nvarchar(4000),@p152 int,@p153 nvarchar(4000),@p154 nvarchar(4000),@p155 nvarchar(4000),@p156 nvarchar(4000),@p157 nvarchar(4000),@p158 int,@p159 nvarchar(4000),@p160 int,@p161 int,@p162 datetime2(7),@p163 datetime2(7),@p164 datetime2(7),@p165 nvarchar(4000),@p166 nvarchar(4000),@p167 nvarchar(4000),@p168 nvarchar(4000),@p169 nvarchar(4000),@p170 nvarchar(4000),@p171 nvarchar(4000),@p172 nvarchar(4000),@p173 nvarchar(4000),@p174 nvarchar(4000),@p175 nvarchar(4000),@p176 nvarchar(4000),@p177 nvarchar(4000),@p178 nvarchar(4000),@p179 datetime2(7),@p180 nvarchar(4000),@p181 nvarchar(4000),@p182 int,@p183 int,@p184 int,@p185 nvarchar(4000),@p186 nvarchar(4000),@p187 nvarchar(4000),@p188 nvarchar(4000),@p189 decimal(18,2),@p190 nvarchar(4000),@p191 nvarchar(4000),@p192 decimal(18,2),@p193 nvarchar(4000),@p194 nvarchar(4000),@p195 nvarchar(4000),@p196 nvarchar(4000),@p197 int,@p198 nvarchar(4000),@p199 nvarchar(4000),@p200 nvarchar(4000),@p201 nvarchar(4000),@p202 nvarchar(4000),@p203 nvarchar(4000),@p204 nvarchar(4000),@p205 nvarchar(4000),@p206 nvarchar(4000),@p207 nvarchar(4000),@p208 int,@p209 nvarchar(4000),@p210 nvarchar(4000),@p211 nvarchar(4000),@p212 nvarchar(4000),@p213 nvarchar(4000),@p214 int,@p215 nvarchar(4000),@p216 int,@p217 int,@p218 datetime2(7),@p219 datetime2(7),@p220 datetime2(7),@p221 nvarchar(4000),@p222 nvarchar(4000),@p223 nvarchar(4000),@p224 nvarchar(4000),@p225 nvarchar(4000),@p226 nvarchar(4000),@p227 nvarchar(4000),@p228 nvarchar(4000),@p229 nvarchar(4000),@p230 nvarchar(4000),@p231 nvarchar(4000),@p232 nvarchar(4000),@p233 nvarchar(4000),@p234 nvarchar(4000),@p235 datetime2(7),@p236 nvarchar(4000),@p237 nvarchar(4000),@p238 int,@p239 int,@p240 int,@p241 nvarchar(4000),@p242 nvarchar(4000),@p243 nvarchar(4000),@p244 nvarchar(4000),@p245 decimal(18,2),@p246 nvarchar(4000),@p247 nvarchar(4000),@p248 decimal(18,2),@p249 nvarchar(4000),@p250 nvarchar(4000),@p251 nvarchar(4000),@p252 nvarchar(4000),@p253 int,@p254 nvarchar(4000),@p255 nvarchar(4000),@p256 nvarchar(4000),@p257 nvarchar(4000),@p258 nvarchar(4000),@p259 nvarchar(4000),@p260 nvarchar(4000),@p261 nvarchar(4000),@p262 nvarchar(4000),@p263 nvarchar(4000),@p264 int,@p265 nvarchar(4000),@p266 nvarchar(4000),@p267 nvarchar(4000),@p268 nvarchar(4000),@p269 nvarchar(4000),@p270 int,@p271 nvarchar(4000),@p272 int,@p273 int,@p274 datetime2(7),@p275 datetime2(7),@p276 datetime2(7),@p277 nvarchar(4000),@p278 nvarchar(4000),@p279 nvarchar(4000),@p280 nvarchar(4000),@p281 nvarchar(4000),@p282 nvarchar(4000),@p283 nvarchar(4000),@p284 nvarchar(4000),@p285 nvarchar(4000),@p286 nvarchar(4000),@p287 nvarchar(4000),@p288 nvarchar(4000),@p289 nvarchar(4000),@p290 nvarchar(4000),@p291 datetime2(7),@p292 nvarchar(4000),@p293 nvarchar(4000),@p294 int,@p295 int,@p296 int,@p297 nvarchar(4000),@p298 nvarchar(4000),@p299 nvarchar(4000),@p300 decimal(18,2),@p301 decimal(18,2),@p302 nvarchar(4000),@p303 nvarchar(4000),@p304 decimal(18,2),@p305 nvarchar(4000),@p306 nvarchar(4000),@p307 nvarchar(4000),@p308 nvarchar(4000),@p309 int,@p310 nvarchar(4000),@p311 nvarchar(4000),@p312 nvarchar(4000),@p313 nvarchar(4000),@p314 nvarchar(4000),@p315 nvarchar(4000),@p316 nvarchar(4000),@p317 nvarchar(4000),@p318 nvarchar(4000),@p319 nvarchar(4000),@p320 int,@p321 nvarchar(4000),@p322 nvarchar(4000),@p323 nvarchar(4000),@p324 nvarchar(4000),@p325 nvarchar(4000),@p326 int,@p327 nvarchar(4000),@p328 int,@p329 int,@p330 datetime2(7),@p331 datetime2(7),@p332 datetime2(7),@p333 nvarchar(4000),@p334 nvarchar(4000),@p335 nvarchar(4000),@p336 nvarchar(4000),@p337 nvarchar(4000),@p338 nvarchar(4000),@p339 nvarchar(4000),@p340 nvarchar(4000),@p341 nvarchar(4000),@p342 nvarchar(4000),@p343 nvarchar(4000),@p344 nvarchar(4000),@p345 nvarchar(4000),@p346 nvarchar(4000),@p347 datetime2(7),@p348 nvarchar(4000),@p349 nvarchar(4000),@p350 int,@p351 int,@p352 int,@p353 nvarchar(4000),@p354 nvarchar(4000),@p355 nvarchar(4000),@p356 nvarchar(4000),@p357 decimal(18,2),@p358 nvarchar(4000),@p359 nvarchar(4000),@p360 decimal(18,2),@p361 nvarchar(4000),@p362 nvarchar(4000),@p363 nvarchar(4000),@p364 nvarchar(4000),@p365 int,@p366 nvarchar(4000),@p367 nvarchar(4000),@p368 nvarchar(4000),@p369 nvarchar(4000),@p370 nvarchar(4000),@p371 nvarchar(4000),@p372 nvarchar(4000),@p373 nvarchar(4000),@p374 nvarchar(4000),@p375 nvarchar(4000),@p376 int,@p377 nvarchar(4000),@p378 nvarchar(4000),@p379 nvarchar(4000),@p380 nvarchar(4000),@p381 nvarchar(4000),@p382 int,@p383 nvarchar(4000),@p384 int,@p385 int,@p386 datetime2(7),@p387 datetime2(7),@p388 datetime2(7),@p389 nvarchar(4000),@p390 nvarchar(4000),@p391 nvarchar(4000),@p392 nvarchar(4000),@p393 nvarchar(4000),@p394 nvarchar(4000),@p395 nvarchar(4000),@p396 nvarchar(4000),@p397 nvarchar(4000),@p398 nvarchar(4000),@p399 nvarchar(4000),@p400 nvarchar(4000),@p401 nvarchar(4000),@p402 nvarchar(4000),@p403 datetime2(7),@p404 nvarchar(4000),@p405 nvarchar(4000),@p406 int,@p407 int,@p408 int,@p409 nvarchar(4000),@p410 nvarchar(4000),@p411 nvarchar(4000),@p412 nvarchar(4000),@p413 decimal(18,2),@p414 nvarchar(4000),@p415 nvarchar(4000),@p416 decimal(18,2),@p417 nvarchar(4000),@p418 nvarchar(4000),@p419 nvarchar(4000),@p420 nvarchar(4000),@p421 int,@p422 nvarchar(4000),@p423 nvarchar(4000),@p424 nvarchar(4000),@p425 nvarchar(4000),@p426 nvarchar(4000),@p427 nvarchar(4000),@p428 nvarchar(4000),@p429 nvarchar(4000),@p430 nvarchar(4000),@p431 nvarchar(4000),@p432 int,@p433 nvarchar(4000),@p434 nvarchar(4000),@p435 nvarchar(4000),@p436 nvarchar(4000),@p437 nvarchar(4000),@p438 int,@p439 nvarchar(4000),@p440 int,@p441 int,@p442 datetime2(7),@p443 datetime2(7),@p444 datetime2(7),@p445 nvarchar(4000),@p446 nvarchar(4000),@p447 nvarchar(4000),@p448 nvarchar(4000),@p449 nvarchar(4000),@p450 nvarchar(4000),@p451 nvarchar(4000),@p452 nvarchar(4000),@p453 nvarchar(4000),@p454 nvarchar(4000),@p455 nvarchar(4000),@p456 nvarchar(4000),@p457 nvarchar(4000),@p458 nvarchar(4000),@p459 datetime2(7),@p460 nvarchar(4000),@p461 nvarchar(4000),@p462 int,@p463 int,@p464 int,@p465 nvarchar(4000),@p466 nvarchar(4000),@p467 nvarchar(4000),@p468 nvarchar(4000),@p469 decimal(18,2),@p470 nvarchar(4000),@p471 nvarchar(4000),@p472 decimal(18,2),@p473 nvarchar(4000),@p474 nvarchar(4000),@p475 nvarchar(4000),@p476 nvarchar(4000),@p477 int,@p478 nvarchar(4000),@p479 nvarchar(4000),@p480 nvarchar(4000),@p481 nvarchar(4000),@p482 nvarchar(4000),@p483 nvarchar(4000),@p484 nvarchar(4000),@p485 nvarchar(4000),@p486 nvarchar(4000),@p487 nvarchar(4000),@p488 int,@p489 nvarchar(4000),@p490 nvarchar(4000),@p491 nvarchar(4000),@p492 nvarchar(4000),@p493 nvarchar(4000),@p494 int,@p495 nvarchar(4000),@p496 int,@p497 int,@p498 datetime2(7),@p499 datetime2(7),@p500 datetime2(7),@p501 nvarchar(4000),@p502 nvarchar(4000),@p503 nvarchar(4000),@p504 nvarchar(4000),@p505 nvarchar(4000),@p506 nvarchar(4000),@p507 nvarchar(4000),@p508 nvarchar(4000),@p509 nvarchar(4000),@p510 nvarchar(4000),@p511 nvarchar(4000),@p512 nvarchar(4000),@p513 nvarchar(4000),@p514 nvarchar(4000),@p515 datetime2(7),@p516 nvarchar(4000),@p517 nvarchar(4000),@p518 int,@p519 int,@p520 int,@p521 nvarchar(4000),@p522 nvarchar(4000),@p523 nvarchar(4000),@p524 nvarchar(4000),@p525 decimal(18,2),@p526 nvarchar(4000),@p527 nvarchar(4000),@p528 decimal(18,2),@p529 nvarchar(4000),@p530 nvarchar(4000),@p531 nvarchar(4000),@p532 nvarchar(4000),@p533 int,@p534 nvarchar(4000),@p535 nvarchar(4000),@p536 nvarchar(4000),@p537 nvarchar(4000),@p538 nvarchar(4000),@p539 nvarchar(4000),@p540 nvarchar(4000),@p541 nvarchar(4000),@p542 nvarchar(4000),@p543 nvarchar(4000),@p544 int,@p545 nvarchar(4000),@p546 nvarchar(4000),@p547 nvarchar(4000),@p548 nvarchar(4000),@p549 nvarchar(4000),@p550 int,@p551 nvarchar(4000),@p552 int,@p553 int,@p554 datetime2(7),@p555 datetime2(7),@p556 datetime2(7),@p557 nvarchar(4000),@p558 nvarchar(4000),@p559 nvarchar(4000),@p560 nvarchar(4000),@p561 nvarchar(4000),@p562 nvarchar(4000),@p563 nvarchar(4000),@p564 nvarchar(4000),@p565 nvarchar(4000),@p566 nvarchar(4000),@p567 nvarchar(4000),@p568 nvarchar(4000),@p569 nvarchar(4000),@p570 nvarchar(4000),@p571 datetime2(7),@p572 nvarchar(4000),@p573 nvarchar(4000),@p574 int,@p575 int,@p576 int,@p577 nvarchar(4000),@p578 nvarchar(4000),@p579 nvarchar(4000),@p580 nvarchar(4000),@p581 decimal(18,2),@p582 nvarchar(4000),@p583 nvarchar(4000),@p584 decimal(18,2),@p585 nvarchar(4000),@p586 nvarchar(4000),@p587 nvarchar(4000),@p588 nvarchar(4000),@p589 int,@p590 nvarchar(4000),@p591 nvarchar(4000),@p592 nvarchar(4000),@p593 nvarchar(4000),@p594 nvarchar(4000),@p595 nvarchar(4000),@p596 nvarchar(4000),@p597 nvarchar(4000),@p598 nvarchar(4000),@p599 nvarchar(4000),@p600 int,@p601 nvarchar(4000),@p602 nvarchar(4000),@p603 nvarchar(4000),@p604 nvarchar(4000),@p605 nvarchar(4000),@p606 int,@p607 nvarchar(4000),@p608 int,@p609 int,@p610 datetime2(7),@p611 datetime2(7),@p612 datetime2(7),@p613 nvarchar(4000),@p614 nvarchar(4000),@p615 nvarchar(4000),@p616 nvarchar(4000),@p617 nvarchar(4000),@p618 nvarchar(4000),@p619 nvarchar(4000),@p620 nvarchar(4000),@p621 nvarchar(4000),@p622 nvarchar(4000),@p623 nvarchar(4000),@p624 nvarchar(4000),@p625 nvarchar(4000),@p626 nvarchar(4000),@p627 datetime2(7),@p628 nvarchar(4000),@p629 nvarchar(4000),@p630 int,@p631 int,@p632 int,@p633 nvarchar(4000),@p634 nvarchar(4000),@p635 nvarchar(4000),@p636 nvarchar(4000),@p637 decimal(18,2),@p638 nvarchar(4000),@p639 nvarchar(4000),@p640 decimal(18,2),@p641 nvarchar(4000),@p642 nvarchar(4000),@p643 nvarchar(4000),@p644 nvarchar(4000),@p645 int,@p646 nvarchar(4000),@p647 nvarchar(4000),@p648 nvarchar(4000),@p649 nvarchar(4000),@p650 nvarchar(4000),@p651 nvarchar(4000),@p652 nvarchar(4000),@p653 nvarchar(4000),@p654 nvarchar(4000),@p655 nvarchar(4000),@p656 int,@p657 nvarchar(4000),@p658 nvarchar(4000),@p659 nvarchar(4000),@p660 nvarchar(4000),@p661 nvarchar(4000),@p662 int,@p663 nvarchar(4000),@p664 int,@p665 int,@p666 datetime2(7),@p667 datetime2(7),@p668 datetime2(7),@p669 nvarchar(4000),@p670 nvarchar(4000),@p671 nvarchar(4000),@p672 nvarchar(4000),@p673 nvarchar(4000),@p674 nvarchar(4000),@p675 nvarchar(4000),@p676 nvarchar(4000),@p677 nvarchar(4000),@p678 nvarchar(4000),@p679 nvarchar(4000),@p680 nvarchar(4000),@p681 nvarchar(4000),@p682 nvarchar(4000),@p683 datetime2(7),@p684 nvarchar(4000),@p685 nvarchar(4000),@p686 int,@p687 int,@p688 int,@p689 nvarchar(4000),@p690 nvarchar(4000),@p691 nvarchar(4000),@p692 nvarchar(4000),@p693 decimal(18,2),@p694 nvarchar(4000),@p695 nvarchar(4000),@p696 decimal(18,2),@p697 nvarchar(4000),@p698 nvarchar(4000),@p699 nvarchar(4000),@p700 nvarchar(4000),@p701 int,@p702 nvarchar(4000),@p703 nvarchar(4000),@p704 nvarchar(4000),@p705 nvarchar(4000),@p706 nvarchar(4000),@p707 nvarchar(4000),@p708 nvarchar(4000),@p709 nvarchar(4000),@p710 nvarchar(4000),@p711 nvarchar(4000),@p712 int,@p713 nvarchar(4000),@p714 nvarchar(4000),@p715 nvarchar(4000),@p716 nvarchar(4000),@p717 nvarchar(4000),@p718 int,@p719 nvarchar(4000),@p720 int,@p721 int,@p722 datetime2(7),@p723 datetime2(7),@p724 datetime2(7),@p725 nvarchar(4000),@p726 nvarchar(4000),@p727 nvarchar(4000),@p728 nvarchar(4000),@p729 nvarchar(4000),@p730 nvarchar(4000),@p731 nvarchar(4000),@p732 nvarchar(4000),@p733 nvarchar(4000),@p734 nvarchar(4000),@p735 nvarchar(4000),@p736 nvarchar(4000),@p737 nvarchar(4000),@p738 nvarchar(4000),@p739 datetime2(7),@p740 nvarchar(4000),@p741 nvarchar(4000),@p742 int,@p743 int,@p744 int,@p745 nvarchar(4000),@p746 nvarchar(4000),@p747 nvarchar(4000),@p748 decimal(18,2),@p749 decimal(18,2),@p750 nvarchar(4000),@p751 nvarchar(4000),@p752 decimal(18,2),@p753 nvarchar(4000),@p754 nvarchar(4000),@p755 nvarchar(4000),@p756 nvarchar(4000),@p757 int,@p758 nvarchar(4000),@p759 nvarchar(4000),@p760 nvarchar(4000),@p761 nvarchar(4000),@p762 nvarchar(4000),@p763 nvarchar(4000),@p764 nvarchar(4000),@p765 nvarchar(4000),@p766 nvarchar(4000),@p767 nvarchar(4000),@p768 int,@p769 nvarchar(4000),@p770 nvarchar(4000),@p771 nvarchar(4000),@p772 nvarchar(4000),@p773 nvarchar(4000),@p774 int,@p775 nvarchar(4000),@p776 int,@p777 int,@p778 datetime2(7),@p779 datetime2(7),@p780 datetime2(7),@p781 nvarchar(4000),@p782 nvarchar(4000),@p783 nvarchar(4000),@p784 nvarchar(4000),@p785 nvarchar(4000),@p786 nvarchar(4000),@p787 nvarchar(4000),@p788 nvarchar(4000),@p789 nvarchar(4000),@p790 nvarchar(4000),@p791 nvarchar(4000),@p792 nvarchar(4000),@p793 nvarchar(4000),@p794 nvarchar(4000),@p795 datetime2(7),@p796 nvarchar(4000),@p797 nvarchar(4000),@p798 int,@p799 int,@p800 int,@p801 nvarchar(4000),@p802 nvarchar(4000),@p803 nvarchar(4000),@p804 decimal(18,2),@p805 decimal(18,2),@p806 nvarchar(4000),@p807 nvarchar(4000),@p808 decimal(18,2),@p809 nvarchar(4000),@p810 nvarchar(4000),@p811 nvarchar(4000),@p812 nvarchar(4000),@p813 int,@p814 nvarchar(4000),@p815 nvarchar(4000),@p816 nvarchar(4000),@p817 nvarchar(4000),@p818 nvarchar(4000),@p819 nvarchar(4000),@p820 nvarchar(4000),@p821 nvarchar(4000),@p822 nvarchar(4000),@p823 nvarchar(4000),@p824 int,@p825 nvarchar(4000),@p826 nvarchar(4000),@p827 nvarchar(4000),@p828 nvarchar(4000),@p829 nvarchar(4000),@p830 int,@p831 nvarchar(4000),@p832 int,@p833 int,@p834 datetime2(7),@p835 datetime2(7),@p836 datetime2(7),@p837 nvarchar(4000),@p838 nvarchar(4000),@p839 nvarchar(4000),@p840 nvarchar(4000),@p841 nvarchar(4000),@p842 nvarchar(4000),@p843 nvarchar(4000),@p844 nvarchar(4000),@p845 nvarchar(4000),@p846 nvarchar(4000),@p847 nvarchar(4000),@p848 nvarchar(4000),@p849 nvarchar(4000),@p850 nvarchar(4000),@p851 datetime2(7),@p852 nvarchar(4000),@p853 nvarchar(4000),@p854 int,@p855 int,@p856 int,@p857 nvarchar(4000),@p858 nvarchar(4000),@p859 nvarchar(4000),@p860 decimal(18,2),@p861 decimal(18,2),@p862 nvarchar(4000),@p863 nvarchar(4000),@p864 decimal(18,2),@p865 nvarchar(4000),@p866 nvarchar(4000),@p867 nvarchar(4000),@p868 nvarchar(4000),@p869 int,@p870 nvarchar(4000),@p871 nvarchar(4000),@p872 nvarchar(4000),@p873 nvarchar(4000),@p874 nvarchar(4000),@p875 nvarchar(4000),@p876 nvarchar(4000),@p877 nvarchar(4000),@p878 nvarchar(4000),@p879 nvarchar(4000),@p880 int,@p881 nvarchar(4000),@p882 nvarchar(4000),@p883 nvarchar(4000),@p884 nvarchar(4000),@p885 nvarchar(4000),@p886 int,@p887 nvarchar(4000),@p888 int,@p889 int,@p890 datetime2(7),@p891 datetime2(7),@p892 datetime2(7),@p893 nvarchar(4000),@p894 nvarchar(4000),@p895 nvarchar(4000),@p896 nvarchar(4000),@p897 nvarchar(4000),@p898 nvarchar(4000),@p899 nvarchar(4000),@p900 nvarchar(4000),@p901 nvarchar(4000),@p902 nvarchar(4000),@p903 nvarchar(4000),@p904 nvarchar(4000),@p905 nvarchar(4000),@p906 nvarchar(4000),@p907 datetime2(7),@p908 nvarchar(4000),@p909 nvarchar(4000),@p910 int,@p911 int,@p912 int,@p913 nvarchar(4000),@p914 nvarchar(4000),@p915 nvarchar(4000),@p916 decimal(18,2),@p917 decimal(18,2),@p918 nvarchar(4000),@p919 nvarchar(4000),@p920 decimal(18,2),@p921 nvarchar(4000),@p922 nvarchar(4000),@p923 nvarchar(4000),@p924 nvarchar(4000),@p925 int,@p926 nvarchar(4000),@p927 nvarchar(4000),@p928 nvarchar(4000),@p929 nvarchar(4000),@p930 nvarchar(4000),@p931 nvarchar(4000),@p932 nvarchar(4000),@p933 nvarchar(4000),@p934 nvarchar(4000),@p935 nvarchar(4000),@p936 int,@p937 nvarchar(4000),@p938 nvarchar(4000),@p939 nvarchar(4000),@p940 nvarchar(4000),@p941 nvarchar(4000),@p942 int,@p943 nvarchar(4000),@p944 int,@p945 int,@p946 datetime2(7),@p947 datetime2(7),@p948 datetime2(7),@p949 nvarchar(4000),@p950 nvarchar(4000),@p951 nvarchar(4000),@p952 nvarchar(4000),@p953 nvarchar(4000),@p954 nvarchar(4000),@p955 nvarchar(4000),@p956 nvarchar(4000),@p957 nvarchar(4000),@p958 nvarchar(4000),@p959 nvarchar(4000),@p960 nvarchar(4000),@p961 nvarchar(4000),@p962 nvarchar(4000),@p963 datetime2(7),@p964 nvarchar(4000),@p965 nvarchar(4000),@p966 int,@p967 int,@p968 int,@p969 nvarchar(4000),@p970 nvarchar(4000),@p971 nvarchar(4000),@p972 decimal(18,2),@p973 decimal(18,2),@p974 nvarchar(4000),@p975 nvarchar(4000),@p976 decimal(18,2),@p977 nvarchar(4000),@p978 nvarchar(4000),@p979 nvarchar(4000),@p980 nvarchar(4000),@p981 int,@p982 nvarchar(4000),@p983 nvarchar(4000),@p984 nvarchar(4000),@p985 nvarchar(4000),@p986 nvarchar(4000),@p987 nvarchar(4000),@p988 nvarchar(4000),@p989 nvarchar(4000),@p990 nvarchar(4000),@p991 nvarchar(4000),@p992 int,@p993 nvarchar(4000),@p994 nvarchar(4000),@p995 nvarchar(4000),@p996 nvarchar(4000),@p997 nvarchar(4000),@p998 int,@p999 nvarchar(4000),@p1000 int,@p1001 int,@p1002 datetime2(7),@p1003 datetime2(7),@p1004 datetime2(7),@p1005 nvarchar(4000),@p1006 nvarchar(4000),@p1007 nvarchar(4000),@p1008 nvarchar(4000),@p1009 nvarchar(4000),@p1010 nvarchar(4000),@p1011 nvarchar(4000),@p1012 nvarchar(4000),@p1013 nvarchar(4000),@p1014 nvarchar(4000),@p1015 nvarchar(4000),@p1016 nvarchar(4000),@p1017 nvarchar(4000),@p1018 nvarchar(4000),@p1019 datetime2(7),@p1020 nvarchar(4000),@p1021 nvarchar(4000),@p1022 int,@p1023 int,@p1024 int,@p1025 nvarchar(4000),@p1026 nvarchar(4000),@p1027 nvarchar(4000),@p1028 decimal(18,2),@p1029 decimal(18,2),@p1030 nvarchar(4000),@p1031 nvarchar(4000),@p1032 decimal(18,2),@p1033 nvarchar(4000),@p1034 nvarchar(4000),@p1035 nvarchar(4000),@p1036 nvarchar(4000),@p1037 int,@p1038 nvarchar(4000),@p1039 nvarchar(4000),@p1040 nvarchar(4000),@p1041 nvarchar(4000),@p1042 nvarchar(4000),@p1043 nvarchar(4000),@p1044 nvarchar(4000),@p1045 nvarchar(4000),@p1046 nvarchar(4000),@p1047 nvarchar(4000),@p1048 int,@p1049 nvarchar(4000),@p1050 nvarchar(4000),@p1051 nvarchar(4000),@p1052 nvarchar(4000),@p1053 nvarchar(4000),@p1054 int,@p1055 nvarchar(4000),@p1056 int,@p1057 int,@p1058 datetime2(7),@p1059 datetime2(7),@p1060 datetime2(7),@p1061 nvarchar(4000),@p1062 nvarchar(4000),@p1063 nvarchar(4000),@p1064 nvarchar(4000),@p1065 nvarchar(4000),@p1066 nvarchar(4000),@p1067 nvarchar(4000),@p1068 nvarchar(4000),@p1069 nvarchar(4000),@p1070 nvarchar(4000),@p1071 nvarchar(4000),@p1072 nvarchar(4000),@p1073 nvarchar(4000),@p1074 nvarchar(4000),@p1075 datetime2(7),@p1076 nvarchar(4000),@p1077 nvarchar(4000),@p1078 int,@p1079 int,@p1080 int,@p1081 nvarchar(4000),@p1082 nvarchar(4000),@p1083 nvarchar(4000),@p1084 decimal(18,2),@p1085 decimal(18,2),@p1086 nvarchar(4000),@p1087 nvarchar(4000),@p1088 decimal(18,2),@p1089 nvarchar(4000),@p1090 nvarchar(4000),@p1091 nvarchar(4000),@p1092 nvarchar(4000),@p1093 int,@p1094 nvarchar(4000),@p1095 nvarchar(4000),@p1096 nvarchar(4000),@p1097 nvarchar(4000),@p1098 nvarchar(4000),@p1099 nvarchar(4000),@p1100 nvarchar(4000),@p1101 nvarchar(4000),@p1102 nvarchar(4000),@p1103 nvarchar(4000),@p1104 int,@p1105 nvarchar(4000),@p1106 nvarchar(4000),@p1107 nvarchar(4000),@p1108 nvarchar(4000),@p1109 nvarchar(4000),@p1110 int,@p1111 nvarchar(4000),@p1112 int,@p1113 int,@p1114 datetime2(7),@p1115 datetime2(7),@p1116 datetime2(7),@p1117 nvarchar(4000),@p1118 nvarchar(4000),@p1119 nvarchar(4000),@p1120 nvarchar(4000),@p1121 nvarchar(4000),@p1122 nvarchar(4000),@p1123 nvarchar(4000),@p1124 nvarchar(4000),@p1125 nvarchar(4000),@p1126 nvarchar(4000),@p1127 nvarchar(4000),@p1128 nvarchar(4000),@p1129 nvarchar(4000),@p1130 nvarchar(4000),@p1131 datetime2(7),@p1132 nvarchar(4000),@p1133 nvarchar(4000),@p1134 int,@p1135 int,@p1136 int,@p1137 nvarchar(4000),@p1138 nvarchar(4000),@p1139 nvarchar(4000),@p1140 decimal(18,2),@p1141 decimal(18,2),@p1142 nvarchar(4000),@p1143 nvarchar(4000),@p1144 decimal(18,2),@p1145 nvarchar(4000),@p1146 nvarchar(4000),@p1147 nvarchar(4000),@p1148 nvarchar(4000),@p1149 int,@p1150 nvarchar(4000),@p1151 nvarchar(4000),@p1152 nvarchar(4000),@p1153 nvarchar(4000),@p1154 nvarchar(4000),@p1155 nvarchar(4000),@p1156 nvarchar(4000),@p1157 nvarchar(4000),@p1158 nvarchar(4000),@p1159 nvarchar(4000),@p1160 int,@p1161 nvarchar(4000),@p1162 nvarchar(4000),@p1163 nvarchar(4000),@p1164 nvarchar(4000),@p1165 nvarchar(4000),@p1166 int,@p1167 nvarchar(4000),@p1168 int,@p1169 int,@p1170 datetime2(7),@p1171 datetime2(7),@p1172 datetime2(7),@p1173 nvarchar(4000),@p1174 nvarchar(4000),@p1175 nvarchar(4000),@p1176 nvarchar(4000),@p1177 nvarchar(4000),@p1178 nvarchar(4000),@p1179 nvarchar(4000),@p1180 nvarchar(4000),@p1181 nvarchar(4000),@p1182 nvarchar(4000),@p1183 nvarchar(4000),@p1184 nvarchar(4000),@p1185 nvarchar(4000),@p1186 nvarchar(4000),@p1187 datetime2(7),@p1188 nvarchar(4000),@p1189 nvarchar(4000),@p1190 int,@p1191 int,@p1192 int,@p1193 nvarchar(4000),@p1194 nvarchar(4000),@p1195 nvarchar(4000),@p1196 nvarchar(4000),@p1197 decimal(18,2),@p1198 nvarchar(4000),@p1199 nvarchar(4000),@p1200 decimal(18,2),@p1201 nvarchar(4000),@p1202 nvarchar(4000),@p1203 nvarchar(4000),@p1204 nvarchar(4000),@p1205 int,@p1206 nvarchar(4000),@p1207 nvarchar(4000),@p1208 nvarchar(4000),@p1209 nvarchar(4000),@p1210 nvarchar(4000),@p1211 nvarchar(4000),@p1212 nvarchar(4000),@p1213 nvarchar(4000),@p1214 nvarchar(4000),@p1215 nvarchar(4000),@p1216 int,@p1217 nvarchar(4000),@p1218 nvarchar(4000),@p1219 nvarchar(4000),@p1220 nvarchar(4000),@p1221 nvarchar(4000),@p1222 int,@p1223 nvarchar(4000),@p1224 int,@p1225 int,@p1226 datetime2(7),@p1227 datetime2(7),@p1228 datetime2(7),@p1229 nvarchar(4000),@p1230 nvarchar(4000),@p1231 nvarchar(4000),@p1232 nvarchar(4000),@p1233 nvarchar(4000),@p1234 nvarchar(4000),@p1235 nvarchar(4000),@p1236 nvarchar(4000),@p1237 nvarchar(4000),@p1238 nvarchar(4000),@p1239 nvarchar(4000),@p1240 nvarchar(4000),@p1241 nvarchar(4000),@p1242 nvarchar(4000),@p1243 datetime2(7),@p1244 nvarchar(4000),@p1245 nvarchar(4000),@p1246 int,@p1247 int,@p1248 int,@p1249 nvarchar(4000),@p1250 nvarchar(4000),@p1251 nvarchar(4000),@p1252 nvarchar(4000),@p1253 decimal(18,2),@p1254 nvarchar(4000),@p1255 nvarchar(4000),@p1256 decimal(18,2),@p1257 nvarchar(4000),@p1258 nvarchar(4000),@p1259 nvarchar(4000),@p1260 nvarchar(4000),@p1261 int,@p1262 nvarchar(4000),@p1263 nvarchar(4000),@p1264 nvarchar(4000),@p1265 nvarchar(4000),@p1266 nvarchar(4000),@p1267 nvarchar(4000),@p1268 nvarchar(4000),@p1269 nvarchar(4000),@p1270 nvarchar(4000),@p1271 nvarchar(4000),@p1272 int,@p1273 nvarchar(4000),@p1274 nvarchar(4000),@p1275 nvarchar(4000),@p1276 nvarchar(4000),@p1277 nvarchar(4000),@p1278 int,@p1279 nvarchar(4000),@p1280 int,@p1281 int,@p1282 datetime2(7),@p1283 datetime2(7),@p1284 datetime2(7),@p1285 nvarchar(4000),@p1286 nvarchar(4000),@p1287 nvarchar(4000),@p1288 nvarchar(4000),@p1289 nvarchar(4000),@p1290 nvarchar(4000),@p1291 nvarchar(4000),@p1292 nvarchar(4000),@p1293 nvarchar(4000),@p1294 nvarchar(4000),@p1295 nvarchar(4000),@p1296 nvarchar(4000),@p1297 nvarchar(4000),@p1298 nvarchar(4000),@p1299 datetime2(7),@p1300 nvarchar(4000),@p1301 nvarchar(4000),@p1302 int,@p1303 int,@p1304 int,@p1305 nvarchar(4000),@p1306 nvarchar(4000),@p1307 nvarchar(4000),@p1308 nvarchar(4000),@p1309 decimal(18,2),@p1310 nvarchar(4000),@p1311 nvarchar(4000),@p1312 decimal(18,2),@p1313 nvarchar(4000),@p1314 nvarchar(4000),@p1315 nvarchar(4000),@p1316 nvarchar(4000),@p1317 int,@p1318 nvarchar(4000),@p1319 nvarchar(4000),@p1320 nvarchar(4000),@p1321 nvarchar(4000),@p1322 nvarchar(4000),@p1323 nvarchar(4000),@p1324 nvarchar(4000),@p1325 nvarchar(4000),@p1326 nvarchar(4000),@p1327 nvarchar(4000),@p1328 int,@p1329 nvarchar(4000),@p1330 nvarchar(4000),@p1331 nvarchar(4000),@p1332 nvarchar(4000),@p1333 nvarchar(4000),@p1334 int,@p1335 nvarchar(4000),@p1336 int,@p1337 int,@p1338 datetime2(7),@p1339 datetime2(7),@p1340 datetime2(7),@p1341 nvarchar(4000),@p1342 nvarchar(4000),@p1343 nvarchar(4000),@p1344 nvarchar(4000),@p1345 nvarchar(4000),@p1346 nvarchar(4000),@p1347 nvarchar(4000),@p1348 nvarchar(4000),@p1349 nvarchar(4000),@p1350 nvarchar(4000),@p1351 nvarchar(4000),@p1352 nvarchar(4000),@p1353 nvarchar(4000),@p1354 nvarchar(4000),@p1355 datetime2(7),@p1356 nvarchar(4000),@p1357 nvarchar(4000),@p1358 int,@p1359 int,@p1360 int,@p1361 nvarchar(4000),@p1362 nvarchar(4000),@p1363 nvarchar(4000),@p1364 nvarchar(4000),@p1365 decimal(18,2),@p1366 nvarchar(4000),@p1367 nvarchar(4000),@p1368 decimal(18,2),@p1369 nvarchar(4000),@p1370 nvarchar(4000),@p1371 nvarchar(4000),@p1372 nvarchar(4000),@p1373 int,@p1374 nvarchar(4000),@p1375 nvarchar(4000),@p1376 nvarchar(4000),@p1377 nvarchar(4000),@p1378 nvarchar(4000),@p1379 nvarchar(4000),@p1380 nvarchar(4000),@p1381 nvarchar(4000),@p1382 nvarchar(4000),@p1383 nvarchar(4000),@p1384 int,@p1385 nvarchar(4000),@p1386 nvarchar(4000),@p1387 nvarchar(4000),@p1388 nvarchar(4000),@p1389 nvarchar(4000),@p1390 int,@p1391 nvarchar(4000),@p1392 int,@p1393 int,@p1394 datetime2(7),@p1395 datetime2(7),@p1396 datetime2(7),@p1397 nvarchar(4000),@p1398 nvarchar(4000),@p1399 nvarchar(4000),@p1400 nvarchar(4000),@p1401 nvarchar(4000),@p1402 nvarchar(4000),@p1403 nvarchar(4000),@p1404 nvarchar(4000),@p1405 nvarchar(4000),@p1406 nvarchar(4000),@p1407 nvarchar(4000),@p1408 nvarchar(4000),@p1409 nvarchar(4000),@p1410 nvarchar(4000),@p1411 datetime2(7),@p1412 nvarchar(4000),@p1413 nvarchar(4000),@p1414 int,@p1415 int,@p1416 int,@p1417 nvarchar(4000),@p1418 nvarchar(4000),@p1419 nvarchar(4000),@p1420 nvarchar(4000),@p1421 decimal(18,2),@p1422 nvarchar(4000),@p1423 nvarchar(4000),@p1424 decimal(18,2),@p1425 nvarchar(4000),@p1426 nvarchar(4000),@p1427 nvarchar(4000),@p1428 nvarchar(4000),@p1429 int,@p1430 nvarchar(4000),@p1431 nvarchar(4000),@p1432 nvarchar(4000),@p1433 nvarchar(4000),@p1434 nvarchar(4000),@p1435 nvarchar(4000),@p1436 nvarchar(4000),@p1437 nvarchar(4000),@p1438 nvarchar(4000),@p1439 nvarchar(4000),@p1440 int,@p1441 nvarchar(4000),@p1442 nvarchar(4000),@p1443 nvarchar(4000),@p1444 nvarchar(4000),@p1445 nvarchar(4000),@p1446 int,@p1447 nvarchar(4000),@p1448 int,@p1449 int,@p1450 datetime2(7),@p1451 datetime2(7),@p1452 datetime2(7),@p1453 nvarchar(4000),@p1454 nvarchar(4000),@p1455 nvarchar(4000),@p1456 nvarchar(4000),@p1457 nvarchar(4000),@p1458 nvarchar(4000),@p1459 nvarchar(4000),@p1460 nvarchar(4000),@p1461 nvarchar(4000),@p1462 nvarchar(4000),@p1463 nvarchar(4000),@p1464 nvarchar(4000),@p1465 nvarchar(4000),@p1466 nvarchar(4000),@p1467 datetime2(7),@p1468 nvarchar(4000),@p1469 nvarchar(4000),@p1470 int,@p1471 int,@p1472 int,@p1473 nvarchar(4000),@p1474 nvarchar(4000),@p1475 nvarchar(4000),@p1476 nvarchar(4000),@p1477 decimal(18,2),@p1478 nvarchar(4000),@p1479 nvarchar(4000),@p1480 decimal(18,2),@p1481 nvarchar(4000),@p1482 nvarchar(4000),@p1483 nvarchar(4000),@p1484 nvarchar(4000),@p1485 int,@p1486 nvarchar(4000),@p1487 nvarchar(4000),@p1488 nvarchar(4000),@p1489 nvarchar(4000),@p1490 nvarchar(4000),@p1491 nvarchar(4000),@p1492 nvarchar(4000),@p1493 nvarchar(4000),@p1494 nvarchar(4000),@p1495 nvarchar(4000),@p1496 int,@p1497 nvarchar(4000),@p1498 nvarchar(4000),@p1499 nvarchar(4000),@p1500 nvarchar(4000),@p1501 nvarchar(4000),@p1502 int,@p1503 nvarchar(4000),@p1504 int,@p1505 int,@p1506 datetime2(7),@p1507 datetime2(7),@p1508 datetime2(7),@p1509 nvarchar(4000),@p1510 nvarchar(4000),@p1511 nvarchar(4000),@p1512 nvarchar(4000),@p1513 nvarchar(4000),@p1514 nvarchar(4000),@p1515 nvarchar(4000),@p1516 nvarchar(4000),@p1517 nvarchar(4000),@p1518 nvarchar(4000),@p1519 nvarchar(4000),@p1520 nvarchar(4000),@p1521 nvarchar(4000),@p1522 nvarchar(4000),@p1523 datetime2(7),@p1524 nvarchar(4000),@p1525 nvarchar(4000),@p1526 int,@p1527 int,@p1528 int,@p1529 nvarchar(4000),@p1530 nvarchar(4000),@p1531 nvarchar(4000),@p1532 nvarchar(4000),@p1533 decimal(18,2),@p1534 nvarchar(4000),@p1535 nvarchar(4000),@p1536 decimal(18,2),@p1537 nvarchar(4000),@p1538 nvarchar(4000),@p1539 nvarchar(4000),@p1540 nvarchar(4000),@p1541 int,@p1542 nvarchar(4000),@p1543 nvarchar(4000),@p1544 nvarchar(4000),@p1545 nvarchar(4000),@p1546 nvarchar(4000),@p1547 nvarchar(4000),@p1548 nvarchar(4000),@p1549 nvarchar(4000),@p1550 nvarchar(4000),@p1551 nvarchar(4000),@p1552 int,@p1553 nvarchar(4000),@p1554 nvarchar(4000),@p1555 nvarchar(4000),@p1556 nvarchar(4000),@p1557 nvarchar(4000),@p1558 int,@p1559 nvarchar(4000),@p1560 int,@p1561 int,@p1562 datetime2(7),@p1563 datetime2(7),@p1564 datetime2(7),@p1565 nvarchar(4000),@p1566 nvarchar(4000),@p1567 nvarchar(4000),@p1568 nvarchar(4000),@p1569 nvarchar(4000),@p1570 nvarchar(4000),@p1571 nvarchar(4000),@p1572 nvarchar(4000),@p1573 nvarchar(4000),@p1574 nvarchar(4000),@p1575 nvarchar(4000),@p1576 nvarchar(4000),@p1577 nvarchar(4000),@p1578 nvarchar(4000),@p1579 datetime2(7),@p1580 nvarchar(4000),@p1581 nvarchar(4000),@p1582 int,@p1583 int,@p1584 int,@p1585 nvarchar(4000),@p1586 nvarchar(4000),@p1587 nvarchar(4000),@p1588 nvarchar(4000),@p1589 decimal(18,2),@p1590 nvarchar(4000),@p1591 nvarchar(4000),@p1592 decimal(18,2),@p1593 nvarchar(4000),@p1594 nvarchar(4000),@p1595 nvarchar(4000),@p1596 nvarchar(4000),@p1597 int,@p1598 nvarchar(4000),@p1599 nvarchar(4000),@p1600 nvarchar(4000),@p1601 nvarchar(4000),@p1602 nvarchar(4000),@p1603 nvarchar(4000),@p1604 nvarchar(4000),@p1605 nvarchar(4000),@p1606 nvarchar(4000),@p1607 nvarchar(4000),@p1608 int,@p1609 nvarchar(4000),@p1610 nvarchar(4000),@p1611 nvarchar(4000),@p1612 nvarchar(4000),@p1613 nvarchar(4000),@p1614 int,@p1615 nvarchar(4000),@p1616 int,@p1617 int,@p1618 datetime2(7),@p1619 datetime2(7),@p1620 datetime2(7),@p1621 nvarchar(4000),@p1622 nvarchar(4000),@p1623 nvarchar(4000),@p1624 nvarchar(4000),@p1625 nvarchar(4000),@p1626 nvarchar(4000),@p1627 nvarchar(4000),@p1628 nvarchar(4000),@p1629 nvarchar(4000),@p1630 nvarchar(4000),@p1631 nvarchar(4000),@p1632 nvarchar(4000),@p1633 nvarchar(4000),@p1634 nvarchar(4000),@p1635 datetime2(7),@p1636 nvarchar(4000),@p1637 nvarchar(4000),@p1638 int,@p1639 int,@p1640 int,@p1641 nvarchar(4000),@p1642 nvarchar(4000),@p1643 nvarchar(4000),@p1644 nvarchar(4000),@p1645 decimal(18,2),@p1646 nvarchar(4000),@p1647 nvarchar(4000),@p1648 decimal(18,2),@p1649 nvarchar(4000),@p1650 nvarchar(4000),@p1651 nvarchar(4000),@p1652 nvarchar(4000),@p1653 int,@p1654 nvarchar(4000),@p1655 nvarchar(4000),@p1656 nvarchar(4000),@p1657 nvarchar(4000),@p1658 nvarchar(4000),@p1659 nvarchar(4000),@p1660 nvarchar(4000),@p1661 nvarchar(4000),@p1662 nvarchar(4000),@p1663 nvarchar(4000),@p1664 int,@p1665 nvarchar(4000),@p1666 nvarchar(4000),@p1667 nvarchar(4000),@p1668 nvarchar(4000),@p1669 nvarchar(4000),@p1670 int,@p1671 nvarchar(4000),@p1672 int,@p1673 int,@p1674 datetime2(7),@p1675 datetime2(7),@p1676 datetime2(7),@p1677 nvarchar(4000),@p1678 nvarchar(4000),@p1679 nvarchar(4000),@p1680 nvarchar(4000),@p1681 nvarchar(4000),@p1682 nvarchar(4000),@p1683 nvarchar(4000),@p1684 nvarchar(4000),@p1685 nvarchar(4000),@p1686 nvarchar(4000),@p1687 nvarchar(4000),@p1688 nvarchar(4000),@p1689 nvarchar(4000),@p1690 nvarchar(4000),@p1691 datetime2(7),@p1692 nvarchar(4000),@p1693 nvarchar(4000),@p1694 int,@p1695 int,@p1696 int,@p1697 nvarchar(4000),@p1698 nvarchar(4000),@p1699 nvarchar(4000),@p1700 nvarchar(4000),@p1701 decimal(18,2),@p1702 nvarchar(4000),@p1703 nvarchar(4000),@p1704 decimal(18,2),@p1705 nvarchar(4000),@p1706 nvarchar(4000),@p1707 nvarchar(4000),@p1708 nvarchar(4000),@p1709 int,@p1710 nvarchar(4000),@p1711 nvarchar(4000),@p1712 nvarchar(4000),@p1713 nvarchar(4000),@p1714 nvarchar(4000),@p1715 nvarchar(4000),@p1716 nvarchar(4000),@p1717 nvarchar(4000),@p1718 nvarchar(4000),@p1719 nvarchar(4000),@p1720 int,@p1721 nvarchar(4000),@p1722 nvarchar(4000),@p1723 nvarchar(4000),@p1724 nvarchar(4000),@p1725 nvarchar(4000),@p1726 int,@p1727 nvarchar(4000),@p1728 int,@p1729 int,@p1730 datetime2(7),@p1731 datetime2(7),@p1732 datetime2(7),@p1733 nvarchar(4000),@p1734 nvarchar(4000),@p1735 nvarchar(4000),@p1736 nvarchar(4000),@p1737 nvarchar(4000),@p1738 nvarchar(4000),@p1739 nvarchar(4000),@p1740 nvarchar(4000),@p1741 nvarchar(4000),@p1742 nvarchar(4000),@p1743 nvarchar(4000),@p1744 nvarchar(4000),@p1745 nvarchar(4000),@p1746 nvarchar(4000),@p1747 datetime2(7),@p1748 nvarchar(4000),@p1749 nvarchar(4000),@p1750 int,@p1751 int,@p1752 int,@p1753 nvarchar(4000),@p1754 nvarchar(4000),@p1755 nvarchar(4000),@p1756 nvarchar(4000),@p1757 decimal(18,2),@p1758 nvarchar(4000),@p1759 nvarchar(4000),@p1760 decimal(18,2),@p1761 nvarchar(4000),@p1762 nvarchar(4000),@p1763 nvarchar(4000),@p1764 nvarchar(4000),@p1765 int,@p1766 nvarchar(4000),@p1767 nvarchar(4000),@p1768 nvarchar(4000),@p1769 nvarchar(4000),@p1770 nvarchar(4000),@p1771 nvarchar(4000),@p1772 nvarchar(4000),@p1773 nvarchar(4000),@p1774 nvarchar(4000),@p1775 nvarchar(4000),@p1776 int,@p1777 nvarchar(4000),@p1778 nvarchar(4000),@p1779 nvarchar(4000),@p1780 nvarchar(4000),@p1781 nvarchar(4000),@p1782 int,@p1783 nvarchar(4000),@p1784 int,@p1785 int,@p1786 datetime2(7),@p1787 datetime2(7),@p1788 datetime2(7),@p1789 nvarchar(4000),@p1790 nvarchar(4000),@p1791 nvarchar(4000),@p1792 nvarchar(4000),@p1793 nvarchar(4000),@p1794 nvarchar(4000),@p1795 nvarchar(4000),@p1796 nvarchar(4000),@p1797 nvarchar(4000),@p1798 nvarchar(4000),@p1799 nvarchar(4000),@p1800 nvarchar(4000),@p1801 nvarchar(4000),@p1802 nvarchar(4000),@p1803 datetime2(7),@p1804 nvarchar(4000),@p1805 nvarchar(4000),@p1806 int,@p1807 int,@p1808 int,@p1809 nvarchar(4000),@p1810 nvarchar(4000),@p1811 nvarchar(4000),@p1812 nvarchar(4000),@p1813 decimal(18,2),@p1814 nvarchar(4000),@p1815 nvarchar(4000),@p1816 decimal(18,2),@p1817 nvarchar(4000),@p1818 nvarchar(4000),@p1819 nvarchar(4000),@p1820 nvarchar(4000),@p1821 int,@p1822 nvarchar(4000),@p1823 nvarchar(4000),@p1824 nvarchar(4000),@p1825 nvarchar(4000),@p1826 nvarchar(4000),@p1827 nvarchar(4000),@p1828 nvarchar(4000),@p1829 nvarchar(4000),@p1830 nvarchar(4000),@p1831 nvarchar(4000),@p1832 int,@p1833 nvarchar(4000),@p1834 nvarchar(4000),@p1835 nvarchar(4000),@p1836 nvarchar(4000),@p1837 nvarchar(4000),@p1838 int,@p1839 nvarchar(4000),@p1840 int,@p1841 int,@p1842 datetime2(7),@p1843 datetime2(7),@p1844 datetime2(7),@p1845 nvarchar(4000),@p1846 nvarchar(4000),@p1847 nvarchar(4000),@p1848 nvarchar(4000),@p1849 nvarchar(4000),@p1850 nvarchar(4000),@p1851 nvarchar(4000),@p1852 nvarchar(4000),@p1853 nvarchar(4000),@p1854 nvarchar(4000),@p1855 nvarchar(4000),@p1856 nvarchar(4000),@p1857 nvarchar(4000),@p1858 nvarchar(4000),@p1859 datetime2(7),@p1860 nvarchar(4000),@p1861 nvarchar(4000),@p1862 int,@p1863 int,@p1864 int,@p1865 nvarchar(4000),@p1866 nvarchar(4000),@p1867 nvarchar(4000),@p1868 nvarchar(4000),@p1869 decimal(18,2),@p1870 nvarchar(4000),@p1871 nvarchar(4000),@p1872 decimal(18,2),@p1873 nvarchar(4000),@p1874 nvarchar(4000),@p1875 nvarchar(4000),@p1876 nvarchar(4000),@p1877 int,@p1878 nvarchar(4000),@p1879 nvarchar(4000),@p1880 nvarchar(4000),@p1881 nvarchar(4000),@p1882 nvarchar(4000),@p1883 nvarchar(4000),@p1884 nvarchar(4000),@p1885 nvarchar(4000),@p1886 nvarchar(4000),@p1887 nvarchar(4000),@p1888 int,@p1889 nvarchar(4000),@p1890 nvarchar(4000),@p1891 nvarchar(4000),@p1892 nvarchar(4000),@p1893 nvarchar(4000),@p1894 int,@p1895 nvarchar(4000),@p1896 int,@p1897 int,@p1898 datetime2(7),@p1899 datetime2(7),@p1900 datetime2(7),@p1901 nvarchar(4000),@p1902 nvarchar(4000),@p1903 nvarchar(4000),@p1904 nvarchar(4000),@p1905 nvarchar(4000),@p1906 nvarchar(4000),@p1907 nvarchar(4000),@p1908 nvarchar(4000),@p1909 nvarchar(4000),@p1910 nvarchar(4000),@p1911 nvarchar(4000),@p1912 nvarchar(4000),@p1913 nvarchar(4000),@p1914 nvarchar(4000),@p1915 datetime2(7),@p1916 nvarchar(4000),@p1917 nvarchar(4000),@p1918 int,@p1919 int,@p1920 int,@p1921 nvarchar(4000),@p1922 nvarchar(4000),@p1923 nvarchar(4000),@p1924 nvarchar(4000),@p1925 decimal(18,2),@p1926 nvarchar(4000),@p1927 nvarchar(4000),@p1928 decimal(18,2),@p1929 nvarchar(4000),@p1930 nvarchar(4000),@p1931 nvarchar(4000),@p1932 nvarchar(4000),@p1933 int,@p1934 nvarchar(4000),@p1935 nvarchar(4000),@p1936 nvarchar(4000),@p1937 nvarchar(4000),@p1938 nvarchar(4000),@p1939 nvarchar(4000),@p1940 nvarchar(4000),@p1941 nvarchar(4000),@p1942 nvarchar(4000),@p1943 nvarchar(4000),@p1944 int,@p1945 nvarchar(4000),@p1946 nvarchar(4000),@p1947 nvarchar(4000),@p1948 nvarchar(4000),@p1949 nvarchar(4000),@p1950 int,@p1951 nvarchar(4000),@p1952 int,@p1953 int,@p1954 datetime2(7),@p1955 datetime2(7),@p1956 datetime2(7),@p1957 nvarchar(4000),@p1958 nvarchar(4000),@p1959 nvarchar(4000),@p1960 nvarchar(4000),@p1961 nvarchar(4000),@p1962 nvarchar(4000),@p1963 nvarchar(4000),@p1964 nvarchar(4000),@p1965 nvarchar(4000),@p1966 nvarchar(4000),@p1967 nvarchar(4000),@p1968 nvarchar(4000),@p1969 nvarchar(4000),@p1970 nvarchar(4000),@p1971 datetime2(7),@p1972 nvarchar(4000),@p1973 nvarchar(4000),@p1974 int,@p1975 int,@p1976 int,@p1977 nvarchar(4000),@p1978 nvarchar(4000),@p1979 nvarchar(4000),@p1980 nvarchar(4000),@p1981 decimal(18,2),@p1982 nvarchar(4000),@p1983 nvarchar(4000),@p1984 decimal(18,2),@p1985 nvarchar(4000),@p1986 nvarchar(4000),@p1987 nvarchar(4000),@p1988 nvarchar(4000),@p1989 int,@p1990 nvarchar(4000),@p1991 nvarchar(4000),@p1992 nvarchar(4000),@p1993 nvarchar(4000),@p1994 nvarchar(4000),@p1995 nvarchar(4000),@p1996 nvarchar(4000),@p1997 nvarchar(4000),@p1998 nvarchar(4000),@p1999 nvarchar(4000),@p2000 int,@p2001 nvarchar(4000),@p2002 nvarchar(4000),@p2003 nvarchar(4000),@p2004 nvarchar(4000),@p2005 nvarchar(4000),@p2006 int,@p2007 nvarchar(4000),@p2008 int,@p2009 int,@p2010 datetime2(7),@p2011 datetime2(7),@p2012 datetime2(7),@p2013 nvarchar(4000),@p2014 nvarchar(4000),@p2015 nvarchar(4000),@p2016 nvarchar(4000),@p2017 nvarchar(4000),@p2018 nvarchar(4000),@p2019 nvarchar(4000),@p2020 nvarchar(4000),@p2021 nvarchar(4000),@p2022 nvarchar(4000),@p2023 nvarchar(4000),@p2024 nvarchar(4000),@p2025 nvarchar(4000),@p2026 nvarchar(4000),@p2027 datetime2(7),@p2028 nvarchar(4000),@p2029 nvarchar(4000),@p2030 int,@p2031 int,@p2032 int,@p2033 nvarchar(4000),@p2034 nvarchar(4000),@p2035 nvarchar(4000),@p2036 nvarchar(4000),@p2037 decimal(18,2),@p2038 nvarchar(4000),@p2039 nvarchar(4000),@p2040 decimal(18,2),@p2041 nvarchar(4000),@p2042 nvarchar(4000),@p2043 nvarchar(4000),@p2044 nvarchar(4000),@p2045 int,@p2046 nvarchar(4000),@p2047 nvarchar(4000),@p2048 nvarchar(4000),@p2049 nvarchar(4000),@p2050 nvarchar(4000),@p2051 nvarchar(4000),@p2052 nvarchar(4000),@p2053 nvarchar(4000),@p2054 nvarchar(4000),@p2055 nvarchar(4000),@p2056 int,@p2057 nvarchar(4000),@p2058 nvarchar(4000),@p2059 nvarchar(4000),@p2060 nvarchar(4000),@p2061 nvarchar(4000),@p2062 int,@p2063 nvarchar(4000),@p2064 int,@p2065 int,@p2066 datetime2(7),@p2067 datetime2(7),@p2068 datetime2(7),@p2069 nvarchar(4000),@p2070 nvarchar(4000),@p2071 nvarchar(4000))SET NOCOUNT ON; DECLARE @inserted0 TABLE ([item_id] int, [_Position] [int]); MERGE [raw_data] USING ( VALUES (@p0, @p1, @p2, @p3, @p4, @p5, @p6, @p7, @p8, @p9, @p10, @p11, @p12, @p13, @p14, @p15, @p16, @p17, @p18, @p19, @p20, @p21, @p22, @p23, @p24, @p25, @p26, @p27, @p28, @p29, @p30, @p31, @p32, @p33, @p34, @p35, @p36, @p37, @p38, @p39, @p40, @p41, @p42, @p43, @p44, @p45, @p46, @p47, @p48, @p49, @p50, @p51, @p52, @p53, @p54, @p55, 0), (@p56, @p57, @p58, @p59, @p60, @p61, @p62, @p63, @p64, @p65, @p66, @p67, @p68, @p69, @p70, @p71, @p72, @p73, @p74, @p75, @p76, @p77, @p78, @p79, @p80, @p81, @p82, @p83, @p84, @p85, @p86, @p87, @p88, @p89, @p90, @p91, @p92, @p93, @p94, @p95, @p96, @p97, @p98, @p99, @p100, @p101, @p102, @p103, @p104, @p105, @p106, @p107, @p108, @p109, @p110, @p111, 1), (@p112, @p113, @p114, @p115, @p116, @p117, @p118, @p119, @p120, @p121, @p122, @p123, @p124, @p125, @p126, @p127, @p128, @p129, @p130, @p131, @p132, @p133, @p134, @p135, @p136, @p137, @p138, @p139, @p140, @p141, @p142, @p143, @p144, @p145, @p146, @p147, @p148, @p149, @p150, @p151, @p152, @p153, @p154, @p155, @p156, @p157, @p158, @p159, @p160, @p161, @p162, @p163, @p164, @p165, @p166, @p167, 2), (@p168, @p169, @p170, @p171, @p172, @p173, @p174, @p175, @p176, @p177, @p178, @p179, @p180, @p181, @p182, @p183, @p184, @p185, @p186, @p187, @p188, @p189, @p190, @p191, @p192, @p193, @p194, @p195, @p196, @p197, @p198, @p199, @p200, @p201, @p202, @p203, @p204, @p205, @p206, @p207, @p208, @p209, @p210, @p211, @p212, @p213, @p214, @p215, @p216, @p217, @p218, @p219, @p220, @p221, @p222, @p223, 3), (@p224, @p225, @p226, @p227, @p228, @p229, @p230, @p231, @p232, @p233, @p234, @p235, @p236, @p237, @p238, @p239, @p240, @p241, @p242, @p243, @p244, @p245, @p246, @p247, @p248, @p249, @p250, @p251, @p252, @p253, @p254, @p255, @p256, @p257, @p258, @p259, @p260, @p261, @p262, @p263, @p264, @p265, @p266, @p267, @p268, @p269, @p270, @p271, @p272, @p273, @p274, @p275, @p276, @p277, @p278, @p279, 4), (@p280, @p281, @p282, @p283, @p284, @p285, @p286, @p287, @p288, @p289, @p290, @p291, @p292, @p293, @p294, @p295, @p296, @p297, @p298, @p299, @p300, @p301, @p302, @p303, @p304, @p305, @p306, @p307, @p308, @p309, @p310, @p311, @p312, @p313, @p314, @p315, @p316, @p317, @p318, @p319, @p320, @p321, @p322, @p323, @p324, @p325, @p326, @p327, @p328, @p329, @p330, @p331, @p332, @p333, @p334, @p335, 5), (@p336, @p337, @p338, @p339, @p340, @p341, @p342, @p343, @p344, @p345, @p346, @p347, @p348, @p349, @p350, @p351, @p352, @p353, @p354, @p355, @p356, @p357, @p358, @p359, @p360, @p361, @p362, @p363, @p364, @p365, @p366, @p367, @p368, @p369, @p370, @p371, @p372, @p373, @p374, @p375, @p376, @p377, @p378, @p379, @p380, @p381, @p382, @p383, @p384, @p385, @p386, @p387, @p388, @p389, @p390, @p391, 6), (@p392, @p393, @p394, @p395, @p396, @p397, @p398, @p399, @p400, @p401, @p402, @p403, @p404, @p405, @p406, @p407, @p408, @p409, @p410, @p411, @p412, @p413, @p414, @p415, @p416, @p417, @p418, @p419, @p420, @p421, @p422, @p423, @p424, @p425, @p426, @p427, @p428, @p429, @p430, @p431, @p432, @p433, @p434, @p435, @p436, @p437, @p438, @p439, @p440, @p441, @p442, @p443, @p444, @p445, @p446, @p447, 7), (@p448, @p449, @p450, @p451, @p452, @p453, @p454, @p455, @p456, @p457, @p458, @p459, @p460, @p461, @p462, @p463, @p464, @p465, @p466, @p467, @p468, @p469, @p470, @p471, @p472, @p473, @p474, @p475, @p476, @p477, @p478, @p479, @p480, @p481, @p482, @p483, @p484, @p485, @p486, @p487, @p488, @p489, @p490, @p491, @p492, @p493, @p494, @p495, @p496, @p497, @p498, @p499, @p500, @p501, @p502, @p503, 8), (@p504, @p505, @p506, @p507, @p508, @p509, @p510, @p511, @p512, @p513, @p514, @p515, @p516, @p517, @p518, @p519, @p520, @p521, @p522, @p523, @p524, @p525, @p526, @p527, @p528, @p529, @p530, @p531, @p532, @p533, @p534, @p535, @p536, @p537, @p538, @p539, @p540, @p541, @p542, @p543, @p544, @p545, @p546, @p547, @p548, @p549, @p550, @p551, @p552, @p553, @p554, @p555, @p556, @p557, @p558, @p559, 9), (@p560, @p561, @p562, @p563, @p564, @p565, @p566, @p567, @p568, @p569, @p570, @p571, @p572, @p573, @p574, @p575, @p576, @p577, @p578, @p579, @p580, @p581, @p582, @p583, @p584, @p585, @p586, @p587, @p588, @p589, @p590, @p591, @p592, @p593, @p594, @p595, @p596, @p597, @p598, @p599, @p600, @p601, @p602, @p603, @p604, @p605, @p606, @p607, @p608, @p609, @p610, @p611, @p612, @p613, @p614, @p615, 10), (@p616, @p617, @p618, @p619, @p620, @p621, @p622, @p623, @p624, @p625, @p626, @p627, @p628, @p629, @p630, @p631, @p632, @p633, @p634, @p635, @p636, @p637, @p638, @p639, @p640, @p641, @p642, @p643, @p644, @p645, @p646, @p647, @p648, @p649, @p650, @p651, @p652, @p653, @p654, @p655, @p656, @p657, @p658, @p659, @p660, @p661, @p662, @p663, @p664, @p665, @p666, @p667, @p668, @p669, @p670, @p671, 11), (@p672, @p673, @p674, @p675, @p676, @p677, @p678, @p679, @p680, @p681, @p682, @p683, @p684, @p685, @p686, @p687, @p688, @p689, @p690, @p691, @p692, @p693, @p694, @p695, @p696, @p697, @p698, @p699, @p700, @p701, @p702, @p703, @p704, @p705, @p706, @p707, @p708, @p709, @p710, @p711, @p712, @p713, @p714, @p715, @p716, @p717, @p718, @p719, @p720, @p721, @p722, @p723, @p724, @p725, @p726, @p727, 12), (@p728, @p729, @p730, @p731, @p732, @p733, @p734, @p735, @p736, @p737, @p738, @p739, @p740, @p741, @p742, @p743, @p744, @p745, @p746, @p747, @p748, @p749, @p750, @p751, @p752, @p753, @p754, @p755, @p756, @p757, @p758, @p759, @p760, @p761, @p762, @p763, @p764, @p765, @p766, @p767, @p768, @p769, @p770, @p771, @p772, @p773, @p774, @p775, @p776, @p777, @p778, @p779, @p780, @p781, @p782, @p783, 13), (@p784, @p785, @p786, @p787, @p788, @p789, @p790, @p791, @p792, @p793, @p794, @p795, @p796, @p797, @p798, @p799, @p800, @p801, @p802, @p803, @p804, @p805, @p806, @p807, @p808, @p809, @p810, @p811, @p812, @p813, @p814, @p815, @p816, @p817, @p818, @p819, @p820, @p821, @p822, @p823, @p824, @p825, @p826, @p827, @p828, @p829, @p830, @p831, @p832, @p833, @p834, @p835, @p836, @p837, @p838, @p839, 14), (@p840, @p841, @p842, @p843, @p844, @p845, @p846, @p847, @p848, @p849, @p850, @p851, @p852, @p853, @p854, @p855, @p856, @p857, @p858, @p859, @p860, @p861, @p862, @p863, @p864, @p865, @p866, @p867, @p868, @p869, @p870, @p871, @p872, @p873, @p874, @p875, @p876, @p877, @p878, @p879, @p880, @p881, @p882, @p883, @p884, @p885, @p886, @p887, @p888, @p889, @p890, @p891, @p892, @p893, @p894, @p895, 15), (@p896, @p897, @p898, @p899, @p900, @p901, @p902, @p903, @p904, @p905, @p906, @p907, @p908, @p909, @p910, @p911, @p912, @p913, @p914, @p915, @p916, @p917, @p918, @p919, @p920, @p921, @p922, @p923, @p924, @p925, @p926, @p927, @p928, @p929, @p930, @p931, @p932, @p933, @p934, @p935, @p936, @p937, @p938, @p939, @p940, @p941, @p942, @p943, @p944, @p945, @p946, @p947, @p948, @p949, @p950, @p951, 16), (@p952, @p953, @p954, @p955, @p956, @p957, @p958, @p959, @p960, @p961, @p962, @p963, @p964, @p965, @p966, @p967, @p968, @p969, @p970, @p971, @p972, @p973, @p974, @p975, @p976, @p977, @p978, @p979, @p980, @p981, @p982, @p983, @p984, @p985, @p986, @p987, @p988, @p989, @p990, @p991, @p992, @p993, @p994, @p995, @p996, @p997, @p998, @p999, @p1000, @p1001, @p1002, @p1003, @p1004, @p1005, @p1006, @p1007, 17), (@p1008, @p1009, @p1010, @p1011, @p1012, @p1013, @p1014, @p1015, @p1016, @p1017, @p1018, @p1019, @p1020, @p1021, @p1022, @p1023, @p1024, @p1025, @p1026, @p1027, @p1028, @p1029, @p1030, @p1031, @p1032, @p1033, @p1034, @p1035, @p1036, @p1037, @p1038, @p1039, @p1040, @p1041, @p1042, @p1043, @p1044, @p1045, @p1046, @p1047, @p1048, @p1049, @p1050, @p1051, @p1052, @p1053, @p1054, @p1055, @p1056, @p1057, @p1058, @p1059, @p1060, @p1061, @p1062, @p1063, 18), (@p1064, @p1065, @p1066, @p1067, @p1068, @p1069, @p1070, @p1071, @p1072, @p1073, @p1074, @p1075, @p1076, @p1077, @p1078, @p1079, @p1080, @p1081, @p1082, @p1083, @p1084, @p1085, @p1086, @p1087, @p1088, @p1089, @p1090, @p1091, @p1092, @p1093, @p1094, @p1095, @p1096, @p1097, @p1098, @p1099, @p1100, @p1101, @p1102, @p1103, @p1104, @p1105, @p1106, @p1107, @p1108, @p1109, @p1110, @p1111, @p1112, @p1113, @p1114, @p1115, @p1116, @p1117, @p1118, @p1119, 19), (@p1120, @p1121, @p1122, @p1123, @p1124, @p1125, @p1126, @p1127, @p1128, @p1129, @p1130, @p1131, @p1132, @p1133, @p1134, @p1135, @p1136, @p1137, @p1138, @p1139, @p1140, @p1141, @p1142, @p1143, @p1144, @p1145, @p1146, @p1147, @p1148, @p1149, @p1150, @p1151, @p1152, @p1153, @p1154, @p1155, @p1156, @p1157, @p1158, @p1159, @p1160, @p1161, @p1162, @p1163, @p1164, @p1165, @p1166, @p1167, @p1168, @p1169, @p1170, @p1171, @p1172, @p1173, @p1174, @p1175, 20), (@p1176, @p1177, @p1178, @p1179, @p1180, @p1181, @p1182, @p1183, @p1184, @p1185, @p1186, @p1187, @p1188, @p1189, @p1190, @p1191, @p1192, @p1193, @p1194, @p1195, @p1196, @p1197, @p1198, @p1199, @p1200, @p1201, @p1202, @p1203, @p1204, @p1205, @p1206, @p1207, @p1208, @p1209, @p1210, @p1211, @p1212, @p1213, @p1214, @p1215, @p1216, @p1217, @p1218, @p1219, @p1220, @p1221, @p1222, @p1223, @p1224, @p1225, @p1226, @p1227, @p1228, @p1229, @p1230, @p1231, 21), (@p1232, @p1233, @p1234, @p1235, @p1236, @p1237, @p1238, @p1239, @p1240, @p1241, @p1242, @p1243, @p1244, @p1245, @p1246, @p1247, @p1248, @p1249, @p1250, @p1251, @p1252, @p1253, @p1254, @p1255, @p1256, @p1257, @p1258, @p1259, @p1260, @p1261, @p1262, @p1263, @p1264, @p1265, @p1266, @p1267, @p1268, @p1269, @p1270, @p1271, @p1272, @p1273, @p1274, @p1275, @p1276, @p1277, @p1278, @p1279, @p1280, @p1281, @p1282, @p1283, @p1284, @p1285, @p1286, @p1287, 22), (@p1288, @p1289, @p1290, @p1291, @p1292, @p1293, @p1294, @p1295, @p1296, @p1297, @p1298, @p1299, @p1300, @p1301, @p1302, @p1303, @p1304, @p1305, @p1306, @p1307, @p1308, @p1309, @p1310, @p1311, @p1312, @p1313, @p1314, @p1315, @p1316, @p1317, @p1318, @p1319, @p1320, @p1321, @p1322, @p1323, @p1324, @p1325, @p1326, @p1327, @p1328, @p1329, @p1330, @p1331, @p1332, @p1333, @p1334, @p1335, @p1336, @p1337, @p1338, @p1339, @p1340, @p1341, @p1342, @p1343, 23), (@p1344, @p1345, @p1346, @p1347, @p1348, @p1349, @p1350, @p1351, @p1352, @p1353, @p1354, @p1355, @p1356, @p1357, @p1358, @p1359, @p1360, @p1361, @p1362, @p1363, @p1364, @p1365, @p1366, @p1367, @p1368, @p1369, @p1370, @p1371, @p1372, @p1373, @p1374, @p1375, @p1376, @p1377, @p1378, @p1379, @p1380, @p1381, @p1382, @p1383, @p1384, @p1385, @p1386, @p1387, @p1388, @p1389, @p1390, @p1391, @p1392, @p1393, @p1394, @p1395, @p1396, @p1397, @p1398, @p1399, 24), (@p1400, @p1401, @p1402, @p1403, @p1404, @p1405, @p1406, @p1407, @p1408, @p1409, @p1410, @p1411, @p1412, @p1413, @p1414, @p1415, @p1416, @p1417, @p1418, @p1419, @p1420, @p1421, @p1422, @p1423, @p1424, @p1425, @p1426, @p1427, @p1428, @p1429, @p1430, @p1431, @p1432, @p1433, @p1434, @p1435, @p1436, @p1437, @p1438, @p1439, @p1440, @p1441, @p1442, @p1443, @p1444, @p1445, @p1446, @p1447, @p1448, @p1449, @p1450, @p1451, @p1452, @p1453, @p1454, @p1455, 25), (@p1456, @p1457, @p1458, @p1459, @p1460, @p1461, @p1462, @p1463, @p1464, @p1465, @p1466, @p1467, @p1468, @p1469, @p1470, @p1471, @p1472, @p1473, @p1474, @p1475, @p1476, @p1477, @p1478, @p1479, @p1480, @p1481, @p1482, @p1483, @p1484, @p1485, @p1486, @p1487, @p1488, @p1489, @p1490, @p1491, @p1492, @p1493, @p1494, @p1495, @p1496, @p1497, @p1498, @p1499, @p1500, @p1501, @p1502, @p1503, @p1504, @p1505, @p1506, @p1507, @p1508, @p1509, @p1510, @p1511, 26), (@p1512, @p1513, @p1514, @p1515, @p1516, @p1517, @p1518, @p1519, @p1520, @p1521, @p1522, @p1523, @p1524, @p1525, @p1526, @p1527, @p1528, @p1529, @p1530, @p1531, @p1532, @p1533, @p1534, @p1535, @p1536, @p1537, @p1538, @p1539, @p1540, @p1541, @p1542, @p1543, @p1544, @p1545, @p1546, @p1547, @p1548, @p1549, @p1550, @p1551, @p1552, @p1553, @p1554, @p1555, @p1556, @p1557, @p1558, @p1559, @p1560, @p1561, @p1562, @p1563, @p1564, @p1565, @p1566, @p1567, 27), (@p1568, @p1569, @p1570, @p1571, @p1572, @p1573, @p1574, @p1575, @p1576, @p1577, @p1578, @p1579, @p1580, @p1581, @p1582, @p1583, @p1584, @p1585, @p1586, @p1587, @p1588, @p1589, @p1590, @p1591, @p1592, @p1593, @p1594, @p1595, @p1596, @p1597, @p1598, @p1599, @p1600, @p1601, @p1602, @p1603, @p1604, @p1605, @p1606, @p1607, @p1608, @p1609, @p1610, @p1611, @p1612, @p1613, @p1614, @p1615, @p1616, @p1617, @p1618, @p1619, @p1620, @p1621, @p1622, @p1623, 28), (@p1624, @p1625, @p1626, @p1627, @p1628, @p1629, @p1630, @p1631, @p1632, @p1633, @p1634, @p1635, @p1636, @p1637, @p1638, @p1639, @p1640, @p1641, @p1642, @p1643, @p1644, @p1645, @p1646, @p1647, @p1648, @p1649, @p1650, @p1651, @p1652, @p1653, @p1654, @p1655, @p1656, @p1657, @p1658, @p1659, @p1660, @p1661, @p1662, @p1663, @p1664, @p1665, @p1666, @p1667, @p1668, @p1669, @p1670, @p1671, @p1672, @p1673, @p1674, @p1675, @p1676, @p1677, @p1678, @p1679, 29), (@p1680, @p1681, @p1682, @p1683, @p1684, @p1685, @p1686, @p1687, @p1688, @p1689, @p1690, @p1691, @p1692, @p1693, @p1694, @p1695, @p1696, @p1697, @p1698, @p1699, @p1700, @p1701, @p1702, @p1703, @p1704, @p1705, @p1706, @p1707, @p1708, @p1709, @p1710, @p1711, @p1712, @p1713, @p1714, @p1715, @p1716, @p1717, @p1718, @p1719, @p1720, @p1721, @p1722, @p1723, @p1724, @p1725, @p1726, @p1727, @p1728, @p1729, @p1730, @p1731, @p1732, @p1733, @p1734, @p1735, 30), (@p1736, @p1737, @p1738, @p1739, @p1740, @p1741, @p1742, @p1743, @p1744, @p1745, @p1746, @p1747, @p1748, @p1749, @p1750, @p1751, @p1752, @p1753, @p1754, @p1755, @p1756, @p1757, @p1758, @p1759, @p1760, @p1761, @p1762, @p1763, @p1764, @p1765, @p1766, @p1767, @p1768, @p1769, @p1770, @p1771, @p1772, @p1773, @p1774, @p1775, @p1776, @p1777, @p1778, @p1779, @p1780, @p1781, @p1782, @p1783, @p1784, @p1785, @p1786, @p1787, @p1788, @p1789, @p1790, @p1791, 31), (@p1792, @p1793, @p1794, @p1795, @p1796, @p1797, @p1798, @p1799, @p1800, @p1801, @p1802, @p1803, @p1804, @p1805, @p1806, @p1807, @p1808, @p1809, @p1810, @p1811, @p1812, @p1813, @p1814, @p1815, @p1816, @p1817, @p1818, @p1819, @p1820, @p1821, @p1822, @p1823, @p1824, @p1825, @p1826, @p1827, @p1828, @p1829, @p1830, @p1831, @p1832, @p1833, @p1834, @p1835, @p1836, @p1837, @p1838, @p1839, @p1840, @p1841, @p1842, @p1843, @p1844, @p1845, @p1846, @p1847, 32), (@p1848, @p1849, @p1850, @p1851, @p1852, @p1853, @p1854, @p1855, @p1856, @p1857, @p1858, @p1859, @p1860, @p1861, @p1862, @p1863, @p1864, @p1865, @p1866, @p1867, @p1868, @p1869, @p1870, @p1871, @p1872, @p1873, @p1874, @p1875, @p1876, @p1877, @p1878, @p1879, @p1880, @p1881, @p1882, @p1883, @p1884, @p1885, @p1886, @p1887, @p1888, @p1889, @p1890, @p1891, @p1892, @p1893, @p1894, @p1895, @p1896, @p1897, @p1898, @p1899, @p1900, @p1901, @p1902, @p1903, 33), (@p1904, @p1905, @p1906, @p1907, @p1908, @p1909, @p1910, @p1911, @p1912, @p1913, @p1914, @p1915, @p1916, @p1917, @p1918, @p1919, @p1920, @p1921, @p1922, @p1923, @p1924, @p1925, @p1926, @p1927, @p1928, @p1929, @p1930, @p1931, @p1932, @p1933, @p1934, @p1935, @p1936, @p1937, @p1938, @p1939, @p1940, @p1941, @p1942, @p1943, @p1944, @p1945, @p1946, @p1947, @p1948, @p1949, @p1950, @p1951, @p1952, @p1953, @p1954, @p1955, @p1956, @p1957, @p1958, @p1959, 34), (@p1960, @p1961, @p1962, @p1963, @p1964, @p1965, @p1966, @p1967, @p1968, @p1969, @p1970, @p1971, @p1972, @p1973, @p1974, @p1975, @p1976, @p1977, @p1978, @p1979, @p1980, @p1981, @p1982, @p1983, @p1984, @p1985, @p1986, @p1987, @p1988, @p1989, @p1990, @p1991, @p1992, @p1993, @p1994, @p1995, @p1996, @p1997, @p1998, @p1999, @p2000, @p2001, @p2002, @p2003, @p2004, @p2005, @p2006, @p2007, @p2008, @p2009, @p2010, @p2011, @p2012, @p2013, @p2014, @p2015, 35), (@p2016, @p2017, @p2018, @p2019, @p2020, @p2021, @p2022, @p2023, @p2024, @p2025, @p2026, @p2027, @p2028, @p2029, @p2030, @p2031, @p2032, @p2033, @p2034, @p2035, @p2036, @p2037, @p2038, @p2039, @p2040, @p2041, @p2042, @p2043, @p2044, @p2045, @p2046, @p2047, @p2048, @p2049, @p2050, @p2051, @p2052, @p2053, @p2054, @p2055, @p2056, @p2057, @p2058, @p2059, @p2060, @p2061, @p2062, @p2063, @p2064, @p2065, @p2066, @p2067, @p2068, @p2069, @p2070, @p2071, 36)) AS i ([addressee_cntry_cd], [addressee_city], [addressee_district], [addressee_email], [addressee_full_address], [addressee_home_address], [addressee_name], [addressee_postcode], [addressee_province], [addressee_subdistrict], [addressee_tel], [create_table], [delivery_code], [delivery_recipient_name], [delivery_relation_id], [delivery_status_id], [dest_outlet_id], [dest_outlet_port], [document_number], [item_barcode], [item_cod], [item_gross_weight], [item_height], [item_length], [item_price], [item_width], [lat], [log_id], [long], [outlet_id], [outlet_port], [podUrl], [remark], [scan_cntry_cd], [scan_cntry_postcode], [sender_cntry_cd], [sender_district], [sender_email], [sender_full_address], [sender_home_address], [member_id], [sender_name], [sender_postcode], [sender_province], [sender_subdistrict], [sender_tel], [server_id], [signatureUrl], [state], [status_code], [status_dtm], [timestamp], [transmit_dtm], [user_id], [wckt_id], [wkstn_no], _Position) ON 1=0 WHEN NOT MATCHED THEN INSERT ([addressee_cntry_cd], [addressee_city], [addressee_district], [addressee_email], [addressee_full_address], [addressee_home_address], [addressee_name], [addressee_postcode], [addressee_province], [addressee_subdistrict], [addressee_tel], [create_table], [delivery_code], [delivery_recipient_name], [delivery_relation_id], [delivery_status_id], [dest_outlet_id], [dest_outlet_port], [document_number], [item_barcode], [item_cod], [item_gross_weight], [item_height], [item_length], [item_price], [item_width], [lat], [log_id], [long], [outlet_id], [outlet_port], [podUrl], [remark], [scan_cntry_cd], [scan_cntry_postcode], [sender_cntry_cd], [sender_district], [sender_email], [sender_full_address], [sender_home_address], [member_id], [sender_name], [sender_postcode], [sender_province], [sender_subdistrict], [sender_tel], [server_id], [signatureUrl], [state], [status_code], [status_dtm], [timestamp], [transmit_dtm], [user_id], [wckt_id], [wkstn_no]) VALUES (i.[addressee_cntry_cd], i.[addressee_city], i.[addressee_district], i.[addressee_email], i.[addressee_full_address], i.[addressee_home_address], i.[addressee_name], i.[addressee_postcode], i.[addressee_province], i.[addressee_subdistrict], i.[addressee_tel], i.[create_table], i.[delivery_code], i.[delivery_recipient_name], i.[delivery_relation_id], i.[delivery_status_id], i.[dest_outlet_id], i.[dest_outlet_port], i.[document_number], i.[item_barcode], i.[item_cod], i.[item_gross_weight], i.[item_height], i.[item_length], i.[item_price], i.[item_width], i.[lat], i.[log_id], i.[long], i.[outlet_id], i.[outlet_port], i.[podUrl], i.[remark], i.[scan_cntry_cd], i.[scan_cntry_postcode], i.[sender_cntry_cd], i.[sender_district], i.[sender_email], i.[sender_full_address], i.[sender_home_address], i.[member_id], i.[sender_name], i.[sender_postcode], i.[sender_province], i.[sender_subdistrict], i.[sender_tel], i.[server_id], i.[signatureUrl], i.[state], i.[status_code], i.[status_dtm], i.[timestamp], i.[transmit_dtm], i.[user_id], i.[wckt_id], i.[wkstn_no]) OUTPUT INSERTED.[item_id], i._Position INTO @inserted0;  SELECT [t].[item_id] FROM [raw_data] t INNER JOIN @inserted0 i ON ([t].[item_id] = [i].[item_id]) ORDER BY [i].[_Position];  ",4,4,0,430,2,4
"(@p0 nvarchar(4000),@p1 nvarchar(4000),@p2 nvarchar(4000),@p3 nvarchar(4000),@p4 nvarchar(4000),@p5 nvarchar(4000),@p6 nvarchar(4000),@p7 nvarchar(4000),@p8 nvarchar(4000),@p9 nvarchar(4000),@p10 nvarchar(4000),@p11 datetime2(7),@p12 nvarchar(4000),@p13 nvarchar(4000),@p14 int,@p15 int,@p16 int,@p17 nvarchar(4000),@p18 nvarchar(4000),@p19 nvarchar(4000),@p20 nvarchar(4000),@p21 decimal(18,2),@p22 nvarchar(4000),@p23 nvarchar(4000),@p24 decimal(18,2),@p25 nvarchar(4000),@p26 nvarchar(4000),@p27 nvarchar(4000),@p28 nvarchar(4000),@p29 int,@p30 nvarchar(4000),@p31 nvarchar(4000),@p32 nvarchar(4000),@p33 nvarchar(4000),@p34 nvarchar(4000),@p35 nvarchar(4000),@p36 nvarchar(4000),@p37 nvarchar(4000),@p38 nvarchar(4000),@p39 nvarchar(4000),@p40 int,@p41 nvarchar(4000),@p42 nvarchar(4000),@p43 nvarchar(4000),@p44 nvarchar(4000),@p45 nvarchar(4000),@p46 int,@p47 nvarchar(4000),@p48 int,@p49 int,@p50 datetime2(7),@p51 datetime2(7),@p52 datetime2(7),@p53 nvarchar(4000),@p54 nvarchar(4000),@p55 nvarchar(4000),@p56 nvarchar(4000),@p57 nvarchar(4000),@p58 nvarchar(4000),@p59 nvarchar(4000),@p60 nvarchar(4000),@p61 nvarchar(4000),@p62 nvarchar(4000),@p63 nvarchar(4000),@p64 nvarchar(4000),@p65 nvarchar(4000),@p66 nvarchar(4000),@p67 datetime2(7),@p68 nvarchar(4000),@p69 nvarchar(4000),@p70 int,@p71 int,@p72 int,@p73 nvarchar(4000),@p74 nvarchar(4000),@p75 nvarchar(4000),@p76 nvarchar(4000),@p77 decimal(18,2),@p78 nvarchar(4000),@p79 nvarchar(4000),@p80 decimal(18,2),@p81 nvarchar(4000),@p82 nvarchar(4000),@p83 nvarchar(4000),@p84 nvarchar(4000),@p85 int,@p86 nvarchar(4000),@p87 nvarchar(4000),@p88 nvarchar(4000),@p89 nvarchar(4000),@p90 nvarchar(4000),@p91 nvarchar(4000),@p92 nvarchar(4000),@p93 nvarchar(4000),@p94 nvarchar(4000),@p95 nvarchar(4000),@p96 int,@p97 nvarchar(4000),@p98 nvarchar(4000),@p99 nvarchar(4000),@p100 nvarchar(4000),@p101 nvarchar(4000),@p102 int,@p103 nvarchar(4000),@p104 int,@p105 int,@p106 datetime2(7),@p107 datetime2(7),@p108 datetime2(7),@p109 nvarchar(4000),@p110 nvarchar(4000),@p111 nvarchar(4000),@p112 nvarchar(4000),@p113 nvarchar(4000),@p114 nvarchar(4000),@p115 nvarchar(4000),@p116 nvarchar(4000),@p117 nvarchar(4000),@p118 nvarchar(4000),@p119 nvarchar(4000),@p120 nvarchar(4000),@p121 nvarchar(4000),@p122 nvarchar(4000),@p123 datetime2(7),@p124 nvarchar(4000),@p125 nvarchar(4000),@p126 int,@p127 int,@p128 int,@p129 nvarchar(4000),@p130 nvarchar(4000),@p131 nvarchar(4000),@p132 nvarchar(4000),@p133 decimal(18,2),@p134 nvarchar(4000),@p135 nvarchar(4000),@p136 decimal(18,2),@p137 nvarchar(4000),@p138 nvarchar(4000),@p139 nvarchar(4000),@p140 nvarchar(4000),@p141 int,@p142 nvarchar(4000),@p143 nvarchar(4000),@p144 nvarchar(4000),@p145 nvarchar(4000),@p146 nvarchar(4000),@p147 nvarchar(4000),@p148 nvarchar(4000),@p149 nvarchar(4000),@p150 nvarchar(4000),@p151 nvarchar(4000),@p152 int,@p153 nvarchar(4000),@p154 nvarchar(4000),@p155 nvarchar(4000),@p156 nvarchar(4000),@p157 nvarchar(4000),@p158 int,@p159 nvarchar(4000),@p160 int,@p161 int,@p162 datetime2(7),@p163 datetime2(7),@p164 datetime2(7),@p165 nvarchar(4000),@p166 nvarchar(4000),@p167 nvarchar(4000),@p168 nvarchar(4000),@p169 nvarchar(4000),@p170 nvarchar(4000),@p171 nvarchar(4000),@p172 nvarchar(4000),@p173 nvarchar(4000),@p174 nvarchar(4000),@p175 nvarchar(4000),@p176 nvarchar(4000),@p177 nvarchar(4000),@p178 nvarchar(4000),@p179 datetime2(7),@p180 nvarchar(4000),@p181 nvarchar(4000),@p182 int,@p183 int,@p184 int,@p185 nvarchar(4000),@p186 nvarchar(4000),@p187 nvarchar(4000),@p188 nvarchar(4000),@p189 decimal(18,2),@p190 nvarchar(4000),@p191 nvarchar(4000),@p192 decimal(18,2),@p193 nvarchar(4000),@p194 nvarchar(4000),@p195 nvarchar(4000),@p196 nvarchar(4000),@p197 int,@p198 nvarchar(4000),@p199 nvarchar(4000),@p200 nvarchar(4000),@p201 nvarchar(4000),@p202 nvarchar(4000),@p203 nvarchar(4000),@p204 nvarchar(4000),@p205 nvarchar(4000),@p206 nvarchar(4000),@p207 nvarchar(4000),@p208 int,@p209 nvarchar(4000),@p210 nvarchar(4000),@p211 nvarchar(4000),@p212 nvarchar(4000),@p213 nvarchar(4000),@p214 int,@p215 nvarchar(4000),@p216 int,@p217 int,@p218 datetime2(7),@p219 datetime2(7),@p220 datetime2(7),@p221 nvarchar(4000),@p222 nvarchar(4000),@p223 nvarchar(4000),@p224 nvarchar(4000),@p225 nvarchar(4000),@p226 nvarchar(4000),@p227 nvarchar(4000),@p228 nvarchar(4000),@p229 nvarchar(4000),@p230 nvarchar(4000),@p231 nvarchar(4000),@p232 nvarchar(4000),@p233 nvarchar(4000),@p234 nvarchar(4000),@p235 datetime2(7),@p236 nvarchar(4000),@p237 nvarchar(4000),@p238 int,@p239 int,@p240 int,@p241 nvarchar(4000),@p242 nvarchar(4000),@p243 nvarchar(4000),@p244 nvarchar(4000),@p245 decimal(18,2),@p246 nvarchar(4000),@p247 nvarchar(4000),@p248 decimal(18,2),@p249 nvarchar(4000),@p250 nvarchar(4000),@p251 nvarchar(4000),@p252 nvarchar(4000),@p253 int,@p254 nvarchar(4000),@p255 nvarchar(4000),@p256 nvarchar(4000),@p257 nvarchar(4000),@p258 nvarchar(4000),@p259 nvarchar(4000),@p260 nvarchar(4000),@p261 nvarchar(4000),@p262 nvarchar(4000),@p263 nvarchar(4000),@p264 int,@p265 nvarchar(4000),@p266 nvarchar(4000),@p267 nvarchar(4000),@p268 nvarchar(4000),@p269 nvarchar(4000),@p270 int,@p271 nvarchar(4000),@p272 int,@p273 int,@p274 datetime2(7),@p275 datetime2(7),@p276 datetime2(7),@p277 nvarchar(4000),@p278 nvarchar(4000),@p279 nvarchar(4000),@p280 nvarchar(4000),@p281 nvarchar(4000),@p282 nvarchar(4000),@p283 nvarchar(4000),@p284 nvarchar(4000),@p285 nvarchar(4000),@p286 nvarchar(4000),@p287 nvarchar(4000),@p288 nvarchar(4000),@p289 nvarchar(4000),@p290 nvarchar(4000),@p291 datetime2(7),@p292 nvarchar(4000),@p293 nvarchar(4000),@p294 int,@p295 int,@p296 int,@p297 nvarchar(4000),@p298 nvarchar(4000),@p299 nvarchar(4000),@p300 nvarchar(4000),@p301 decimal(18,2),@p302 nvarchar(4000),@p303 nvarchar(4000),@p304 decimal(18,2),@p305 nvarchar(4000),@p306 nvarchar(4000),@p307 nvarchar(4000),@p308 nvarchar(4000),@p309 int,@p310 nvarchar(4000),@p311 nvarchar(4000),@p312 nvarchar(4000),@p313 nvarchar(4000),@p314 nvarchar(4000),@p315 nvarchar(4000),@p316 nvarchar(4000),@p317 nvarchar(4000),@p318 nvarchar(4000),@p319 nvarchar(4000),@p320 int,@p321 nvarchar(4000),@p322 nvarchar(4000),@p323 nvarchar(4000),@p324 nvarchar(4000),@p325 nvarchar(4000),@p326 int,@p327 nvarchar(4000),@p328 int,@p329 int,@p330 datetime2(7),@p331 datetime2(7),@p332 datetime2(7),@p333 nvarchar(4000),@p334 nvarchar(4000),@p335 nvarchar(4000),@p336 nvarchar(4000),@p337 nvarchar(4000),@p338 nvarchar(4000),@p339 nvarchar(4000),@p340 nvarchar(4000),@p341 nvarchar(4000),@p342 nvarchar(4000),@p343 nvarchar(4000),@p344 nvarchar(4000),@p345 nvarchar(4000),@p346 nvarchar(4000),@p347 datetime2(7),@p348 nvarchar(4000),@p349 nvarchar(4000),@p350 int,@p351 int,@p352 int,@p353 nvarchar(4000),@p354 nvarchar(4000),@p355 nvarchar(4000),@p356 nvarchar(4000),@p357 decimal(18,2),@p358 nvarchar(4000),@p359 nvarchar(4000),@p360 decimal(18,2),@p361 nvarchar(4000),@p362 nvarchar(4000),@p363 nvarchar(4000),@p364 nvarchar(4000),@p365 int,@p366 nvarchar(4000),@p367 nvarchar(4000),@p368 nvarchar(4000),@p369 nvarchar(4000),@p370 nvarchar(4000),@p371 nvarchar(4000),@p372 nvarchar(4000),@p373 nvarchar(4000),@p374 nvarchar(4000),@p375 nvarchar(4000),@p376 int,@p377 nvarchar(4000),@p378 nvarchar(4000),@p379 nvarchar(4000),@p380 nvarchar(4000),@p381 nvarchar(4000),@p382 int,@p383 nvarchar(4000),@p384 int,@p385 int,@p386 datetime2(7),@p387 datetime2(7),@p388 datetime2(7),@p389 nvarchar(4000),@p390 nvarchar(4000),@p391 nvarchar(4000),@p392 nvarchar(4000),@p393 nvarchar(4000),@p394 nvarchar(4000),@p395 nvarchar(4000),@p396 nvarchar(4000),@p397 nvarchar(4000),@p398 nvarchar(4000),@p399 nvarchar(4000),@p400 nvarchar(4000),@p401 nvarchar(4000),@p402 nvarchar(4000),@p403 datetime2(7),@p404 nvarchar(4000),@p405 nvarchar(4000),@p406 int,@p407 int,@p408 int,@p409 nvarchar(4000),@p410 nvarchar(4000),@p411 nvarchar(4000),@p412 nvarchar(4000),@p413 decimal(18,2),@p414 nvarchar(4000),@p415 nvarchar(4000),@p416 decimal(18,2),@p417 nvarchar(4000),@p418 nvarchar(4000),@p419 nvarchar(4000),@p420 nvarchar(4000),@p421 int,@p422 nvarchar(4000),@p423 nvarchar(4000),@p424 nvarchar(4000),@p425 nvarchar(4000),@p426 nvarchar(4000),@p427 nvarchar(4000),@p428 nvarchar(4000),@p429 nvarchar(4000),@p430 nvarchar(4000),@p431 nvarchar(4000),@p432 int,@p433 nvarchar(4000),@p434 nvarchar(4000),@p435 nvarchar(4000),@p436 nvarchar(4000),@p437 nvarchar(4000),@p438 int,@p439 nvarchar(4000),@p440 int,@p441 int,@p442 datetime2(7),@p443 datetime2(7),@p444 datetime2(7),@p445 nvarchar(4000),@p446 nvarchar(4000),@p447 nvarchar(4000),@p448 nvarchar(4000),@p449 nvarchar(4000),@p450 nvarchar(4000),@p451 nvarchar(4000),@p452 nvarchar(4000),@p453 nvarchar(4000),@p454 nvarchar(4000),@p455 nvarchar(4000),@p456 nvarchar(4000),@p457 nvarchar(4000),@p458 nvarchar(4000),@p459 datetime2(7),@p460 nvarchar(4000),@p461 nvarchar(4000),@p462 int,@p463 int,@p464 int,@p465 nvarchar(4000),@p466 nvarchar(4000),@p467 nvarchar(4000),@p468 nvarchar(4000),@p469 decimal(18,2),@p470 nvarchar(4000),@p471 nvarchar(4000),@p472 decimal(18,2),@p473 nvarchar(4000),@p474 nvarchar(4000),@p475 nvarchar(4000),@p476 nvarchar(4000),@p477 int,@p478 nvarchar(4000),@p479 nvarchar(4000),@p480 nvarchar(4000),@p481 nvarchar(4000),@p482 nvarchar(4000),@p483 nvarchar(4000),@p484 nvarchar(4000),@p485 nvarchar(4000),@p486 nvarchar(4000),@p487 nvarchar(4000),@p488 int,@p489 nvarchar(4000),@p490 nvarchar(4000),@p491 nvarchar(4000),@p492 nvarchar(4000),@p493 nvarchar(4000),@p494 int,@p495 nvarchar(4000),@p496 int,@p497 int,@p498 datetime2(7),@p499 datetime2(7),@p500 datetime2(7),@p501 nvarchar(4000),@p502 nvarchar(4000),@p503 nvarchar(4000),@p504 nvarchar(4000),@p505 nvarchar(4000),@p506 nvarchar(4000),@p507 nvarchar(4000),@p508 nvarchar(4000),@p509 nvarchar(4000),@p510 nvarchar(4000),@p511 nvarchar(4000),@p512 nvarchar(4000),@p513 nvarchar(4000),@p514 nvarchar(4000),@p515 datetime2(7),@p516 nvarchar(4000),@p517 nvarchar(4000),@p518 int,@p519 int,@p520 int,@p521 nvarchar(4000),@p522 nvarchar(4000),@p523 nvarchar(4000),@p524 nvarchar(4000),@p525 decimal(18,2),@p526 nvarchar(4000),@p527 nvarchar(4000),@p528 decimal(18,2),@p529 nvarchar(4000),@p530 nvarchar(4000),@p531 nvarchar(4000),@p532 nvarchar(4000),@p533 int,@p534 nvarchar(4000),@p535 nvarchar(4000),@p536 nvarchar(4000),@p537 nvarchar(4000),@p538 nvarchar(4000),@p539 nvarchar(4000),@p540 nvarchar(4000),@p541 nvarchar(4000),@p542 nvarchar(4000),@p543 nvarchar(4000),@p544 int,@p545 nvarchar(4000),@p546 nvarchar(4000),@p547 nvarchar(4000),@p548 nvarchar(4000),@p549 nvarchar(4000),@p550 int,@p551 nvarchar(4000),@p552 int,@p553 int,@p554 datetime2(7),@p555 datetime2(7),@p556 datetime2(7),@p557 nvarchar(4000),@p558 nvarchar(4000),@p559 nvarchar(4000),@p560 nvarchar(4000),@p561 nvarchar(4000),@p562 nvarchar(4000),@p563 nvarchar(4000),@p564 nvarchar(4000),@p565 nvarchar(4000),@p566 nvarchar(4000),@p567 nvarchar(4000),@p568 nvarchar(4000),@p569 nvarchar(4000),@p570 nvarchar(4000),@p571 datetime2(7),@p572 nvarchar(4000),@p573 nvarchar(4000),@p574 int,@p575 int,@p576 int,@p577 nvarchar(4000),@p578 nvarchar(4000),@p579 nvarchar(4000),@p580 nvarchar(4000),@p581 decimal(18,2),@p582 nvarchar(4000),@p583 nvarchar(4000),@p584 decimal(18,2),@p585 nvarchar(4000),@p586 nvarchar(4000),@p587 nvarchar(4000),@p588 nvarchar(4000),@p589 int,@p590 nvarchar(4000),@p591 nvarchar(4000),@p592 nvarchar(4000),@p593 nvarchar(4000),@p594 nvarchar(4000),@p595 nvarchar(4000),@p596 nvarchar(4000),@p597 nvarchar(4000),@p598 nvarchar(4000),@p599 nvarchar(4000),@p600 int,@p601 nvarchar(4000),@p602 nvarchar(4000),@p603 nvarchar(4000),@p604 nvarchar(4000),@p605 nvarchar(4000),@p606 int,@p607 nvarchar(4000),@p608 int,@p609 int,@p610 datetime2(7),@p611 datetime2(7),@p612 datetime2(7),@p613 nvarchar(4000),@p614 nvarchar(4000),@p615 nvarchar(4000),@p616 nvarchar(4000),@p617 nvarchar(4000),@p618 nvarchar(4000),@p619 nvarchar(4000),@p620 nvarchar(4000),@p621 nvarchar(4000),@p622 nvarchar(4000),@p623 nvarchar(4000),@p624 nvarchar(4000),@p625 nvarchar(4000),@p626 nvarchar(4000),@p627 datetime2(7),@p628 nvarchar(4000),@p629 nvarchar(4000),@p630 int,@p631 int,@p632 int,@p633 nvarchar(4000),@p634 nvarchar(4000),@p635 nvarchar(4000),@p636 nvarchar(4000),@p637 decimal(18,2),@p638 nvarchar(4000),@p639 nvarchar(4000),@p640 decimal(18,2),@p641 nvarchar(4000),@p642 nvarchar(4000),@p643 nvarchar(4000),@p644 nvarchar(4000),@p645 int,@p646 nvarchar(4000),@p647 nvarchar(4000),@p648 nvarchar(4000),@p649 nvarchar(4000),@p650 nvarchar(4000),@p651 nvarchar(4000),@p652 nvarchar(4000),@p653 nvarchar(4000),@p654 nvarchar(4000),@p655 nvarchar(4000),@p656 int,@p657 nvarchar(4000),@p658 nvarchar(4000),@p659 nvarchar(4000),@p660 nvarchar(4000),@p661 nvarchar(4000),@p662 int,@p663 nvarchar(4000),@p664 int,@p665 int,@p666 datetime2(7),@p667 datetime2(7),@p668 datetime2(7),@p669 nvarchar(4000),@p670 nvarchar(4000),@p671 nvarchar(4000),@p672 nvarchar(4000),@p673 nvarchar(4000),@p674 nvarchar(4000),@p675 nvarchar(4000),@p676 nvarchar(4000),@p677 nvarchar(4000),@p678 nvarchar(4000),@p679 nvarchar(4000),@p680 nvarchar(4000),@p681 nvarchar(4000),@p682 nvarchar(4000),@p683 datetime2(7),@p684 nvarchar(4000),@p685 nvarchar(4000),@p686 int,@p687 int,@p688 int,@p689 nvarchar(4000),@p690 nvarchar(4000),@p691 nvarchar(4000),@p692 nvarchar(4000),@p693 decimal(18,2),@p694 nvarchar(4000),@p695 nvarchar(4000),@p696 decimal(18,2),@p697 nvarchar(4000),@p698 nvarchar(4000),@p699 nvarchar(4000),@p700 nvarchar(4000),@p701 int,@p702 nvarchar(4000),@p703 nvarchar(4000),@p704 nvarchar(4000),@p705 nvarchar(4000),@p706 nvarchar(4000),@p707 nvarchar(4000),@p708 nvarchar(4000),@p709 nvarchar(4000),@p710 nvarchar(4000),@p711 nvarchar(4000),@p712 int,@p713 nvarchar(4000),@p714 nvarchar(4000),@p715 nvarchar(4000),@p716 nvarchar(4000),@p717 nvarchar(4000),@p718 int,@p719 nvarchar(4000),@p720 int,@p721 int,@p722 datetime2(7),@p723 datetime2(7),@p724 datetime2(7),@p725 nvarchar(4000),@p726 nvarchar(4000),@p727 nvarchar(4000),@p728 nvarchar(4000),@p729 nvarchar(4000),@p730 nvarchar(4000),@p731 nvarchar(4000),@p732 nvarchar(4000),@p733 nvarchar(4000),@p734 nvarchar(4000),@p735 nvarchar(4000),@p736 nvarchar(4000),@p737 nvarchar(4000),@p738 nvarchar(4000),@p739 datetime2(7),@p740 nvarchar(4000),@p741 nvarchar(4000),@p742 int,@p743 int,@p744 int,@p745 nvarchar(4000),@p746 nvarchar(4000),@p747 nvarchar(4000),@p748 nvarchar(4000),@p749 decimal(18,2),@p750 nvarchar(4000),@p751 nvarchar(4000),@p752 decimal(18,2),@p753 nvarchar(4000),@p754 nvarchar(4000),@p755 nvarchar(4000),@p756 nvarchar(4000),@p757 int,@p758 nvarchar(4000),@p759 nvarchar(4000),@p760 nvarchar(4000),@p761 nvarchar(4000),@p762 nvarchar(4000),@p763 nvarchar(4000),@p764 nvarchar(4000),@p765 nvarchar(4000),@p766 nvarchar(4000),@p767 nvarchar(4000),@p768 int,@p769 nvarchar(4000),@p770 nvarchar(4000),@p771 nvarchar(4000),@p772 nvarchar(4000),@p773 nvarchar(4000),@p774 int,@p775 nvarchar(4000),@p776 int,@p777 int,@p778 datetime2(7),@p779 datetime2(7),@p780 datetime2(7),@p781 nvarchar(4000),@p782 nvarchar(4000),@p783 nvarchar(4000),@p784 nvarchar(4000),@p785 nvarchar(4000),@p786 nvarchar(4000),@p787 nvarchar(4000),@p788 nvarchar(4000),@p789 nvarchar(4000),@p790 nvarchar(4000),@p791 nvarchar(4000),@p792 nvarchar(4000),@p793 nvarchar(4000),@p794 nvarchar(4000),@p795 datetime2(7),@p796 nvarchar(4000),@p797 nvarchar(4000),@p798 int,@p799 int,@p800 int,@p801 nvarchar(4000),@p802 nvarchar(4000),@p803 nvarchar(4000),@p804 nvarchar(4000),@p805 decimal(18,2),@p806 nvarchar(4000),@p807 nvarchar(4000),@p808 decimal(18,2),@p809 nvarchar(4000),@p810 nvarchar(4000),@p811 nvarchar(4000),@p812 nvarchar(4000),@p813 int,@p814 nvarchar(4000),@p815 nvarchar(4000),@p816 nvarchar(4000),@p817 nvarchar(4000),@p818 nvarchar(4000),@p819 nvarchar(4000),@p820 nvarchar(4000),@p821 nvarchar(4000),@p822 nvarchar(4000),@p823 nvarchar(4000),@p824 int,@p825 nvarchar(4000),@p826 nvarchar(4000),@p827 nvarchar(4000),@p828 nvarchar(4000),@p829 nvarchar(4000),@p830 int,@p831 nvarchar(4000),@p832 int,@p833 int,@p834 datetime2(7),@p835 datetime2(7),@p836 datetime2(7),@p837 nvarchar(4000),@p838 nvarchar(4000),@p839 nvarchar(4000),@p840 nvarchar(4000),@p841 nvarchar(4000),@p842 nvarchar(4000),@p843 nvarchar(4000),@p844 nvarchar(4000),@p845 nvarchar(4000),@p846 nvarchar(4000),@p847 nvarchar(4000),@p848 nvarchar(4000),@p849 nvarchar(4000),@p850 nvarchar(4000),@p851 datetime2(7),@p852 nvarchar(4000),@p853 nvarchar(4000),@p854 int,@p855 int,@p856 int,@p857 nvarchar(4000),@p858 nvarchar(4000),@p859 nvarchar(4000),@p860 nvarchar(4000),@p861 decimal(18,2),@p862 nvarchar(4000),@p863 nvarchar(4000),@p864 decimal(18,2),@p865 nvarchar(4000),@p866 nvarchar(4000),@p867 nvarchar(4000),@p868 nvarchar(4000),@p869 int,@p870 nvarchar(4000),@p871 nvarchar(4000),@p872 nvarchar(4000),@p873 nvarchar(4000),@p874 nvarchar(4000),@p875 nvarchar(4000),@p876 nvarchar(4000),@p877 nvarchar(4000),@p878 nvarchar(4000),@p879 nvarchar(4000),@p880 int,@p881 nvarchar(4000),@p882 nvarchar(4000),@p883 nvarchar(4000),@p884 nvarchar(4000),@p885 nvarchar(4000),@p886 int,@p887 nvarchar(4000),@p888 int,@p889 int,@p890 datetime2(7),@p891 datetime2(7),@p892 datetime2(7),@p893 nvarchar(4000),@p894 nvarchar(4000),@p895 nvarchar(4000),@p896 nvarchar(4000),@p897 nvarchar(4000),@p898 nvarchar(4000),@p899 nvarchar(4000),@p900 nvarchar(4000),@p901 nvarchar(4000),@p902 nvarchar(4000),@p903 nvarchar(4000),@p904 nvarchar(4000),@p905 nvarchar(4000),@p906 nvarchar(4000),@p907 datetime2(7),@p908 nvarchar(4000),@p909 nvarchar(4000),@p910 int,@p911 int,@p912 int,@p913 nvarchar(4000),@p914 nvarchar(4000),@p915 nvarchar(4000),@p916 nvarchar(4000),@p917 decimal(18,2),@p918 nvarchar(4000),@p919 nvarchar(4000),@p920 decimal(18,2),@p921 nvarchar(4000),@p922 nvarchar(4000),@p923 nvarchar(4000),@p924 nvarchar(4000),@p925 int,@p926 nvarchar(4000),@p927 nvarchar(4000),@p928 nvarchar(4000),@p929 nvarchar(4000),@p930 nvarchar(4000),@p931 nvarchar(4000),@p932 nvarchar(4000),@p933 nvarchar(4000),@p934 nvarchar(4000),@p935 nvarchar(4000),@p936 int,@p937 nvarchar(4000),@p938 nvarchar(4000),@p939 nvarchar(4000),@p940 nvarchar(4000),@p941 nvarchar(4000),@p942 int,@p943 nvarchar(4000),@p944 int,@p945 int,@p946 datetime2(7),@p947 datetime2(7),@p948 datetime2(7),@p949 nvarchar(4000),@p950 nvarchar(4000),@p951 nvarchar(4000),@p952 nvarchar(4000),@p953 nvarchar(4000),@p954 nvarchar(4000),@p955 nvarchar(4000),@p956 nvarchar(4000),@p957 nvarchar(4000),@p958 nvarchar(4000),@p959 nvarchar(4000),@p960 nvarchar(4000),@p961 nvarchar(4000),@p962 nvarchar(4000),@p963 datetime2(7),@p964 nvarchar(4000),@p965 nvarchar(4000),@p966 int,@p967 int,@p968 int,@p969 nvarchar(4000),@p970 nvarchar(4000),@p971 nvarchar(4000),@p972 nvarchar(4000),@p973 decimal(18,2),@p974 nvarchar(4000),@p975 nvarchar(4000),@p976 decimal(18,2),@p977 nvarchar(4000),@p978 nvarchar(4000),@p979 nvarchar(4000),@p980 nvarchar(4000),@p981 int,@p982 nvarchar(4000),@p983 nvarchar(4000),@p984 nvarchar(4000),@p985 nvarchar(4000),@p986 nvarchar(4000),@p987 nvarchar(4000),@p988 nvarchar(4000),@p989 nvarchar(4000),@p990 nvarchar(4000),@p991 nvarchar(4000),@p992 int,@p993 nvarchar(4000),@p994 nvarchar(4000),@p995 nvarchar(4000),@p996 nvarchar(4000),@p997 nvarchar(4000),@p998 int,@p999 nvarchar(4000),@p1000 int,@p1001 int,@p1002 datetime2(7),@p1003 datetime2(7),@p1004 datetime2(7),@p1005 nvarchar(4000),@p1006 nvarchar(4000),@p1007 nvarchar(4000),@p1008 nvarchar(4000),@p1009 nvarchar(4000),@p1010 nvarchar(4000),@p1011 nvarchar(4000),@p1012 nvarchar(4000),@p1013 nvarchar(4000),@p1014 nvarchar(4000),@p1015 nvarchar(4000),@p1016 nvarchar(4000),@p1017 nvarchar(4000),@p1018 nvarchar(4000),@p1019 datetime2(7),@p1020 nvarchar(4000),@p1021 nvarchar(4000),@p1022 int,@p1023 int,@p1024 int,@p1025 nvarchar(4000),@p1026 nvarchar(4000),@p1027 nvarchar(4000),@p1028 nvarchar(4000),@p1029 decimal(18,2),@p1030 nvarchar(4000),@p1031 nvarchar(4000),@p1032 decimal(18,2),@p1033 nvarchar(4000),@p1034 nvarchar(4000),@p1035 nvarchar(4000),@p1036 nvarchar(4000),@p1037 int,@p1038 nvarchar(4000),@p1039 nvarchar(4000),@p1040 nvarchar(4000),@p1041 nvarchar(4000),@p1042 nvarchar(4000),@p1043 nvarchar(4000),@p1044 nvarchar(4000),@p1045 nvarchar(4000),@p1046 nvarchar(4000),@p1047 nvarchar(4000),@p1048 int,@p1049 nvarchar(4000),@p1050 nvarchar(4000),@p1051 nvarchar(4000),@p1052 nvarchar(4000),@p1053 nvarchar(4000),@p1054 int,@p1055 nvarchar(4000),@p1056 int,@p1057 int,@p1058 datetime2(7),@p1059 datetime2(7),@p1060 datetime2(7),@p1061 nvarchar(4000),@p1062 nvarchar(4000),@p1063 nvarchar(4000),@p1064 nvarchar(4000),@p1065 nvarchar(4000),@p1066 nvarchar(4000),@p1067 nvarchar(4000),@p1068 nvarchar(4000),@p1069 nvarchar(4000),@p1070 nvarchar(4000),@p1071 nvarchar(4000),@p1072 nvarchar(4000),@p1073 nvarchar(4000),@p1074 nvarchar(4000),@p1075 datetime2(7),@p1076 nvarchar(4000),@p1077 nvarchar(4000),@p1078 int,@p1079 int,@p1080 int,@p1081 nvarchar(4000),@p1082 nvarchar(4000),@p1083 nvarchar(4000),@p1084 nvarchar(4000),@p1085 decimal(18,2),@p1086 nvarchar(4000),@p1087 nvarchar(4000),@p1088 decimal(18,2),@p1089 nvarchar(4000),@p1090 nvarchar(4000),@p1091 nvarchar(4000),@p1092 nvarchar(4000),@p1093 int,@p1094 nvarchar(4000),@p1095 nvarchar(4000),@p1096 nvarchar(4000),@p1097 nvarchar(4000),@p1098 nvarchar(4000),@p1099 nvarchar(4000),@p1100 nvarchar(4000),@p1101 nvarchar(4000),@p1102 nvarchar(4000),@p1103 nvarchar(4000),@p1104 int,@p1105 nvarchar(4000),@p1106 nvarchar(4000),@p1107 nvarchar(4000),@p1108 nvarchar(4000),@p1109 nvarchar(4000),@p1110 int,@p1111 nvarchar(4000),@p1112 int,@p1113 int,@p1114 datetime2(7),@p1115 datetime2(7),@p1116 datetime2(7),@p1117 nvarchar(4000),@p1118 nvarchar(4000),@p1119 nvarchar(4000),@p1120 nvarchar(4000),@p1121 nvarchar(4000),@p1122 nvarchar(4000),@p1123 nvarchar(4000),@p1124 nvarchar(4000),@p1125 nvarchar(4000),@p1126 nvarchar(4000),@p1127 nvarchar(4000),@p1128 nvarchar(4000),@p1129 nvarchar(4000),@p1130 nvarchar(4000),@p1131 datetime2(7),@p1132 nvarchar(4000),@p1133 nvarchar(4000),@p1134 int,@p1135 int,@p1136 int,@p1137 nvarchar(4000),@p1138 nvarchar(4000),@p1139 nvarchar(4000),@p1140 nvarchar(4000),@p1141 decimal(18,2),@p1142 nvarchar(4000),@p1143 nvarchar(4000),@p1144 decimal(18,2),@p1145 nvarchar(4000),@p1146 nvarchar(4000),@p1147 nvarchar(4000),@p1148 nvarchar(4000),@p1149 int,@p1150 nvarchar(4000),@p1151 nvarchar(4000),@p1152 nvarchar(4000),@p1153 nvarchar(4000),@p1154 nvarchar(4000),@p1155 nvarchar(4000),@p1156 nvarchar(4000),@p1157 nvarchar(4000),@p1158 nvarchar(4000),@p1159 nvarchar(4000),@p1160 int,@p1161 nvarchar(4000),@p1162 nvarchar(4000),@p1163 nvarchar(4000),@p1164 nvarchar(4000),@p1165 nvarchar(4000),@p1166 int,@p1167 nvarchar(4000),@p1168 int,@p1169 int,@p1170 datetime2(7),@p1171 datetime2(7),@p1172 datetime2(7),@p1173 nvarchar(4000),@p1174 nvarchar(4000),@p1175 nvarchar(4000),@p1176 nvarchar(4000),@p1177 nvarchar(4000),@p1178 nvarchar(4000),@p1179 nvarchar(4000),@p1180 nvarchar(4000),@p1181 nvarchar(4000),@p1182 nvarchar(4000),@p1183 nvarchar(4000),@p1184 nvarchar(4000),@p1185 nvarchar(4000),@p1186 nvarchar(4000),@p1187 datetime2(7),@p1188 nvarchar(4000),@p1189 nvarchar(4000),@p1190 int,@p1191 int,@p1192 int,@p1193 nvarchar(4000),@p1194 nvarchar(4000),@p1195 nvarchar(4000),@p1196 decimal(18,2),@p1197 decimal(18,2),@p1198 nvarchar(4000),@p1199 nvarchar(4000),@p1200 decimal(18,2),@p1201 nvarchar(4000),@p1202 nvarchar(4000),@p1203 nvarchar(4000),@p1204 nvarchar(4000),@p1205 int,@p1206 nvarchar(4000),@p1207 nvarchar(4000),@p1208 nvarchar(4000),@p1209 nvarchar(4000),@p1210 nvarchar(4000),@p1211 nvarchar(4000),@p1212 nvarchar(4000),@p1213 nvarchar(4000),@p1214 nvarchar(4000),@p1215 nvarchar(4000),@p1216 int,@p1217 nvarchar(4000),@p1218 nvarchar(4000),@p1219 nvarchar(4000),@p1220 nvarchar(4000),@p1221 nvarchar(4000),@p1222 int,@p1223 nvarchar(4000),@p1224 int,@p1225 int,@p1226 datetime2(7),@p1227 datetime2(7),@p1228 datetime2(7),@p1229 nvarchar(4000),@p1230 nvarchar(4000),@p1231 nvarchar(4000),@p1232 nvarchar(4000),@p1233 nvarchar(4000),@p1234 nvarchar(4000),@p1235 nvarchar(4000),@p1236 nvarchar(4000),@p1237 nvarchar(4000),@p1238 nvarchar(4000),@p1239 nvarchar(4000),@p1240 nvarchar(4000),@p1241 nvarchar(4000),@p1242 nvarchar(4000),@p1243 datetime2(7),@p1244 nvarchar(4000),@p1245 nvarchar(4000),@p1246 int,@p1247 int,@p1248 int,@p1249 nvarchar(4000),@p1250 nvarchar(4000),@p1251 nvarchar(4000),@p1252 decimal(18,2),@p1253 decimal(18,2),@p1254 nvarchar(4000),@p1255 nvarchar(4000),@p1256 decimal(18,2),@p1257 nvarchar(4000),@p1258 nvarchar(4000),@p1259 nvarchar(4000),@p1260 nvarchar(4000),@p1261 int,@p1262 nvarchar(4000),@p1263 nvarchar(4000),@p1264 nvarchar(4000),@p1265 nvarchar(4000),@p1266 nvarchar(4000),@p1267 nvarchar(4000),@p1268 nvarchar(4000),@p1269 nvarchar(4000),@p1270 nvarchar(4000),@p1271 nvarchar(4000),@p1272 int,@p1273 nvarchar(4000),@p1274 nvarchar(4000),@p1275 nvarchar(4000),@p1276 nvarchar(4000),@p1277 nvarchar(4000),@p1278 int,@p1279 nvarchar(4000),@p1280 int,@p1281 int,@p1282 datetime2(7),@p1283 datetime2(7),@p1284 datetime2(7),@p1285 nvarchar(4000),@p1286 nvarchar(4000),@p1287 nvarchar(4000),@p1288 nvarchar(4000),@p1289 nvarchar(4000),@p1290 nvarchar(4000),@p1291 nvarchar(4000),@p1292 nvarchar(4000),@p1293 nvarchar(4000),@p1294 nvarchar(4000),@p1295 nvarchar(4000),@p1296 nvarchar(4000),@p1297 nvarchar(4000),@p1298 nvarchar(4000),@p1299 datetime2(7),@p1300 nvarchar(4000),@p1301 nvarchar(4000),@p1302 int,@p1303 int,@p1304 int,@p1305 nvarchar(4000),@p1306 nvarchar(4000),@p1307 nvarchar(4000),@p1308 decimal(18,2),@p1309 decimal(18,2),@p1310 nvarchar(4000),@p1311 nvarchar(4000),@p1312 decimal(18,2),@p1313 nvarchar(4000),@p1314 nvarchar(4000),@p1315 nvarchar(4000),@p1316 nvarchar(4000),@p1317 int,@p1318 nvarchar(4000),@p1319 nvarchar(4000),@p1320 nvarchar(4000),@p1321 nvarchar(4000),@p1322 nvarchar(4000),@p1323 nvarchar(4000),@p1324 nvarchar(4000),@p1325 nvarchar(4000),@p1326 nvarchar(4000),@p1327 nvarchar(4000),@p1328 int,@p1329 nvarchar(4000),@p1330 nvarchar(4000),@p1331 nvarchar(4000),@p1332 nvarchar(4000),@p1333 nvarchar(4000),@p1334 int,@p1335 nvarchar(4000),@p1336 int,@p1337 int,@p1338 datetime2(7),@p1339 datetime2(7),@p1340 datetime2(7),@p1341 nvarchar(4000),@p1342 nvarchar(4000),@p1343 nvarchar(4000),@p1344 nvarchar(4000),@p1345 nvarchar(4000),@p1346 nvarchar(4000),@p1347 nvarchar(4000),@p1348 nvarchar(4000),@p1349 nvarchar(4000),@p1350 nvarchar(4000),@p1351 nvarchar(4000),@p1352 nvarchar(4000),@p1353 nvarchar(4000),@p1354 nvarchar(4000),@p1355 datetime2(7),@p1356 nvarchar(4000),@p1357 nvarchar(4000),@p1358 int,@p1359 int,@p1360 int,@p1361 nvarchar(4000),@p1362 nvarchar(4000),@p1363 nvarchar(4000),@p1364 decimal(18,2),@p1365 decimal(18,2),@p1366 nvarchar(4000),@p1367 nvarchar(4000),@p1368 decimal(18,2),@p1369 nvarchar(4000),@p1370 nvarchar(4000),@p1371 nvarchar(4000),@p1372 nvarchar(4000),@p1373 int,@p1374 nvarchar(4000),@p1375 nvarchar(4000),@p1376 nvarchar(4000),@p1377 nvarchar(4000),@p1378 nvarchar(4000),@p1379 nvarchar(4000),@p1380 nvarchar(4000),@p1381 nvarchar(4000),@p1382 nvarchar(4000),@p1383 nvarchar(4000),@p1384 int,@p1385 nvarchar(4000),@p1386 nvarchar(4000),@p1387 nvarchar(4000),@p1388 nvarchar(4000),@p1389 nvarchar(4000),@p1390 int,@p1391 nvarchar(4000),@p1392 int,@p1393 int,@p1394 datetime2(7),@p1395 datetime2(7),@p1396 datetime2(7),@p1397 nvarchar(4000),@p1398 nvarchar(4000),@p1399 nvarchar(4000),@p1400 nvarchar(4000),@p1401 nvarchar(4000),@p1402 nvarchar(4000),@p1403 nvarchar(4000),@p1404 nvarchar(4000),@p1405 nvarchar(4000),@p1406 nvarchar(4000),@p1407 nvarchar(4000),@p1408 nvarchar(4000),@p1409 nvarchar(4000),@p1410 nvarchar(4000),@p1411 datetime2(7),@p1412 nvarchar(4000),@p1413 nvarchar(4000),@p1414 int,@p1415 int,@p1416 int,@p1417 nvarchar(4000),@p1418 nvarchar(4000),@p1419 nvarchar(4000),@p1420 decimal(18,2),@p1421 decimal(18,2),@p1422 nvarchar(4000),@p1423 nvarchar(4000),@p1424 decimal(18,2),@p1425 nvarchar(4000),@p1426 nvarchar(4000),@p1427 nvarchar(4000),@p1428 nvarchar(4000),@p1429 int,@p1430 nvarchar(4000),@p1431 nvarchar(4000),@p1432 nvarchar(4000),@p1433 nvarchar(4000),@p1434 nvarchar(4000),@p1435 nvarchar(4000),@p1436 nvarchar(4000),@p1437 nvarchar(4000),@p1438 nvarchar(4000),@p1439 nvarchar(4000),@p1440 int,@p1441 nvarchar(4000),@p1442 nvarchar(4000),@p1443 nvarchar(4000),@p1444 nvarchar(4000),@p1445 nvarchar(4000),@p1446 int,@p1447 nvarchar(4000),@p1448 int,@p1449 int,@p1450 datetime2(7),@p1451 datetime2(7),@p1452 datetime2(7),@p1453 nvarchar(4000),@p1454 nvarchar(4000),@p1455 nvarchar(4000),@p1456 nvarchar(4000),@p1457 nvarchar(4000),@p1458 nvarchar(4000),@p1459 nvarchar(4000),@p1460 nvarchar(4000),@p1461 nvarchar(4000),@p1462 nvarchar(4000),@p1463 nvarchar(4000),@p1464 nvarchar(4000),@p1465 nvarchar(4000),@p1466 nvarchar(4000),@p1467 datetime2(7),@p1468 nvarchar(4000),@p1469 nvarchar(4000),@p1470 int,@p1471 int,@p1472 int,@p1473 nvarchar(4000),@p1474 nvarchar(4000),@p1475 nvarchar(4000),@p1476 decimal(18,2),@p1477 decimal(18,2),@p1478 nvarchar(4000),@p1479 nvarchar(4000),@p1480 decimal(18,2),@p1481 nvarchar(4000),@p1482 nvarchar(4000),@p1483 nvarchar(4000),@p1484 nvarchar(4000),@p1485 int,@p1486 nvarchar(4000),@p1487 nvarchar(4000),@p1488 nvarchar(4000),@p1489 nvarchar(4000),@p1490 nvarchar(4000),@p1491 nvarchar(4000),@p1492 nvarchar(4000),@p1493 nvarchar(4000),@p1494 nvarchar(4000),@p1495 nvarchar(4000),@p1496 int,@p1497 nvarchar(4000),@p1498 nvarchar(4000),@p1499 nvarchar(4000),@p1500 nvarchar(4000),@p1501 nvarchar(4000),@p1502 int,@p1503 nvarchar(4000),@p1504 int,@p1505 int,@p1506 datetime2(7),@p1507 datetime2(7),@p1508 datetime2(7),@p1509 nvarchar(4000),@p1510 nvarchar(4000),@p1511 nvarchar(4000),@p1512 nvarchar(4000),@p1513 nvarchar(4000),@p1514 nvarchar(4000),@p1515 nvarchar(4000),@p1516 nvarchar(4000),@p1517 nvarchar(4000),@p1518 nvarchar(4000),@p1519 nvarchar(4000),@p1520 nvarchar(4000),@p1521 nvarchar(4000),@p1522 nvarchar(4000),@p1523 datetime2(7),@p1524 nvarchar(4000),@p1525 nvarchar(4000),@p1526 int,@p1527 int,@p1528 int,@p1529 nvarchar(4000),@p1530 nvarchar(4000),@p1531 nvarchar(4000),@p1532 decimal(18,2),@p1533 decimal(18,2),@p1534 nvarchar(4000),@p1535 nvarchar(4000),@p1536 decimal(18,2),@p1537 nvarchar(4000),@p1538 nvarchar(4000),@p1539 nvarchar(4000),@p1540 nvarchar(4000),@p1541 int,@p1542 nvarchar(4000),@p1543 nvarchar(4000),@p1544 nvarchar(4000),@p1545 nvarchar(4000),@p1546 nvarchar(4000),@p1547 nvarchar(4000),@p1548 nvarchar(4000),@p1549 nvarchar(4000),@p1550 nvarchar(4000),@p1551 nvarchar(4000),@p1552 int,@p1553 nvarchar(4000),@p1554 nvarchar(4000),@p1555 nvarchar(4000),@p1556 nvarchar(4000),@p1557 nvarchar(4000),@p1558 int,@p1559 nvarchar(4000),@p1560 int,@p1561 int,@p1562 datetime2(7),@p1563 datetime2(7),@p1564 datetime2(7),@p1565 nvarchar(4000),@p1566 nvarchar(4000),@p1567 nvarchar(4000),@p1568 nvarchar(4000),@p1569 nvarchar(4000),@p1570 nvarchar(4000),@p1571 nvarchar(4000),@p1572 nvarchar(4000),@p1573 nvarchar(4000),@p1574 nvarchar(4000),@p1575 nvarchar(4000),@p1576 nvarchar(4000),@p1577 nvarchar(4000),@p1578 nvarchar(4000),@p1579 datetime2(7),@p1580 nvarchar(4000),@p1581 nvarchar(4000),@p1582 int,@p1583 int,@p1584 int,@p1585 nvarchar(4000),@p1586 nvarchar(4000),@p1587 nvarchar(4000),@p1588 decimal(18,2),@p1589 decimal(18,2),@p1590 nvarchar(4000),@p1591 nvarchar(4000),@p1592 decimal(18,2),@p1593 nvarchar(4000),@p1594 nvarchar(4000),@p1595 nvarchar(4000),@p1596 nvarchar(4000),@p1597 int,@p1598 nvarchar(4000),@p1599 nvarchar(4000),@p1600 nvarchar(4000),@p1601 nvarchar(4000),@p1602 nvarchar(4000),@p1603 nvarchar(4000),@p1604 nvarchar(4000),@p1605 nvarchar(4000),@p1606 nvarchar(4000),@p1607 nvarchar(4000),@p1608 int,@p1609 nvarchar(4000),@p1610 nvarchar(4000),@p1611 nvarchar(4000),@p1612 nvarchar(4000),@p1613 nvarchar(4000),@p1614 int,@p1615 nvarchar(4000),@p1616 int,@p1617 int,@p1618 datetime2(7),@p1619 datetime2(7),@p1620 datetime2(7),@p1621 nvarchar(4000),@p1622 nvarchar(4000),@p1623 nvarchar(4000),@p1624 nvarchar(4000),@p1625 nvarchar(4000),@p1626 nvarchar(4000),@p1627 nvarchar(4000),@p1628 nvarchar(4000),@p1629 nvarchar(4000),@p1630 nvarchar(4000),@p1631 nvarchar(4000),@p1632 nvarchar(4000),@p1633 nvarchar(4000),@p1634 nvarchar(4000),@p1635 datetime2(7),@p1636 nvarchar(4000),@p1637 nvarchar(4000),@p1638 int,@p1639 int,@p1640 int,@p1641 nvarchar(4000),@p1642 nvarchar(4000),@p1643 nvarchar(4000),@p1644 decimal(18,2),@p1645 decimal(18,2),@p1646 nvarchar(4000),@p1647 nvarchar(4000),@p1648 decimal(18,2),@p1649 nvarchar(4000),@p1650 nvarchar(4000),@p1651 nvarchar(4000),@p1652 nvarchar(4000),@p1653 int,@p1654 nvarchar(4000),@p1655 nvarchar(4000),@p1656 nvarchar(4000),@p1657 nvarchar(4000),@p1658 nvarchar(4000),@p1659 nvarchar(4000),@p1660 nvarchar(4000),@p1661 nvarchar(4000),@p1662 nvarchar(4000),@p1663 nvarchar(4000),@p1664 int,@p1665 nvarchar(4000),@p1666 nvarchar(4000),@p1667 nvarchar(4000),@p1668 nvarchar(4000),@p1669 nvarchar(4000),@p1670 int,@p1671 nvarchar(4000),@p1672 int,@p1673 int,@p1674 datetime2(7),@p1675 datetime2(7),@p1676 datetime2(7),@p1677 nvarchar(4000),@p1678 nvarchar(4000),@p1679 nvarchar(4000),@p1680 nvarchar(4000),@p1681 nvarchar(4000),@p1682 nvarchar(4000),@p1683 nvarchar(4000),@p1684 nvarchar(4000),@p1685 nvarchar(4000),@p1686 nvarchar(4000),@p1687 nvarchar(4000),@p1688 nvarchar(4000),@p1689 nvarchar(4000),@p1690 nvarchar(4000),@p1691 datetime2(7),@p1692 nvarchar(4000),@p1693 nvarchar(4000),@p1694 int,@p1695 int,@p1696 int,@p1697 nvarchar(4000),@p1698 nvarchar(4000),@p1699 nvarchar(4000),@p1700 decimal(18,2),@p1701 decimal(18,2),@p1702 nvarchar(4000),@p1703 nvarchar(4000),@p1704 decimal(18,2),@p1705 nvarchar(4000),@p1706 nvarchar(4000),@p1707 nvarchar(4000),@p1708 nvarchar(4000),@p1709 int,@p1710 nvarchar(4000),@p1711 nvarchar(4000),@p1712 nvarchar(4000),@p1713 nvarchar(4000),@p1714 nvarchar(4000),@p1715 nvarchar(4000),@p1716 nvarchar(4000),@p1717 nvarchar(4000),@p1718 nvarchar(4000),@p1719 nvarchar(4000),@p1720 int,@p1721 nvarchar(4000),@p1722 nvarchar(4000),@p1723 nvarchar(4000),@p1724 nvarchar(4000),@p1725 nvarchar(4000),@p1726 int,@p1727 nvarchar(4000),@p1728 int,@p1729 int,@p1730 datetime2(7),@p1731 datetime2(7),@p1732 datetime2(7),@p1733 nvarchar(4000),@p1734 nvarchar(4000),@p1735 nvarchar(4000),@p1736 nvarchar(4000),@p1737 nvarchar(4000),@p1738 nvarchar(4000),@p1739 nvarchar(4000),@p1740 nvarchar(4000),@p1741 nvarchar(4000),@p1742 nvarchar(4000),@p1743 nvarchar(4000),@p1744 nvarchar(4000),@p1745 nvarchar(4000),@p1746 nvarchar(4000),@p1747 datetime2(7),@p1748 nvarchar(4000),@p1749 nvarchar(4000),@p1750 int,@p1751 int,@p1752 int,@p1753 nvarchar(4000),@p1754 nvarchar(4000),@p1755 nvarchar(4000),@p1756 nvarchar(4000),@p1757 decimal(18,2),@p1758 nvarchar(4000),@p1759 nvarchar(4000),@p1760 decimal(18,2),@p1761 nvarchar(4000),@p1762 nvarchar(4000),@p1763 nvarchar(4000),@p1764 nvarchar(4000),@p1765 int,@p1766 nvarchar(4000),@p1767 nvarchar(4000),@p1768 nvarchar(4000),@p1769 nvarchar(4000),@p1770 nvarchar(4000),@p1771 nvarchar(4000),@p1772 nvarchar(4000),@p1773 nvarchar(4000),@p1774 nvarchar(4000),@p1775 nvarchar(4000),@p1776 int,@p1777 nvarchar(4000),@p1778 nvarchar(4000),@p1779 nvarchar(4000),@p1780 nvarchar(4000),@p1781 nvarchar(4000),@p1782 int,@p1783 nvarchar(4000),@p1784 int,@p1785 int,@p1786 datetime2(7),@p1787 datetime2(7),@p1788 datetime2(7),@p1789 nvarchar(4000),@p1790 nvarchar(4000),@p1791 nvarchar(4000),@p1792 nvarchar(4000),@p1793 nvarchar(4000),@p1794 nvarchar(4000),@p1795 nvarchar(4000),@p1796 nvarchar(4000),@p1797 nvarchar(4000),@p1798 nvarchar(4000),@p1799 nvarchar(4000),@p1800 nvarchar(4000),@p1801 nvarchar(4000),@p1802 nvarchar(4000),@p1803 datetime2(7),@p1804 nvarchar(4000),@p1805 nvarchar(4000),@p1806 int,@p1807 int,@p1808 int,@p1809 nvarchar(4000),@p1810 nvarchar(4000),@p1811 nvarchar(4000),@p1812 decimal(18,2),@p1813 decimal(18,2),@p1814 nvarchar(4000),@p1815 nvarchar(4000),@p1816 decimal(18,2),@p1817 nvarchar(4000),@p1818 nvarchar(4000),@p1819 nvarchar(4000),@p1820 nvarchar(4000),@p1821 int,@p1822 nvarchar(4000),@p1823 nvarchar(4000),@p1824 nvarchar(4000),@p1825 nvarchar(4000),@p1826 nvarchar(4000),@p1827 nvarchar(4000),@p1828 nvarchar(4000),@p1829 nvarchar(4000),@p1830 nvarchar(4000),@p1831 nvarchar(4000),@p1832 int,@p1833 nvarchar(4000),@p1834 nvarchar(4000),@p1835 nvarchar(4000),@p1836 nvarchar(4000),@p1837 nvarchar(4000),@p1838 int,@p1839 nvarchar(4000),@p1840 int,@p1841 int,@p1842 datetime2(7),@p1843 datetime2(7),@p1844 datetime2(7),@p1845 nvarchar(4000),@p1846 nvarchar(4000),@p1847 nvarchar(4000),@p1848 nvarchar(4000),@p1849 nvarchar(4000),@p1850 nvarchar(4000),@p1851 nvarchar(4000),@p1852 nvarchar(4000),@p1853 nvarchar(4000),@p1854 nvarchar(4000),@p1855 nvarchar(4000),@p1856 nvarchar(4000),@p1857 nvarchar(4000),@p1858 nvarchar(4000),@p1859 datetime2(7),@p1860 nvarchar(4000),@p1861 nvarchar(4000),@p1862 int,@p1863 int,@p1864 int,@p1865 nvarchar(4000),@p1866 nvarchar(4000),@p1867 nvarchar(4000),@p1868 nvarchar(4000),@p1869 decimal(18,2),@p1870 nvarchar(4000),@p1871 nvarchar(4000),@p1872 decimal(18,2),@p1873 nvarchar(4000),@p1874 nvarchar(4000),@p1875 nvarchar(4000),@p1876 nvarchar(4000),@p1877 int,@p1878 nvarchar(4000),@p1879 nvarchar(4000),@p1880 nvarchar(4000),@p1881 nvarchar(4000),@p1882 nvarchar(4000),@p1883 nvarchar(4000),@p1884 nvarchar(4000),@p1885 nvarchar(4000),@p1886 nvarchar(4000),@p1887 nvarchar(4000),@p1888 int,@p1889 nvarchar(4000),@p1890 nvarchar(4000),@p1891 nvarchar(4000),@p1892 nvarchar(4000),@p1893 nvarchar(4000),@p1894 int,@p1895 nvarchar(4000),@p1896 int,@p1897 int,@p1898 datetime2(7),@p1899 datetime2(7),@p1900 datetime2(7),@p1901 nvarchar(4000),@p1902 nvarchar(4000),@p1903 nvarchar(4000),@p1904 nvarchar(4000),@p1905 nvarchar(4000),@p1906 nvarchar(4000),@p1907 nvarchar(4000),@p1908 nvarchar(4000),@p1909 nvarchar(4000),@p1910 nvarchar(4000),@p1911 nvarchar(4000),@p1912 nvarchar(4000),@p1913 nvarchar(4000),@p1914 nvarchar(4000),@p1915 datetime2(7),@p1916 nvarchar(4000),@p1917 nvarchar(4000),@p1918 int,@p1919 int,@p1920 int,@p1921 nvarchar(4000),@p1922 nvarchar(4000),@p1923 nvarchar(4000),@p1924 nvarchar(4000),@p1925 decimal(18,2),@p1926 nvarchar(4000),@p1927 nvarchar(4000),@p1928 decimal(18,2),@p1929 nvarchar(4000),@p1930 nvarchar(4000),@p1931 nvarchar(4000),@p1932 nvarchar(4000),@p1933 int,@p1934 nvarchar(4000),@p1935 nvarchar(4000),@p1936 nvarchar(4000),@p1937 nvarchar(4000),@p1938 nvarchar(4000),@p1939 nvarchar(4000),@p1940 nvarchar(4000),@p1941 nvarchar(4000),@p1942 nvarchar(4000),@p1943 nvarchar(4000),@p1944 int,@p1945 nvarchar(4000),@p1946 nvarchar(4000),@p1947 nvarchar(4000),@p1948 nvarchar(4000),@p1949 nvarchar(4000),@p1950 int,@p1951 nvarchar(4000),@p1952 int,@p1953 int,@p1954 datetime2(7),@p1955 datetime2(7),@p1956 datetime2(7),@p1957 nvarchar(4000),@p1958 nvarchar(4000),@p1959 nvarchar(4000),@p1960 nvarchar(4000),@p1961 nvarchar(4000),@p1962 nvarchar(4000),@p1963 nvarchar(4000),@p1964 nvarchar(4000),@p1965 nvarchar(4000),@p1966 nvarchar(4000),@p1967 nvarchar(4000),@p1968 nvarchar(4000),@p1969 nvarchar(4000),@p1970 nvarchar(4000),@p1971 datetime2(7),@p1972 nvarchar(4000),@p1973 nvarchar(4000),@p1974 int,@p1975 int,@p1976 int,@p1977 nvarchar(4000),@p1978 nvarchar(4000),@p1979 nvarchar(4000),@p1980 nvarchar(4000),@p1981 decimal(18,2),@p1982 nvarchar(4000),@p1983 nvarchar(4000),@p1984 decimal(18,2),@p1985 nvarchar(4000),@p1986 nvarchar(4000),@p1987 nvarchar(4000),@p1988 nvarchar(4000),@p1989 int,@p1990 nvarchar(4000),@p1991 nvarchar(4000),@p1992 nvarchar(4000),@p1993 nvarchar(4000),@p1994 nvarchar(4000),@p1995 nvarchar(4000),@p1996 nvarchar(4000),@p1997 nvarchar(4000),@p1998 nvarchar(4000),@p1999 nvarchar(4000),@p2000 int,@p2001 nvarchar(4000),@p2002 nvarchar(4000),@p2003 nvarchar(4000),@p2004 nvarchar(4000),@p2005 nvarchar(4000),@p2006 int,@p2007 nvarchar(4000),@p2008 int,@p2009 int,@p2010 datetime2(7),@p2011 datetime2(7),@p2012 datetime2(7),@p2013 nvarchar(4000),@p2014 nvarchar(4000),@p2015 nvarchar(4000),@p2016 nvarchar(4000),@p2017 nvarchar(4000),@p2018 nvarchar(4000),@p2019 nvarchar(4000),@p2020 nvarchar(4000),@p2021 nvarchar(4000),@p2022 nvarchar(4000),@p2023 nvarchar(4000),@p2024 nvarchar(4000),@p2025 nvarchar(4000),@p2026 nvarchar(4000),@p2027 datetime2(7),@p2028 nvarchar(4000),@p2029 nvarchar(4000),@p2030 int,@p2031 int,@p2032 int,@p2033 nvarchar(4000),@p2034 nvarchar(4000),@p2035 nvarchar(4000),@p2036 nvarchar(4000),@p2037 decimal(18,2),@p2038 nvarchar(4000),@p2039 nvarchar(4000),@p2040 decimal(18,2),@p2041 nvarchar(4000),@p2042 nvarchar(4000),@p2043 nvarchar(4000),@p2044 nvarchar(4000),@p2045 int,@p2046 nvarchar(4000),@p2047 nvarchar(4000),@p2048 nvarchar(4000),@p2049 nvarchar(4000),@p2050 nvarchar(4000),@p2051 nvarchar(4000),@p2052 nvarchar(4000),@p2053 nvarchar(4000),@p2054 nvarchar(4000),@p2055 nvarchar(4000),@p2056 int,@p2057 nvarchar(4000),@p2058 nvarchar(4000),@p2059 nvarchar(4000),@p2060 nvarchar(4000),@p2061 nvarchar(4000),@p2062 int,@p2063 nvarchar(4000),@p2064 int,@p2065 int,@p2066 datetime2(7),@p2067 datetime2(7),@p2068 datetime2(7),@p2069 nvarchar(4000),@p2070 nvarchar(4000),@p2071 nvarchar(4000))SET NOCOUNT ON; DECLARE @inserted0 TABLE ([item_id] int, [_Position] [int]); MERGE [raw_data] USING ( VALUES (@p0, @p1, @p2, @p3, @p4, @p5, @p6, @p7, @p8, @p9, @p10, @p11, @p12, @p13, @p14, @p15, @p16, @p17, @p18, @p19, @p20, @p21, @p22, @p23, @p24, @p25, @p26, @p27, @p28, @p29, @p30, @p31, @p32, @p33, @p34, @p35, @p36, @p37, @p38, @p39, @p40, @p41, @p42, @p43, @p44, @p45, @p46, @p47, @p48, @p49, @p50, @p51, @p52, @p53, @p54, @p55, 0), (@p56, @p57, @p58, @p59, @p60, @p61, @p62, @p63, @p64, @p65, @p66, @p67, @p68, @p69, @p70, @p71, @p72, @p73, @p74, @p75, @p76, @p77, @p78, @p79, @p80, @p81, @p82, @p83, @p84, @p85, @p86, @p87, @p88, @p89, @p90, @p91, @p92, @p93, @p94, @p95, @p96, @p97, @p98, @p99, @p100, @p101, @p102, @p103, @p104, @p105, @p106, @p107, @p108, @p109, @p110, @p111, 1), (@p112, @p113, @p114, @p115, @p116, @p117, @p118, @p119, @p120, @p121, @p122, @p123, @p124, @p125, @p126, @p127, @p128, @p129, @p130, @p131, @p132, @p133, @p134, @p135, @p136, @p137, @p138, @p139, @p140, @p141, @p142, @p143, @p144, @p145, @p146, @p147, @p148, @p149, @p150, @p151, @p152, @p153, @p154, @p155, @p156, @p157, @p158, @p159, @p160, @p161, @p162, @p163, @p164, @p165, @p166, @p167, 2), (@p168, @p169, @p170, @p171, @p172, @p173, @p174, @p175, @p176, @p177, @p178, @p179, @p180, @p181, @p182, @p183, @p184, @p185, @p186, @p187, @p188, @p189, @p190, @p191, @p192, @p193, @p194, @p195, @p196, @p197, @p198, @p199, @p200, @p201, @p202, @p203, @p204, @p205, @p206, @p207, @p208, @p209, @p210, @p211, @p212, @p213, @p214, @p215, @p216, @p217, @p218, @p219, @p220, @p221, @p222, @p223, 3), (@p224, @p225, @p226, @p227, @p228, @p229, @p230, @p231, @p232, @p233, @p234, @p235, @p236, @p237, @p238, @p239, @p240, @p241, @p242, @p243, @p244, @p245, @p246, @p247, @p248, @p249, @p250, @p251, @p252, @p253, @p254, @p255, @p256, @p257, @p258, @p259, @p260, @p261, @p262, @p263, @p264, @p265, @p266, @p267, @p268, @p269, @p270, @p271, @p272, @p273, @p274, @p275, @p276, @p277, @p278, @p279, 4), (@p280, @p281, @p282, @p283, @p284, @p285, @p286, @p287, @p288, @p289, @p290, @p291, @p292, @p293, @p294, @p295, @p296, @p297, @p298, @p299, @p300, @p301, @p302, @p303, @p304, @p305, @p306, @p307, @p308, @p309, @p310, @p311, @p312, @p313, @p314, @p315, @p316, @p317, @p318, @p319, @p320, @p321, @p322, @p323, @p324, @p325, @p326, @p327, @p328, @p329, @p330, @p331, @p332, @p333, @p334, @p335, 5), (@p336, @p337, @p338, @p339, @p340, @p341, @p342, @p343, @p344, @p345, @p346, @p347, @p348, @p349, @p350, @p351, @p352, @p353, @p354, @p355, @p356, @p357, @p358, @p359, @p360, @p361, @p362, @p363, @p364, @p365, @p366, @p367, @p368, @p369, @p370, @p371, @p372, @p373, @p374, @p375, @p376, @p377, @p378, @p379, @p380, @p381, @p382, @p383, @p384, @p385, @p386, @p387, @p388, @p389, @p390, @p391, 6), (@p392, @p393, @p394, @p395, @p396, @p397, @p398, @p399, @p400, @p401, @p402, @p403, @p404, @p405, @p406, @p407, @p408, @p409, @p410, @p411, @p412, @p413, @p414, @p415, @p416, @p417, @p418, @p419, @p420, @p421, @p422, @p423, @p424, @p425, @p426, @p427, @p428, @p429, @p430, @p431, @p432, @p433, @p434, @p435, @p436, @p437, @p438, @p439, @p440, @p441, @p442, @p443, @p444, @p445, @p446, @p447, 7), (@p448, @p449, @p450, @p451, @p452, @p453, @p454, @p455, @p456, @p457, @p458, @p459, @p460, @p461, @p462, @p463, @p464, @p465, @p466, @p467, @p468, @p469, @p470, @p471, @p472, @p473, @p474, @p475, @p476, @p477, @p478, @p479, @p480, @p481, @p482, @p483, @p484, @p485, @p486, @p487, @p488, @p489, @p490, @p491, @p492, @p493, @p494, @p495, @p496, @p497, @p498, @p499, @p500, @p501, @p502, @p503, 8), (@p504, @p505, @p506, @p507, @p508, @p509, @p510, @p511, @p512, @p513, @p514, @p515, @p516, @p517, @p518, @p519, @p520, @p521, @p522, @p523, @p524, @p525, @p526, @p527, @p528, @p529, @p530, @p531, @p532, @p533, @p534, @p535, @p536, @p537, @p538, @p539, @p540, @p541, @p542, @p543, @p544, @p545, @p546, @p547, @p548, @p549, @p550, @p551, @p552, @p553, @p554, @p555, @p556, @p557, @p558, @p559, 9), (@p560, @p561, @p562, @p563, @p564, @p565, @p566, @p567, @p568, @p569, @p570, @p571, @p572, @p573, @p574, @p575, @p576, @p577, @p578, @p579, @p580, @p581, @p582, @p583, @p584, @p585, @p586, @p587, @p588, @p589, @p590, @p591, @p592, @p593, @p594, @p595, @p596, @p597, @p598, @p599, @p600, @p601, @p602, @p603, @p604, @p605, @p606, @p607, @p608, @p609, @p610, @p611, @p612, @p613, @p614, @p615, 10), (@p616, @p617, @p618, @p619, @p620, @p621, @p622, @p623, @p624, @p625, @p626, @p627, @p628, @p629, @p630, @p631, @p632, @p633, @p634, @p635, @p636, @p637, @p638, @p639, @p640, @p641, @p642, @p643, @p644, @p645, @p646, @p647, @p648, @p649, @p650, @p651, @p652, @p653, @p654, @p655, @p656, @p657, @p658, @p659, @p660, @p661, @p662, @p663, @p664, @p665, @p666, @p667, @p668, @p669, @p670, @p671, 11), (@p672, @p673, @p674, @p675, @p676, @p677, @p678, @p679, @p680, @p681, @p682, @p683, @p684, @p685, @p686, @p687, @p688, @p689, @p690, @p691, @p692, @p693, @p694, @p695, @p696, @p697, @p698, @p699, @p700, @p701, @p702, @p703, @p704, @p705, @p706, @p707, @p708, @p709, @p710, @p711, @p712, @p713, @p714, @p715, @p716, @p717, @p718, @p719, @p720, @p721, @p722, @p723, @p724, @p725, @p726, @p727, 12), (@p728, @p729, @p730, @p731, @p732, @p733, @p734, @p735, @p736, @p737, @p738, @p739, @p740, @p741, @p742, @p743, @p744, @p745, @p746, @p747, @p748, @p749, @p750, @p751, @p752, @p753, @p754, @p755, @p756, @p757, @p758, @p759, @p760, @p761, @p762, @p763, @p764, @p765, @p766, @p767, @p768, @p769, @p770, @p771, @p772, @p773, @p774, @p775, @p776, @p777, @p778, @p779, @p780, @p781, @p782, @p783, 13), (@p784, @p785, @p786, @p787, @p788, @p789, @p790, @p791, @p792, @p793, @p794, @p795, @p796, @p797, @p798, @p799, @p800, @p801, @p802, @p803, @p804, @p805, @p806, @p807, @p808, @p809, @p810, @p811, @p812, @p813, @p814, @p815, @p816, @p817, @p818, @p819, @p820, @p821, @p822, @p823, @p824, @p825, @p826, @p827, @p828, @p829, @p830, @p831, @p832, @p833, @p834, @p835, @p836, @p837, @p838, @p839, 14), (@p840, @p841, @p842, @p843, @p844, @p845, @p846, @p847, @p848, @p849, @p850, @p851, @p852, @p853, @p854, @p855, @p856, @p857, @p858, @p859, @p860, @p861, @p862, @p863, @p864, @p865, @p866, @p867, @p868, @p869, @p870, @p871, @p872, @p873, @p874, @p875, @p876, @p877, @p878, @p879, @p880, @p881, @p882, @p883, @p884, @p885, @p886, @p887, @p888, @p889, @p890, @p891, @p892, @p893, @p894, @p895, 15), (@p896, @p897, @p898, @p899, @p900, @p901, @p902, @p903, @p904, @p905, @p906, @p907, @p908, @p909, @p910, @p911, @p912, @p913, @p914, @p915, @p916, @p917, @p918, @p919, @p920, @p921, @p922, @p923, @p924, @p925, @p926, @p927, @p928, @p929, @p930, @p931, @p932, @p933, @p934, @p935, @p936, @p937, @p938, @p939, @p940, @p941, @p942, @p943, @p944, @p945, @p946, @p947, @p948, @p949, @p950, @p951, 16), (@p952, @p953, @p954, @p955, @p956, @p957, @p958, @p959, @p960, @p961, @p962, @p963, @p964, @p965, @p966, @p967, @p968, @p969, @p970, @p971, @p972, @p973, @p974, @p975, @p976, @p977, @p978, @p979, @p980, @p981, @p982, @p983, @p984, @p985, @p986, @p987, @p988, @p989, @p990, @p991, @p992, @p993, @p994, @p995, @p996, @p997, @p998, @p999, @p1000, @p1001, @p1002, @p1003, @p1004, @p1005, @p1006, @p1007, 17), (@p1008, @p1009, @p1010, @p1011, @p1012, @p1013, @p1014, @p1015, @p1016, @p1017, @p1018, @p1019, @p1020, @p1021, @p1022, @p1023, @p1024, @p1025, @p1026, @p1027, @p1028, @p1029, @p1030, @p1031, @p1032, @p1033, @p1034, @p1035, @p1036, @p1037, @p1038, @p1039, @p1040, @p1041, @p1042, @p1043, @p1044, @p1045, @p1046, @p1047, @p1048, @p1049, @p1050, @p1051, @p1052, @p1053, @p1054, @p1055, @p1056, @p1057, @p1058, @p1059, @p1060, @p1061, @p1062, @p1063, 18), (@p1064, @p1065, @p1066, @p1067, @p1068, @p1069, @p1070, @p1071, @p1072, @p1073, @p1074, @p1075, @p1076, @p1077, @p1078, @p1079, @p1080, @p1081, @p1082, @p1083, @p1084, @p1085, @p1086, @p1087, @p1088, @p1089, @p1090, @p1091, @p1092, @p1093, @p1094, @p1095, @p1096, @p1097, @p1098, @p1099, @p1100, @p1101, @p1102, @p1103, @p1104, @p1105, @p1106, @p1107, @p1108, @p1109, @p1110, @p1111, @p1112, @p1113, @p1114, @p1115, @p1116, @p1117, @p1118, @p1119, 19), (@p1120, @p1121, @p1122, @p1123, @p1124, @p1125, @p1126, @p1127, @p1128, @p1129, @p1130, @p1131, @p1132, @p1133, @p1134, @p1135, @p1136, @p1137, @p1138, @p1139, @p1140, @p1141, @p1142, @p1143, @p1144, @p1145, @p1146, @p1147, @p1148, @p1149, @p1150, @p1151, @p1152, @p1153, @p1154, @p1155, @p1156, @p1157, @p1158, @p1159, @p1160, @p1161, @p1162, @p1163, @p1164, @p1165, @p1166, @p1167, @p1168, @p1169, @p1170, @p1171, @p1172, @p1173, @p1174, @p1175, 20), (@p1176, @p1177, @p1178, @p1179, @p1180, @p1181, @p1182, @p1183, @p1184, @p1185, @p1186, @p1187, @p1188, @p1189, @p1190, @p1191, @p1192, @p1193, @p1194, @p1195, @p1196, @p1197, @p1198, @p1199, @p1200, @p1201, @p1202, @p1203, @p1204, @p1205, @p1206, @p1207, @p1208, @p1209, @p1210, @p1211, @p1212, @p1213, @p1214, @p1215, @p1216, @p1217, @p1218, @p1219, @p1220, @p1221, @p1222, @p1223, @p1224, @p1225, @p1226, @p1227, @p1228, @p1229, @p1230, @p1231, 21), (@p1232, @p1233, @p1234, @p1235, @p1236, @p1237, @p1238, @p1239, @p1240, @p1241, @p1242, @p1243, @p1244, @p1245, @p1246, @p1247, @p1248, @p1249, @p1250, @p1251, @p1252, @p1253, @p1254, @p1255, @p1256, @p1257, @p1258, @p1259, @p1260, @p1261, @p1262, @p1263, @p1264, @p1265, @p1266, @p1267, @p1268, @p1269, @p1270, @p1271, @p1272, @p1273, @p1274, @p1275, @p1276, @p1277, @p1278, @p1279, @p1280, @p1281, @p1282, @p1283, @p1284, @p1285, @p1286, @p1287, 22), (@p1288, @p1289, @p1290, @p1291, @p1292, @p1293, @p1294, @p1295, @p1296, @p1297, @p1298, @p1299, @p1300, @p1301, @p1302, @p1303, @p1304, @p1305, @p1306, @p1307, @p1308, @p1309, @p1310, @p1311, @p1312, @p1313, @p1314, @p1315, @p1316, @p1317, @p1318, @p1319, @p1320, @p1321, @p1322, @p1323, @p1324, @p1325, @p1326, @p1327, @p1328, @p1329, @p1330, @p1331, @p1332, @p1333, @p1334, @p1335, @p1336, @p1337, @p1338, @p1339, @p1340, @p1341, @p1342, @p1343, 23), (@p1344, @p1345, @p1346, @p1347, @p1348, @p1349, @p1350, @p1351, @p1352, @p1353, @p1354, @p1355, @p1356, @p1357, @p1358, @p1359, @p1360, @p1361, @p1362, @p1363, @p1364, @p1365, @p1366, @p1367, @p1368, @p1369, @p1370, @p1371, @p1372, @p1373, @p1374, @p1375, @p1376, @p1377, @p1378, @p1379, @p1380, @p1381, @p1382, @p1383, @p1384, @p1385, @p1386, @p1387, @p1388, @p1389, @p1390, @p1391, @p1392, @p1393, @p1394, @p1395, @p1396, @p1397, @p1398, @p1399, 24), (@p1400, @p1401, @p1402, @p1403, @p1404, @p1405, @p1406, @p1407, @p1408, @p1409, @p1410, @p1411, @p1412, @p1413, @p1414, @p1415, @p1416, @p1417, @p1418, @p1419, @p1420, @p1421, @p1422, @p1423, @p1424, @p1425, @p1426, @p1427, @p1428, @p1429, @p1430, @p1431, @p1432, @p1433, @p1434, @p1435, @p1436, @p1437, @p1438, @p1439, @p1440, @p1441, @p1442, @p1443, @p1444, @p1445, @p1446, @p1447, @p1448, @p1449, @p1450, @p1451, @p1452, @p1453, @p1454, @p1455, 25), (@p1456, @p1457, @p1458, @p1459, @p1460, @p1461, @p1462, @p1463, @p1464, @p1465, @p1466, @p1467, @p1468, @p1469, @p1470, @p1471, @p1472, @p1473, @p1474, @p1475, @p1476, @p1477, @p1478, @p1479, @p1480, @p1481, @p1482, @p1483, @p1484, @p1485, @p1486, @p1487, @p1488, @p1489, @p1490, @p1491, @p1492, @p1493, @p1494, @p1495, @p1496, @p1497, @p1498, @p1499, @p1500, @p1501, @p1502, @p1503, @p1504, @p1505, @p1506, @p1507, @p1508, @p1509, @p1510, @p1511, 26), (@p1512, @p1513, @p1514, @p1515, @p1516, @p1517, @p1518, @p1519, @p1520, @p1521, @p1522, @p1523, @p1524, @p1525, @p1526, @p1527, @p1528, @p1529, @p1530, @p1531, @p1532, @p1533, @p1534, @p1535, @p1536, @p1537, @p1538, @p1539, @p1540, @p1541, @p1542, @p1543, @p1544, @p1545, @p1546, @p1547, @p1548, @p1549, @p1550, @p1551, @p1552, @p1553, @p1554, @p1555, @p1556, @p1557, @p1558, @p1559, @p1560, @p1561, @p1562, @p1563, @p1564, @p1565, @p1566, @p1567, 27), (@p1568, @p1569, @p1570, @p1571, @p1572, @p1573, @p1574, @p1575, @p1576, @p1577, @p1578, @p1579, @p1580, @p1581, @p1582, @p1583, @p1584, @p1585, @p1586, @p1587, @p1588, @p1589, @p1590, @p1591, @p1592, @p1593, @p1594, @p1595, @p1596, @p1597, @p1598, @p1599, @p1600, @p1601, @p1602, @p1603, @p1604, @p1605, @p1606, @p1607, @p1608, @p1609, @p1610, @p1611, @p1612, @p1613, @p1614, @p1615, @p1616, @p1617, @p1618, @p1619, @p1620, @p1621, @p1622, @p1623, 28), (@p1624, @p1625, @p1626, @p1627, @p1628, @p1629, @p1630, @p1631, @p1632, @p1633, @p1634, @p1635, @p1636, @p1637, @p1638, @p1639, @p1640, @p1641, @p1642, @p1643, @p1644, @p1645, @p1646, @p1647, @p1648, @p1649, @p1650, @p1651, @p1652, @p1653, @p1654, @p1655, @p1656, @p1657, @p1658, @p1659, @p1660, @p1661, @p1662, @p1663, @p1664, @p1665, @p1666, @p1667, @p1668, @p1669, @p1670, @p1671, @p1672, @p1673, @p1674, @p1675, @p1676, @p1677, @p1678, @p1679, 29), (@p1680, @p1681, @p1682, @p1683, @p1684, @p1685, @p1686, @p1687, @p1688, @p1689, @p1690, @p1691, @p1692, @p1693, @p1694, @p1695, @p1696, @p1697, @p1698, @p1699, @p1700, @p1701, @p1702, @p1703, @p1704, @p1705, @p1706, @p1707, @p1708, @p1709, @p1710, @p1711, @p1712, @p1713, @p1714, @p1715, @p1716, @p1717, @p1718, @p1719, @p1720, @p1721, @p1722, @p1723, @p1724, @p1725, @p1726, @p1727, @p1728, @p1729, @p1730, @p1731, @p1732, @p1733, @p1734, @p1735, 30), (@p1736, @p1737, @p1738, @p1739, @p1740, @p1741, @p1742, @p1743, @p1744, @p1745, @p1746, @p1747, @p1748, @p1749, @p1750, @p1751, @p1752, @p1753, @p1754, @p1755, @p1756, @p1757, @p1758, @p1759, @p1760, @p1761, @p1762, @p1763, @p1764, @p1765, @p1766, @p1767, @p1768, @p1769, @p1770, @p1771, @p1772, @p1773, @p1774, @p1775, @p1776, @p1777, @p1778, @p1779, @p1780, @p1781, @p1782, @p1783, @p1784, @p1785, @p1786, @p1787, @p1788, @p1789, @p1790, @p1791, 31), (@p1792, @p1793, @p1794, @p1795, @p1796, @p1797, @p1798, @p1799, @p1800, @p1801, @p1802, @p1803, @p1804, @p1805, @p1806, @p1807, @p1808, @p1809, @p1810, @p1811, @p1812, @p1813, @p1814, @p1815, @p1816, @p1817, @p1818, @p1819, @p1820, @p1821, @p1822, @p1823, @p1824, @p1825, @p1826, @p1827, @p1828, @p1829, @p1830, @p1831, @p1832, @p1833, @p1834, @p1835, @p1836, @p1837, @p1838, @p1839, @p1840, @p1841, @p1842, @p1843, @p1844, @p1845, @p1846, @p1847, 32), (@p1848, @p1849, @p1850, @p1851, @p1852, @p1853, @p1854, @p1855, @p1856, @p1857, @p1858, @p1859, @p1860, @p1861, @p1862, @p1863, @p1864, @p1865, @p1866, @p1867, @p1868, @p1869, @p1870, @p1871, @p1872, @p1873, @p1874, @p1875, @p1876, @p1877, @p1878, @p1879, @p1880, @p1881, @p1882, @p1883, @p1884, @p1885, @p1886, @p1887, @p1888, @p1889, @p1890, @p1891, @p1892, @p1893, @p1894, @p1895, @p1896, @p1897, @p1898, @p1899, @p1900, @p1901, @p1902, @p1903, 33), (@p1904, @p1905, @p1906, @p1907, @p1908, @p1909, @p1910, @p1911, @p1912, @p1913, @p1914, @p1915, @p1916, @p1917, @p1918, @p1919, @p1920, @p1921, @p1922, @p1923, @p1924, @p1925, @p1926, @p1927, @p1928, @p1929, @p1930, @p1931, @p1932, @p1933, @p1934, @p1935, @p1936, @p1937, @p1938, @p1939, @p1940, @p1941, @p1942, @p1943, @p1944, @p1945, @p1946, @p1947, @p1948, @p1949, @p1950, @p1951, @p1952, @p1953, @p1954, @p1955, @p1956, @p1957, @p1958, @p1959, 34), (@p1960, @p1961, @p1962, @p1963, @p1964, @p1965, @p1966, @p1967, @p1968, @p1969, @p1970, @p1971, @p1972, @p1973, @p1974, @p1975, @p1976, @p1977, @p1978, @p1979, @p1980, @p1981, @p1982, @p1983, @p1984, @p1985, @p1986, @p1987, @p1988, @p1989, @p1990, @p1991, @p1992, @p1993, @p1994, @p1995, @p1996, @p1997, @p1998, @p1999, @p2000, @p2001, @p2002, @p2003, @p2004, @p2005, @p2006, @p2007, @p2008, @p2009, @p2010, @p2011, @p2012, @p2013, @p2014, @p2015, 35), (@p2016, @p2017, @p2018, @p2019, @p2020, @p2021, @p2022, @p2023, @p2024, @p2025, @p2026, @p2027, @p2028, @p2029, @p2030, @p2031, @p2032, @p2033, @p2034, @p2035, @p2036, @p2037, @p2038, @p2039, @p2040, @p2041, @p2042, @p2043, @p2044, @p2045, @p2046, @p2047, @p2048, @p2049, @p2050, @p2051, @p2052, @p2053, @p2054, @p2055, @p2056, @p2057, @p2058, @p2059, @p2060, @p2061, @p2062, @p2063, @p2064, @p2065, @p2066, @p2067, @p2068, @p2069, @p2070, @p2071, 36)) AS i ([addressee_cntry_cd], [addressee_city], [addressee_district], [addressee_email], [addressee_full_address], [addressee_home_address], [addressee_name], [addressee_postcode], [addressee_province], [addressee_subdistrict], [addressee_tel], [create_table], [delivery_code], [delivery_recipient_name], [delivery_relation_id], [delivery_status_id], [dest_outlet_id], [dest_outlet_port], [document_number], [item_barcode], [item_cod], [item_gross_weight], [item_height], [item_length], [item_price], [item_width], [lat], [log_id], [long], [outlet_id], [outlet_port], [podUrl], [remark], [scan_cntry_cd], [scan_cntry_postcode], [sender_cntry_cd], [sender_district], [sender_email], [sender_full_address], [sender_home_address], [member_id], [sender_name], [sender_postcode], [sender_province], [sender_subdistrict], [sender_tel], [server_id], [signatureUrl], [state], [status_code], [status_dtm], [timestamp], [transmit_dtm], [user_id], [wckt_id], [wkstn_no], _Position) ON 1=0 WHEN NOT MATCHED THEN INSERT ([addressee_cntry_cd], [addressee_city], [addressee_district], [addressee_email], [addressee_full_address], [addressee_home_address], [addressee_name], [addressee_postcode], [addressee_province], [addressee_subdistrict], [addressee_tel], [create_table], [delivery_code], [delivery_recipient_name], [delivery_relation_id], [delivery_status_id], [dest_outlet_id], [dest_outlet_port], [document_number], [item_barcode], [item_cod], [item_gross_weight], [item_height], [item_length], [item_price], [item_width], [lat], [log_id], [long], [outlet_id], [outlet_port], [podUrl], [remark], [scan_cntry_cd], [scan_cntry_postcode], [sender_cntry_cd], [sender_district], [sender_email], [sender_full_address], [sender_home_address], [member_id], [sender_name], [sender_postcode], [sender_province], [sender_subdistrict], [sender_tel], [server_id], [signatureUrl], [state], [status_code], [status_dtm], [timestamp], [transmit_dtm], [user_id], [wckt_id], [wkstn_no]) VALUES (i.[addressee_cntry_cd], i.[addressee_city], i.[addressee_district], i.[addressee_email], i.[addressee_full_address], i.[addressee_home_address], i.[addressee_name], i.[addressee_postcode], i.[addressee_province], i.[addressee_subdistrict], i.[addressee_tel], i.[create_table], i.[delivery_code], i.[delivery_recipient_name], i.[delivery_relation_id], i.[delivery_status_id], i.[dest_outlet_id], i.[dest_outlet_port], i.[document_number], i.[item_barcode], i.[item_cod], i.[item_gross_weight], i.[item_height], i.[item_length], i.[item_price], i.[item_width], i.[lat], i.[log_id], i.[long], i.[outlet_id], i.[outlet_port], i.[podUrl], i.[remark], i.[scan_cntry_cd], i.[scan_cntry_postcode], i.[sender_cntry_cd], i.[sender_district], i.[sender_email], i.[sender_full_address], i.[sender_home_address], i.[member_id], i.[sender_name], i.[sender_postcode], i.[sender_province], i.[sender_subdistrict], i.[sender_tel], i.[server_id], i.[signatureUrl], i.[state], i.[status_code], i.[status_dtm], i.[timestamp], i.[transmit_dtm], i.[user_id], i.[wckt_id], i.[wkstn_no]) OUTPUT INSERTED.[item_id], i._Position INTO @inserted0;  SELECT [t].[item_id] FROM [raw_data] t INNER JOIN @inserted0 i ON ([t].[item_id] = [i].[item_id]) ORDER BY [i].[_Position];  ",4,4,0,446,3,4
"(@p0 nvarchar(4000),@p1 nvarchar(4000),@p2 nvarchar(4000),@p3 nvarchar(4000),@p4 nvarchar(4000),@p5 nvarchar(4000),@p6 nvarchar(4000),@p7 nvarchar(4000),@p8 nvarchar(4000),@p9 nvarchar(4000),@p10 nvarchar(4000),@p11 datetime2(7),@p12 nvarchar(4000),@p13 nvarchar(4000),@p14 int,@p15 int,@p16 int,@p17 nvarchar(4000),@p18 nvarchar(4000),@p19 nvarchar(4000),@p20 nvarchar(4000),@p21 decimal(18,2),@p22 nvarchar(4000),@p23 nvarchar(4000),@p24 decimal(18,2),@p25 nvarchar(4000),@p26 nvarchar(4000),@p27 nvarchar(4000),@p28 nvarchar(4000),@p29 int,@p30 nvarchar(4000),@p31 nvarchar(4000),@p32 nvarchar(4000),@p33 nvarchar(4000),@p34 nvarchar(4000),@p35 nvarchar(4000),@p36 nvarchar(4000),@p37 nvarchar(4000),@p38 nvarchar(4000),@p39 nvarchar(4000),@p40 int,@p41 nvarchar(4000),@p42 nvarchar(4000),@p43 nvarchar(4000),@p44 nvarchar(4000),@p45 nvarchar(4000),@p46 int,@p47 nvarchar(4000),@p48 int,@p49 int,@p50 datetime2(7),@p51 datetime2(7),@p52 datetime2(7),@p53 nvarchar(4000),@p54 nvarchar(4000),@p55 nvarchar(4000),@p56 nvarchar(4000),@p57 nvarchar(4000),@p58 nvarchar(4000),@p59 nvarchar(4000),@p60 nvarchar(4000),@p61 nvarchar(4000),@p62 nvarchar(4000),@p63 nvarchar(4000),@p64 nvarchar(4000),@p65 nvarchar(4000),@p66 nvarchar(4000),@p67 datetime2(7),@p68 nvarchar(4000),@p69 nvarchar(4000),@p70 int,@p71 int,@p72 int,@p73 nvarchar(4000),@p74 nvarchar(4000),@p75 nvarchar(4000),@p76 decimal(18,2),@p77 decimal(18,2),@p78 nvarchar(4000),@p79 nvarchar(4000),@p80 decimal(18,2),@p81 nvarchar(4000),@p82 nvarchar(4000),@p83 nvarchar(4000),@p84 nvarchar(4000),@p85 int,@p86 nvarchar(4000),@p87 nvarchar(4000),@p88 nvarchar(4000),@p89 nvarchar(4000),@p90 nvarchar(4000),@p91 nvarchar(4000),@p92 nvarchar(4000),@p93 nvarchar(4000),@p94 nvarchar(4000),@p95 nvarchar(4000),@p96 int,@p97 nvarchar(4000),@p98 nvarchar(4000),@p99 nvarchar(4000),@p100 nvarchar(4000),@p101 nvarchar(4000),@p102 int,@p103 nvarchar(4000),@p104 int,@p105 int,@p106 datetime2(7),@p107 datetime2(7),@p108 datetime2(7),@p109 nvarchar(4000),@p110 nvarchar(4000),@p111 nvarchar(4000),@p112 nvarchar(4000),@p113 nvarchar(4000),@p114 nvarchar(4000),@p115 nvarchar(4000),@p116 nvarchar(4000),@p117 nvarchar(4000),@p118 nvarchar(4000),@p119 nvarchar(4000),@p120 nvarchar(4000),@p121 nvarchar(4000),@p122 nvarchar(4000),@p123 datetime2(7),@p124 nvarchar(4000),@p125 nvarchar(4000),@p126 int,@p127 int,@p128 int,@p129 nvarchar(4000),@p130 nvarchar(4000),@p131 nvarchar(4000),@p132 decimal(18,2),@p133 decimal(18,2),@p134 nvarchar(4000),@p135 nvarchar(4000),@p136 decimal(18,2),@p137 nvarchar(4000),@p138 nvarchar(4000),@p139 nvarchar(4000),@p140 nvarchar(4000),@p141 int,@p142 nvarchar(4000),@p143 nvarchar(4000),@p144 nvarchar(4000),@p145 nvarchar(4000),@p146 nvarchar(4000),@p147 nvarchar(4000),@p148 nvarchar(4000),@p149 nvarchar(4000),@p150 nvarchar(4000),@p151 nvarchar(4000),@p152 int,@p153 nvarchar(4000),@p154 nvarchar(4000),@p155 nvarchar(4000),@p156 nvarchar(4000),@p157 nvarchar(4000),@p158 int,@p159 nvarchar(4000),@p160 int,@p161 int,@p162 datetime2(7),@p163 datetime2(7),@p164 datetime2(7),@p165 nvarchar(4000),@p166 nvarchar(4000),@p167 nvarchar(4000),@p168 nvarchar(4000),@p169 nvarchar(4000),@p170 nvarchar(4000),@p171 nvarchar(4000),@p172 nvarchar(4000),@p173 nvarchar(4000),@p174 nvarchar(4000),@p175 nvarchar(4000),@p176 nvarchar(4000),@p177 nvarchar(4000),@p178 nvarchar(4000),@p179 datetime2(7),@p180 nvarchar(4000),@p181 nvarchar(4000),@p182 int,@p183 int,@p184 int,@p185 nvarchar(4000),@p186 nvarchar(4000),@p187 nvarchar(4000),@p188 decimal(18,2),@p189 decimal(18,2),@p190 nvarchar(4000),@p191 nvarchar(4000),@p192 decimal(18,2),@p193 nvarchar(4000),@p194 nvarchar(4000),@p195 nvarchar(4000),@p196 nvarchar(4000),@p197 int,@p198 nvarchar(4000),@p199 nvarchar(4000),@p200 nvarchar(4000),@p201 nvarchar(4000),@p202 nvarchar(4000),@p203 nvarchar(4000),@p204 nvarchar(4000),@p205 nvarchar(4000),@p206 nvarchar(4000),@p207 nvarchar(4000),@p208 int,@p209 nvarchar(4000),@p210 nvarchar(4000),@p211 nvarchar(4000),@p212 nvarchar(4000),@p213 nvarchar(4000),@p214 int,@p215 nvarchar(4000),@p216 int,@p217 int,@p218 datetime2(7),@p219 datetime2(7),@p220 datetime2(7),@p221 nvarchar(4000),@p222 nvarchar(4000),@p223 nvarchar(4000),@p224 nvarchar(4000),@p225 nvarchar(4000),@p226 nvarchar(4000),@p227 nvarchar(4000),@p228 nvarchar(4000),@p229 nvarchar(4000),@p230 nvarchar(4000),@p231 nvarchar(4000),@p232 nvarchar(4000),@p233 nvarchar(4000),@p234 nvarchar(4000),@p235 datetime2(7),@p236 nvarchar(4000),@p237 nvarchar(4000),@p238 int,@p239 int,@p240 int,@p241 nvarchar(4000),@p242 nvarchar(4000),@p243 nvarchar(4000),@p244 decimal(18,2),@p245 decimal(18,2),@p246 nvarchar(4000),@p247 nvarchar(4000),@p248 decimal(18,2),@p249 nvarchar(4000),@p250 nvarchar(4000),@p251 nvarchar(4000),@p252 nvarchar(4000),@p253 int,@p254 nvarchar(4000),@p255 nvarchar(4000),@p256 nvarchar(4000),@p257 nvarchar(4000),@p258 nvarchar(4000),@p259 nvarchar(4000),@p260 nvarchar(4000),@p261 nvarchar(4000),@p262 nvarchar(4000),@p263 nvarchar(4000),@p264 int,@p265 nvarchar(4000),@p266 nvarchar(4000),@p267 nvarchar(4000),@p268 nvarchar(4000),@p269 nvarchar(4000),@p270 int,@p271 nvarchar(4000),@p272 int,@p273 int,@p274 datetime2(7),@p275 datetime2(7),@p276 datetime2(7),@p277 nvarchar(4000),@p278 nvarchar(4000),@p279 nvarchar(4000),@p280 nvarchar(4000),@p281 nvarchar(4000),@p282 nvarchar(4000),@p283 nvarchar(4000),@p284 nvarchar(4000),@p285 nvarchar(4000),@p286 nvarchar(4000),@p287 nvarchar(4000),@p288 nvarchar(4000),@p289 nvarchar(4000),@p290 nvarchar(4000),@p291 datetime2(7),@p292 nvarchar(4000),@p293 nvarchar(4000),@p294 int,@p295 int,@p296 int,@p297 nvarchar(4000),@p298 nvarchar(4000),@p299 nvarchar(4000),@p300 nvarchar(4000),@p301 decimal(18,2),@p302 nvarchar(4000),@p303 nvarchar(4000),@p304 decimal(18,2),@p305 nvarchar(4000),@p306 nvarchar(4000),@p307 nvarchar(4000),@p308 nvarchar(4000),@p309 int,@p310 nvarchar(4000),@p311 nvarchar(4000),@p312 nvarchar(4000),@p313 nvarchar(4000),@p314 nvarchar(4000),@p315 nvarchar(4000),@p316 nvarchar(4000),@p317 nvarchar(4000),@p318 nvarchar(4000),@p319 nvarchar(4000),@p320 int,@p321 nvarchar(4000),@p322 nvarchar(4000),@p323 nvarchar(4000),@p324 nvarchar(4000),@p325 nvarchar(4000),@p326 int,@p327 nvarchar(4000),@p328 int,@p329 int,@p330 datetime2(7),@p331 datetime2(7),@p332 datetime2(7),@p333 nvarchar(4000),@p334 nvarchar(4000),@p335 nvarchar(4000),@p336 nvarchar(4000),@p337 nvarchar(4000),@p338 nvarchar(4000),@p339 nvarchar(4000),@p340 nvarchar(4000),@p341 nvarchar(4000),@p342 nvarchar(4000),@p343 nvarchar(4000),@p344 nvarchar(4000),@p345 nvarchar(4000),@p346 nvarchar(4000),@p347 datetime2(7),@p348 nvarchar(4000),@p349 nvarchar(4000),@p350 int,@p351 int,@p352 int,@p353 nvarchar(4000),@p354 nvarchar(4000),@p355 nvarchar(4000),@p356 nvarchar(4000),@p357 decimal(18,2),@p358 nvarchar(4000),@p359 nvarchar(4000),@p360 decimal(18,2),@p361 nvarchar(4000),@p362 nvarchar(4000),@p363 nvarchar(4000),@p364 nvarchar(4000),@p365 int,@p366 nvarchar(4000),@p367 nvarchar(4000),@p368 nvarchar(4000),@p369 nvarchar(4000),@p370 nvarchar(4000),@p371 nvarchar(4000),@p372 nvarchar(4000),@p373 nvarchar(4000),@p374 nvarchar(4000),@p375 nvarchar(4000),@p376 int,@p377 nvarchar(4000),@p378 nvarchar(4000),@p379 nvarchar(4000),@p380 nvarchar(4000),@p381 nvarchar(4000),@p382 int,@p383 nvarchar(4000),@p384 int,@p385 int,@p386 datetime2(7),@p387 datetime2(7),@p388 datetime2(7),@p389 nvarchar(4000),@p390 nvarchar(4000),@p391 nvarchar(4000),@p392 nvarchar(4000),@p393 nvarchar(4000),@p394 nvarchar(4000),@p395 nvarchar(4000),@p396 nvarchar(4000),@p397 nvarchar(4000),@p398 nvarchar(4000),@p399 nvarchar(4000),@p400 nvarchar(4000),@p401 nvarchar(4000),@p402 nvarchar(4000),@p403 datetime2(7),@p404 nvarchar(4000),@p405 nvarchar(4000),@p406 int,@p407 int,@p408 int,@p409 nvarchar(4000),@p410 nvarchar(4000),@p411 nvarchar(4000),@p412 nvarchar(4000),@p413 decimal(18,2),@p414 nvarchar(4000),@p415 nvarchar(4000),@p416 decimal(18,2),@p417 nvarchar(4000),@p418 nvarchar(4000),@p419 nvarchar(4000),@p420 nvarchar(4000),@p421 int,@p422 nvarchar(4000),@p423 nvarchar(4000),@p424 nvarchar(4000),@p425 nvarchar(4000),@p426 nvarchar(4000),@p427 nvarchar(4000),@p428 nvarchar(4000),@p429 nvarchar(4000),@p430 nvarchar(4000),@p431 nvarchar(4000),@p432 int,@p433 nvarchar(4000),@p434 nvarchar(4000),@p435 nvarchar(4000),@p436 nvarchar(4000),@p437 nvarchar(4000),@p438 int,@p439 nvarchar(4000),@p440 int,@p441 int,@p442 datetime2(7),@p443 datetime2(7),@p444 datetime2(7),@p445 nvarchar(4000),@p446 nvarchar(4000),@p447 nvarchar(4000),@p448 nvarchar(4000),@p449 nvarchar(4000),@p450 nvarchar(4000),@p451 nvarchar(4000),@p452 nvarchar(4000),@p453 nvarchar(4000),@p454 nvarchar(4000),@p455 nvarchar(4000),@p456 nvarchar(4000),@p457 nvarchar(4000),@p458 nvarchar(4000),@p459 datetime2(7),@p460 nvarchar(4000),@p461 nvarchar(4000),@p462 int,@p463 int,@p464 int,@p465 nvarchar(4000),@p466 nvarchar(4000),@p467 nvarchar(4000),@p468 nvarchar(4000),@p469 decimal(18,2),@p470 nvarchar(4000),@p471 nvarchar(4000),@p472 decimal(18,2),@p473 nvarchar(4000),@p474 nvarchar(4000),@p475 nvarchar(4000),@p476 nvarchar(4000),@p477 int,@p478 nvarchar(4000),@p479 nvarchar(4000),@p480 nvarchar(4000),@p481 nvarchar(4000),@p482 nvarchar(4000),@p483 nvarchar(4000),@p484 nvarchar(4000),@p485 nvarchar(4000),@p486 nvarchar(4000),@p487 nvarchar(4000),@p488 int,@p489 nvarchar(4000),@p490 nvarchar(4000),@p491 nvarchar(4000),@p492 nvarchar(4000),@p493 nvarchar(4000),@p494 int,@p495 nvarchar(4000),@p496 int,@p497 int,@p498 datetime2(7),@p499 datetime2(7),@p500 datetime2(7),@p501 nvarchar(4000),@p502 nvarchar(4000),@p503 nvarchar(4000),@p504 nvarchar(4000),@p505 nvarchar(4000),@p506 nvarchar(4000),@p507 nvarchar(4000),@p508 nvarchar(4000),@p509 nvarchar(4000),@p510 nvarchar(4000),@p511 nvarchar(4000),@p512 nvarchar(4000),@p513 nvarchar(4000),@p514 nvarchar(4000),@p515 datetime2(7),@p516 nvarchar(4000),@p517 nvarchar(4000),@p518 int,@p519 int,@p520 int,@p521 nvarchar(4000),@p522 nvarchar(4000),@p523 nvarchar(4000),@p524 nvarchar(4000),@p525 decimal(18,2),@p526 nvarchar(4000),@p527 nvarchar(4000),@p528 decimal(18,2),@p529 nvarchar(4000),@p530 nvarchar(4000),@p531 nvarchar(4000),@p532 nvarchar(4000),@p533 int,@p534 nvarchar(4000),@p535 nvarchar(4000),@p536 nvarchar(4000),@p537 nvarchar(4000),@p538 nvarchar(4000),@p539 nvarchar(4000),@p540 nvarchar(4000),@p541 nvarchar(4000),@p542 nvarchar(4000),@p543 nvarchar(4000),@p544 int,@p545 nvarchar(4000),@p546 nvarchar(4000),@p547 nvarchar(4000),@p548 nvarchar(4000),@p549 nvarchar(4000),@p550 int,@p551 nvarchar(4000),@p552 int,@p553 int,@p554 datetime2(7),@p555 datetime2(7),@p556 datetime2(7),@p557 nvarchar(4000),@p558 nvarchar(4000),@p559 nvarchar(4000),@p560 nvarchar(4000),@p561 nvarchar(4000),@p562 nvarchar(4000),@p563 nvarchar(4000),@p564 nvarchar(4000),@p565 nvarchar(4000),@p566 nvarchar(4000),@p567 nvarchar(4000),@p568 nvarchar(4000),@p569 nvarchar(4000),@p570 nvarchar(4000),@p571 datetime2(7),@p572 nvarchar(4000),@p573 nvarchar(4000),@p574 int,@p575 int,@p576 int,@p577 nvarchar(4000),@p578 nvarchar(4000),@p579 nvarchar(4000),@p580 nvarchar(4000),@p581 decimal(18,2),@p582 nvarchar(4000),@p583 nvarchar(4000),@p584 decimal(18,2),@p585 nvarchar(4000),@p586 nvarchar(4000),@p587 nvarchar(4000),@p588 nvarchar(4000),@p589 int,@p590 nvarchar(4000),@p591 nvarchar(4000),@p592 nvarchar(4000),@p593 nvarchar(4000),@p594 nvarchar(4000),@p595 nvarchar(4000),@p596 nvarchar(4000),@p597 nvarchar(4000),@p598 nvarchar(4000),@p599 nvarchar(4000),@p600 int,@p601 nvarchar(4000),@p602 nvarchar(4000),@p603 nvarchar(4000),@p604 nvarchar(4000),@p605 nvarchar(4000),@p606 int,@p607 nvarchar(4000),@p608 int,@p609 int,@p610 datetime2(7),@p611 datetime2(7),@p612 datetime2(7),@p613 nvarchar(4000),@p614 nvarchar(4000),@p615 nvarchar(4000),@p616 nvarchar(4000),@p617 nvarchar(4000),@p618 nvarchar(4000),@p619 nvarchar(4000),@p620 nvarchar(4000),@p621 nvarchar(4000),@p622 nvarchar(4000),@p623 nvarchar(4000),@p624 nvarchar(4000),@p625 nvarchar(4000),@p626 nvarchar(4000),@p627 datetime2(7),@p628 nvarchar(4000),@p629 nvarchar(4000),@p630 int,@p631 int,@p632 int,@p633 nvarchar(4000),@p634 nvarchar(4000),@p635 nvarchar(4000),@p636 nvarchar(4000),@p637 decimal(18,2),@p638 nvarchar(4000),@p639 nvarchar(4000),@p640 decimal(18,2),@p641 nvarchar(4000),@p642 nvarchar(4000),@p643 nvarchar(4000),@p644 nvarchar(4000),@p645 int,@p646 nvarchar(4000),@p647 nvarchar(4000),@p648 nvarchar(4000),@p649 nvarchar(4000),@p650 nvarchar(4000),@p651 nvarchar(4000),@p652 nvarchar(4000),@p653 nvarchar(4000),@p654 nvarchar(4000),@p655 nvarchar(4000),@p656 int,@p657 nvarchar(4000),@p658 nvarchar(4000),@p659 nvarchar(4000),@p660 nvarchar(4000),@p661 nvarchar(4000),@p662 int,@p663 nvarchar(4000),@p664 int,@p665 int,@p666 datetime2(7),@p667 datetime2(7),@p668 datetime2(7),@p669 nvarchar(4000),@p670 nvarchar(4000),@p671 nvarchar(4000),@p672 nvarchar(4000),@p673 nvarchar(4000),@p674 nvarchar(4000),@p675 nvarchar(4000),@p676 nvarchar(4000),@p677 nvarchar(4000),@p678 nvarchar(4000),@p679 nvarchar(4000),@p680 nvarchar(4000),@p681 nvarchar(4000),@p682 nvarchar(4000),@p683 datetime2(7),@p684 nvarchar(4000),@p685 nvarchar(4000),@p686 int,@p687 int,@p688 int,@p689 nvarchar(4000),@p690 nvarchar(4000),@p691 nvarchar(4000),@p692 nvarchar(4000),@p693 decimal(18,2),@p694 nvarchar(4000),@p695 nvarchar(4000),@p696 decimal(18,2),@p697 nvarchar(4000),@p698 nvarchar(4000),@p699 nvarchar(4000),@p700 nvarchar(4000),@p701 int,@p702 nvarchar(4000),@p703 nvarchar(4000),@p704 nvarchar(4000),@p705 nvarchar(4000),@p706 nvarchar(4000),@p707 nvarchar(4000),@p708 nvarchar(4000),@p709 nvarchar(4000),@p710 nvarchar(4000),@p711 nvarchar(4000),@p712 int,@p713 nvarchar(4000),@p714 nvarchar(4000),@p715 nvarchar(4000),@p716 nvarchar(4000),@p717 nvarchar(4000),@p718 int,@p719 nvarchar(4000),@p720 int,@p721 int,@p722 datetime2(7),@p723 datetime2(7),@p724 datetime2(7),@p725 nvarchar(4000),@p726 nvarchar(4000),@p727 nvarchar(4000),@p728 nvarchar(4000),@p729 nvarchar(4000),@p730 nvarchar(4000),@p731 nvarchar(4000),@p732 nvarchar(4000),@p733 nvarchar(4000),@p734 nvarchar(4000),@p735 nvarchar(4000),@p736 nvarchar(4000),@p737 nvarchar(4000),@p738 nvarchar(4000),@p739 datetime2(7),@p740 nvarchar(4000),@p741 nvarchar(4000),@p742 int,@p743 int,@p744 int,@p745 nvarchar(4000),@p746 nvarchar(4000),@p747 nvarchar(4000),@p748 nvarchar(4000),@p749 decimal(18,2),@p750 nvarchar(4000),@p751 nvarchar(4000),@p752 decimal(18,2),@p753 nvarchar(4000),@p754 nvarchar(4000),@p755 nvarchar(4000),@p756 nvarchar(4000),@p757 int,@p758 nvarchar(4000),@p759 nvarchar(4000),@p760 nvarchar(4000),@p761 nvarchar(4000),@p762 nvarchar(4000),@p763 nvarchar(4000),@p764 nvarchar(4000),@p765 nvarchar(4000),@p766 nvarchar(4000),@p767 nvarchar(4000),@p768 int,@p769 nvarchar(4000),@p770 nvarchar(4000),@p771 nvarchar(4000),@p772 nvarchar(4000),@p773 nvarchar(4000),@p774 int,@p775 nvarchar(4000),@p776 int,@p777 int,@p778 datetime2(7),@p779 datetime2(7),@p780 datetime2(7),@p781 nvarchar(4000),@p782 nvarchar(4000),@p783 nvarchar(4000),@p784 nvarchar(4000),@p785 nvarchar(4000),@p786 nvarchar(4000),@p787 nvarchar(4000),@p788 nvarchar(4000),@p789 nvarchar(4000),@p790 nvarchar(4000),@p791 nvarchar(4000),@p792 nvarchar(4000),@p793 nvarchar(4000),@p794 nvarchar(4000),@p795 datetime2(7),@p796 nvarchar(4000),@p797 nvarchar(4000),@p798 int,@p799 int,@p800 int,@p801 nvarchar(4000),@p802 nvarchar(4000),@p803 nvarchar(4000),@p804 nvarchar(4000),@p805 decimal(18,2),@p806 nvarchar(4000),@p807 nvarchar(4000),@p808 decimal(18,2),@p809 nvarchar(4000),@p810 nvarchar(4000),@p811 nvarchar(4000),@p812 nvarchar(4000),@p813 int,@p814 nvarchar(4000),@p815 nvarchar(4000),@p816 nvarchar(4000),@p817 nvarchar(4000),@p818 nvarchar(4000),@p819 nvarchar(4000),@p820 nvarchar(4000),@p821 nvarchar(4000),@p822 nvarchar(4000),@p823 nvarchar(4000),@p824 int,@p825 nvarchar(4000),@p826 nvarchar(4000),@p827 nvarchar(4000),@p828 nvarchar(4000),@p829 nvarchar(4000),@p830 int,@p831 nvarchar(4000),@p832 int,@p833 int,@p834 datetime2(7),@p835 datetime2(7),@p836 datetime2(7),@p837 nvarchar(4000),@p838 nvarchar(4000),@p839 nvarchar(4000),@p840 nvarchar(4000),@p841 nvarchar(4000),@p842 nvarchar(4000),@p843 nvarchar(4000),@p844 nvarchar(4000),@p845 nvarchar(4000),@p846 nvarchar(4000),@p847 nvarchar(4000),@p848 nvarchar(4000),@p849 nvarchar(4000),@p850 nvarchar(4000),@p851 datetime2(7),@p852 nvarchar(4000),@p853 nvarchar(4000),@p854 int,@p855 int,@p856 int,@p857 nvarchar(4000),@p858 nvarchar(4000),@p859 nvarchar(4000),@p860 nvarchar(4000),@p861 decimal(18,2),@p862 nvarchar(4000),@p863 nvarchar(4000),@p864 decimal(18,2),@p865 nvarchar(4000),@p866 nvarchar(4000),@p867 nvarchar(4000),@p868 nvarchar(4000),@p869 int,@p870 nvarchar(4000),@p871 nvarchar(4000),@p872 nvarchar(4000),@p873 nvarchar(4000),@p874 nvarchar(4000),@p875 nvarchar(4000),@p876 nvarchar(4000),@p877 nvarchar(4000),@p878 nvarchar(4000),@p879 nvarchar(4000),@p880 int,@p881 nvarchar(4000),@p882 nvarchar(4000),@p883 nvarchar(4000),@p884 nvarchar(4000),@p885 nvarchar(4000),@p886 int,@p887 nvarchar(4000),@p888 int,@p889 int,@p890 datetime2(7),@p891 datetime2(7),@p892 datetime2(7),@p893 nvarchar(4000),@p894 nvarchar(4000),@p895 nvarchar(4000),@p896 nvarchar(4000),@p897 nvarchar(4000),@p898 nvarchar(4000),@p899 nvarchar(4000),@p900 nvarchar(4000),@p901 nvarchar(4000),@p902 nvarchar(4000),@p903 nvarchar(4000),@p904 nvarchar(4000),@p905 nvarchar(4000),@p906 nvarchar(4000),@p907 datetime2(7),@p908 nvarchar(4000),@p909 nvarchar(4000),@p910 int,@p911 int,@p912 int,@p913 nvarchar(4000),@p914 nvarchar(4000),@p915 nvarchar(4000),@p916 nvarchar(4000),@p917 decimal(18,2),@p918 nvarchar(4000),@p919 nvarchar(4000),@p920 decimal(18,2),@p921 nvarchar(4000),@p922 nvarchar(4000),@p923 nvarchar(4000),@p924 nvarchar(4000),@p925 int,@p926 nvarchar(4000),@p927 nvarchar(4000),@p928 nvarchar(4000),@p929 nvarchar(4000),@p930 nvarchar(4000),@p931 nvarchar(4000),@p932 nvarchar(4000),@p933 nvarchar(4000),@p934 nvarchar(4000),@p935 nvarchar(4000),@p936 int,@p937 nvarchar(4000),@p938 nvarchar(4000),@p939 nvarchar(4000),@p940 nvarchar(4000),@p941 nvarchar(4000),@p942 int,@p943 nvarchar(4000),@p944 int,@p945 int,@p946 datetime2(7),@p947 datetime2(7),@p948 datetime2(7),@p949 nvarchar(4000),@p950 nvarchar(4000),@p951 nvarchar(4000),@p952 nvarchar(4000),@p953 nvarchar(4000),@p954 nvarchar(4000),@p955 nvarchar(4000),@p956 nvarchar(4000),@p957 nvarchar(4000),@p958 nvarchar(4000),@p959 nvarchar(4000),@p960 nvarchar(4000),@p961 nvarchar(4000),@p962 nvarchar(4000),@p963 datetime2(7),@p964 nvarchar(4000),@p965 nvarchar(4000),@p966 int,@p967 int,@p968 int,@p969 nvarchar(4000),@p970 nvarchar(4000),@p971 nvarchar(4000),@p972 nvarchar(4000),@p973 decimal(18,2),@p974 nvarchar(4000),@p975 nvarchar(4000),@p976 decimal(18,2),@p977 nvarchar(4000),@p978 nvarchar(4000),@p979 nvarchar(4000),@p980 nvarchar(4000),@p981 int,@p982 nvarchar(4000),@p983 nvarchar(4000),@p984 nvarchar(4000),@p985 nvarchar(4000),@p986 nvarchar(4000),@p987 nvarchar(4000),@p988 nvarchar(4000),@p989 nvarchar(4000),@p990 nvarchar(4000),@p991 nvarchar(4000),@p992 int,@p993 nvarchar(4000),@p994 nvarchar(4000),@p995 nvarchar(4000),@p996 nvarchar(4000),@p997 nvarchar(4000),@p998 int,@p999 nvarchar(4000),@p1000 int,@p1001 int,@p1002 datetime2(7),@p1003 datetime2(7),@p1004 datetime2(7),@p1005 nvarchar(4000),@p1006 nvarchar(4000),@p1007 nvarchar(4000),@p1008 nvarchar(4000),@p1009 nvarchar(4000),@p1010 nvarchar(4000),@p1011 nvarchar(4000),@p1012 nvarchar(4000),@p1013 nvarchar(4000),@p1014 nvarchar(4000),@p1015 nvarchar(4000),@p1016 nvarchar(4000),@p1017 nvarchar(4000),@p1018 nvarchar(4000),@p1019 datetime2(7),@p1020 nvarchar(4000),@p1021 nvarchar(4000),@p1022 int,@p1023 int,@p1024 int,@p1025 nvarchar(4000),@p1026 nvarchar(4000),@p1027 nvarchar(4000),@p1028 nvarchar(4000),@p1029 decimal(18,2),@p1030 nvarchar(4000),@p1031 nvarchar(4000),@p1032 decimal(18,2),@p1033 nvarchar(4000),@p1034 nvarchar(4000),@p1035 nvarchar(4000),@p1036 nvarchar(4000),@p1037 int,@p1038 nvarchar(4000),@p1039 nvarchar(4000),@p1040 nvarchar(4000),@p1041 nvarchar(4000),@p1042 nvarchar(4000),@p1043 nvarchar(4000),@p1044 nvarchar(4000),@p1045 nvarchar(4000),@p1046 nvarchar(4000),@p1047 nvarchar(4000),@p1048 int,@p1049 nvarchar(4000),@p1050 nvarchar(4000),@p1051 nvarchar(4000),@p1052 nvarchar(4000),@p1053 nvarchar(4000),@p1054 int,@p1055 nvarchar(4000),@p1056 int,@p1057 int,@p1058 datetime2(7),@p1059 datetime2(7),@p1060 datetime2(7),@p1061 nvarchar(4000),@p1062 nvarchar(4000),@p1063 nvarchar(4000),@p1064 nvarchar(4000),@p1065 nvarchar(4000),@p1066 nvarchar(4000),@p1067 nvarchar(4000),@p1068 nvarchar(4000),@p1069 nvarchar(4000),@p1070 nvarchar(4000),@p1071 nvarchar(4000),@p1072 nvarchar(4000),@p1073 nvarchar(4000),@p1074 nvarchar(4000),@p1075 datetime2(7),@p1076 nvarchar(4000),@p1077 nvarchar(4000),@p1078 int,@p1079 int,@p1080 int,@p1081 nvarchar(4000),@p1082 nvarchar(4000),@p1083 nvarchar(4000),@p1084 nvarchar(4000),@p1085 decimal(18,2),@p1086 nvarchar(4000),@p1087 nvarchar(4000),@p1088 decimal(18,2),@p1089 nvarchar(4000),@p1090 nvarchar(4000),@p1091 nvarchar(4000),@p1092 nvarchar(4000),@p1093 int,@p1094 nvarchar(4000),@p1095 nvarchar(4000),@p1096 nvarchar(4000),@p1097 nvarchar(4000),@p1098 nvarchar(4000),@p1099 nvarchar(4000),@p1100 nvarchar(4000),@p1101 nvarchar(4000),@p1102 nvarchar(4000),@p1103 nvarchar(4000),@p1104 int,@p1105 nvarchar(4000),@p1106 nvarchar(4000),@p1107 nvarchar(4000),@p1108 nvarchar(4000),@p1109 nvarchar(4000),@p1110 int,@p1111 nvarchar(4000),@p1112 int,@p1113 int,@p1114 datetime2(7),@p1115 datetime2(7),@p1116 datetime2(7),@p1117 nvarchar(4000),@p1118 nvarchar(4000),@p1119 nvarchar(4000),@p1120 nvarchar(4000),@p1121 nvarchar(4000),@p1122 nvarchar(4000),@p1123 nvarchar(4000),@p1124 nvarchar(4000),@p1125 nvarchar(4000),@p1126 nvarchar(4000),@p1127 nvarchar(4000),@p1128 nvarchar(4000),@p1129 nvarchar(4000),@p1130 nvarchar(4000),@p1131 datetime2(7),@p1132 nvarchar(4000),@p1133 nvarchar(4000),@p1134 int,@p1135 int,@p1136 int,@p1137 nvarchar(4000),@p1138 nvarchar(4000),@p1139 nvarchar(4000),@p1140 nvarchar(4000),@p1141 decimal(18,2),@p1142 nvarchar(4000),@p1143 nvarchar(4000),@p1144 decimal(18,2),@p1145 nvarchar(4000),@p1146 nvarchar(4000),@p1147 nvarchar(4000),@p1148 nvarchar(4000),@p1149 int,@p1150 nvarchar(4000),@p1151 nvarchar(4000),@p1152 nvarchar(4000),@p1153 nvarchar(4000),@p1154 nvarchar(4000),@p1155 nvarchar(4000),@p1156 nvarchar(4000),@p1157 nvarchar(4000),@p1158 nvarchar(4000),@p1159 nvarchar(4000),@p1160 int,@p1161 nvarchar(4000),@p1162 nvarchar(4000),@p1163 nvarchar(4000),@p1164 nvarchar(4000),@p1165 nvarchar(4000),@p1166 int,@p1167 nvarchar(4000),@p1168 int,@p1169 int,@p1170 datetime2(7),@p1171 datetime2(7),@p1172 datetime2(7),@p1173 nvarchar(4000),@p1174 nvarchar(4000),@p1175 nvarchar(4000),@p1176 nvarchar(4000),@p1177 nvarchar(4000),@p1178 nvarchar(4000),@p1179 nvarchar(4000),@p1180 nvarchar(4000),@p1181 nvarchar(4000),@p1182 nvarchar(4000),@p1183 nvarchar(4000),@p1184 nvarchar(4000),@p1185 nvarchar(4000),@p1186 nvarchar(4000),@p1187 datetime2(7),@p1188 nvarchar(4000),@p1189 nvarchar(4000),@p1190 int,@p1191 int,@p1192 int,@p1193 nvarchar(4000),@p1194 nvarchar(4000),@p1195 nvarchar(4000),@p1196 nvarchar(4000),@p1197 decimal(18,2),@p1198 nvarchar(4000),@p1199 nvarchar(4000),@p1200 decimal(18,2),@p1201 nvarchar(4000),@p1202 nvarchar(4000),@p1203 nvarchar(4000),@p1204 nvarchar(4000),@p1205 int,@p1206 nvarchar(4000),@p1207 nvarchar(4000),@p1208 nvarchar(4000),@p1209 nvarchar(4000),@p1210 nvarchar(4000),@p1211 nvarchar(4000),@p1212 nvarchar(4000),@p1213 nvarchar(4000),@p1214 nvarchar(4000),@p1215 nvarchar(4000),@p1216 int,@p1217 nvarchar(4000),@p1218 nvarchar(4000),@p1219 nvarchar(4000),@p1220 nvarchar(4000),@p1221 nvarchar(4000),@p1222 int,@p1223 nvarchar(4000),@p1224 int,@p1225 int,@p1226 datetime2(7),@p1227 datetime2(7),@p1228 datetime2(7),@p1229 nvarchar(4000),@p1230 nvarchar(4000),@p1231 nvarchar(4000),@p1232 nvarchar(4000),@p1233 nvarchar(4000),@p1234 nvarchar(4000),@p1235 nvarchar(4000),@p1236 nvarchar(4000),@p1237 nvarchar(4000),@p1238 nvarchar(4000),@p1239 nvarchar(4000),@p1240 nvarchar(4000),@p1241 nvarchar(4000),@p1242 nvarchar(4000),@p1243 datetime2(7),@p1244 nvarchar(4000),@p1245 nvarchar(4000),@p1246 int,@p1247 int,@p1248 int,@p1249 nvarchar(4000),@p1250 nvarchar(4000),@p1251 nvarchar(4000),@p1252 nvarchar(4000),@p1253 decimal(18,2),@p1254 nvarchar(4000),@p1255 nvarchar(4000),@p1256 decimal(18,2),@p1257 nvarchar(4000),@p1258 nvarchar(4000),@p1259 nvarchar(4000),@p1260 nvarchar(4000),@p1261 int,@p1262 nvarchar(4000),@p1263 nvarchar(4000),@p1264 nvarchar(4000),@p1265 nvarchar(4000),@p1266 nvarchar(4000),@p1267 nvarchar(4000),@p1268 nvarchar(4000),@p1269 nvarchar(4000),@p1270 nvarchar(4000),@p1271 nvarchar(4000),@p1272 int,@p1273 nvarchar(4000),@p1274 nvarchar(4000),@p1275 nvarchar(4000),@p1276 nvarchar(4000),@p1277 nvarchar(4000),@p1278 int,@p1279 nvarchar(4000),@p1280 int,@p1281 int,@p1282 datetime2(7),@p1283 datetime2(7),@p1284 datetime2(7),@p1285 nvarchar(4000),@p1286 nvarchar(4000),@p1287 nvarchar(4000),@p1288 nvarchar(4000),@p1289 nvarchar(4000),@p1290 nvarchar(4000),@p1291 nvarchar(4000),@p1292 nvarchar(4000),@p1293 nvarchar(4000),@p1294 nvarchar(4000),@p1295 nvarchar(4000),@p1296 nvarchar(4000),@p1297 nvarchar(4000),@p1298 nvarchar(4000),@p1299 datetime2(7),@p1300 nvarchar(4000),@p1301 nvarchar(4000),@p1302 int,@p1303 int,@p1304 int,@p1305 nvarchar(4000),@p1306 nvarchar(4000),@p1307 nvarchar(4000),@p1308 nvarchar(4000),@p1309 decimal(18,2),@p1310 nvarchar(4000),@p1311 nvarchar(4000),@p1312 decimal(18,2),@p1313 nvarchar(4000),@p1314 nvarchar(4000),@p1315 nvarchar(4000),@p1316 nvarchar(4000),@p1317 int,@p1318 nvarchar(4000),@p1319 nvarchar(4000),@p1320 nvarchar(4000),@p1321 nvarchar(4000),@p1322 nvarchar(4000),@p1323 nvarchar(4000),@p1324 nvarchar(4000),@p1325 nvarchar(4000),@p1326 nvarchar(4000),@p1327 nvarchar(4000),@p1328 int,@p1329 nvarchar(4000),@p1330 nvarchar(4000),@p1331 nvarchar(4000),@p1332 nvarchar(4000),@p1333 nvarchar(4000),@p1334 int,@p1335 nvarchar(4000),@p1336 int,@p1337 int,@p1338 datetime2(7),@p1339 datetime2(7),@p1340 datetime2(7),@p1341 nvarchar(4000),@p1342 nvarchar(4000),@p1343 nvarchar(4000),@p1344 nvarchar(4000),@p1345 nvarchar(4000),@p1346 nvarchar(4000),@p1347 nvarchar(4000),@p1348 nvarchar(4000),@p1349 nvarchar(4000),@p1350 nvarchar(4000),@p1351 nvarchar(4000),@p1352 nvarchar(4000),@p1353 nvarchar(4000),@p1354 nvarchar(4000),@p1355 datetime2(7),@p1356 nvarchar(4000),@p1357 nvarchar(4000),@p1358 int,@p1359 int,@p1360 int,@p1361 nvarchar(4000),@p1362 nvarchar(4000),@p1363 nvarchar(4000),@p1364 nvarchar(4000),@p1365 decimal(18,2),@p1366 nvarchar(4000),@p1367 nvarchar(4000),@p1368 decimal(18,2),@p1369 nvarchar(4000),@p1370 nvarchar(4000),@p1371 nvarchar(4000),@p1372 nvarchar(4000),@p1373 int,@p1374 nvarchar(4000),@p1375 nvarchar(4000),@p1376 nvarchar(4000),@p1377 nvarchar(4000),@p1378 nvarchar(4000),@p1379 nvarchar(4000),@p1380 nvarchar(4000),@p1381 nvarchar(4000),@p1382 nvarchar(4000),@p1383 nvarchar(4000),@p1384 int,@p1385 nvarchar(4000),@p1386 nvarchar(4000),@p1387 nvarchar(4000),@p1388 nvarchar(4000),@p1389 nvarchar(4000),@p1390 int,@p1391 nvarchar(4000),@p1392 int,@p1393 int,@p1394 datetime2(7),@p1395 datetime2(7),@p1396 datetime2(7),@p1397 nvarchar(4000),@p1398 nvarchar(4000),@p1399 nvarchar(4000),@p1400 nvarchar(4000),@p1401 nvarchar(4000),@p1402 nvarchar(4000),@p1403 nvarchar(4000),@p1404 nvarchar(4000),@p1405 nvarchar(4000),@p1406 nvarchar(4000),@p1407 nvarchar(4000),@p1408 nvarchar(4000),@p1409 nvarchar(4000),@p1410 nvarchar(4000),@p1411 datetime2(7),@p1412 nvarchar(4000),@p1413 nvarchar(4000),@p1414 int,@p1415 int,@p1416 int,@p1417 nvarchar(4000),@p1418 nvarchar(4000),@p1419 nvarchar(4000),@p1420 nvarchar(4000),@p1421 decimal(18,2),@p1422 nvarchar(4000),@p1423 nvarchar(4000),@p1424 decimal(18,2),@p1425 nvarchar(4000),@p1426 nvarchar(4000),@p1427 nvarchar(4000),@p1428 nvarchar(4000),@p1429 int,@p1430 nvarchar(4000),@p1431 nvarchar(4000),@p1432 nvarchar(4000),@p1433 nvarchar(4000),@p1434 nvarchar(4000),@p1435 nvarchar(4000),@p1436 nvarchar(4000),@p1437 nvarchar(4000),@p1438 nvarchar(4000),@p1439 nvarchar(4000),@p1440 int,@p1441 nvarchar(4000),@p1442 nvarchar(4000),@p1443 nvarchar(4000),@p1444 nvarchar(4000),@p1445 nvarchar(4000),@p1446 int,@p1447 nvarchar(4000),@p1448 int,@p1449 int,@p1450 datetime2(7),@p1451 datetime2(7),@p1452 datetime2(7),@p1453 nvarchar(4000),@p1454 nvarchar(4000),@p1455 nvarchar(4000),@p1456 nvarchar(4000),@p1457 nvarchar(4000),@p1458 nvarchar(4000),@p1459 nvarchar(4000),@p1460 nvarchar(4000),@p1461 nvarchar(4000),@p1462 nvarchar(4000),@p1463 nvarchar(4000),@p1464 nvarchar(4000),@p1465 nvarchar(4000),@p1466 nvarchar(4000),@p1467 datetime2(7),@p1468 nvarchar(4000),@p1469 nvarchar(4000),@p1470 int,@p1471 int,@p1472 int,@p1473 nvarchar(4000),@p1474 nvarchar(4000),@p1475 nvarchar(4000),@p1476 nvarchar(4000),@p1477 decimal(18,2),@p1478 nvarchar(4000),@p1479 nvarchar(4000),@p1480 decimal(18,2),@p1481 nvarchar(4000),@p1482 nvarchar(4000),@p1483 nvarchar(4000),@p1484 nvarchar(4000),@p1485 int,@p1486 nvarchar(4000),@p1487 nvarchar(4000),@p1488 nvarchar(4000),@p1489 nvarchar(4000),@p1490 nvarchar(4000),@p1491 nvarchar(4000),@p1492 nvarchar(4000),@p1493 nvarchar(4000),@p1494 nvarchar(4000),@p1495 nvarchar(4000),@p1496 int,@p1497 nvarchar(4000),@p1498 nvarchar(4000),@p1499 nvarchar(4000),@p1500 nvarchar(4000),@p1501 nvarchar(4000),@p1502 int,@p1503 nvarchar(4000),@p1504 int,@p1505 int,@p1506 datetime2(7),@p1507 datetime2(7),@p1508 datetime2(7),@p1509 nvarchar(4000),@p1510 nvarchar(4000),@p1511 nvarchar(4000),@p1512 nvarchar(4000),@p1513 nvarchar(4000),@p1514 nvarchar(4000),@p1515 nvarchar(4000),@p1516 nvarchar(4000),@p1517 nvarchar(4000),@p1518 nvarchar(4000),@p1519 nvarchar(4000),@p1520 nvarchar(4000),@p1521 nvarchar(4000),@p1522 nvarchar(4000),@p1523 datetime2(7),@p1524 nvarchar(4000),@p1525 nvarchar(4000),@p1526 int,@p1527 int,@p1528 int,@p1529 nvarchar(4000),@p1530 nvarchar(4000),@p1531 nvarchar(4000),@p1532 nvarchar(4000),@p1533 decimal(18,2),@p1534 nvarchar(4000),@p1535 nvarchar(4000),@p1536 decimal(18,2),@p1537 nvarchar(4000),@p1538 nvarchar(4000),@p1539 nvarchar(4000),@p1540 nvarchar(4000),@p1541 int,@p1542 nvarchar(4000),@p1543 nvarchar(4000),@p1544 nvarchar(4000),@p1545 nvarchar(4000),@p1546 nvarchar(4000),@p1547 nvarchar(4000),@p1548 nvarchar(4000),@p1549 nvarchar(4000),@p1550 nvarchar(4000),@p1551 nvarchar(4000),@p1552 int,@p1553 nvarchar(4000),@p1554 nvarchar(4000),@p1555 nvarchar(4000),@p1556 nvarchar(4000),@p1557 nvarchar(4000),@p1558 int,@p1559 nvarchar(4000),@p1560 int,@p1561 int,@p1562 datetime2(7),@p1563 datetime2(7),@p1564 datetime2(7),@p1565 nvarchar(4000),@p1566 nvarchar(4000),@p1567 nvarchar(4000),@p1568 nvarchar(4000),@p1569 nvarchar(4000),@p1570 nvarchar(4000),@p1571 nvarchar(4000),@p1572 nvarchar(4000),@p1573 nvarchar(4000),@p1574 nvarchar(4000),@p1575 nvarchar(4000),@p1576 nvarchar(4000),@p1577 nvarchar(4000),@p1578 nvarchar(4000),@p1579 datetime2(7),@p1580 nvarchar(4000),@p1581 nvarchar(4000),@p1582 int,@p1583 int,@p1584 int,@p1585 nvarchar(4000),@p1586 nvarchar(4000),@p1587 nvarchar(4000),@p1588 nvarchar(4000),@p1589 decimal(18,2),@p1590 nvarchar(4000),@p1591 nvarchar(4000),@p1592 decimal(18,2),@p1593 nvarchar(4000),@p1594 nvarchar(4000),@p1595 nvarchar(4000),@p1596 nvarchar(4000),@p1597 int,@p1598 nvarchar(4000),@p1599 nvarchar(4000),@p1600 nvarchar(4000),@p1601 nvarchar(4000),@p1602 nvarchar(4000),@p1603 nvarchar(4000),@p1604 nvarchar(4000),@p1605 nvarchar(4000),@p1606 nvarchar(4000),@p1607 nvarchar(4000),@p1608 int,@p1609 nvarchar(4000),@p1610 nvarchar(4000),@p1611 nvarchar(4000),@p1612 nvarchar(4000),@p1613 nvarchar(4000),@p1614 int,@p1615 nvarchar(4000),@p1616 int,@p1617 int,@p1618 datetime2(7),@p1619 datetime2(7),@p1620 datetime2(7),@p1621 nvarchar(4000),@p1622 nvarchar(4000),@p1623 nvarchar(4000),@p1624 nvarchar(4000),@p1625 nvarchar(4000),@p1626 nvarchar(4000),@p1627 nvarchar(4000),@p1628 nvarchar(4000),@p1629 nvarchar(4000),@p1630 nvarchar(4000),@p1631 nvarchar(4000),@p1632 nvarchar(4000),@p1633 nvarchar(4000),@p1634 nvarchar(4000),@p1635 datetime2(7),@p1636 nvarchar(4000),@p1637 nvarchar(4000),@p1638 int,@p1639 int,@p1640 int,@p1641 nvarchar(4000),@p1642 nvarchar(4000),@p1643 nvarchar(4000),@p1644 nvarchar(4000),@p1645 decimal(18,2),@p1646 nvarchar(4000),@p1647 nvarchar(4000),@p1648 decimal(18,2),@p1649 nvarchar(4000),@p1650 nvarchar(4000),@p1651 nvarchar(4000),@p1652 nvarchar(4000),@p1653 int,@p1654 nvarchar(4000),@p1655 nvarchar(4000),@p1656 nvarchar(4000),@p1657 nvarchar(4000),@p1658 nvarchar(4000),@p1659 nvarchar(4000),@p1660 nvarchar(4000),@p1661 nvarchar(4000),@p1662 nvarchar(4000),@p1663 nvarchar(4000),@p1664 int,@p1665 nvarchar(4000),@p1666 nvarchar(4000),@p1667 nvarchar(4000),@p1668 nvarchar(4000),@p1669 nvarchar(4000),@p1670 int,@p1671 nvarchar(4000),@p1672 int,@p1673 int,@p1674 datetime2(7),@p1675 datetime2(7),@p1676 datetime2(7),@p1677 nvarchar(4000),@p1678 nvarchar(4000),@p1679 nvarchar(4000),@p1680 nvarchar(4000),@p1681 nvarchar(4000),@p1682 nvarchar(4000),@p1683 nvarchar(4000),@p1684 nvarchar(4000),@p1685 nvarchar(4000),@p1686 nvarchar(4000),@p1687 nvarchar(4000),@p1688 nvarchar(4000),@p1689 nvarchar(4000),@p1690 nvarchar(4000),@p1691 datetime2(7),@p1692 nvarchar(4000),@p1693 nvarchar(4000),@p1694 int,@p1695 int,@p1696 int,@p1697 nvarchar(4000),@p1698 nvarchar(4000),@p1699 nvarchar(4000),@p1700 nvarchar(4000),@p1701 decimal(18,2),@p1702 nvarchar(4000),@p1703 nvarchar(4000),@p1704 decimal(18,2),@p1705 nvarchar(4000),@p1706 nvarchar(4000),@p1707 nvarchar(4000),@p1708 nvarchar(4000),@p1709 int,@p1710 nvarchar(4000),@p1711 nvarchar(4000),@p1712 nvarchar(4000),@p1713 nvarchar(4000),@p1714 nvarchar(4000),@p1715 nvarchar(4000),@p1716 nvarchar(4000),@p1717 nvarchar(4000),@p1718 nvarchar(4000),@p1719 nvarchar(4000),@p1720 int,@p1721 nvarchar(4000),@p1722 nvarchar(4000),@p1723 nvarchar(4000),@p1724 nvarchar(4000),@p1725 nvarchar(4000),@p1726 int,@p1727 nvarchar(4000),@p1728 int,@p1729 int,@p1730 datetime2(7),@p1731 datetime2(7),@p1732 datetime2(7),@p1733 nvarchar(4000),@p1734 nvarchar(4000),@p1735 nvarchar(4000),@p1736 nvarchar(4000),@p1737 nvarchar(4000),@p1738 nvarchar(4000),@p1739 nvarchar(4000),@p1740 nvarchar(4000),@p1741 nvarchar(4000),@p1742 nvarchar(4000),@p1743 nvarchar(4000),@p1744 nvarchar(4000),@p1745 nvarchar(4000),@p1746 nvarchar(4000),@p1747 datetime2(7),@p1748 nvarchar(4000),@p1749 nvarchar(4000),@p1750 int,@p1751 int,@p1752 int,@p1753 nvarchar(4000),@p1754 nvarchar(4000),@p1755 nvarchar(4000),@p1756 nvarchar(4000),@p1757 decimal(18,2),@p1758 nvarchar(4000),@p1759 nvarchar(4000),@p1760 decimal(18,2),@p1761 nvarchar(4000),@p1762 nvarchar(4000),@p1763 nvarchar(4000),@p1764 nvarchar(4000),@p1765 int,@p1766 nvarchar(4000),@p1767 nvarchar(4000),@p1768 nvarchar(4000),@p1769 nvarchar(4000),@p1770 nvarchar(4000),@p1771 nvarchar(4000),@p1772 nvarchar(4000),@p1773 nvarchar(4000),@p1774 nvarchar(4000),@p1775 nvarchar(4000),@p1776 int,@p1777 nvarchar(4000),@p1778 nvarchar(4000),@p1779 nvarchar(4000),@p1780 nvarchar(4000),@p1781 nvarchar(4000),@p1782 int,@p1783 nvarchar(4000),@p1784 int,@p1785 int,@p1786 datetime2(7),@p1787 datetime2(7),@p1788 datetime2(7),@p1789 nvarchar(4000),@p1790 nvarchar(4000),@p1791 nvarchar(4000),@p1792 nvarchar(4000),@p1793 nvarchar(4000),@p1794 nvarchar(4000),@p1795 nvarchar(4000),@p1796 nvarchar(4000),@p1797 nvarchar(4000),@p1798 nvarchar(4000),@p1799 nvarchar(4000),@p1800 nvarchar(4000),@p1801 nvarchar(4000),@p1802 nvarchar(4000),@p1803 datetime2(7),@p1804 nvarchar(4000),@p1805 nvarchar(4000),@p1806 int,@p1807 int,@p1808 int,@p1809 nvarchar(4000),@p1810 nvarchar(4000),@p1811 nvarchar(4000),@p1812 nvarchar(4000),@p1813 decimal(18,2),@p1814 nvarchar(4000),@p1815 nvarchar(4000),@p1816 decimal(18,2),@p1817 nvarchar(4000),@p1818 nvarchar(4000),@p1819 nvarchar(4000),@p1820 nvarchar(4000),@p1821 int,@p1822 nvarchar(4000),@p1823 nvarchar(4000),@p1824 nvarchar(4000),@p1825 nvarchar(4000),@p1826 nvarchar(4000),@p1827 nvarchar(4000),@p1828 nvarchar(4000),@p1829 nvarchar(4000),@p1830 nvarchar(4000),@p1831 nvarchar(4000),@p1832 int,@p1833 nvarchar(4000),@p1834 nvarchar(4000),@p1835 nvarchar(4000),@p1836 nvarchar(4000),@p1837 nvarchar(4000),@p1838 int,@p1839 nvarchar(4000),@p1840 int,@p1841 int,@p1842 datetime2(7),@p1843 datetime2(7),@p1844 datetime2(7),@p1845 nvarchar(4000),@p1846 nvarchar(4000),@p1847 nvarchar(4000),@p1848 nvarchar(4000),@p1849 nvarchar(4000),@p1850 nvarchar(4000),@p1851 nvarchar(4000),@p1852 nvarchar(4000),@p1853 nvarchar(4000),@p1854 nvarchar(4000),@p1855 nvarchar(4000),@p1856 nvarchar(4000),@p1857 nvarchar(4000),@p1858 nvarchar(4000),@p1859 datetime2(7),@p1860 nvarchar(4000),@p1861 nvarchar(4000),@p1862 int,@p1863 int,@p1864 int,@p1865 nvarchar(4000),@p1866 nvarchar(4000),@p1867 nvarchar(4000),@p1868 nvarchar(4000),@p1869 decimal(18,2),@p1870 nvarchar(4000),@p1871 nvarchar(4000),@p1872 decimal(18,2),@p1873 nvarchar(4000),@p1874 nvarchar(4000),@p1875 nvarchar(4000),@p1876 nvarchar(4000),@p1877 int,@p1878 nvarchar(4000),@p1879 nvarchar(4000),@p1880 nvarchar(4000),@p1881 nvarchar(4000),@p1882 nvarchar(4000),@p1883 nvarchar(4000),@p1884 nvarchar(4000),@p1885 nvarchar(4000),@p1886 nvarchar(4000),@p1887 nvarchar(4000),@p1888 int,@p1889 nvarchar(4000),@p1890 nvarchar(4000),@p1891 nvarchar(4000),@p1892 nvarchar(4000),@p1893 nvarchar(4000),@p1894 int,@p1895 nvarchar(4000),@p1896 int,@p1897 int,@p1898 datetime2(7),@p1899 datetime2(7),@p1900 datetime2(7),@p1901 nvarchar(4000),@p1902 nvarchar(4000),@p1903 nvarchar(4000),@p1904 nvarchar(4000),@p1905 nvarchar(4000),@p1906 nvarchar(4000),@p1907 nvarchar(4000),@p1908 nvarchar(4000),@p1909 nvarchar(4000),@p1910 nvarchar(4000),@p1911 nvarchar(4000),@p1912 nvarchar(4000),@p1913 nvarchar(4000),@p1914 nvarchar(4000),@p1915 datetime2(7),@p1916 nvarchar(4000),@p1917 nvarchar(4000),@p1918 int,@p1919 int,@p1920 int,@p1921 nvarchar(4000),@p1922 nvarchar(4000),@p1923 nvarchar(4000),@p1924 nvarchar(4000),@p1925 decimal(18,2),@p1926 nvarchar(4000),@p1927 nvarchar(4000),@p1928 decimal(18,2),@p1929 nvarchar(4000),@p1930 nvarchar(4000),@p1931 nvarchar(4000),@p1932 nvarchar(4000),@p1933 int,@p1934 nvarchar(4000),@p1935 nvarchar(4000),@p1936 nvarchar(4000),@p1937 nvarchar(4000),@p1938 nvarchar(4000),@p1939 nvarchar(4000),@p1940 nvarchar(4000),@p1941 nvarchar(4000),@p1942 nvarchar(4000),@p1943 nvarchar(4000),@p1944 int,@p1945 nvarchar(4000),@p1946 nvarchar(4000),@p1947 nvarchar(4000),@p1948 nvarchar(4000),@p1949 nvarchar(4000),@p1950 int,@p1951 nvarchar(4000),@p1952 int,@p1953 int,@p1954 datetime2(7),@p1955 datetime2(7),@p1956 datetime2(7),@p1957 nvarchar(4000),@p1958 nvarchar(4000),@p1959 nvarchar(4000),@p1960 nvarchar(4000),@p1961 nvarchar(4000),@p1962 nvarchar(4000),@p1963 nvarchar(4000),@p1964 nvarchar(4000),@p1965 nvarchar(4000),@p1966 nvarchar(4000),@p1967 nvarchar(4000),@p1968 nvarchar(4000),@p1969 nvarchar(4000),@p1970 nvarchar(4000),@p1971 datetime2(7),@p1972 nvarchar(4000),@p1973 nvarchar(4000),@p1974 int,@p1975 int,@p1976 int,@p1977 nvarchar(4000),@p1978 nvarchar(4000),@p1979 nvarchar(4000),@p1980 nvarchar(4000),@p1981 decimal(18,2),@p1982 nvarchar(4000),@p1983 nvarchar(4000),@p1984 decimal(18,2),@p1985 nvarchar(4000),@p1986 nvarchar(4000),@p1987 nvarchar(4000),@p1988 nvarchar(4000),@p1989 int,@p1990 nvarchar(4000),@p1991 nvarchar(4000),@p1992 nvarchar(4000),@p1993 nvarchar(4000),@p1994 nvarchar(4000),@p1995 nvarchar(4000),@p1996 nvarchar(4000),@p1997 nvarchar(4000),@p1998 nvarchar(4000),@p1999 nvarchar(4000),@p2000 int,@p2001 nvarchar(4000),@p2002 nvarchar(4000),@p2003 nvarchar(4000),@p2004 nvarchar(4000),@p2005 nvarchar(4000),@p2006 int,@p2007 nvarchar(4000),@p2008 int,@p2009 int,@p2010 datetime2(7),@p2011 datetime2(7),@p2012 datetime2(7),@p2013 nvarchar(4000),@p2014 nvarchar(4000),@p2015 nvarchar(4000),@p2016 nvarchar(4000),@p2017 nvarchar(4000),@p2018 nvarchar(4000),@p2019 nvarchar(4000),@p2020 nvarchar(4000),@p2021 nvarchar(4000),@p2022 nvarchar(4000),@p2023 nvarchar(4000),@p2024 nvarchar(4000),@p2025 nvarchar(4000),@p2026 nvarchar(4000),@p2027 datetime2(7),@p2028 nvarchar(4000),@p2029 nvarchar(4000),@p2030 int,@p2031 int,@p2032 int,@p2033 nvarchar(4000),@p2034 nvarchar(4000),@p2035 nvarchar(4000),@p2036 decimal(18,2),@p2037 decimal(18,2),@p2038 nvarchar(4000),@p2039 nvarchar(4000),@p2040 decimal(18,2),@p2041 nvarchar(4000),@p2042 nvarchar(4000),@p2043 nvarchar(4000),@p2044 nvarchar(4000),@p2045 int,@p2046 nvarchar(4000),@p2047 nvarchar(4000),@p2048 nvarchar(4000),@p2049 nvarchar(4000),@p2050 nvarchar(4000),@p2051 nvarchar(4000),@p2052 nvarchar(4000),@p2053 nvarchar(4000),@p2054 nvarchar(4000),@p2055 nvarchar(4000),@p2056 int,@p2057 nvarchar(4000),@p2058 nvarchar(4000),@p2059 nvarchar(4000),@p2060 nvarchar(4000),@p2061 nvarchar(4000),@p2062 int,@p2063 nvarchar(4000),@p2064 int,@p2065 int,@p2066 datetime2(7),@p2067 datetime2(7),@p2068 datetime2(7),@p2069 nvarchar(4000),@p2070 nvarchar(4000),@p2071 nvarchar(4000))SET NOCOUNT ON; DECLARE @inserted0 TABLE ([item_id] int, [_Position] [int]); MERGE [raw_data] USING ( VALUES (@p0, @p1, @p2, @p3, @p4, @p5, @p6, @p7, @p8, @p9, @p10, @p11, @p12, @p13, @p14, @p15, @p16, @p17, @p18, @p19, @p20, @p21, @p22, @p23, @p24, @p25, @p26, @p27, @p28, @p29, @p30, @p31, @p32, @p33, @p34, @p35, @p36, @p37, @p38, @p39, @p40, @p41, @p42, @p43, @p44, @p45, @p46, @p47, @p48, @p49, @p50, @p51, @p52, @p53, @p54, @p55, 0), (@p56, @p57, @p58, @p59, @p60, @p61, @p62, @p63, @p64, @p65, @p66, @p67, @p68, @p69, @p70, @p71, @p72, @p73, @p74, @p75, @p76, @p77, @p78, @p79, @p80, @p81, @p82, @p83, @p84, @p85, @p86, @p87, @p88, @p89, @p90, @p91, @p92, @p93, @p94, @p95, @p96, @p97, @p98, @p99, @p100, @p101, @p102, @p103, @p104, @p105, @p106, @p107, @p108, @p109, @p110, @p111, 1), (@p112, @p113, @p114, @p115, @p116, @p117, @p118, @p119, @p120, @p121, @p122, @p123, @p124, @p125, @p126, @p127, @p128, @p129, @p130, @p131, @p132, @p133, @p134, @p135, @p136, @p137, @p138, @p139, @p140, @p141, @p142, @p143, @p144, @p145, @p146, @p147, @p148, @p149, @p150, @p151, @p152, @p153, @p154, @p155, @p156, @p157, @p158, @p159, @p160, @p161, @p162, @p163, @p164, @p165, @p166, @p167, 2), (@p168, @p169, @p170, @p171, @p172, @p173, @p174, @p175, @p176, @p177, @p178, @p179, @p180, @p181, @p182, @p183, @p184, @p185, @p186, @p187, @p188, @p189, @p190, @p191, @p192, @p193, @p194, @p195, @p196, @p197, @p198, @p199, @p200, @p201, @p202, @p203, @p204, @p205, @p206, @p207, @p208, @p209, @p210, @p211, @p212, @p213, @p214, @p215, @p216, @p217, @p218, @p219, @p220, @p221, @p222, @p223, 3), (@p224, @p225, @p226, @p227, @p228, @p229, @p230, @p231, @p232, @p233, @p234, @p235, @p236, @p237, @p238, @p239, @p240, @p241, @p242, @p243, @p244, @p245, @p246, @p247, @p248, @p249, @p250, @p251, @p252, @p253, @p254, @p255, @p256, @p257, @p258, @p259, @p260, @p261, @p262, @p263, @p264, @p265, @p266, @p267, @p268, @p269, @p270, @p271, @p272, @p273, @p274, @p275, @p276, @p277, @p278, @p279, 4), (@p280, @p281, @p282, @p283, @p284, @p285, @p286, @p287, @p288, @p289, @p290, @p291, @p292, @p293, @p294, @p295, @p296, @p297, @p298, @p299, @p300, @p301, @p302, @p303, @p304, @p305, @p306, @p307, @p308, @p309, @p310, @p311, @p312, @p313, @p314, @p315, @p316, @p317, @p318, @p319, @p320, @p321, @p322, @p323, @p324, @p325, @p326, @p327, @p328, @p329, @p330, @p331, @p332, @p333, @p334, @p335, 5), (@p336, @p337, @p338, @p339, @p340, @p341, @p342, @p343, @p344, @p345, @p346, @p347, @p348, @p349, @p350, @p351, @p352, @p353, @p354, @p355, @p356, @p357, @p358, @p359, @p360, @p361, @p362, @p363, @p364, @p365, @p366, @p367, @p368, @p369, @p370, @p371, @p372, @p373, @p374, @p375, @p376, @p377, @p378, @p379, @p380, @p381, @p382, @p383, @p384, @p385, @p386, @p387, @p388, @p389, @p390, @p391, 6), (@p392, @p393, @p394, @p395, @p396, @p397, @p398, @p399, @p400, @p401, @p402, @p403, @p404, @p405, @p406, @p407, @p408, @p409, @p410, @p411, @p412, @p413, @p414, @p415, @p416, @p417, @p418, @p419, @p420, @p421, @p422, @p423, @p424, @p425, @p426, @p427, @p428, @p429, @p430, @p431, @p432, @p433, @p434, @p435, @p436, @p437, @p438, @p439, @p440, @p441, @p442, @p443, @p444, @p445, @p446, @p447, 7), (@p448, @p449, @p450, @p451, @p452, @p453, @p454, @p455, @p456, @p457, @p458, @p459, @p460, @p461, @p462, @p463, @p464, @p465, @p466, @p467, @p468, @p469, @p470, @p471, @p472, @p473, @p474, @p475, @p476, @p477, @p478, @p479, @p480, @p481, @p482, @p483, @p484, @p485, @p486, @p487, @p488, @p489, @p490, @p491, @p492, @p493, @p494, @p495, @p496, @p497, @p498, @p499, @p500, @p501, @p502, @p503, 8), (@p504, @p505, @p506, @p507, @p508, @p509, @p510, @p511, @p512, @p513, @p514, @p515, @p516, @p517, @p518, @p519, @p520, @p521, @p522, @p523, @p524, @p525, @p526, @p527, @p528, @p529, @p530, @p531, @p532, @p533, @p534, @p535, @p536, @p537, @p538, @p539, @p540, @p541, @p542, @p543, @p544, @p545, @p546, @p547, @p548, @p549, @p550, @p551, @p552, @p553, @p554, @p555, @p556, @p557, @p558, @p559, 9), (@p560, @p561, @p562, @p563, @p564, @p565, @p566, @p567, @p568, @p569, @p570, @p571, @p572, @p573, @p574, @p575, @p576, @p577, @p578, @p579, @p580, @p581, @p582, @p583, @p584, @p585, @p586, @p587, @p588, @p589, @p590, @p591, @p592, @p593, @p594, @p595, @p596, @p597, @p598, @p599, @p600, @p601, @p602, @p603, @p604, @p605, @p606, @p607, @p608, @p609, @p610, @p611, @p612, @p613, @p614, @p615, 10), (@p616, @p617, @p618, @p619, @p620, @p621, @p622, @p623, @p624, @p625, @p626, @p627, @p628, @p629, @p630, @p631, @p632, @p633, @p634, @p635, @p636, @p637, @p638, @p639, @p640, @p641, @p642, @p643, @p644, @p645, @p646, @p647, @p648, @p649, @p650, @p651, @p652, @p653, @p654, @p655, @p656, @p657, @p658, @p659, @p660, @p661, @p662, @p663, @p664, @p665, @p666, @p667, @p668, @p669, @p670, @p671, 11), (@p672, @p673, @p674, @p675, @p676, @p677, @p678, @p679, @p680, @p681, @p682, @p683, @p684, @p685, @p686, @p687, @p688, @p689, @p690, @p691, @p692, @p693, @p694, @p695, @p696, @p697, @p698, @p699, @p700, @p701, @p702, @p703, @p704, @p705, @p706, @p707, @p708, @p709, @p710, @p711, @p712, @p713, @p714, @p715, @p716, @p717, @p718, @p719, @p720, @p721, @p722, @p723, @p724, @p725, @p726, @p727, 12), (@p728, @p729, @p730, @p731, @p732, @p733, @p734, @p735, @p736, @p737, @p738, @p739, @p740, @p741, @p742, @p743, @p744, @p745, @p746, @p747, @p748, @p749, @p750, @p751, @p752, @p753, @p754, @p755, @p756, @p757, @p758, @p759, @p760, @p761, @p762, @p763, @p764, @p765, @p766, @p767, @p768, @p769, @p770, @p771, @p772, @p773, @p774, @p775, @p776, @p777, @p778, @p779, @p780, @p781, @p782, @p783, 13), (@p784, @p785, @p786, @p787, @p788, @p789, @p790, @p791, @p792, @p793, @p794, @p795, @p796, @p797, @p798, @p799, @p800, @p801, @p802, @p803, @p804, @p805, @p806, @p807, @p808, @p809, @p810, @p811, @p812, @p813, @p814, @p815, @p816, @p817, @p818, @p819, @p820, @p821, @p822, @p823, @p824, @p825, @p826, @p827, @p828, @p829, @p830, @p831, @p832, @p833, @p834, @p835, @p836, @p837, @p838, @p839, 14), (@p840, @p841, @p842, @p843, @p844, @p845, @p846, @p847, @p848, @p849, @p850, @p851, @p852, @p853, @p854, @p855, @p856, @p857, @p858, @p859, @p860, @p861, @p862, @p863, @p864, @p865, @p866, @p867, @p868, @p869, @p870, @p871, @p872, @p873, @p874, @p875, @p876, @p877, @p878, @p879, @p880, @p881, @p882, @p883, @p884, @p885, @p886, @p887, @p888, @p889, @p890, @p891, @p892, @p893, @p894, @p895, 15), (@p896, @p897, @p898, @p899, @p900, @p901, @p902, @p903, @p904, @p905, @p906, @p907, @p908, @p909, @p910, @p911, @p912, @p913, @p914, @p915, @p916, @p917, @p918, @p919, @p920, @p921, @p922, @p923, @p924, @p925, @p926, @p927, @p928, @p929, @p930, @p931, @p932, @p933, @p934, @p935, @p936, @p937, @p938, @p939, @p940, @p941, @p942, @p943, @p944, @p945, @p946, @p947, @p948, @p949, @p950, @p951, 16), (@p952, @p953, @p954, @p955, @p956, @p957, @p958, @p959, @p960, @p961, @p962, @p963, @p964, @p965, @p966, @p967, @p968, @p969, @p970, @p971, @p972, @p973, @p974, @p975, @p976, @p977, @p978, @p979, @p980, @p981, @p982, @p983, @p984, @p985, @p986, @p987, @p988, @p989, @p990, @p991, @p992, @p993, @p994, @p995, @p996, @p997, @p998, @p999, @p1000, @p1001, @p1002, @p1003, @p1004, @p1005, @p1006, @p1007, 17), (@p1008, @p1009, @p1010, @p1011, @p1012, @p1013, @p1014, @p1015, @p1016, @p1017, @p1018, @p1019, @p1020, @p1021, @p1022, @p1023, @p1024, @p1025, @p1026, @p1027, @p1028, @p1029, @p1030, @p1031, @p1032, @p1033, @p1034, @p1035, @p1036, @p1037, @p1038, @p1039, @p1040, @p1041, @p1042, @p1043, @p1044, @p1045, @p1046, @p1047, @p1048, @p1049, @p1050, @p1051, @p1052, @p1053, @p1054, @p1055, @p1056, @p1057, @p1058, @p1059, @p1060, @p1061, @p1062, @p1063, 18), (@p1064, @p1065, @p1066, @p1067, @p1068, @p1069, @p1070, @p1071, @p1072, @p1073, @p1074, @p1075, @p1076, @p1077, @p1078, @p1079, @p1080, @p1081, @p1082, @p1083, @p1084, @p1085, @p1086, @p1087, @p1088, @p1089, @p1090, @p1091, @p1092, @p1093, @p1094, @p1095, @p1096, @p1097, @p1098, @p1099, @p1100, @p1101, @p1102, @p1103, @p1104, @p1105, @p1106, @p1107, @p1108, @p1109, @p1110, @p1111, @p1112, @p1113, @p1114, @p1115, @p1116, @p1117, @p1118, @p1119, 19), (@p1120, @p1121, @p1122, @p1123, @p1124, @p1125, @p1126, @p1127, @p1128, @p1129, @p1130, @p1131, @p1132, @p1133, @p1134, @p1135, @p1136, @p1137, @p1138, @p1139, @p1140, @p1141, @p1142, @p1143, @p1144, @p1145, @p1146, @p1147, @p1148, @p1149, @p1150, @p1151, @p1152, @p1153, @p1154, @p1155, @p1156, @p1157, @p1158, @p1159, @p1160, @p1161, @p1162, @p1163, @p1164, @p1165, @p1166, @p1167, @p1168, @p1169, @p1170, @p1171, @p1172, @p1173, @p1174, @p1175, 20), (@p1176, @p1177, @p1178, @p1179, @p1180, @p1181, @p1182, @p1183, @p1184, @p1185, @p1186, @p1187, @p1188, @p1189, @p1190, @p1191, @p1192, @p1193, @p1194, @p1195, @p1196, @p1197, @p1198, @p1199, @p1200, @p1201, @p1202, @p1203, @p1204, @p1205, @p1206, @p1207, @p1208, @p1209, @p1210, @p1211, @p1212, @p1213, @p1214, @p1215, @p1216, @p1217, @p1218, @p1219, @p1220, @p1221, @p1222, @p1223, @p1224, @p1225, @p1226, @p1227, @p1228, @p1229, @p1230, @p1231, 21), (@p1232, @p1233, @p1234, @p1235, @p1236, @p1237, @p1238, @p1239, @p1240, @p1241, @p1242, @p1243, @p1244, @p1245, @p1246, @p1247, @p1248, @p1249, @p1250, @p1251, @p1252, @p1253, @p1254, @p1255, @p1256, @p1257, @p1258, @p1259, @p1260, @p1261, @p1262, @p1263, @p1264, @p1265, @p1266, @p1267, @p1268, @p1269, @p1270, @p1271, @p1272, @p1273, @p1274, @p1275, @p1276, @p1277, @p1278, @p1279, @p1280, @p1281, @p1282, @p1283, @p1284, @p1285, @p1286, @p1287, 22), (@p1288, @p1289, @p1290, @p1291, @p1292, @p1293, @p1294, @p1295, @p1296, @p1297, @p1298, @p1299, @p1300, @p1301, @p1302, @p1303, @p1304, @p1305, @p1306, @p1307, @p1308, @p1309, @p1310, @p1311, @p1312, @p1313, @p1314, @p1315, @p1316, @p1317, @p1318, @p1319, @p1320, @p1321, @p1322, @p1323, @p1324, @p1325, @p1326, @p1327, @p1328, @p1329, @p1330, @p1331, @p1332, @p1333, @p1334, @p1335, @p1336, @p1337, @p1338, @p1339, @p1340, @p1341, @p1342, @p1343, 23), (@p1344, @p1345, @p1346, @p1347, @p1348, @p1349, @p1350, @p1351, @p1352, @p1353, @p1354, @p1355, @p1356, @p1357, @p1358, @p1359, @p1360, @p1361, @p1362, @p1363, @p1364, @p1365, @p1366, @p1367, @p1368, @p1369, @p1370, @p1371, @p1372, @p1373, @p1374, @p1375, @p1376, @p1377, @p1378, @p1379, @p1380, @p1381, @p1382, @p1383, @p1384, @p1385, @p1386, @p1387, @p1388, @p1389, @p1390, @p1391, @p1392, @p1393, @p1394, @p1395, @p1396, @p1397, @p1398, @p1399, 24), (@p1400, @p1401, @p1402, @p1403, @p1404, @p1405, @p1406, @p1407, @p1408, @p1409, @p1410, @p1411, @p1412, @p1413, @p1414, @p1415, @p1416, @p1417, @p1418, @p1419, @p1420, @p1421, @p1422, @p1423, @p1424, @p1425, @p1426, @p1427, @p1428, @p1429, @p1430, @p1431, @p1432, @p1433, @p1434, @p1435, @p1436, @p1437, @p1438, @p1439, @p1440, @p1441, @p1442, @p1443, @p1444, @p1445, @p1446, @p1447, @p1448, @p1449, @p1450, @p1451, @p1452, @p1453, @p1454, @p1455, 25), (@p1456, @p1457, @p1458, @p1459, @p1460, @p1461, @p1462, @p1463, @p1464, @p1465, @p1466, @p1467, @p1468, @p1469, @p1470, @p1471, @p1472, @p1473, @p1474, @p1475, @p1476, @p1477, @p1478, @p1479, @p1480, @p1481, @p1482, @p1483, @p1484, @p1485, @p1486, @p1487, @p1488, @p1489, @p1490, @p1491, @p1492, @p1493, @p1494, @p1495, @p1496, @p1497, @p1498, @p1499, @p1500, @p1501, @p1502, @p1503, @p1504, @p1505, @p1506, @p1507, @p1508, @p1509, @p1510, @p1511, 26), (@p1512, @p1513, @p1514, @p1515, @p1516, @p1517, @p1518, @p1519, @p1520, @p1521, @p1522, @p1523, @p1524, @p1525, @p1526, @p1527, @p1528, @p1529, @p1530, @p1531, @p1532, @p1533, @p1534, @p1535, @p1536, @p1537, @p1538, @p1539, @p1540, @p1541, @p1542, @p1543, @p1544, @p1545, @p1546, @p1547, @p1548, @p1549, @p1550, @p1551, @p1552, @p1553, @p1554, @p1555, @p1556, @p1557, @p1558, @p1559, @p1560, @p1561, @p1562, @p1563, @p1564, @p1565, @p1566, @p1567, 27), (@p1568, @p1569, @p1570, @p1571, @p1572, @p1573, @p1574, @p1575, @p1576, @p1577, @p1578, @p1579, @p1580, @p1581, @p1582, @p1583, @p1584, @p1585, @p1586, @p1587, @p1588, @p1589, @p1590, @p1591, @p1592, @p1593, @p1594, @p1595, @p1596, @p1597, @p1598, @p1599, @p1600, @p1601, @p1602, @p1603, @p1604, @p1605, @p1606, @p1607, @p1608, @p1609, @p1610, @p1611, @p1612, @p1613, @p1614, @p1615, @p1616, @p1617, @p1618, @p1619, @p1620, @p1621, @p1622, @p1623, 28), (@p1624, @p1625, @p1626, @p1627, @p1628, @p1629, @p1630, @p1631, @p1632, @p1633, @p1634, @p1635, @p1636, @p1637, @p1638, @p1639, @p1640, @p1641, @p1642, @p1643, @p1644, @p1645, @p1646, @p1647, @p1648, @p1649, @p1650, @p1651, @p1652, @p1653, @p1654, @p1655, @p1656, @p1657, @p1658, @p1659, @p1660, @p1661, @p1662, @p1663, @p1664, @p1665, @p1666, @p1667, @p1668, @p1669, @p1670, @p1671, @p1672, @p1673, @p1674, @p1675, @p1676, @p1677, @p1678, @p1679, 29), (@p1680, @p1681, @p1682, @p1683, @p1684, @p1685, @p1686, @p1687, @p1688, @p1689, @p1690, @p1691, @p1692, @p1693, @p1694, @p1695, @p1696, @p1697, @p1698, @p1699, @p1700, @p1701, @p1702, @p1703, @p1704, @p1705, @p1706, @p1707, @p1708, @p1709, @p1710, @p1711, @p1712, @p1713, @p1714, @p1715, @p1716, @p1717, @p1718, @p1719, @p1720, @p1721, @p1722, @p1723, @p1724, @p1725, @p1726, @p1727, @p1728, @p1729, @p1730, @p1731, @p1732, @p1733, @p1734, @p1735, 30), (@p1736, @p1737, @p1738, @p1739, @p1740, @p1741, @p1742, @p1743, @p1744, @p1745, @p1746, @p1747, @p1748, @p1749, @p1750, @p1751, @p1752, @p1753, @p1754, @p1755, @p1756, @p1757, @p1758, @p1759, @p1760, @p1761, @p1762, @p1763, @p1764, @p1765, @p1766, @p1767, @p1768, @p1769, @p1770, @p1771, @p1772, @p1773, @p1774, @p1775, @p1776, @p1777, @p1778, @p1779, @p1780, @p1781, @p1782, @p1783, @p1784, @p1785, @p1786, @p1787, @p1788, @p1789, @p1790, @p1791, 31), (@p1792, @p1793, @p1794, @p1795, @p1796, @p1797, @p1798, @p1799, @p1800, @p1801, @p1802, @p1803, @p1804, @p1805, @p1806, @p1807, @p1808, @p1809, @p1810, @p1811, @p1812, @p1813, @p1814, @p1815, @p1816, @p1817, @p1818, @p1819, @p1820, @p1821, @p1822, @p1823, @p1824, @p1825, @p1826, @p1827, @p1828, @p1829, @p1830, @p1831, @p1832, @p1833, @p1834, @p1835, @p1836, @p1837, @p1838, @p1839, @p1840, @p1841, @p1842, @p1843, @p1844, @p1845, @p1846, @p1847, 32), (@p1848, @p1849, @p1850, @p1851, @p1852, @p1853, @p1854, @p1855, @p1856, @p1857, @p1858, @p1859, @p1860, @p1861, @p1862, @p1863, @p1864, @p1865, @p1866, @p1867, @p1868, @p1869, @p1870, @p1871, @p1872, @p1873, @p1874, @p1875, @p1876, @p1877, @p1878, @p1879, @p1880, @p1881, @p1882, @p1883, @p1884, @p1885, @p1886, @p1887, @p1888, @p1889, @p1890, @p1891, @p1892, @p1893, @p1894, @p1895, @p1896, @p1897, @p1898, @p1899, @p1900, @p1901, @p1902, @p1903, 33), (@p1904, @p1905, @p1906, @p1907, @p1908, @p1909, @p1910, @p1911, @p1912, @p1913, @p1914, @p1915, @p1916, @p1917, @p1918, @p1919, @p1920, @p1921, @p1922, @p1923, @p1924, @p1925, @p1926, @p1927, @p1928, @p1929, @p1930, @p1931, @p1932, @p1933, @p1934, @p1935, @p1936, @p1937, @p1938, @p1939, @p1940, @p1941, @p1942, @p1943, @p1944, @p1945, @p1946, @p1947, @p1948, @p1949, @p1950, @p1951, @p1952, @p1953, @p1954, @p1955, @p1956, @p1957, @p1958, @p1959, 34), (@p1960, @p1961, @p1962, @p1963, @p1964, @p1965, @p1966, @p1967, @p1968, @p1969, @p1970, @p1971, @p1972, @p1973, @p1974, @p1975, @p1976, @p1977, @p1978, @p1979, @p1980, @p1981, @p1982, @p1983, @p1984, @p1985, @p1986, @p1987, @p1988, @p1989, @p1990, @p1991, @p1992, @p1993, @p1994, @p1995, @p1996, @p1997, @p1998, @p1999, @p2000, @p2001, @p2002, @p2003, @p2004, @p2005, @p2006, @p2007, @p2008, @p2009, @p2010, @p2011, @p2012, @p2013, @p2014, @p2015, 35), (@p2016, @p2017, @p2018, @p2019, @p2020, @p2021, @p2022, @p2023, @p2024, @p2025, @p2026, @p2027, @p2028, @p2029, @p2030, @p2031, @p2032, @p2033, @p2034, @p2035, @p2036, @p2037, @p2038, @p2039, @p2040, @p2041, @p2042, @p2043, @p2044, @p2045, @p2046, @p2047, @p2048, @p2049, @p2050, @p2051, @p2052, @p2053, @p2054, @p2055, @p2056, @p2057, @p2058, @p2059, @p2060, @p2061, @p2062, @p2063, @p2064, @p2065, @p2066, @p2067, @p2068, @p2069, @p2070, @p2071, 36)) AS i ([addressee_cntry_cd], [addressee_city], [addressee_district], [addressee_email], [addressee_full_address], [addressee_home_address], [addressee_name], [addressee_postcode], [addressee_province], [addressee_subdistrict], [addressee_tel], [create_table], [delivery_code], [delivery_recipient_name], [delivery_relation_id], [delivery_status_id], [dest_outlet_id], [dest_outlet_port], [document_number], [item_barcode], [item_cod], [item_gross_weight], [item_height], [item_length], [item_price], [item_width], [lat], [log_id], [long], [outlet_id], [outlet_port], [podUrl], [remark], [scan_cntry_cd], [scan_cntry_postcode], [sender_cntry_cd], [sender_district], [sender_email], [sender_full_address], [sender_home_address], [member_id], [sender_name], [sender_postcode], [sender_province], [sender_subdistrict], [sender_tel], [server_id], [signatureUrl], [state], [status_code], [status_dtm], [timestamp], [transmit_dtm], [user_id], [wckt_id], [wkstn_no], _Position) ON 1=0 WHEN NOT MATCHED THEN INSERT ([addressee_cntry_cd], [addressee_city], [addressee_district], [addressee_email], [addressee_full_address], [addressee_home_address], [addressee_name], [addressee_postcode], [addressee_province], [addressee_subdistrict], [addressee_tel], [create_table], [delivery_code], [delivery_recipient_name], [delivery_relation_id], [delivery_status_id], [dest_outlet_id], [dest_outlet_port], [document_number], [item_barcode], [item_cod], [item_gross_weight], [item_height], [item_length], [item_price], [item_width], [lat], [log_id], [long], [outlet_id], [outlet_port], [podUrl], [remark], [scan_cntry_cd], [scan_cntry_postcode], [sender_cntry_cd], [sender_district], [sender_email], [sender_full_address], [sender_home_address], [member_id], [sender_name], [sender_postcode], [sender_province], [sender_subdistrict], [sender_tel], [server_id], [signatureUrl], [state], [status_code], [status_dtm], [timestamp], [transmit_dtm], [user_id], [wckt_id], [wkstn_no]) VALUES (i.[addressee_cntry_cd], i.[addressee_city], i.[addressee_district], i.[addressee_email], i.[addressee_full_address], i.[addressee_home_address], i.[addressee_name], i.[addressee_postcode], i.[addressee_province], i.[addressee_subdistrict], i.[addressee_tel], i.[create_table], i.[delivery_code], i.[delivery_recipient_name], i.[delivery_relation_id], i.[delivery_status_id], i.[dest_outlet_id], i.[dest_outlet_port], i.[document_number], i.[item_barcode], i.[item_cod], i.[item_gross_weight], i.[item_height], i.[item_length], i.[item_price], i.[item_width], i.[lat], i.[log_id], i.[long], i.[outlet_id], i.[outlet_port], i.[podUrl], i.[remark], i.[scan_cntry_cd], i.[scan_cntry_postcode], i.[sender_cntry_cd], i.[sender_district], i.[sender_email], i.[sender_full_address], i.[sender_home_address], i.[member_id], i.[sender_name], i.[sender_postcode], i.[sender_province], i.[sender_subdistrict], i.[sender_tel], i.[server_id], i.[signatureUrl], i.[state], i.[status_code], i.[status_dtm], i.[timestamp], i.[transmit_dtm], i.[user_id], i.[wckt_id], i.[wkstn_no]) OUTPUT INSERTED.[item_id], i._Position INTO @inserted0;  SELECT [t].[item_id] FROM [raw_data] t INNER JOIN @inserted0 i ON ([t].[item_id] = [i].[item_id]) ORDER BY [i].[_Position];  ",4,4,0,433,10,4
"(@p0 nvarchar(4000),@p1 nvarchar(4000),@p2 nvarchar(4000),@p3 nvarchar(4000),@p4 nvarchar(4000),@p5 nvarchar(4000),@p6 nvarchar(4000),@p7 nvarchar(4000),@p8 nvarchar(4000),@p9 nvarchar(4000),@p10 nvarchar(4000),@p11 datetime2(7),@p12 nvarchar(4000),@p13 nvarchar(4000),@p14 int,@p15 int,@p16 int,@p17 nvarchar(4000),@p18 nvarchar(4000),@p19 nvarchar(4000),@p20 nvarchar(4000),@p21 decimal(18,2),@p22 nvarchar(4000),@p23 nvarchar(4000),@p24 decimal(18,2),@p25 nvarchar(4000),@p26 nvarchar(4000),@p27 nvarchar(4000),@p28 nvarchar(4000),@p29 int,@p30 nvarchar(4000),@p31 nvarchar(4000),@p32 nvarchar(4000),@p33 nvarchar(4000),@p34 nvarchar(4000),@p35 nvarchar(4000),@p36 nvarchar(4000),@p37 nvarchar(4000),@p38 nvarchar(4000),@p39 nvarchar(4000),@p40 int,@p41 nvarchar(4000),@p42 nvarchar(4000),@p43 nvarchar(4000),@p44 nvarchar(4000),@p45 nvarchar(4000),@p46 int,@p47 nvarchar(4000),@p48 int,@p49 int,@p50 datetime2(7),@p51 datetime2(7),@p52 datetime2(7),@p53 nvarchar(4000),@p54 nvarchar(4000),@p55 nvarchar(4000),@p56 nvarchar(4000),@p57 nvarchar(4000),@p58 nvarchar(4000),@p59 nvarchar(4000),@p60 nvarchar(4000),@p61 nvarchar(4000),@p62 nvarchar(4000),@p63 nvarchar(4000),@p64 nvarchar(4000),@p65 nvarchar(4000),@p66 nvarchar(4000),@p67 datetime2(7),@p68 nvarchar(4000),@p69 nvarchar(4000),@p70 int,@p71 int,@p72 int,@p73 nvarchar(4000),@p74 nvarchar(4000),@p75 nvarchar(4000),@p76 nvarchar(4000),@p77 decimal(18,2),@p78 nvarchar(4000),@p79 nvarchar(4000),@p80 decimal(18,2),@p81 nvarchar(4000),@p82 nvarchar(4000),@p83 nvarchar(4000),@p84 nvarchar(4000),@p85 int,@p86 nvarchar(4000),@p87 nvarchar(4000),@p88 nvarchar(4000),@p89 nvarchar(4000),@p90 nvarchar(4000),@p91 nvarchar(4000),@p92 nvarchar(4000),@p93 nvarchar(4000),@p94 nvarchar(4000),@p95 nvarchar(4000),@p96 int,@p97 nvarchar(4000),@p98 nvarchar(4000),@p99 nvarchar(4000),@p100 nvarchar(4000),@p101 nvarchar(4000),@p102 int,@p103 nvarchar(4000),@p104 int,@p105 int,@p106 datetime2(7),@p107 datetime2(7),@p108 datetime2(7),@p109 nvarchar(4000),@p110 nvarchar(4000),@p111 nvarchar(4000),@p112 nvarchar(4000),@p113 nvarchar(4000),@p114 nvarchar(4000),@p115 nvarchar(4000),@p116 nvarchar(4000),@p117 nvarchar(4000),@p118 nvarchar(4000),@p119 nvarchar(4000),@p120 nvarchar(4000),@p121 nvarchar(4000),@p122 nvarchar(4000),@p123 datetime2(7),@p124 nvarchar(4000),@p125 nvarchar(4000),@p126 int,@p127 int,@p128 int,@p129 nvarchar(4000),@p130 nvarchar(4000),@p131 nvarchar(4000),@p132 nvarchar(4000),@p133 decimal(18,2),@p134 nvarchar(4000),@p135 nvarchar(4000),@p136 decimal(18,2),@p137 nvarchar(4000),@p138 nvarchar(4000),@p139 nvarchar(4000),@p140 nvarchar(4000),@p141 int,@p142 nvarchar(4000),@p143 nvarchar(4000),@p144 nvarchar(4000),@p145 nvarchar(4000),@p146 nvarchar(4000),@p147 nvarchar(4000),@p148 nvarchar(4000),@p149 nvarchar(4000),@p150 nvarchar(4000),@p151 nvarchar(4000),@p152 int,@p153 nvarchar(4000),@p154 nvarchar(4000),@p155 nvarchar(4000),@p156 nvarchar(4000),@p157 nvarchar(4000),@p158 int,@p159 nvarchar(4000),@p160 int,@p161 int,@p162 datetime2(7),@p163 datetime2(7),@p164 datetime2(7),@p165 nvarchar(4000),@p166 nvarchar(4000),@p167 nvarchar(4000),@p168 nvarchar(4000),@p169 nvarchar(4000),@p170 nvarchar(4000),@p171 nvarchar(4000),@p172 nvarchar(4000),@p173 nvarchar(4000),@p174 nvarchar(4000),@p175 nvarchar(4000),@p176 nvarchar(4000),@p177 nvarchar(4000),@p178 nvarchar(4000),@p179 datetime2(7),@p180 nvarchar(4000),@p181 nvarchar(4000),@p182 int,@p183 int,@p184 int,@p185 nvarchar(4000),@p186 nvarchar(4000),@p187 nvarchar(4000),@p188 nvarchar(4000),@p189 decimal(18,2),@p190 nvarchar(4000),@p191 nvarchar(4000),@p192 decimal(18,2),@p193 nvarchar(4000),@p194 nvarchar(4000),@p195 nvarchar(4000),@p196 nvarchar(4000),@p197 int,@p198 nvarchar(4000),@p199 nvarchar(4000),@p200 nvarchar(4000),@p201 nvarchar(4000),@p202 nvarchar(4000),@p203 nvarchar(4000),@p204 nvarchar(4000),@p205 nvarchar(4000),@p206 nvarchar(4000),@p207 nvarchar(4000),@p208 int,@p209 nvarchar(4000),@p210 nvarchar(4000),@p211 nvarchar(4000),@p212 nvarchar(4000),@p213 nvarchar(4000),@p214 int,@p215 nvarchar(4000),@p216 int,@p217 int,@p218 datetime2(7),@p219 datetime2(7),@p220 datetime2(7),@p221 nvarchar(4000),@p222 nvarchar(4000),@p223 nvarchar(4000),@p224 nvarchar(4000),@p225 nvarchar(4000),@p226 nvarchar(4000),@p227 nvarchar(4000),@p228 nvarchar(4000),@p229 nvarchar(4000),@p230 nvarchar(4000),@p231 nvarchar(4000),@p232 nvarchar(4000),@p233 nvarchar(4000),@p234 nvarchar(4000),@p235 datetime2(7),@p236 nvarchar(4000),@p237 nvarchar(4000),@p238 int,@p239 int,@p240 int,@p241 nvarchar(4000),@p242 nvarchar(4000),@p243 nvarchar(4000),@p244 nvarchar(4000),@p245 decimal(18,2),@p246 nvarchar(4000),@p247 nvarchar(4000),@p248 decimal(18,2),@p249 nvarchar(4000),@p250 nvarchar(4000),@p251 nvarchar(4000),@p252 nvarchar(4000),@p253 int,@p254 nvarchar(4000),@p255 nvarchar(4000),@p256 nvarchar(4000),@p257 nvarchar(4000),@p258 nvarchar(4000),@p259 nvarchar(4000),@p260 nvarchar(4000),@p261 nvarchar(4000),@p262 nvarchar(4000),@p263 nvarchar(4000),@p264 int,@p265 nvarchar(4000),@p266 nvarchar(4000),@p267 nvarchar(4000),@p268 nvarchar(4000),@p269 nvarchar(4000),@p270 int,@p271 nvarchar(4000),@p272 int,@p273 int,@p274 datetime2(7),@p275 datetime2(7),@p276 datetime2(7),@p277 nvarchar(4000),@p278 nvarchar(4000),@p279 nvarchar(4000),@p280 nvarchar(4000),@p281 nvarchar(4000),@p282 nvarchar(4000),@p283 nvarchar(4000),@p284 nvarchar(4000),@p285 nvarchar(4000),@p286 nvarchar(4000),@p287 nvarchar(4000),@p288 nvarchar(4000),@p289 nvarchar(4000),@p290 nvarchar(4000),@p291 datetime2(7),@p292 nvarchar(4000),@p293 nvarchar(4000),@p294 int,@p295 int,@p296 int,@p297 nvarchar(4000),@p298 nvarchar(4000),@p299 nvarchar(4000),@p300 nvarchar(4000),@p301 decimal(18,2),@p302 nvarchar(4000),@p303 nvarchar(4000),@p304 decimal(18,2),@p305 nvarchar(4000),@p306 nvarchar(4000),@p307 nvarchar(4000),@p308 nvarchar(4000),@p309 int,@p310 nvarchar(4000),@p311 nvarchar(4000),@p312 nvarchar(4000),@p313 nvarchar(4000),@p314 nvarchar(4000),@p315 nvarchar(4000),@p316 nvarchar(4000),@p317 nvarchar(4000),@p318 nvarchar(4000),@p319 nvarchar(4000),@p320 int,@p321 nvarchar(4000),@p322 nvarchar(4000),@p323 nvarchar(4000),@p324 nvarchar(4000),@p325 nvarchar(4000),@p326 int,@p327 nvarchar(4000),@p328 int,@p329 int,@p330 datetime2(7),@p331 datetime2(7),@p332 datetime2(7),@p333 nvarchar(4000),@p334 nvarchar(4000),@p335 nvarchar(4000),@p336 nvarchar(4000),@p337 nvarchar(4000),@p338 nvarchar(4000),@p339 nvarchar(4000),@p340 nvarchar(4000),@p341 nvarchar(4000),@p342 nvarchar(4000),@p343 nvarchar(4000),@p344 nvarchar(4000),@p345 nvarchar(4000),@p346 nvarchar(4000),@p347 datetime2(7),@p348 nvarchar(4000),@p349 nvarchar(4000),@p350 int,@p351 int,@p352 int,@p353 nvarchar(4000),@p354 nvarchar(4000),@p355 nvarchar(4000),@p356 nvarchar(4000),@p357 decimal(18,2),@p358 nvarchar(4000),@p359 nvarchar(4000),@p360 decimal(18,2),@p361 nvarchar(4000),@p362 nvarchar(4000),@p363 nvarchar(4000),@p364 nvarchar(4000),@p365 int,@p366 nvarchar(4000),@p367 nvarchar(4000),@p368 nvarchar(4000),@p369 nvarchar(4000),@p370 nvarchar(4000),@p371 nvarchar(4000),@p372 nvarchar(4000),@p373 nvarchar(4000),@p374 nvarchar(4000),@p375 nvarchar(4000),@p376 int,@p377 nvarchar(4000),@p378 nvarchar(4000),@p379 nvarchar(4000),@p380 nvarchar(4000),@p381 nvarchar(4000),@p382 int,@p383 nvarchar(4000),@p384 int,@p385 int,@p386 datetime2(7),@p387 datetime2(7),@p388 datetime2(7),@p389 nvarchar(4000),@p390 nvarchar(4000),@p391 nvarchar(4000),@p392 nvarchar(4000),@p393 nvarchar(4000),@p394 nvarchar(4000),@p395 nvarchar(4000),@p396 nvarchar(4000),@p397 nvarchar(4000),@p398 nvarchar(4000),@p399 nvarchar(4000),@p400 nvarchar(4000),@p401 nvarchar(4000),@p402 nvarchar(4000),@p403 datetime2(7),@p404 nvarchar(4000),@p405 nvarchar(4000),@p406 int,@p407 int,@p408 int,@p409 nvarchar(4000),@p410 nvarchar(4000),@p411 nvarchar(4000),@p412 nvarchar(4000),@p413 decimal(18,2),@p414 nvarchar(4000),@p415 nvarchar(4000),@p416 decimal(18,2),@p417 nvarchar(4000),@p418 nvarchar(4000),@p419 nvarchar(4000),@p420 nvarchar(4000),@p421 int,@p422 nvarchar(4000),@p423 nvarchar(4000),@p424 nvarchar(4000),@p425 nvarchar(4000),@p426 nvarchar(4000),@p427 nvarchar(4000),@p428 nvarchar(4000),@p429 nvarchar(4000),@p430 nvarchar(4000),@p431 nvarchar(4000),@p432 int,@p433 nvarchar(4000),@p434 nvarchar(4000),@p435 nvarchar(4000),@p436 nvarchar(4000),@p437 nvarchar(4000),@p438 int,@p439 nvarchar(4000),@p440 int,@p441 int,@p442 datetime2(7),@p443 datetime2(7),@p444 datetime2(7),@p445 nvarchar(4000),@p446 nvarchar(4000),@p447 nvarchar(4000),@p448 nvarchar(4000),@p449 nvarchar(4000),@p450 nvarchar(4000),@p451 nvarchar(4000),@p452 nvarchar(4000),@p453 nvarchar(4000),@p454 nvarchar(4000),@p455 nvarchar(4000),@p456 nvarchar(4000),@p457 nvarchar(4000),@p458 nvarchar(4000),@p459 datetime2(7),@p460 nvarchar(4000),@p461 nvarchar(4000),@p462 int,@p463 int,@p464 int,@p465 nvarchar(4000),@p466 nvarchar(4000),@p467 nvarchar(4000),@p468 nvarchar(4000),@p469 decimal(18,2),@p470 nvarchar(4000),@p471 nvarchar(4000),@p472 decimal(18,2),@p473 nvarchar(4000),@p474 nvarchar(4000),@p475 nvarchar(4000),@p476 nvarchar(4000),@p477 int,@p478 nvarchar(4000),@p479 nvarchar(4000),@p480 nvarchar(4000),@p481 nvarchar(4000),@p482 nvarchar(4000),@p483 nvarchar(4000),@p484 nvarchar(4000),@p485 nvarchar(4000),@p486 nvarchar(4000),@p487 nvarchar(4000),@p488 int,@p489 nvarchar(4000),@p490 nvarchar(4000),@p491 nvarchar(4000),@p492 nvarchar(4000),@p493 nvarchar(4000),@p494 int,@p495 nvarchar(4000),@p496 int,@p497 int,@p498 datetime2(7),@p499 datetime2(7),@p500 datetime2(7),@p501 nvarchar(4000),@p502 nvarchar(4000),@p503 nvarchar(4000),@p504 nvarchar(4000),@p505 nvarchar(4000),@p506 nvarchar(4000),@p507 nvarchar(4000),@p508 nvarchar(4000),@p509 nvarchar(4000),@p510 nvarchar(4000),@p511 nvarchar(4000),@p512 nvarchar(4000),@p513 nvarchar(4000),@p514 nvarchar(4000),@p515 datetime2(7),@p516 nvarchar(4000),@p517 nvarchar(4000),@p518 int,@p519 int,@p520 int,@p521 nvarchar(4000),@p522 nvarchar(4000),@p523 nvarchar(4000),@p524 nvarchar(4000),@p525 decimal(18,2),@p526 nvarchar(4000),@p527 nvarchar(4000),@p528 decimal(18,2),@p529 nvarchar(4000),@p530 nvarchar(4000),@p531 nvarchar(4000),@p532 nvarchar(4000),@p533 int,@p534 nvarchar(4000),@p535 nvarchar(4000),@p536 nvarchar(4000),@p537 nvarchar(4000),@p538 nvarchar(4000),@p539 nvarchar(4000),@p540 nvarchar(4000),@p541 nvarchar(4000),@p542 nvarchar(4000),@p543 nvarchar(4000),@p544 int,@p545 nvarchar(4000),@p546 nvarchar(4000),@p547 nvarchar(4000),@p548 nvarchar(4000),@p549 nvarchar(4000),@p550 int,@p551 nvarchar(4000),@p552 int,@p553 int,@p554 datetime2(7),@p555 datetime2(7),@p556 datetime2(7),@p557 nvarchar(4000),@p558 nvarchar(4000),@p559 nvarchar(4000),@p560 nvarchar(4000),@p561 nvarchar(4000),@p562 nvarchar(4000),@p563 nvarchar(4000),@p564 nvarchar(4000),@p565 nvarchar(4000),@p566 nvarchar(4000),@p567 nvarchar(4000),@p568 nvarchar(4000),@p569 nvarchar(4000),@p570 nvarchar(4000),@p571 datetime2(7),@p572 nvarchar(4000),@p573 nvarchar(4000),@p574 int,@p575 int,@p576 int,@p577 nvarchar(4000),@p578 nvarchar(4000),@p579 nvarchar(4000),@p580 nvarchar(4000),@p581 decimal(18,2),@p582 nvarchar(4000),@p583 nvarchar(4000),@p584 decimal(18,2),@p585 nvarchar(4000),@p586 nvarchar(4000),@p587 nvarchar(4000),@p588 nvarchar(4000),@p589 int,@p590 nvarchar(4000),@p591 nvarchar(4000),@p592 nvarchar(4000),@p593 nvarchar(4000),@p594 nvarchar(4000),@p595 nvarchar(4000),@p596 nvarchar(4000),@p597 nvarchar(4000),@p598 nvarchar(4000),@p599 nvarchar(4000),@p600 int,@p601 nvarchar(4000),@p602 nvarchar(4000),@p603 nvarchar(4000),@p604 nvarchar(4000),@p605 nvarchar(4000),@p606 int,@p607 nvarchar(4000),@p608 int,@p609 int,@p610 datetime2(7),@p611 datetime2(7),@p612 datetime2(7),@p613 nvarchar(4000),@p614 nvarchar(4000),@p615 nvarchar(4000),@p616 nvarchar(4000),@p617 nvarchar(4000),@p618 nvarchar(4000),@p619 nvarchar(4000),@p620 nvarchar(4000),@p621 nvarchar(4000),@p622 nvarchar(4000),@p623 nvarchar(4000),@p624 nvarchar(4000),@p625 nvarchar(4000),@p626 nvarchar(4000),@p627 datetime2(7),@p628 nvarchar(4000),@p629 nvarchar(4000),@p630 int,@p631 int,@p632 int,@p633 nvarchar(4000),@p634 nvarchar(4000),@p635 nvarchar(4000),@p636 nvarchar(4000),@p637 decimal(18,2),@p638 nvarchar(4000),@p639 nvarchar(4000),@p640 decimal(18,2),@p641 nvarchar(4000),@p642 nvarchar(4000),@p643 nvarchar(4000),@p644 nvarchar(4000),@p645 int,@p646 nvarchar(4000),@p647 nvarchar(4000),@p648 nvarchar(4000),@p649 nvarchar(4000),@p650 nvarchar(4000),@p651 nvarchar(4000),@p652 nvarchar(4000),@p653 nvarchar(4000),@p654 nvarchar(4000),@p655 nvarchar(4000),@p656 int,@p657 nvarchar(4000),@p658 nvarchar(4000),@p659 nvarchar(4000),@p660 nvarchar(4000),@p661 nvarchar(4000),@p662 int,@p663 nvarchar(4000),@p664 int,@p665 int,@p666 datetime2(7),@p667 datetime2(7),@p668 datetime2(7),@p669 nvarchar(4000),@p670 nvarchar(4000),@p671 nvarchar(4000),@p672 nvarchar(4000),@p673 nvarchar(4000),@p674 nvarchar(4000),@p675 nvarchar(4000),@p676 nvarchar(4000),@p677 nvarchar(4000),@p678 nvarchar(4000),@p679 nvarchar(4000),@p680 nvarchar(4000),@p681 nvarchar(4000),@p682 nvarchar(4000),@p683 datetime2(7),@p684 nvarchar(4000),@p685 nvarchar(4000),@p686 int,@p687 int,@p688 int,@p689 nvarchar(4000),@p690 nvarchar(4000),@p691 nvarchar(4000),@p692 nvarchar(4000),@p693 decimal(18,2),@p694 nvarchar(4000),@p695 nvarchar(4000),@p696 decimal(18,2),@p697 nvarchar(4000),@p698 nvarchar(4000),@p699 nvarchar(4000),@p700 nvarchar(4000),@p701 int,@p702 nvarchar(4000),@p703 nvarchar(4000),@p704 nvarchar(4000),@p705 nvarchar(4000),@p706 nvarchar(4000),@p707 nvarchar(4000),@p708 nvarchar(4000),@p709 nvarchar(4000),@p710 nvarchar(4000),@p711 nvarchar(4000),@p712 int,@p713 nvarchar(4000),@p714 nvarchar(4000),@p715 nvarchar(4000),@p716 nvarchar(4000),@p717 nvarchar(4000),@p718 int,@p719 nvarchar(4000),@p720 int,@p721 int,@p722 datetime2(7),@p723 datetime2(7),@p724 datetime2(7),@p725 nvarchar(4000),@p726 nvarchar(4000),@p727 nvarchar(4000),@p728 nvarchar(4000),@p729 nvarchar(4000),@p730 nvarchar(4000),@p731 nvarchar(4000),@p732 nvarchar(4000),@p733 nvarchar(4000),@p734 nvarchar(4000),@p735 nvarchar(4000),@p736 nvarchar(4000),@p737 nvarchar(4000),@p738 nvarchar(4000),@p739 datetime2(7),@p740 nvarchar(4000),@p741 nvarchar(4000),@p742 int,@p743 int,@p744 int,@p745 nvarchar(4000),@p746 nvarchar(4000),@p747 nvarchar(4000),@p748 nvarchar(4000),@p749 decimal(18,2),@p750 nvarchar(4000),@p751 nvarchar(4000),@p752 decimal(18,2),@p753 nvarchar(4000),@p754 nvarchar(4000),@p755 nvarchar(4000),@p756 nvarchar(4000),@p757 int,@p758 nvarchar(4000),@p759 nvarchar(4000),@p760 nvarchar(4000),@p761 nvarchar(4000),@p762 nvarchar(4000),@p763 nvarchar(4000),@p764 nvarchar(4000),@p765 nvarchar(4000),@p766 nvarchar(4000),@p767 nvarchar(4000),@p768 int,@p769 nvarchar(4000),@p770 nvarchar(4000),@p771 nvarchar(4000),@p772 nvarchar(4000),@p773 nvarchar(4000),@p774 int,@p775 nvarchar(4000),@p776 int,@p777 int,@p778 datetime2(7),@p779 datetime2(7),@p780 datetime2(7),@p781 nvarchar(4000),@p782 nvarchar(4000),@p783 nvarchar(4000),@p784 nvarchar(4000),@p785 nvarchar(4000),@p786 nvarchar(4000),@p787 nvarchar(4000),@p788 nvarchar(4000),@p789 nvarchar(4000),@p790 nvarchar(4000),@p791 nvarchar(4000),@p792 nvarchar(4000),@p793 nvarchar(4000),@p794 nvarchar(4000),@p795 datetime2(7),@p796 nvarchar(4000),@p797 nvarchar(4000),@p798 int,@p799 int,@p800 int,@p801 nvarchar(4000),@p802 nvarchar(4000),@p803 nvarchar(4000),@p804 nvarchar(4000),@p805 decimal(18,2),@p806 nvarchar(4000),@p807 nvarchar(4000),@p808 decimal(18,2),@p809 nvarchar(4000),@p810 nvarchar(4000),@p811 nvarchar(4000),@p812 nvarchar(4000),@p813 int,@p814 nvarchar(4000),@p815 nvarchar(4000),@p816 nvarchar(4000),@p817 nvarchar(4000),@p818 nvarchar(4000),@p819 nvarchar(4000),@p820 nvarchar(4000),@p821 nvarchar(4000),@p822 nvarchar(4000),@p823 nvarchar(4000),@p824 int,@p825 nvarchar(4000),@p826 nvarchar(4000),@p827 nvarchar(4000),@p828 nvarchar(4000),@p829 nvarchar(4000),@p830 int,@p831 nvarchar(4000),@p832 int,@p833 int,@p834 datetime2(7),@p835 datetime2(7),@p836 datetime2(7),@p837 nvarchar(4000),@p838 nvarchar(4000),@p839 nvarchar(4000),@p840 nvarchar(4000),@p841 nvarchar(4000),@p842 nvarchar(4000),@p843 nvarchar(4000),@p844 nvarchar(4000),@p845 nvarchar(4000),@p846 nvarchar(4000),@p847 nvarchar(4000),@p848 nvarchar(4000),@p849 nvarchar(4000),@p850 nvarchar(4000),@p851 datetime2(7),@p852 nvarchar(4000),@p853 nvarchar(4000),@p854 int,@p855 int,@p856 int,@p857 nvarchar(4000),@p858 nvarchar(4000),@p859 nvarchar(4000),@p860 nvarchar(4000),@p861 decimal(18,2),@p862 nvarchar(4000),@p863 nvarchar(4000),@p864 decimal(18,2),@p865 nvarchar(4000),@p866 nvarchar(4000),@p867 nvarchar(4000),@p868 nvarchar(4000),@p869 int,@p870 nvarchar(4000),@p871 nvarchar(4000),@p872 nvarchar(4000),@p873 nvarchar(4000),@p874 nvarchar(4000),@p875 nvarchar(4000),@p876 nvarchar(4000),@p877 nvarchar(4000),@p878 nvarchar(4000),@p879 nvarchar(4000),@p880 int,@p881 nvarchar(4000),@p882 nvarchar(4000),@p883 nvarchar(4000),@p884 nvarchar(4000),@p885 nvarchar(4000),@p886 int,@p887 nvarchar(4000),@p888 int,@p889 int,@p890 datetime2(7),@p891 datetime2(7),@p892 datetime2(7),@p893 nvarchar(4000),@p894 nvarchar(4000),@p895 nvarchar(4000),@p896 nvarchar(4000),@p897 nvarchar(4000),@p898 nvarchar(4000),@p899 nvarchar(4000),@p900 nvarchar(4000),@p901 nvarchar(4000),@p902 nvarchar(4000),@p903 nvarchar(4000),@p904 nvarchar(4000),@p905 nvarchar(4000),@p906 nvarchar(4000),@p907 datetime2(7),@p908 nvarchar(4000),@p909 nvarchar(4000),@p910 int,@p911 int,@p912 int,@p913 nvarchar(4000),@p914 nvarchar(4000),@p915 nvarchar(4000),@p916 nvarchar(4000),@p917 decimal(18,2),@p918 nvarchar(4000),@p919 nvarchar(4000),@p920 decimal(18,2),@p921 nvarchar(4000),@p922 nvarchar(4000),@p923 nvarchar(4000),@p924 nvarchar(4000),@p925 int,@p926 nvarchar(4000),@p927 nvarchar(4000),@p928 nvarchar(4000),@p929 nvarchar(4000),@p930 nvarchar(4000),@p931 nvarchar(4000),@p932 nvarchar(4000),@p933 nvarchar(4000),@p934 nvarchar(4000),@p935 nvarchar(4000),@p936 int,@p937 nvarchar(4000),@p938 nvarchar(4000),@p939 nvarchar(4000),@p940 nvarchar(4000),@p941 nvarchar(4000),@p942 int,@p943 nvarchar(4000),@p944 int,@p945 int,@p946 datetime2(7),@p947 datetime2(7),@p948 datetime2(7),@p949 nvarchar(4000),@p950 nvarchar(4000),@p951 nvarchar(4000),@p952 nvarchar(4000),@p953 nvarchar(4000),@p954 nvarchar(4000),@p955 nvarchar(4000),@p956 nvarchar(4000),@p957 nvarchar(4000),@p958 nvarchar(4000),@p959 nvarchar(4000),@p960 nvarchar(4000),@p961 nvarchar(4000),@p962 nvarchar(4000),@p963 datetime2(7),@p964 nvarchar(4000),@p965 nvarchar(4000),@p966 int,@p967 int,@p968 int,@p969 nvarchar(4000),@p970 nvarchar(4000),@p971 nvarchar(4000),@p972 nvarchar(4000),@p973 decimal(18,2),@p974 nvarchar(4000),@p975 nvarchar(4000),@p976 decimal(18,2),@p977 nvarchar(4000),@p978 nvarchar(4000),@p979 nvarchar(4000),@p980 nvarchar(4000),@p981 int,@p982 nvarchar(4000),@p983 nvarchar(4000),@p984 nvarchar(4000),@p985 nvarchar(4000),@p986 nvarchar(4000),@p987 nvarchar(4000),@p988 nvarchar(4000),@p989 nvarchar(4000),@p990 nvarchar(4000),@p991 nvarchar(4000),@p992 int,@p993 nvarchar(4000),@p994 nvarchar(4000),@p995 nvarchar(4000),@p996 nvarchar(4000),@p997 nvarchar(4000),@p998 int,@p999 nvarchar(4000),@p1000 int,@p1001 int,@p1002 datetime2(7),@p1003 datetime2(7),@p1004 datetime2(7),@p1005 nvarchar(4000),@p1006 nvarchar(4000),@p1007 nvarchar(4000),@p1008 nvarchar(4000),@p1009 nvarchar(4000),@p1010 nvarchar(4000),@p1011 nvarchar(4000),@p1012 nvarchar(4000),@p1013 nvarchar(4000),@p1014 nvarchar(4000),@p1015 nvarchar(4000),@p1016 nvarchar(4000),@p1017 nvarchar(4000),@p1018 nvarchar(4000),@p1019 datetime2(7),@p1020 nvarchar(4000),@p1021 nvarchar(4000),@p1022 int,@p1023 int,@p1024 int,@p1025 nvarchar(4000),@p1026 nvarchar(4000),@p1027 nvarchar(4000),@p1028 nvarchar(4000),@p1029 decimal(18,2),@p1030 nvarchar(4000),@p1031 nvarchar(4000),@p1032 decimal(18,2),@p1033 nvarchar(4000),@p1034 nvarchar(4000),@p1035 nvarchar(4000),@p1036 nvarchar(4000),@p1037 int,@p1038 nvarchar(4000),@p1039 nvarchar(4000),@p1040 nvarchar(4000),@p1041 nvarchar(4000),@p1042 nvarchar(4000),@p1043 nvarchar(4000),@p1044 nvarchar(4000),@p1045 nvarchar(4000),@p1046 nvarchar(4000),@p1047 nvarchar(4000),@p1048 int,@p1049 nvarchar(4000),@p1050 nvarchar(4000),@p1051 nvarchar(4000),@p1052 nvarchar(4000),@p1053 nvarchar(4000),@p1054 int,@p1055 nvarchar(4000),@p1056 int,@p1057 int,@p1058 datetime2(7),@p1059 datetime2(7),@p1060 datetime2(7),@p1061 nvarchar(4000),@p1062 nvarchar(4000),@p1063 nvarchar(4000),@p1064 nvarchar(4000),@p1065 nvarchar(4000),@p1066 nvarchar(4000),@p1067 nvarchar(4000),@p1068 nvarchar(4000),@p1069 nvarchar(4000),@p1070 nvarchar(4000),@p1071 nvarchar(4000),@p1072 nvarchar(4000),@p1073 nvarchar(4000),@p1074 nvarchar(4000),@p1075 datetime2(7),@p1076 nvarchar(4000),@p1077 nvarchar(4000),@p1078 int,@p1079 int,@p1080 int,@p1081 nvarchar(4000),@p1082 nvarchar(4000),@p1083 nvarchar(4000),@p1084 nvarchar(4000),@p1085 decimal(18,2),@p1086 nvarchar(4000),@p1087 nvarchar(4000),@p1088 decimal(18,2),@p1089 nvarchar(4000),@p1090 nvarchar(4000),@p1091 nvarchar(4000),@p1092 nvarchar(4000),@p1093 int,@p1094 nvarchar(4000),@p1095 nvarchar(4000),@p1096 nvarchar(4000),@p1097 nvarchar(4000),@p1098 nvarchar(4000),@p1099 nvarchar(4000),@p1100 nvarchar(4000),@p1101 nvarchar(4000),@p1102 nvarchar(4000),@p1103 nvarchar(4000),@p1104 int,@p1105 nvarchar(4000),@p1106 nvarchar(4000),@p1107 nvarchar(4000),@p1108 nvarchar(4000),@p1109 nvarchar(4000),@p1110 int,@p1111 nvarchar(4000),@p1112 int,@p1113 int,@p1114 datetime2(7),@p1115 datetime2(7),@p1116 datetime2(7),@p1117 nvarchar(4000),@p1118 nvarchar(4000),@p1119 nvarchar(4000),@p1120 nvarchar(4000),@p1121 nvarchar(4000),@p1122 nvarchar(4000),@p1123 nvarchar(4000),@p1124 nvarchar(4000),@p1125 nvarchar(4000),@p1126 nvarchar(4000),@p1127 nvarchar(4000),@p1128 nvarchar(4000),@p1129 nvarchar(4000),@p1130 nvarchar(4000),@p1131 datetime2(7),@p1132 nvarchar(4000),@p1133 nvarchar(4000),@p1134 int,@p1135 int,@p1136 int,@p1137 nvarchar(4000),@p1138 nvarchar(4000),@p1139 nvarchar(4000),@p1140 nvarchar(4000),@p1141 decimal(18,2),@p1142 nvarchar(4000),@p1143 nvarchar(4000),@p1144 decimal(18,2),@p1145 nvarchar(4000),@p1146 nvarchar(4000),@p1147 nvarchar(4000),@p1148 nvarchar(4000),@p1149 int,@p1150 nvarchar(4000),@p1151 nvarchar(4000),@p1152 nvarchar(4000),@p1153 nvarchar(4000),@p1154 nvarchar(4000),@p1155 nvarchar(4000),@p1156 nvarchar(4000),@p1157 nvarchar(4000),@p1158 nvarchar(4000),@p1159 nvarchar(4000),@p1160 int,@p1161 nvarchar(4000),@p1162 nvarchar(4000),@p1163 nvarchar(4000),@p1164 nvarchar(4000),@p1165 nvarchar(4000),@p1166 int,@p1167 nvarchar(4000),@p1168 int,@p1169 int,@p1170 datetime2(7),@p1171 datetime2(7),@p1172 datetime2(7),@p1173 nvarchar(4000),@p1174 nvarchar(4000),@p1175 nvarchar(4000),@p1176 nvarchar(4000),@p1177 nvarchar(4000),@p1178 nvarchar(4000),@p1179 nvarchar(4000),@p1180 nvarchar(4000),@p1181 nvarchar(4000),@p1182 nvarchar(4000),@p1183 nvarchar(4000),@p1184 nvarchar(4000),@p1185 nvarchar(4000),@p1186 nvarchar(4000),@p1187 datetime2(7),@p1188 nvarchar(4000),@p1189 nvarchar(4000),@p1190 int,@p1191 int,@p1192 int,@p1193 nvarchar(4000),@p1194 nvarchar(4000),@p1195 nvarchar(4000),@p1196 nvarchar(4000),@p1197 decimal(18,2),@p1198 nvarchar(4000),@p1199 nvarchar(4000),@p1200 decimal(18,2),@p1201 nvarchar(4000),@p1202 nvarchar(4000),@p1203 nvarchar(4000),@p1204 nvarchar(4000),@p1205 int,@p1206 nvarchar(4000),@p1207 nvarchar(4000),@p1208 nvarchar(4000),@p1209 nvarchar(4000),@p1210 nvarchar(4000),@p1211 nvarchar(4000),@p1212 nvarchar(4000),@p1213 nvarchar(4000),@p1214 nvarchar(4000),@p1215 nvarchar(4000),@p1216 int,@p1217 nvarchar(4000),@p1218 nvarchar(4000),@p1219 nvarchar(4000),@p1220 nvarchar(4000),@p1221 nvarchar(4000),@p1222 int,@p1223 nvarchar(4000),@p1224 int,@p1225 int,@p1226 datetime2(7),@p1227 datetime2(7),@p1228 datetime2(7),@p1229 nvarchar(4000),@p1230 nvarchar(4000),@p1231 nvarchar(4000),@p1232 nvarchar(4000),@p1233 nvarchar(4000),@p1234 nvarchar(4000),@p1235 nvarchar(4000),@p1236 nvarchar(4000),@p1237 nvarchar(4000),@p1238 nvarchar(4000),@p1239 nvarchar(4000),@p1240 nvarchar(4000),@p1241 nvarchar(4000),@p1242 nvarchar(4000),@p1243 datetime2(7),@p1244 nvarchar(4000),@p1245 nvarchar(4000),@p1246 int,@p1247 int,@p1248 int,@p1249 nvarchar(4000),@p1250 nvarchar(4000),@p1251 nvarchar(4000),@p1252 nvarchar(4000),@p1253 decimal(18,2),@p1254 nvarchar(4000),@p1255 nvarchar(4000),@p1256 decimal(18,2),@p1257 nvarchar(4000),@p1258 nvarchar(4000),@p1259 nvarchar(4000),@p1260 nvarchar(4000),@p1261 int,@p1262 nvarchar(4000),@p1263 nvarchar(4000),@p1264 nvarchar(4000),@p1265 nvarchar(4000),@p1266 nvarchar(4000),@p1267 nvarchar(4000),@p1268 nvarchar(4000),@p1269 nvarchar(4000),@p1270 nvarchar(4000),@p1271 nvarchar(4000),@p1272 int,@p1273 nvarchar(4000),@p1274 nvarchar(4000),@p1275 nvarchar(4000),@p1276 nvarchar(4000),@p1277 nvarchar(4000),@p1278 int,@p1279 nvarchar(4000),@p1280 int,@p1281 int,@p1282 datetime2(7),@p1283 datetime2(7),@p1284 datetime2(7),@p1285 nvarchar(4000),@p1286 nvarchar(4000),@p1287 nvarchar(4000),@p1288 nvarchar(4000),@p1289 nvarchar(4000),@p1290 nvarchar(4000),@p1291 nvarchar(4000),@p1292 nvarchar(4000),@p1293 nvarchar(4000),@p1294 nvarchar(4000),@p1295 nvarchar(4000),@p1296 nvarchar(4000),@p1297 nvarchar(4000),@p1298 nvarchar(4000),@p1299 datetime2(7),@p1300 nvarchar(4000),@p1301 nvarchar(4000),@p1302 int,@p1303 int,@p1304 int,@p1305 nvarchar(4000),@p1306 nvarchar(4000),@p1307 nvarchar(4000),@p1308 decimal(18,2),@p1309 decimal(18,2),@p1310 nvarchar(4000),@p1311 nvarchar(4000),@p1312 decimal(18,2),@p1313 nvarchar(4000),@p1314 nvarchar(4000),@p1315 nvarchar(4000),@p1316 nvarchar(4000),@p1317 int,@p1318 nvarchar(4000),@p1319 nvarchar(4000),@p1320 nvarchar(4000),@p1321 nvarchar(4000),@p1322 nvarchar(4000),@p1323 nvarchar(4000),@p1324 nvarchar(4000),@p1325 nvarchar(4000),@p1326 nvarchar(4000),@p1327 nvarchar(4000),@p1328 int,@p1329 nvarchar(4000),@p1330 nvarchar(4000),@p1331 nvarchar(4000),@p1332 nvarchar(4000),@p1333 nvarchar(4000),@p1334 int,@p1335 nvarchar(4000),@p1336 int,@p1337 int,@p1338 datetime2(7),@p1339 datetime2(7),@p1340 datetime2(7),@p1341 nvarchar(4000),@p1342 nvarchar(4000),@p1343 nvarchar(4000),@p1344 nvarchar(4000),@p1345 nvarchar(4000),@p1346 nvarchar(4000),@p1347 nvarchar(4000),@p1348 nvarchar(4000),@p1349 nvarchar(4000),@p1350 nvarchar(4000),@p1351 nvarchar(4000),@p1352 nvarchar(4000),@p1353 nvarchar(4000),@p1354 nvarchar(4000),@p1355 datetime2(7),@p1356 nvarchar(4000),@p1357 nvarchar(4000),@p1358 int,@p1359 int,@p1360 int,@p1361 nvarchar(4000),@p1362 nvarchar(4000),@p1363 nvarchar(4000),@p1364 decimal(18,2),@p1365 decimal(18,2),@p1366 nvarchar(4000),@p1367 nvarchar(4000),@p1368 decimal(18,2),@p1369 nvarchar(4000),@p1370 nvarchar(4000),@p1371 nvarchar(4000),@p1372 nvarchar(4000),@p1373 int,@p1374 nvarchar(4000),@p1375 nvarchar(4000),@p1376 nvarchar(4000),@p1377 nvarchar(4000),@p1378 nvarchar(4000),@p1379 nvarchar(4000),@p1380 nvarchar(4000),@p1381 nvarchar(4000),@p1382 nvarchar(4000),@p1383 nvarchar(4000),@p1384 int,@p1385 nvarchar(4000),@p1386 nvarchar(4000),@p1387 nvarchar(4000),@p1388 nvarchar(4000),@p1389 nvarchar(4000),@p1390 int,@p1391 nvarchar(4000),@p1392 int,@p1393 int,@p1394 datetime2(7),@p1395 datetime2(7),@p1396 datetime2(7),@p1397 nvarchar(4000),@p1398 nvarchar(4000),@p1399 nvarchar(4000),@p1400 nvarchar(4000),@p1401 nvarchar(4000),@p1402 nvarchar(4000),@p1403 nvarchar(4000),@p1404 nvarchar(4000),@p1405 nvarchar(4000),@p1406 nvarchar(4000),@p1407 nvarchar(4000),@p1408 nvarchar(4000),@p1409 nvarchar(4000),@p1410 nvarchar(4000),@p1411 datetime2(7),@p1412 nvarchar(4000),@p1413 nvarchar(4000),@p1414 int,@p1415 int,@p1416 int,@p1417 nvarchar(4000),@p1418 nvarchar(4000),@p1419 nvarchar(4000),@p1420 decimal(18,2),@p1421 decimal(18,2),@p1422 nvarchar(4000),@p1423 nvarchar(4000),@p1424 decimal(18,2),@p1425 nvarchar(4000),@p1426 nvarchar(4000),@p1427 nvarchar(4000),@p1428 nvarchar(4000),@p1429 int,@p1430 nvarchar(4000),@p1431 nvarchar(4000),@p1432 nvarchar(4000),@p1433 nvarchar(4000),@p1434 nvarchar(4000),@p1435 nvarchar(4000),@p1436 nvarchar(4000),@p1437 nvarchar(4000),@p1438 nvarchar(4000),@p1439 nvarchar(4000),@p1440 int,@p1441 nvarchar(4000),@p1442 nvarchar(4000),@p1443 nvarchar(4000),@p1444 nvarchar(4000),@p1445 nvarchar(4000),@p1446 int,@p1447 nvarchar(4000),@p1448 int,@p1449 int,@p1450 datetime2(7),@p1451 datetime2(7),@p1452 datetime2(7),@p1453 nvarchar(4000),@p1454 nvarchar(4000),@p1455 nvarchar(4000),@p1456 nvarchar(4000),@p1457 nvarchar(4000),@p1458 nvarchar(4000),@p1459 nvarchar(4000),@p1460 nvarchar(4000),@p1461 nvarchar(4000),@p1462 nvarchar(4000),@p1463 nvarchar(4000),@p1464 nvarchar(4000),@p1465 nvarchar(4000),@p1466 nvarchar(4000),@p1467 datetime2(7),@p1468 nvarchar(4000),@p1469 nvarchar(4000),@p1470 int,@p1471 int,@p1472 int,@p1473 nvarchar(4000),@p1474 nvarchar(4000),@p1475 nvarchar(4000),@p1476 decimal(18,2),@p1477 decimal(18,2),@p1478 nvarchar(4000),@p1479 nvarchar(4000),@p1480 decimal(18,2),@p1481 nvarchar(4000),@p1482 nvarchar(4000),@p1483 nvarchar(4000),@p1484 nvarchar(4000),@p1485 int,@p1486 nvarchar(4000),@p1487 nvarchar(4000),@p1488 nvarchar(4000),@p1489 nvarchar(4000),@p1490 nvarchar(4000),@p1491 nvarchar(4000),@p1492 nvarchar(4000),@p1493 nvarchar(4000),@p1494 nvarchar(4000),@p1495 nvarchar(4000),@p1496 int,@p1497 nvarchar(4000),@p1498 nvarchar(4000),@p1499 nvarchar(4000),@p1500 nvarchar(4000),@p1501 nvarchar(4000),@p1502 int,@p1503 nvarchar(4000),@p1504 int,@p1505 int,@p1506 datetime2(7),@p1507 datetime2(7),@p1508 datetime2(7),@p1509 nvarchar(4000),@p1510 nvarchar(4000),@p1511 nvarchar(4000),@p1512 nvarchar(4000),@p1513 nvarchar(4000),@p1514 nvarchar(4000),@p1515 nvarchar(4000),@p1516 nvarchar(4000),@p1517 nvarchar(4000),@p1518 nvarchar(4000),@p1519 nvarchar(4000),@p1520 nvarchar(4000),@p1521 nvarchar(4000),@p1522 nvarchar(4000),@p1523 datetime2(7),@p1524 nvarchar(4000),@p1525 nvarchar(4000),@p1526 int,@p1527 int,@p1528 int,@p1529 nvarchar(4000),@p1530 nvarchar(4000),@p1531 nvarchar(4000),@p1532 decimal(18,2),@p1533 decimal(18,2),@p1534 nvarchar(4000),@p1535 nvarchar(4000),@p1536 decimal(18,2),@p1537 nvarchar(4000),@p1538 nvarchar(4000),@p1539 nvarchar(4000),@p1540 nvarchar(4000),@p1541 int,@p1542 nvarchar(4000),@p1543 nvarchar(4000),@p1544 nvarchar(4000),@p1545 nvarchar(4000),@p1546 nvarchar(4000),@p1547 nvarchar(4000),@p1548 nvarchar(4000),@p1549 nvarchar(4000),@p1550 nvarchar(4000),@p1551 nvarchar(4000),@p1552 int,@p1553 nvarchar(4000),@p1554 nvarchar(4000),@p1555 nvarchar(4000),@p1556 nvarchar(4000),@p1557 nvarchar(4000),@p1558 int,@p1559 nvarchar(4000),@p1560 int,@p1561 int,@p1562 datetime2(7),@p1563 datetime2(7),@p1564 datetime2(7),@p1565 nvarchar(4000),@p1566 nvarchar(4000),@p1567 nvarchar(4000),@p1568 nvarchar(4000),@p1569 nvarchar(4000),@p1570 nvarchar(4000),@p1571 nvarchar(4000),@p1572 nvarchar(4000),@p1573 nvarchar(4000),@p1574 nvarchar(4000),@p1575 nvarchar(4000),@p1576 nvarchar(4000),@p1577 nvarchar(4000),@p1578 nvarchar(4000),@p1579 datetime2(7),@p1580 nvarchar(4000),@p1581 nvarchar(4000),@p1582 int,@p1583 int,@p1584 int,@p1585 nvarchar(4000),@p1586 nvarchar(4000),@p1587 nvarchar(4000),@p1588 decimal(18,2),@p1589 decimal(18,2),@p1590 nvarchar(4000),@p1591 nvarchar(4000),@p1592 decimal(18,2),@p1593 nvarchar(4000),@p1594 nvarchar(4000),@p1595 nvarchar(4000),@p1596 nvarchar(4000),@p1597 int,@p1598 nvarchar(4000),@p1599 nvarchar(4000),@p1600 nvarchar(4000),@p1601 nvarchar(4000),@p1602 nvarchar(4000),@p1603 nvarchar(4000),@p1604 nvarchar(4000),@p1605 nvarchar(4000),@p1606 nvarchar(4000),@p1607 nvarchar(4000),@p1608 int,@p1609 nvarchar(4000),@p1610 nvarchar(4000),@p1611 nvarchar(4000),@p1612 nvarchar(4000),@p1613 nvarchar(4000),@p1614 int,@p1615 nvarchar(4000),@p1616 int,@p1617 int,@p1618 datetime2(7),@p1619 datetime2(7),@p1620 datetime2(7),@p1621 nvarchar(4000),@p1622 nvarchar(4000),@p1623 nvarchar(4000),@p1624 nvarchar(4000),@p1625 nvarchar(4000),@p1626 nvarchar(4000),@p1627 nvarchar(4000),@p1628 nvarchar(4000),@p1629 nvarchar(4000),@p1630 nvarchar(4000),@p1631 nvarchar(4000),@p1632 nvarchar(4000),@p1633 nvarchar(4000),@p1634 nvarchar(4000),@p1635 datetime2(7),@p1636 nvarchar(4000),@p1637 nvarchar(4000),@p1638 int,@p1639 int,@p1640 int,@p1641 nvarchar(4000),@p1642 nvarchar(4000),@p1643 nvarchar(4000),@p1644 decimal(18,2),@p1645 decimal(18,2),@p1646 nvarchar(4000),@p1647 nvarchar(4000),@p1648 decimal(18,2),@p1649 nvarchar(4000),@p1650 nvarchar(4000),@p1651 nvarchar(4000),@p1652 nvarchar(4000),@p1653 int,@p1654 nvarchar(4000),@p1655 nvarchar(4000),@p1656 nvarchar(4000),@p1657 nvarchar(4000),@p1658 nvarchar(4000),@p1659 nvarchar(4000),@p1660 nvarchar(4000),@p1661 nvarchar(4000),@p1662 nvarchar(4000),@p1663 nvarchar(4000),@p1664 int,@p1665 nvarchar(4000),@p1666 nvarchar(4000),@p1667 nvarchar(4000),@p1668 nvarchar(4000),@p1669 nvarchar(4000),@p1670 int,@p1671 nvarchar(4000),@p1672 int,@p1673 int,@p1674 datetime2(7),@p1675 datetime2(7),@p1676 datetime2(7),@p1677 nvarchar(4000),@p1678 nvarchar(4000),@p1679 nvarchar(4000),@p1680 nvarchar(4000),@p1681 nvarchar(4000),@p1682 nvarchar(4000),@p1683 nvarchar(4000),@p1684 nvarchar(4000),@p1685 nvarchar(4000),@p1686 nvarchar(4000),@p1687 nvarchar(4000),@p1688 nvarchar(4000),@p1689 nvarchar(4000),@p1690 nvarchar(4000),@p1691 datetime2(7),@p1692 nvarchar(4000),@p1693 nvarchar(4000),@p1694 int,@p1695 int,@p1696 int,@p1697 nvarchar(4000),@p1698 nvarchar(4000),@p1699 nvarchar(4000),@p1700 decimal(18,2),@p1701 decimal(18,2),@p1702 nvarchar(4000),@p1703 nvarchar(4000),@p1704 decimal(18,2),@p1705 nvarchar(4000),@p1706 nvarchar(4000),@p1707 nvarchar(4000),@p1708 nvarchar(4000),@p1709 int,@p1710 nvarchar(4000),@p1711 nvarchar(4000),@p1712 nvarchar(4000),@p1713 nvarchar(4000),@p1714 nvarchar(4000),@p1715 nvarchar(4000),@p1716 nvarchar(4000),@p1717 nvarchar(4000),@p1718 nvarchar(4000),@p1719 nvarchar(4000),@p1720 int,@p1721 nvarchar(4000),@p1722 nvarchar(4000),@p1723 nvarchar(4000),@p1724 nvarchar(4000),@p1725 nvarchar(4000),@p1726 int,@p1727 nvarchar(4000),@p1728 int,@p1729 int,@p1730 datetime2(7),@p1731 datetime2(7),@p1732 datetime2(7),@p1733 nvarchar(4000),@p1734 nvarchar(4000),@p1735 nvarchar(4000),@p1736 nvarchar(4000),@p1737 nvarchar(4000),@p1738 nvarchar(4000),@p1739 nvarchar(4000),@p1740 nvarchar(4000),@p1741 nvarchar(4000),@p1742 nvarchar(4000),@p1743 nvarchar(4000),@p1744 nvarchar(4000),@p1745 nvarchar(4000),@p1746 nvarchar(4000),@p1747 datetime2(7),@p1748 nvarchar(4000),@p1749 nvarchar(4000),@p1750 int,@p1751 int,@p1752 int,@p1753 nvarchar(4000),@p1754 nvarchar(4000),@p1755 nvarchar(4000),@p1756 nvarchar(4000),@p1757 decimal(18,2),@p1758 nvarchar(4000),@p1759 nvarchar(4000),@p1760 decimal(18,2),@p1761 nvarchar(4000),@p1762 nvarchar(4000),@p1763 nvarchar(4000),@p1764 nvarchar(4000),@p1765 int,@p1766 nvarchar(4000),@p1767 nvarchar(4000),@p1768 nvarchar(4000),@p1769 nvarchar(4000),@p1770 nvarchar(4000),@p1771 nvarchar(4000),@p1772 nvarchar(4000),@p1773 nvarchar(4000),@p1774 nvarchar(4000),@p1775 nvarchar(4000),@p1776 int,@p1777 nvarchar(4000),@p1778 nvarchar(4000),@p1779 nvarchar(4000),@p1780 nvarchar(4000),@p1781 nvarchar(4000),@p1782 int,@p1783 nvarchar(4000),@p1784 int,@p1785 int,@p1786 datetime2(7),@p1787 datetime2(7),@p1788 datetime2(7),@p1789 nvarchar(4000),@p1790 nvarchar(4000),@p1791 nvarchar(4000),@p1792 nvarchar(4000),@p1793 nvarchar(4000),@p1794 nvarchar(4000),@p1795 nvarchar(4000),@p1796 nvarchar(4000),@p1797 nvarchar(4000),@p1798 nvarchar(4000),@p1799 nvarchar(4000),@p1800 nvarchar(4000),@p1801 nvarchar(4000),@p1802 nvarchar(4000),@p1803 datetime2(7),@p1804 nvarchar(4000),@p1805 nvarchar(4000),@p1806 int,@p1807 int,@p1808 int,@p1809 nvarchar(4000),@p1810 nvarchar(4000),@p1811 nvarchar(4000),@p1812 nvarchar(4000),@p1813 decimal(18,2),@p1814 nvarchar(4000),@p1815 nvarchar(4000),@p1816 decimal(18,2),@p1817 nvarchar(4000),@p1818 nvarchar(4000),@p1819 nvarchar(4000),@p1820 nvarchar(4000),@p1821 int,@p1822 nvarchar(4000),@p1823 nvarchar(4000),@p1824 nvarchar(4000),@p1825 nvarchar(4000),@p1826 nvarchar(4000),@p1827 nvarchar(4000),@p1828 nvarchar(4000),@p1829 nvarchar(4000),@p1830 nvarchar(4000),@p1831 nvarchar(4000),@p1832 int,@p1833 nvarchar(4000),@p1834 nvarchar(4000),@p1835 nvarchar(4000),@p1836 nvarchar(4000),@p1837 nvarchar(4000),@p1838 int,@p1839 nvarchar(4000),@p1840 int,@p1841 int,@p1842 datetime2(7),@p1843 datetime2(7),@p1844 datetime2(7),@p1845 nvarchar(4000),@p1846 nvarchar(4000),@p1847 nvarchar(4000),@p1848 nvarchar(4000),@p1849 nvarchar(4000),@p1850 nvarchar(4000),@p1851 nvarchar(4000),@p1852 nvarchar(4000),@p1853 nvarchar(4000),@p1854 nvarchar(4000),@p1855 nvarchar(4000),@p1856 nvarchar(4000),@p1857 nvarchar(4000),@p1858 nvarchar(4000),@p1859 datetime2(7),@p1860 nvarchar(4000),@p1861 nvarchar(4000),@p1862 int,@p1863 int,@p1864 int,@p1865 nvarchar(4000),@p1866 nvarchar(4000),@p1867 nvarchar(4000),@p1868 nvarchar(4000),@p1869 decimal(18,2),@p1870 nvarchar(4000),@p1871 nvarchar(4000),@p1872 decimal(18,2),@p1873 nvarchar(4000),@p1874 nvarchar(4000),@p1875 nvarchar(4000),@p1876 nvarchar(4000),@p1877 int,@p1878 nvarchar(4000),@p1879 nvarchar(4000),@p1880 nvarchar(4000),@p1881 nvarchar(4000),@p1882 nvarchar(4000),@p1883 nvarchar(4000),@p1884 nvarchar(4000),@p1885 nvarchar(4000),@p1886 nvarchar(4000),@p1887 nvarchar(4000),@p1888 int,@p1889 nvarchar(4000),@p1890 nvarchar(4000),@p1891 nvarchar(4000),@p1892 nvarchar(4000),@p1893 nvarchar(4000),@p1894 int,@p1895 nvarchar(4000),@p1896 int,@p1897 int,@p1898 datetime2(7),@p1899 datetime2(7),@p1900 datetime2(7),@p1901 nvarchar(4000),@p1902 nvarchar(4000),@p1903 nvarchar(4000),@p1904 nvarchar(4000),@p1905 nvarchar(4000),@p1906 nvarchar(4000),@p1907 nvarchar(4000),@p1908 nvarchar(4000),@p1909 nvarchar(4000),@p1910 nvarchar(4000),@p1911 nvarchar(4000),@p1912 nvarchar(4000),@p1913 nvarchar(4000),@p1914 nvarchar(4000),@p1915 datetime2(7),@p1916 nvarchar(4000),@p1917 nvarchar(4000),@p1918 int,@p1919 int,@p1920 int,@p1921 nvarchar(4000),@p1922 nvarchar(4000),@p1923 nvarchar(4000),@p1924 nvarchar(4000),@p1925 decimal(18,2),@p1926 nvarchar(4000),@p1927 nvarchar(4000),@p1928 decimal(18,2),@p1929 nvarchar(4000),@p1930 nvarchar(4000),@p1931 nvarchar(4000),@p1932 nvarchar(4000),@p1933 int,@p1934 nvarchar(4000),@p1935 nvarchar(4000),@p1936 nvarchar(4000),@p1937 nvarchar(4000),@p1938 nvarchar(4000),@p1939 nvarchar(4000),@p1940 nvarchar(4000),@p1941 nvarchar(4000),@p1942 nvarchar(4000),@p1943 nvarchar(4000),@p1944 int,@p1945 nvarchar(4000),@p1946 nvarchar(4000),@p1947 nvarchar(4000),@p1948 nvarchar(4000),@p1949 nvarchar(4000),@p1950 int,@p1951 nvarchar(4000),@p1952 int,@p1953 int,@p1954 datetime2(7),@p1955 datetime2(7),@p1956 datetime2(7),@p1957 nvarchar(4000),@p1958 nvarchar(4000),@p1959 nvarchar(4000),@p1960 nvarchar(4000),@p1961 nvarchar(4000),@p1962 nvarchar(4000),@p1963 nvarchar(4000),@p1964 nvarchar(4000),@p1965 nvarchar(4000),@p1966 nvarchar(4000),@p1967 nvarchar(4000),@p1968 nvarchar(4000),@p1969 nvarchar(4000),@p1970 nvarchar(4000),@p1971 datetime2(7),@p1972 nvarchar(4000),@p1973 nvarchar(4000),@p1974 int,@p1975 int,@p1976 int,@p1977 nvarchar(4000),@p1978 nvarchar(4000),@p1979 nvarchar(4000),@p1980 nvarchar(4000),@p1981 decimal(18,2),@p1982 nvarchar(4000),@p1983 nvarchar(4000),@p1984 decimal(18,2),@p1985 nvarchar(4000),@p1986 nvarchar(4000),@p1987 nvarchar(4000),@p1988 nvarchar(4000),@p1989 int,@p1990 nvarchar(4000),@p1991 nvarchar(4000),@p1992 nvarchar(4000),@p1993 nvarchar(4000),@p1994 nvarchar(4000),@p1995 nvarchar(4000),@p1996 nvarchar(4000),@p1997 nvarchar(4000),@p1998 nvarchar(4000),@p1999 nvarchar(4000),@p2000 int,@p2001 nvarchar(4000),@p2002 nvarchar(4000),@p2003 nvarchar(4000),@p2004 nvarchar(4000),@p2005 nvarchar(4000),@p2006 int,@p2007 nvarchar(4000),@p2008 int,@p2009 int,@p2010 datetime2(7),@p2011 datetime2(7),@p2012 datetime2(7),@p2013 nvarchar(4000),@p2014 nvarchar(4000),@p2015 nvarchar(4000),@p2016 nvarchar(4000),@p2017 nvarchar(4000),@p2018 nvarchar(4000),@p2019 nvarchar(4000),@p2020 nvarchar(4000),@p2021 nvarchar(4000),@p2022 nvarchar(4000),@p2023 nvarchar(4000),@p2024 nvarchar(4000),@p2025 nvarchar(4000),@p2026 nvarchar(4000),@p2027 datetime2(7),@p2028 nvarchar(4000),@p2029 nvarchar(4000),@p2030 int,@p2031 int,@p2032 int,@p2033 nvarchar(4000),@p2034 nvarchar(4000),@p2035 nvarchar(4000),@p2036 nvarchar(4000),@p2037 decimal(18,2),@p2038 nvarchar(4000),@p2039 nvarchar(4000),@p2040 decimal(18,2),@p2041 nvarchar(4000),@p2042 nvarchar(4000),@p2043 nvarchar(4000),@p2044 nvarchar(4000),@p2045 int,@p2046 nvarchar(4000),@p2047 nvarchar(4000),@p2048 nvarchar(4000),@p2049 nvarchar(4000),@p2050 nvarchar(4000),@p2051 nvarchar(4000),@p2052 nvarchar(4000),@p2053 nvarchar(4000),@p2054 nvarchar(4000),@p2055 nvarchar(4000),@p2056 int,@p2057 nvarchar(4000),@p2058 nvarchar(4000),@p2059 nvarchar(4000),@p2060 nvarchar(4000),@p2061 nvarchar(4000),@p2062 int,@p2063 nvarchar(4000),@p2064 int,@p2065 int,@p2066 datetime2(7),@p2067 datetime2(7),@p2068 datetime2(7),@p2069 nvarchar(4000),@p2070 nvarchar(4000),@p2071 nvarchar(4000))SET NOCOUNT ON; DECLARE @inserted0 TABLE ([item_id] int, [_Position] [int]); MERGE [raw_data] USING ( VALUES (@p0, @p1, @p2, @p3, @p4, @p5, @p6, @p7, @p8, @p9, @p10, @p11, @p12, @p13, @p14, @p15, @p16, @p17, @p18, @p19, @p20, @p21, @p22, @p23, @p24, @p25, @p26, @p27, @p28, @p29, @p30, @p31, @p32, @p33, @p34, @p35, @p36, @p37, @p38, @p39, @p40, @p41, @p42, @p43, @p44, @p45, @p46, @p47, @p48, @p49, @p50, @p51, @p52, @p53, @p54, @p55, 0), (@p56, @p57, @p58, @p59, @p60, @p61, @p62, @p63, @p64, @p65, @p66, @p67, @p68, @p69, @p70, @p71, @p72, @p73, @p74, @p75, @p76, @p77, @p78, @p79, @p80, @p81, @p82, @p83, @p84, @p85, @p86, @p87, @p88, @p89, @p90, @p91, @p92, @p93, @p94, @p95, @p96, @p97, @p98, @p99, @p100, @p101, @p102, @p103, @p104, @p105, @p106, @p107, @p108, @p109, @p110, @p111, 1), (@p112, @p113, @p114, @p115, @p116, @p117, @p118, @p119, @p120, @p121, @p122, @p123, @p124, @p125, @p126, @p127, @p128, @p129, @p130, @p131, @p132, @p133, @p134, @p135, @p136, @p137, @p138, @p139, @p140, @p141, @p142, @p143, @p144, @p145, @p146, @p147, @p148, @p149, @p150, @p151, @p152, @p153, @p154, @p155, @p156, @p157, @p158, @p159, @p160, @p161, @p162, @p163, @p164, @p165, @p166, @p167, 2), (@p168, @p169, @p170, @p171, @p172, @p173, @p174, @p175, @p176, @p177, @p178, @p179, @p180, @p181, @p182, @p183, @p184, @p185, @p186, @p187, @p188, @p189, @p190, @p191, @p192, @p193, @p194, @p195, @p196, @p197, @p198, @p199, @p200, @p201, @p202, @p203, @p204, @p205, @p206, @p207, @p208, @p209, @p210, @p211, @p212, @p213, @p214, @p215, @p216, @p217, @p218, @p219, @p220, @p221, @p222, @p223, 3), (@p224, @p225, @p226, @p227, @p228, @p229, @p230, @p231, @p232, @p233, @p234, @p235, @p236, @p237, @p238, @p239, @p240, @p241, @p242, @p243, @p244, @p245, @p246, @p247, @p248, @p249, @p250, @p251, @p252, @p253, @p254, @p255, @p256, @p257, @p258, @p259, @p260, @p261, @p262, @p263, @p264, @p265, @p266, @p267, @p268, @p269, @p270, @p271, @p272, @p273, @p274, @p275, @p276, @p277, @p278, @p279, 4), (@p280, @p281, @p282, @p283, @p284, @p285, @p286, @p287, @p288, @p289, @p290, @p291, @p292, @p293, @p294, @p295, @p296, @p297, @p298, @p299, @p300, @p301, @p302, @p303, @p304, @p305, @p306, @p307, @p308, @p309, @p310, @p311, @p312, @p313, @p314, @p315, @p316, @p317, @p318, @p319, @p320, @p321, @p322, @p323, @p324, @p325, @p326, @p327, @p328, @p329, @p330, @p331, @p332, @p333, @p334, @p335, 5), (@p336, @p337, @p338, @p339, @p340, @p341, @p342, @p343, @p344, @p345, @p346, @p347, @p348, @p349, @p350, @p351, @p352, @p353, @p354, @p355, @p356, @p357, @p358, @p359, @p360, @p361, @p362, @p363, @p364, @p365, @p366, @p367, @p368, @p369, @p370, @p371, @p372, @p373, @p374, @p375, @p376, @p377, @p378, @p379, @p380, @p381, @p382, @p383, @p384, @p385, @p386, @p387, @p388, @p389, @p390, @p391, 6), (@p392, @p393, @p394, @p395, @p396, @p397, @p398, @p399, @p400, @p401, @p402, @p403, @p404, @p405, @p406, @p407, @p408, @p409, @p410, @p411, @p412, @p413, @p414, @p415, @p416, @p417, @p418, @p419, @p420, @p421, @p422, @p423, @p424, @p425, @p426, @p427, @p428, @p429, @p430, @p431, @p432, @p433, @p434, @p435, @p436, @p437, @p438, @p439, @p440, @p441, @p442, @p443, @p444, @p445, @p446, @p447, 7), (@p448, @p449, @p450, @p451, @p452, @p453, @p454, @p455, @p456, @p457, @p458, @p459, @p460, @p461, @p462, @p463, @p464, @p465, @p466, @p467, @p468, @p469, @p470, @p471, @p472, @p473, @p474, @p475, @p476, @p477, @p478, @p479, @p480, @p481, @p482, @p483, @p484, @p485, @p486, @p487, @p488, @p489, @p490, @p491, @p492, @p493, @p494, @p495, @p496, @p497, @p498, @p499, @p500, @p501, @p502, @p503, 8), (@p504, @p505, @p506, @p507, @p508, @p509, @p510, @p511, @p512, @p513, @p514, @p515, @p516, @p517, @p518, @p519, @p520, @p521, @p522, @p523, @p524, @p525, @p526, @p527, @p528, @p529, @p530, @p531, @p532, @p533, @p534, @p535, @p536, @p537, @p538, @p539, @p540, @p541, @p542, @p543, @p544, @p545, @p546, @p547, @p548, @p549, @p550, @p551, @p552, @p553, @p554, @p555, @p556, @p557, @p558, @p559, 9), (@p560, @p561, @p562, @p563, @p564, @p565, @p566, @p567, @p568, @p569, @p570, @p571, @p572, @p573, @p574, @p575, @p576, @p577, @p578, @p579, @p580, @p581, @p582, @p583, @p584, @p585, @p586, @p587, @p588, @p589, @p590, @p591, @p592, @p593, @p594, @p595, @p596, @p597, @p598, @p599, @p600, @p601, @p602, @p603, @p604, @p605, @p606, @p607, @p608, @p609, @p610, @p611, @p612, @p613, @p614, @p615, 10), (@p616, @p617, @p618, @p619, @p620, @p621, @p622, @p623, @p624, @p625, @p626, @p627, @p628, @p629, @p630, @p631, @p632, @p633, @p634, @p635, @p636, @p637, @p638, @p639, @p640, @p641, @p642, @p643, @p644, @p645, @p646, @p647, @p648, @p649, @p650, @p651, @p652, @p653, @p654, @p655, @p656, @p657, @p658, @p659, @p660, @p661, @p662, @p663, @p664, @p665, @p666, @p667, @p668, @p669, @p670, @p671, 11), (@p672, @p673, @p674, @p675, @p676, @p677, @p678, @p679, @p680, @p681, @p682, @p683, @p684, @p685, @p686, @p687, @p688, @p689, @p690, @p691, @p692, @p693, @p694, @p695, @p696, @p697, @p698, @p699, @p700, @p701, @p702, @p703, @p704, @p705, @p706, @p707, @p708, @p709, @p710, @p711, @p712, @p713, @p714, @p715, @p716, @p717, @p718, @p719, @p720, @p721, @p722, @p723, @p724, @p725, @p726, @p727, 12), (@p728, @p729, @p730, @p731, @p732, @p733, @p734, @p735, @p736, @p737, @p738, @p739, @p740, @p741, @p742, @p743, @p744, @p745, @p746, @p747, @p748, @p749, @p750, @p751, @p752, @p753, @p754, @p755, @p756, @p757, @p758, @p759, @p760, @p761, @p762, @p763, @p764, @p765, @p766, @p767, @p768, @p769, @p770, @p771, @p772, @p773, @p774, @p775, @p776, @p777, @p778, @p779, @p780, @p781, @p782, @p783, 13), (@p784, @p785, @p786, @p787, @p788, @p789, @p790, @p791, @p792, @p793, @p794, @p795, @p796, @p797, @p798, @p799, @p800, @p801, @p802, @p803, @p804, @p805, @p806, @p807, @p808, @p809, @p810, @p811, @p812, @p813, @p814, @p815, @p816, @p817, @p818, @p819, @p820, @p821, @p822, @p823, @p824, @p825, @p826, @p827, @p828, @p829, @p830, @p831, @p832, @p833, @p834, @p835, @p836, @p837, @p838, @p839, 14), (@p840, @p841, @p842, @p843, @p844, @p845, @p846, @p847, @p848, @p849, @p850, @p851, @p852, @p853, @p854, @p855, @p856, @p857, @p858, @p859, @p860, @p861, @p862, @p863, @p864, @p865, @p866, @p867, @p868, @p869, @p870, @p871, @p872, @p873, @p874, @p875, @p876, @p877, @p878, @p879, @p880, @p881, @p882, @p883, @p884, @p885, @p886, @p887, @p888, @p889, @p890, @p891, @p892, @p893, @p894, @p895, 15), (@p896, @p897, @p898, @p899, @p900, @p901, @p902, @p903, @p904, @p905, @p906, @p907, @p908, @p909, @p910, @p911, @p912, @p913, @p914, @p915, @p916, @p917, @p918, @p919, @p920, @p921, @p922, @p923, @p924, @p925, @p926, @p927, @p928, @p929, @p930, @p931, @p932, @p933, @p934, @p935, @p936, @p937, @p938, @p939, @p940, @p941, @p942, @p943, @p944, @p945, @p946, @p947, @p948, @p949, @p950, @p951, 16), (@p952, @p953, @p954, @p955, @p956, @p957, @p958, @p959, @p960, @p961, @p962, @p963, @p964, @p965, @p966, @p967, @p968, @p969, @p970, @p971, @p972, @p973, @p974, @p975, @p976, @p977, @p978, @p979, @p980, @p981, @p982, @p983, @p984, @p985, @p986, @p987, @p988, @p989, @p990, @p991, @p992, @p993, @p994, @p995, @p996, @p997, @p998, @p999, @p1000, @p1001, @p1002, @p1003, @p1004, @p1005, @p1006, @p1007, 17), (@p1008, @p1009, @p1010, @p1011, @p1012, @p1013, @p1014, @p1015, @p1016, @p1017, @p1018, @p1019, @p1020, @p1021, @p1022, @p1023, @p1024, @p1025, @p1026, @p1027, @p1028, @p1029, @p1030, @p1031, @p1032, @p1033, @p1034, @p1035, @p1036, @p1037, @p1038, @p1039, @p1040, @p1041, @p1042, @p1043, @p1044, @p1045, @p1046, @p1047, @p1048, @p1049, @p1050, @p1051, @p1052, @p1053, @p1054, @p1055, @p1056, @p1057, @p1058, @p1059, @p1060, @p1061, @p1062, @p1063, 18), (@p1064, @p1065, @p1066, @p1067, @p1068, @p1069, @p1070, @p1071, @p1072, @p1073, @p1074, @p1075, @p1076, @p1077, @p1078, @p1079, @p1080, @p1081, @p1082, @p1083, @p1084, @p1085, @p1086, @p1087, @p1088, @p1089, @p1090, @p1091, @p1092, @p1093, @p1094, @p1095, @p1096, @p1097, @p1098, @p1099, @p1100, @p1101, @p1102, @p1103, @p1104, @p1105, @p1106, @p1107, @p1108, @p1109, @p1110, @p1111, @p1112, @p1113, @p1114, @p1115, @p1116, @p1117, @p1118, @p1119, 19), (@p1120, @p1121, @p1122, @p1123, @p1124, @p1125, @p1126, @p1127, @p1128, @p1129, @p1130, @p1131, @p1132, @p1133, @p1134, @p1135, @p1136, @p1137, @p1138, @p1139, @p1140, @p1141, @p1142, @p1143, @p1144, @p1145, @p1146, @p1147, @p1148, @p1149, @p1150, @p1151, @p1152, @p1153, @p1154, @p1155, @p1156, @p1157, @p1158, @p1159, @p1160, @p1161, @p1162, @p1163, @p1164, @p1165, @p1166, @p1167, @p1168, @p1169, @p1170, @p1171, @p1172, @p1173, @p1174, @p1175, 20), (@p1176, @p1177, @p1178, @p1179, @p1180, @p1181, @p1182, @p1183, @p1184, @p1185, @p1186, @p1187, @p1188, @p1189, @p1190, @p1191, @p1192, @p1193, @p1194, @p1195, @p1196, @p1197, @p1198, @p1199, @p1200, @p1201, @p1202, @p1203, @p1204, @p1205, @p1206, @p1207, @p1208, @p1209, @p1210, @p1211, @p1212, @p1213, @p1214, @p1215, @p1216, @p1217, @p1218, @p1219, @p1220, @p1221, @p1222, @p1223, @p1224, @p1225, @p1226, @p1227, @p1228, @p1229, @p1230, @p1231, 21), (@p1232, @p1233, @p1234, @p1235, @p1236, @p1237, @p1238, @p1239, @p1240, @p1241, @p1242, @p1243, @p1244, @p1245, @p1246, @p1247, @p1248, @p1249, @p1250, @p1251, @p1252, @p1253, @p1254, @p1255, @p1256, @p1257, @p1258, @p1259, @p1260, @p1261, @p1262, @p1263, @p1264, @p1265, @p1266, @p1267, @p1268, @p1269, @p1270, @p1271, @p1272, @p1273, @p1274, @p1275, @p1276, @p1277, @p1278, @p1279, @p1280, @p1281, @p1282, @p1283, @p1284, @p1285, @p1286, @p1287, 22), (@p1288, @p1289, @p1290, @p1291, @p1292, @p1293, @p1294, @p1295, @p1296, @p1297, @p1298, @p1299, @p1300, @p1301, @p1302, @p1303, @p1304, @p1305, @p1306, @p1307, @p1308, @p1309, @p1310, @p1311, @p1312, @p1313, @p1314, @p1315, @p1316, @p1317, @p1318, @p1319, @p1320, @p1321, @p1322, @p1323, @p1324, @p1325, @p1326, @p1327, @p1328, @p1329, @p1330, @p1331, @p1332, @p1333, @p1334, @p1335, @p1336, @p1337, @p1338, @p1339, @p1340, @p1341, @p1342, @p1343, 23), (@p1344, @p1345, @p1346, @p1347, @p1348, @p1349, @p1350, @p1351, @p1352, @p1353, @p1354, @p1355, @p1356, @p1357, @p1358, @p1359, @p1360, @p1361, @p1362, @p1363, @p1364, @p1365, @p1366, @p1367, @p1368, @p1369, @p1370, @p1371, @p1372, @p1373, @p1374, @p1375, @p1376, @p1377, @p1378, @p1379, @p1380, @p1381, @p1382, @p1383, @p1384, @p1385, @p1386, @p1387, @p1388, @p1389, @p1390, @p1391, @p1392, @p1393, @p1394, @p1395, @p1396, @p1397, @p1398, @p1399, 24), (@p1400, @p1401, @p1402, @p1403, @p1404, @p1405, @p1406, @p1407, @p1408, @p1409, @p1410, @p1411, @p1412, @p1413, @p1414, @p1415, @p1416, @p1417, @p1418, @p1419, @p1420, @p1421, @p1422, @p1423, @p1424, @p1425, @p1426, @p1427, @p1428, @p1429, @p1430, @p1431, @p1432, @p1433, @p1434, @p1435, @p1436, @p1437, @p1438, @p1439, @p1440, @p1441, @p1442, @p1443, @p1444, @p1445, @p1446, @p1447, @p1448, @p1449, @p1450, @p1451, @p1452, @p1453, @p1454, @p1455, 25), (@p1456, @p1457, @p1458, @p1459, @p1460, @p1461, @p1462, @p1463, @p1464, @p1465, @p1466, @p1467, @p1468, @p1469, @p1470, @p1471, @p1472, @p1473, @p1474, @p1475, @p1476, @p1477, @p1478, @p1479, @p1480, @p1481, @p1482, @p1483, @p1484, @p1485, @p1486, @p1487, @p1488, @p1489, @p1490, @p1491, @p1492, @p1493, @p1494, @p1495, @p1496, @p1497, @p1498, @p1499, @p1500, @p1501, @p1502, @p1503, @p1504, @p1505, @p1506, @p1507, @p1508, @p1509, @p1510, @p1511, 26), (@p1512, @p1513, @p1514, @p1515, @p1516, @p1517, @p1518, @p1519, @p1520, @p1521, @p1522, @p1523, @p1524, @p1525, @p1526, @p1527, @p1528, @p1529, @p1530, @p1531, @p1532, @p1533, @p1534, @p1535, @p1536, @p1537, @p1538, @p1539, @p1540, @p1541, @p1542, @p1543, @p1544, @p1545, @p1546, @p1547, @p1548, @p1549, @p1550, @p1551, @p1552, @p1553, @p1554, @p1555, @p1556, @p1557, @p1558, @p1559, @p1560, @p1561, @p1562, @p1563, @p1564, @p1565, @p1566, @p1567, 27), (@p1568, @p1569, @p1570, @p1571, @p1572, @p1573, @p1574, @p1575, @p1576, @p1577, @p1578, @p1579, @p1580, @p1581, @p1582, @p1583, @p1584, @p1585, @p1586, @p1587, @p1588, @p1589, @p1590, @p1591, @p1592, @p1593, @p1594, @p1595, @p1596, @p1597, @p1598, @p1599, @p1600, @p1601, @p1602, @p1603, @p1604, @p1605, @p1606, @p1607, @p1608, @p1609, @p1610, @p1611, @p1612, @p1613, @p1614, @p1615, @p1616, @p1617, @p1618, @p1619, @p1620, @p1621, @p1622, @p1623, 28), (@p1624, @p1625, @p1626, @p1627, @p1628, @p1629, @p1630, @p1631, @p1632, @p1633, @p1634, @p1635, @p1636, @p1637, @p1638, @p1639, @p1640, @p1641, @p1642, @p1643, @p1644, @p1645, @p1646, @p1647, @p1648, @p1649, @p1650, @p1651, @p1652, @p1653, @p1654, @p1655, @p1656, @p1657, @p1658, @p1659, @p1660, @p1661, @p1662, @p1663, @p1664, @p1665, @p1666, @p1667, @p1668, @p1669, @p1670, @p1671, @p1672, @p1673, @p1674, @p1675, @p1676, @p1677, @p1678, @p1679, 29), (@p1680, @p1681, @p1682, @p1683, @p1684, @p1685, @p1686, @p1687, @p1688, @p1689, @p1690, @p1691, @p1692, @p1693, @p1694, @p1695, @p1696, @p1697, @p1698, @p1699, @p1700, @p1701, @p1702, @p1703, @p1704, @p1705, @p1706, @p1707, @p1708, @p1709, @p1710, @p1711, @p1712, @p1713, @p1714, @p1715, @p1716, @p1717, @p1718, @p1719, @p1720, @p1721, @p1722, @p1723, @p1724, @p1725, @p1726, @p1727, @p1728, @p1729, @p1730, @p1731, @p1732, @p1733, @p1734, @p1735, 30), (@p1736, @p1737, @p1738, @p1739, @p1740, @p1741, @p1742, @p1743, @p1744, @p1745, @p1746, @p1747, @p1748, @p1749, @p1750, @p1751, @p1752, @p1753, @p1754, @p1755, @p1756, @p1757, @p1758, @p1759, @p1760, @p1761, @p1762, @p1763, @p1764, @p1765, @p1766, @p1767, @p1768, @p1769, @p1770, @p1771, @p1772, @p1773, @p1774, @p1775, @p1776, @p1777, @p1778, @p1779, @p1780, @p1781, @p1782, @p1783, @p1784, @p1785, @p1786, @p1787, @p1788, @p1789, @p1790, @p1791, 31), (@p1792, @p1793, @p1794, @p1795, @p1796, @p1797, @p1798, @p1799, @p1800, @p1801, @p1802, @p1803, @p1804, @p1805, @p1806, @p1807, @p1808, @p1809, @p1810, @p1811, @p1812, @p1813, @p1814, @p1815, @p1816, @p1817, @p1818, @p1819, @p1820, @p1821, @p1822, @p1823, @p1824, @p1825, @p1826, @p1827, @p1828, @p1829, @p1830, @p1831, @p1832, @p1833, @p1834, @p1835, @p1836, @p1837, @p1838, @p1839, @p1840, @p1841, @p1842, @p1843, @p1844, @p1845, @p1846, @p1847, 32), (@p1848, @p1849, @p1850, @p1851, @p1852, @p1853, @p1854, @p1855, @p1856, @p1857, @p1858, @p1859, @p1860, @p1861, @p1862, @p1863, @p1864, @p1865, @p1866, @p1867, @p1868, @p1869, @p1870, @p1871, @p1872, @p1873, @p1874, @p1875, @p1876, @p1877, @p1878, @p1879, @p1880, @p1881, @p1882, @p1883, @p1884, @p1885, @p1886, @p1887, @p1888, @p1889, @p1890, @p1891, @p1892, @p1893, @p1894, @p1895, @p1896, @p1897, @p1898, @p1899, @p1900, @p1901, @p1902, @p1903, 33), (@p1904, @p1905, @p1906, @p1907, @p1908, @p1909, @p1910, @p1911, @p1912, @p1913, @p1914, @p1915, @p1916, @p1917, @p1918, @p1919, @p1920, @p1921, @p1922, @p1923, @p1924, @p1925, @p1926, @p1927, @p1928, @p1929, @p1930, @p1931, @p1932, @p1933, @p1934, @p1935, @p1936, @p1937, @p1938, @p1939, @p1940, @p1941, @p1942, @p1943, @p1944, @p1945, @p1946, @p1947, @p1948, @p1949, @p1950, @p1951, @p1952, @p1953, @p1954, @p1955, @p1956, @p1957, @p1958, @p1959, 34), (@p1960, @p1961, @p1962, @p1963, @p1964, @p1965, @p1966, @p1967, @p1968, @p1969, @p1970, @p1971, @p1972, @p1973, @p1974, @p1975, @p1976, @p1977, @p1978, @p1979, @p1980, @p1981, @p1982, @p1983, @p1984, @p1985, @p1986, @p1987, @p1988, @p1989, @p1990, @p1991, @p1992, @p1993, @p1994, @p1995, @p1996, @p1997, @p1998, @p1999, @p2000, @p2001, @p2002, @p2003, @p2004, @p2005, @p2006, @p2007, @p2008, @p2009, @p2010, @p2011, @p2012, @p2013, @p2014, @p2015, 35), (@p2016, @p2017, @p2018, @p2019, @p2020, @p2021, @p2022, @p2023, @p2024, @p2025, @p2026, @p2027, @p2028, @p2029, @p2030, @p2031, @p2032, @p2033, @p2034, @p2035, @p2036, @p2037, @p2038, @p2039, @p2040, @p2041, @p2042, @p2043, @p2044, @p2045, @p2046, @p2047, @p2048, @p2049, @p2050, @p2051, @p2052, @p2053, @p2054, @p2055, @p2056, @p2057, @p2058, @p2059, @p2060, @p2061, @p2062, @p2063, @p2064, @p2065, @p2066, @p2067, @p2068, @p2069, @p2070, @p2071, 36)) AS i ([addressee_cntry_cd], [addressee_city], [addressee_district], [addressee_email], [addressee_full_address], [addressee_home_address], [addressee_name], [addressee_postcode], [addressee_province], [addressee_subdistrict], [addressee_tel], [create_table], [delivery_code], [delivery_recipient_name], [delivery_relation_id], [delivery_status_id], [dest_outlet_id], [dest_outlet_port], [document_number], [item_barcode], [item_cod], [item_gross_weight], [item_height], [item_length], [item_price], [item_width], [lat], [log_id], [long], [outlet_id], [outlet_port], [podUrl], [remark], [scan_cntry_cd], [scan_cntry_postcode], [sender_cntry_cd], [sender_district], [sender_email], [sender_full_address], [sender_home_address], [member_id], [sender_name], [sender_postcode], [sender_province], [sender_subdistrict], [sender_tel], [server_id], [signatureUrl], [state], [status_code], [status_dtm], [timestamp], [transmit_dtm], [user_id], [wckt_id], [wkstn_no], _Position) ON 1=0 WHEN NOT MATCHED THEN INSERT ([addressee_cntry_cd], [addressee_city], [addressee_district], [addressee_email], [addressee_full_address], [addressee_home_address], [addressee_name], [addressee_postcode], [addressee_province], [addressee_subdistrict], [addressee_tel], [create_table], [delivery_code], [delivery_recipient_name], [delivery_relation_id], [delivery_status_id], [dest_outlet_id], [dest_outlet_port], [document_number], [item_barcode], [item_cod], [item_gross_weight], [item_height], [item_length], [item_price], [item_width], [lat], [log_id], [long], [outlet_id], [outlet_port], [podUrl], [remark], [scan_cntry_cd], [scan_cntry_postcode], [sender_cntry_cd], [sender_district], [sender_email], [sender_full_address], [sender_home_address], [member_id], [sender_name], [sender_postcode], [sender_province], [sender_subdistrict], [sender_tel], [server_id], [signatureUrl], [state], [status_code], [status_dtm], [timestamp], [transmit_dtm], [user_id], [wckt_id], [wkstn_no]) VALUES (i.[addressee_cntry_cd], i.[addressee_city], i.[addressee_district], i.[addressee_email], i.[addressee_full_address], i.[addressee_home_address], i.[addressee_name], i.[addressee_postcode], i.[addressee_province], i.[addressee_subdistrict], i.[addressee_tel], i.[create_table], i.[delivery_code], i.[delivery_recipient_name], i.[delivery_relation_id], i.[delivery_status_id], i.[dest_outlet_id], i.[dest_outlet_port], i.[document_number], i.[item_barcode], i.[item_cod], i.[item_gross_weight], i.[item_height], i.[item_length], i.[item_price], i.[item_width], i.[lat], i.[log_id], i.[long], i.[outlet_id], i.[outlet_port], i.[podUrl], i.[remark], i.[scan_cntry_cd], i.[scan_cntry_postcode], i.[sender_cntry_cd], i.[sender_district], i.[sender_email], i.[sender_full_address], i.[sender_home_address], i.[member_id], i.[sender_name], i.[sender_postcode], i.[sender_province], i.[sender_subdistrict], i.[sender_tel], i.[server_id], i.[signatureUrl], i.[state], i.[status_code], i.[status_dtm], i.[timestamp], i.[transmit_dtm], i.[user_id], i.[wckt_id], i.[wkstn_no]) OUTPUT INSERTED.[item_id], i._Position INTO @inserted0;  SELECT [t].[item_id] FROM [raw_data] t INNER JOIN @inserted0 i ON ([t].[item_id] = [i].[item_id]) ORDER BY [i].[_Position];  ",4,4,0,430,5,4
"(@p0 nvarchar(4000),@p1 nvarchar(4000),@p2 nvarchar(4000),@p3 nvarchar(4000),@p4 nvarchar(4000),@p5 nvarchar(4000),@p6 nvarchar(4000),@p7 nvarchar(4000),@p8 nvarchar(4000),@p9 nvarchar(4000),@p10 nvarchar(4000),@p11 datetime2(7),@p12 nvarchar(4000),@p13 nvarchar(4000),@p14 int,@p15 int,@p16 int,@p17 nvarchar(4000),@p18 nvarchar(4000),@p19 nvarchar(4000),@p20 nvarchar(4000),@p21 decimal(18,2),@p22 nvarchar(4000),@p23 nvarchar(4000),@p24 decimal(18,2),@p25 nvarchar(4000),@p26 nvarchar(4000),@p27 nvarchar(4000),@p28 nvarchar(4000),@p29 int,@p30 nvarchar(4000),@p31 nvarchar(4000),@p32 nvarchar(4000),@p33 nvarchar(4000),@p34 nvarchar(4000),@p35 nvarchar(4000),@p36 nvarchar(4000),@p37 nvarchar(4000),@p38 nvarchar(4000),@p39 nvarchar(4000),@p40 int,@p41 nvarchar(4000),@p42 nvarchar(4000),@p43 nvarchar(4000),@p44 nvarchar(4000),@p45 nvarchar(4000),@p46 int,@p47 nvarchar(4000),@p48 int,@p49 int,@p50 datetime2(7),@p51 datetime2(7),@p52 datetime2(7),@p53 nvarchar(4000),@p54 nvarchar(4000),@p55 nvarchar(4000),@p56 nvarchar(4000),@p57 nvarchar(4000),@p58 nvarchar(4000),@p59 nvarchar(4000),@p60 nvarchar(4000),@p61 nvarchar(4000),@p62 nvarchar(4000),@p63 nvarchar(4000),@p64 nvarchar(4000),@p65 nvarchar(4000),@p66 nvarchar(4000),@p67 datetime2(7),@p68 nvarchar(4000),@p69 nvarchar(4000),@p70 int,@p71 int,@p72 int,@p73 nvarchar(4000),@p74 nvarchar(4000),@p75 nvarchar(4000),@p76 nvarchar(4000),@p77 decimal(18,2),@p78 nvarchar(4000),@p79 nvarchar(4000),@p80 decimal(18,2),@p81 nvarchar(4000),@p82 nvarchar(4000),@p83 nvarchar(4000),@p84 nvarchar(4000),@p85 int,@p86 nvarchar(4000),@p87 nvarchar(4000),@p88 nvarchar(4000),@p89 nvarchar(4000),@p90 nvarchar(4000),@p91 nvarchar(4000),@p92 nvarchar(4000),@p93 nvarchar(4000),@p94 nvarchar(4000),@p95 nvarchar(4000),@p96 int,@p97 nvarchar(4000),@p98 nvarchar(4000),@p99 nvarchar(4000),@p100 nvarchar(4000),@p101 nvarchar(4000),@p102 int,@p103 nvarchar(4000),@p104 int,@p105 int,@p106 datetime2(7),@p107 datetime2(7),@p108 datetime2(7),@p109 nvarchar(4000),@p110 nvarchar(4000),@p111 nvarchar(4000),@p112 nvarchar(4000),@p113 nvarchar(4000),@p114 nvarchar(4000),@p115 nvarchar(4000),@p116 nvarchar(4000),@p117 nvarchar(4000),@p118 nvarchar(4000),@p119 nvarchar(4000),@p120 nvarchar(4000),@p121 nvarchar(4000),@p122 nvarchar(4000),@p123 datetime2(7),@p124 nvarchar(4000),@p125 nvarchar(4000),@p126 int,@p127 int,@p128 int,@p129 nvarchar(4000),@p130 nvarchar(4000),@p131 nvarchar(4000),@p132 nvarchar(4000),@p133 decimal(18,2),@p134 nvarchar(4000),@p135 nvarchar(4000),@p136 decimal(18,2),@p137 nvarchar(4000),@p138 nvarchar(4000),@p139 nvarchar(4000),@p140 nvarchar(4000),@p141 int,@p142 nvarchar(4000),@p143 nvarchar(4000),@p144 nvarchar(4000),@p145 nvarchar(4000),@p146 nvarchar(4000),@p147 nvarchar(4000),@p148 nvarchar(4000),@p149 nvarchar(4000),@p150 nvarchar(4000),@p151 nvarchar(4000),@p152 int,@p153 nvarchar(4000),@p154 nvarchar(4000),@p155 nvarchar(4000),@p156 nvarchar(4000),@p157 nvarchar(4000),@p158 int,@p159 nvarchar(4000),@p160 int,@p161 int,@p162 datetime2(7),@p163 datetime2(7),@p164 datetime2(7),@p165 nvarchar(4000),@p166 nvarchar(4000),@p167 nvarchar(4000),@p168 nvarchar(4000),@p169 nvarchar(4000),@p170 nvarchar(4000),@p171 nvarchar(4000),@p172 nvarchar(4000),@p173 nvarchar(4000),@p174 nvarchar(4000),@p175 nvarchar(4000),@p176 nvarchar(4000),@p177 nvarchar(4000),@p178 nvarchar(4000),@p179 datetime2(7),@p180 nvarchar(4000),@p181 nvarchar(4000),@p182 int,@p183 int,@p184 int,@p185 nvarchar(4000),@p186 nvarchar(4000),@p187 nvarchar(4000),@p188 nvarchar(4000),@p189 decimal(18,2),@p190 nvarchar(4000),@p191 nvarchar(4000),@p192 decimal(18,2),@p193 nvarchar(4000),@p194 nvarchar(4000),@p195 nvarchar(4000),@p196 nvarchar(4000),@p197 int,@p198 nvarchar(4000),@p199 nvarchar(4000),@p200 nvarchar(4000),@p201 nvarchar(4000),@p202 nvarchar(4000),@p203 nvarchar(4000),@p204 nvarchar(4000),@p205 nvarchar(4000),@p206 nvarchar(4000),@p207 nvarchar(4000),@p208 int,@p209 nvarchar(4000),@p210 nvarchar(4000),@p211 nvarchar(4000),@p212 nvarchar(4000),@p213 nvarchar(4000),@p214 int,@p215 nvarchar(4000),@p216 int,@p217 int,@p218 datetime2(7),@p219 datetime2(7),@p220 datetime2(7),@p221 nvarchar(4000),@p222 nvarchar(4000),@p223 nvarchar(4000),@p224 nvarchar(4000),@p225 nvarchar(4000),@p226 nvarchar(4000),@p227 nvarchar(4000),@p228 nvarchar(4000),@p229 nvarchar(4000),@p230 nvarchar(4000),@p231 nvarchar(4000),@p232 nvarchar(4000),@p233 nvarchar(4000),@p234 nvarchar(4000),@p235 datetime2(7),@p236 nvarchar(4000),@p237 nvarchar(4000),@p238 int,@p239 int,@p240 int,@p241 nvarchar(4000),@p242 nvarchar(4000),@p243 nvarchar(4000),@p244 nvarchar(4000),@p245 decimal(18,2),@p246 nvarchar(4000),@p247 nvarchar(4000),@p248 decimal(18,2),@p249 nvarchar(4000),@p250 nvarchar(4000),@p251 nvarchar(4000),@p252 nvarchar(4000),@p253 int,@p254 nvarchar(4000),@p255 nvarchar(4000),@p256 nvarchar(4000),@p257 nvarchar(4000),@p258 nvarchar(4000),@p259 nvarchar(4000),@p260 nvarchar(4000),@p261 nvarchar(4000),@p262 nvarchar(4000),@p263 nvarchar(4000),@p264 int,@p265 nvarchar(4000),@p266 nvarchar(4000),@p267 nvarchar(4000),@p268 nvarchar(4000),@p269 nvarchar(4000),@p270 int,@p271 nvarchar(4000),@p272 int,@p273 int,@p274 datetime2(7),@p275 datetime2(7),@p276 datetime2(7),@p277 nvarchar(4000),@p278 nvarchar(4000),@p279 nvarchar(4000),@p280 nvarchar(4000),@p281 nvarchar(4000),@p282 nvarchar(4000),@p283 nvarchar(4000),@p284 nvarchar(4000),@p285 nvarchar(4000),@p286 nvarchar(4000),@p287 nvarchar(4000),@p288 nvarchar(4000),@p289 nvarchar(4000),@p290 nvarchar(4000),@p291 datetime2(7),@p292 nvarchar(4000),@p293 nvarchar(4000),@p294 int,@p295 int,@p296 int,@p297 nvarchar(4000),@p298 nvarchar(4000),@p299 nvarchar(4000),@p300 nvarchar(4000),@p301 decimal(18,2),@p302 nvarchar(4000),@p303 nvarchar(4000),@p304 decimal(18,2),@p305 nvarchar(4000),@p306 nvarchar(4000),@p307 nvarchar(4000),@p308 nvarchar(4000),@p309 int,@p310 nvarchar(4000),@p311 nvarchar(4000),@p312 nvarchar(4000),@p313 nvarchar(4000),@p314 nvarchar(4000),@p315 nvarchar(4000),@p316 nvarchar(4000),@p317 nvarchar(4000),@p318 nvarchar(4000),@p319 nvarchar(4000),@p320 int,@p321 nvarchar(4000),@p322 nvarchar(4000),@p323 nvarchar(4000),@p324 nvarchar(4000),@p325 nvarchar(4000),@p326 int,@p327 nvarchar(4000),@p328 int,@p329 int,@p330 datetime2(7),@p331 datetime2(7),@p332 datetime2(7),@p333 nvarchar(4000),@p334 nvarchar(4000),@p335 nvarchar(4000),@p336 nvarchar(4000),@p337 nvarchar(4000),@p338 nvarchar(4000),@p339 nvarchar(4000),@p340 nvarchar(4000),@p341 nvarchar(4000),@p342 nvarchar(4000),@p343 nvarchar(4000),@p344 nvarchar(4000),@p345 nvarchar(4000),@p346 nvarchar(4000),@p347 datetime2(7),@p348 nvarchar(4000),@p349 nvarchar(4000),@p350 int,@p351 int,@p352 int,@p353 nvarchar(4000),@p354 nvarchar(4000),@p355 nvarchar(4000),@p356 nvarchar(4000),@p357 decimal(18,2),@p358 nvarchar(4000),@p359 nvarchar(4000),@p360 decimal(18,2),@p361 nvarchar(4000),@p362 nvarchar(4000),@p363 nvarchar(4000),@p364 nvarchar(4000),@p365 int,@p366 nvarchar(4000),@p367 nvarchar(4000),@p368 nvarchar(4000),@p369 nvarchar(4000),@p370 nvarchar(4000),@p371 nvarchar(4000),@p372 nvarchar(4000),@p373 nvarchar(4000),@p374 nvarchar(4000),@p375 nvarchar(4000),@p376 int,@p377 nvarchar(4000),@p378 nvarchar(4000),@p379 nvarchar(4000),@p380 nvarchar(4000),@p381 nvarchar(4000),@p382 int,@p383 nvarchar(4000),@p384 int,@p385 int,@p386 datetime2(7),@p387 datetime2(7),@p388 datetime2(7),@p389 nvarchar(4000),@p390 nvarchar(4000),@p391 nvarchar(4000),@p392 nvarchar(4000),@p393 nvarchar(4000),@p394 nvarchar(4000),@p395 nvarchar(4000),@p396 nvarchar(4000),@p397 nvarchar(4000),@p398 nvarchar(4000),@p399 nvarchar(4000),@p400 nvarchar(4000),@p401 nvarchar(4000),@p402 nvarchar(4000),@p403 datetime2(7),@p404 nvarchar(4000),@p405 nvarchar(4000),@p406 int,@p407 int,@p408 int,@p409 nvarchar(4000),@p410 nvarchar(4000),@p411 nvarchar(4000),@p412 nvarchar(4000),@p413 decimal(18,2),@p414 nvarchar(4000),@p415 nvarchar(4000),@p416 decimal(18,2),@p417 nvarchar(4000),@p418 nvarchar(4000),@p419 nvarchar(4000),@p420 nvarchar(4000),@p421 int,@p422 nvarchar(4000),@p423 nvarchar(4000),@p424 nvarchar(4000),@p425 nvarchar(4000),@p426 nvarchar(4000),@p427 nvarchar(4000),@p428 nvarchar(4000),@p429 nvarchar(4000),@p430 nvarchar(4000),@p431 nvarchar(4000),@p432 int,@p433 nvarchar(4000),@p434 nvarchar(4000),@p435 nvarchar(4000),@p436 nvarchar(4000),@p437 nvarchar(4000),@p438 int,@p439 nvarchar(4000),@p440 int,@p441 int,@p442 datetime2(7),@p443 datetime2(7),@p444 datetime2(7),@p445 nvarchar(4000),@p446 nvarchar(4000),@p447 nvarchar(4000),@p448 nvarchar(4000),@p449 nvarchar(4000),@p450 nvarchar(4000),@p451 nvarchar(4000),@p452 nvarchar(4000),@p453 nvarchar(4000),@p454 nvarchar(4000),@p455 nvarchar(4000),@p456 nvarchar(4000),@p457 nvarchar(4000),@p458 nvarchar(4000),@p459 datetime2(7),@p460 nvarchar(4000),@p461 nvarchar(4000),@p462 int,@p463 int,@p464 int,@p465 nvarchar(4000),@p466 nvarchar(4000),@p467 nvarchar(4000),@p468 nvarchar(4000),@p469 decimal(18,2),@p470 nvarchar(4000),@p471 nvarchar(4000),@p472 decimal(18,2),@p473 nvarchar(4000),@p474 nvarchar(4000),@p475 nvarchar(4000),@p476 nvarchar(4000),@p477 int,@p478 nvarchar(4000),@p479 nvarchar(4000),@p480 nvarchar(4000),@p481 nvarchar(4000),@p482 nvarchar(4000),@p483 nvarchar(4000),@p484 nvarchar(4000),@p485 nvarchar(4000),@p486 nvarchar(4000),@p487 nvarchar(4000),@p488 int,@p489 nvarchar(4000),@p490 nvarchar(4000),@p491 nvarchar(4000),@p492 nvarchar(4000),@p493 nvarchar(4000),@p494 int,@p495 nvarchar(4000),@p496 int,@p497 int,@p498 datetime2(7),@p499 datetime2(7),@p500 datetime2(7),@p501 nvarchar(4000),@p502 nvarchar(4000),@p503 nvarchar(4000),@p504 nvarchar(4000),@p505 nvarchar(4000),@p506 nvarchar(4000),@p507 nvarchar(4000),@p508 nvarchar(4000),@p509 nvarchar(4000),@p510 nvarchar(4000),@p511 nvarchar(4000),@p512 nvarchar(4000),@p513 nvarchar(4000),@p514 nvarchar(4000),@p515 datetime2(7),@p516 nvarchar(4000),@p517 nvarchar(4000),@p518 int,@p519 int,@p520 int,@p521 nvarchar(4000),@p522 nvarchar(4000),@p523 nvarchar(4000),@p524 nvarchar(4000),@p525 decimal(18,2),@p526 nvarchar(4000),@p527 nvarchar(4000),@p528 decimal(18,2),@p529 nvarchar(4000),@p530 nvarchar(4000),@p531 nvarchar(4000),@p532 nvarchar(4000),@p533 int,@p534 nvarchar(4000),@p535 nvarchar(4000),@p536 nvarchar(4000),@p537 nvarchar(4000),@p538 nvarchar(4000),@p539 nvarchar(4000),@p540 nvarchar(4000),@p541 nvarchar(4000),@p542 nvarchar(4000),@p543 nvarchar(4000),@p544 int,@p545 nvarchar(4000),@p546 nvarchar(4000),@p547 nvarchar(4000),@p548 nvarchar(4000),@p549 nvarchar(4000),@p550 int,@p551 nvarchar(4000),@p552 int,@p553 int,@p554 datetime2(7),@p555 datetime2(7),@p556 datetime2(7),@p557 nvarchar(4000),@p558 nvarchar(4000),@p559 nvarchar(4000),@p560 nvarchar(4000),@p561 nvarchar(4000),@p562 nvarchar(4000),@p563 nvarchar(4000),@p564 nvarchar(4000),@p565 nvarchar(4000),@p566 nvarchar(4000),@p567 nvarchar(4000),@p568 nvarchar(4000),@p569 nvarchar(4000),@p570 nvarchar(4000),@p571 datetime2(7),@p572 nvarchar(4000),@p573 nvarchar(4000),@p574 int,@p575 int,@p576 int,@p577 nvarchar(4000),@p578 nvarchar(4000),@p579 nvarchar(4000),@p580 nvarchar(4000),@p581 decimal(18,2),@p582 nvarchar(4000),@p583 nvarchar(4000),@p584 decimal(18,2),@p585 nvarchar(4000),@p586 nvarchar(4000),@p587 nvarchar(4000),@p588 nvarchar(4000),@p589 int,@p590 nvarchar(4000),@p591 nvarchar(4000),@p592 nvarchar(4000),@p593 nvarchar(4000),@p594 nvarchar(4000),@p595 nvarchar(4000),@p596 nvarchar(4000),@p597 nvarchar(4000),@p598 nvarchar(4000),@p599 nvarchar(4000),@p600 int,@p601 nvarchar(4000),@p602 nvarchar(4000),@p603 nvarchar(4000),@p604 nvarchar(4000),@p605 nvarchar(4000),@p606 int,@p607 nvarchar(4000),@p608 int,@p609 int,@p610 datetime2(7),@p611 datetime2(7),@p612 datetime2(7),@p613 nvarchar(4000),@p614 nvarchar(4000),@p615 nvarchar(4000),@p616 nvarchar(4000),@p617 nvarchar(4000),@p618 nvarchar(4000),@p619 nvarchar(4000),@p620 nvarchar(4000),@p621 nvarchar(4000),@p622 nvarchar(4000),@p623 nvarchar(4000),@p624 nvarchar(4000),@p625 nvarchar(4000),@p626 nvarchar(4000),@p627 datetime2(7),@p628 nvarchar(4000),@p629 nvarchar(4000),@p630 int,@p631 int,@p632 int,@p633 nvarchar(4000),@p634 nvarchar(4000),@p635 nvarchar(4000),@p636 nvarchar(4000),@p637 decimal(18,2),@p638 nvarchar(4000),@p639 nvarchar(4000),@p640 decimal(18,2),@p641 nvarchar(4000),@p642 nvarchar(4000),@p643 nvarchar(4000),@p644 nvarchar(4000),@p645 int,@p646 nvarchar(4000),@p647 nvarchar(4000),@p648 nvarchar(4000),@p649 nvarchar(4000),@p650 nvarchar(4000),@p651 nvarchar(4000),@p652 nvarchar(4000),@p653 nvarchar(4000),@p654 nvarchar(4000),@p655 nvarchar(4000),@p656 int,@p657 nvarchar(4000),@p658 nvarchar(4000),@p659 nvarchar(4000),@p660 nvarchar(4000),@p661 nvarchar(4000),@p662 int,@p663 nvarchar(4000),@p664 int,@p665 int,@p666 datetime2(7),@p667 datetime2(7),@p668 datetime2(7),@p669 nvarchar(4000),@p670 nvarchar(4000),@p671 nvarchar(4000),@p672 nvarchar(4000),@p673 nvarchar(4000),@p674 nvarchar(4000),@p675 nvarchar(4000),@p676 nvarchar(4000),@p677 nvarchar(4000),@p678 nvarchar(4000),@p679 nvarchar(4000),@p680 nvarchar(4000),@p681 nvarchar(4000),@p682 nvarchar(4000),@p683 datetime2(7),@p684 nvarchar(4000),@p685 nvarchar(4000),@p686 int,@p687 int,@p688 int,@p689 nvarchar(4000),@p690 nvarchar(4000),@p691 nvarchar(4000),@p692 nvarchar(4000),@p693 decimal(18,2),@p694 nvarchar(4000),@p695 nvarchar(4000),@p696 decimal(18,2),@p697 nvarchar(4000),@p698 nvarchar(4000),@p699 nvarchar(4000),@p700 nvarchar(4000),@p701 int,@p702 nvarchar(4000),@p703 nvarchar(4000),@p704 nvarchar(4000),@p705 nvarchar(4000),@p706 nvarchar(4000),@p707 nvarchar(4000),@p708 nvarchar(4000),@p709 nvarchar(4000),@p710 nvarchar(4000),@p711 nvarchar(4000),@p712 int,@p713 nvarchar(4000),@p714 nvarchar(4000),@p715 nvarchar(4000),@p716 nvarchar(4000),@p717 nvarchar(4000),@p718 int,@p719 nvarchar(4000),@p720 int,@p721 int,@p722 datetime2(7),@p723 datetime2(7),@p724 datetime2(7),@p725 nvarchar(4000),@p726 nvarchar(4000),@p727 nvarchar(4000),@p728 nvarchar(4000),@p729 nvarchar(4000),@p730 nvarchar(4000),@p731 nvarchar(4000),@p732 nvarchar(4000),@p733 nvarchar(4000),@p734 nvarchar(4000),@p735 nvarchar(4000),@p736 nvarchar(4000),@p737 nvarchar(4000),@p738 nvarchar(4000),@p739 datetime2(7),@p740 nvarchar(4000),@p741 nvarchar(4000),@p742 int,@p743 int,@p744 int,@p745 nvarchar(4000),@p746 nvarchar(4000),@p747 nvarchar(4000),@p748 nvarchar(4000),@p749 decimal(18,2),@p750 nvarchar(4000),@p751 nvarchar(4000),@p752 decimal(18,2),@p753 nvarchar(4000),@p754 nvarchar(4000),@p755 nvarchar(4000),@p756 nvarchar(4000),@p757 int,@p758 nvarchar(4000),@p759 nvarchar(4000),@p760 nvarchar(4000),@p761 nvarchar(4000),@p762 nvarchar(4000),@p763 nvarchar(4000),@p764 nvarchar(4000),@p765 nvarchar(4000),@p766 nvarchar(4000),@p767 nvarchar(4000),@p768 int,@p769 nvarchar(4000),@p770 nvarchar(4000),@p771 nvarchar(4000),@p772 nvarchar(4000),@p773 nvarchar(4000),@p774 int,@p775 nvarchar(4000),@p776 int,@p777 int,@p778 datetime2(7),@p779 datetime2(7),@p780 datetime2(7),@p781 nvarchar(4000),@p782 nvarchar(4000),@p783 nvarchar(4000),@p784 nvarchar(4000),@p785 nvarchar(4000),@p786 nvarchar(4000),@p787 nvarchar(4000),@p788 nvarchar(4000),@p789 nvarchar(4000),@p790 nvarchar(4000),@p791 nvarchar(4000),@p792 nvarchar(4000),@p793 nvarchar(4000),@p794 nvarchar(4000),@p795 datetime2(7),@p796 nvarchar(4000),@p797 nvarchar(4000),@p798 int,@p799 int,@p800 int,@p801 nvarchar(4000),@p802 nvarchar(4000),@p803 nvarchar(4000),@p804 nvarchar(4000),@p805 decimal(18,2),@p806 nvarchar(4000),@p807 nvarchar(4000),@p808 decimal(18,2),@p809 nvarchar(4000),@p810 nvarchar(4000),@p811 nvarchar(4000),@p812 nvarchar(4000),@p813 int,@p814 nvarchar(4000),@p815 nvarchar(4000),@p816 nvarchar(4000),@p817 nvarchar(4000),@p818 nvarchar(4000),@p819 nvarchar(4000),@p820 nvarchar(4000),@p821 nvarchar(4000),@p822 nvarchar(4000),@p823 nvarchar(4000),@p824 int,@p825 nvarchar(4000),@p826 nvarchar(4000),@p827 nvarchar(4000),@p828 nvarchar(4000),@p829 nvarchar(4000),@p830 int,@p831 nvarchar(4000),@p832 int,@p833 int,@p834 datetime2(7),@p835 datetime2(7),@p836 datetime2(7),@p837 nvarchar(4000),@p838 nvarchar(4000),@p839 nvarchar(4000),@p840 nvarchar(4000),@p841 nvarchar(4000),@p842 nvarchar(4000),@p843 nvarchar(4000),@p844 nvarchar(4000),@p845 nvarchar(4000),@p846 nvarchar(4000),@p847 nvarchar(4000),@p848 nvarchar(4000),@p849 nvarchar(4000),@p850 nvarchar(4000),@p851 datetime2(7),@p852 nvarchar(4000),@p853 nvarchar(4000),@p854 int,@p855 int,@p856 int,@p857 nvarchar(4000),@p858 nvarchar(4000),@p859 nvarchar(4000),@p860 nvarchar(4000),@p861 decimal(18,2),@p862 nvarchar(4000),@p863 nvarchar(4000),@p864 decimal(18,2),@p865 nvarchar(4000),@p866 nvarchar(4000),@p867 nvarchar(4000),@p868 nvarchar(4000),@p869 int,@p870 nvarchar(4000),@p871 nvarchar(4000),@p872 nvarchar(4000),@p873 nvarchar(4000),@p874 nvarchar(4000),@p875 nvarchar(4000),@p876 nvarchar(4000),@p877 nvarchar(4000),@p878 nvarchar(4000),@p879 nvarchar(4000),@p880 int,@p881 nvarchar(4000),@p882 nvarchar(4000),@p883 nvarchar(4000),@p884 nvarchar(4000),@p885 nvarchar(4000),@p886 int,@p887 nvarchar(4000),@p888 int,@p889 int,@p890 datetime2(7),@p891 datetime2(7),@p892 datetime2(7),@p893 nvarchar(4000),@p894 nvarchar(4000),@p895 nvarchar(4000),@p896 nvarchar(4000),@p897 nvarchar(4000),@p898 nvarchar(4000),@p899 nvarchar(4000),@p900 nvarchar(4000),@p901 nvarchar(4000),@p902 nvarchar(4000),@p903 nvarchar(4000),@p904 nvarchar(4000),@p905 nvarchar(4000),@p906 nvarchar(4000),@p907 datetime2(7),@p908 nvarchar(4000),@p909 nvarchar(4000),@p910 int,@p911 int,@p912 int,@p913 nvarchar(4000),@p914 nvarchar(4000),@p915 nvarchar(4000),@p916 nvarchar(4000),@p917 decimal(18,2),@p918 nvarchar(4000),@p919 nvarchar(4000),@p920 decimal(18,2),@p921 nvarchar(4000),@p922 nvarchar(4000),@p923 nvarchar(4000),@p924 nvarchar(4000),@p925 int,@p926 nvarchar(4000),@p927 nvarchar(4000),@p928 nvarchar(4000),@p929 nvarchar(4000),@p930 nvarchar(4000),@p931 nvarchar(4000),@p932 nvarchar(4000),@p933 nvarchar(4000),@p934 nvarchar(4000),@p935 nvarchar(4000),@p936 int,@p937 nvarchar(4000),@p938 nvarchar(4000),@p939 nvarchar(4000),@p940 nvarchar(4000),@p941 nvarchar(4000),@p942 int,@p943 nvarchar(4000),@p944 int,@p945 int,@p946 datetime2(7),@p947 datetime2(7),@p948 datetime2(7),@p949 nvarchar(4000),@p950 nvarchar(4000),@p951 nvarchar(4000),@p952 nvarchar(4000),@p953 nvarchar(4000),@p954 nvarchar(4000),@p955 nvarchar(4000),@p956 nvarchar(4000),@p957 nvarchar(4000),@p958 nvarchar(4000),@p959 nvarchar(4000),@p960 nvarchar(4000),@p961 nvarchar(4000),@p962 nvarchar(4000),@p963 datetime2(7),@p964 nvarchar(4000),@p965 nvarchar(4000),@p966 int,@p967 int,@p968 int,@p969 nvarchar(4000),@p970 nvarchar(4000),@p971 nvarchar(4000),@p972 nvarchar(4000),@p973 decimal(18,2),@p974 nvarchar(4000),@p975 nvarchar(4000),@p976 decimal(18,2),@p977 nvarchar(4000),@p978 nvarchar(4000),@p979 nvarchar(4000),@p980 nvarchar(4000),@p981 int,@p982 nvarchar(4000),@p983 nvarchar(4000),@p984 nvarchar(4000),@p985 nvarchar(4000),@p986 nvarchar(4000),@p987 nvarchar(4000),@p988 nvarchar(4000),@p989 nvarchar(4000),@p990 nvarchar(4000),@p991 nvarchar(4000),@p992 int,@p993 nvarchar(4000),@p994 nvarchar(4000),@p995 nvarchar(4000),@p996 nvarchar(4000),@p997 nvarchar(4000),@p998 int,@p999 nvarchar(4000),@p1000 int,@p1001 int,@p1002 datetime2(7),@p1003 datetime2(7),@p1004 datetime2(7),@p1005 nvarchar(4000),@p1006 nvarchar(4000),@p1007 nvarchar(4000),@p1008 nvarchar(4000),@p1009 nvarchar(4000),@p1010 nvarchar(4000),@p1011 nvarchar(4000),@p1012 nvarchar(4000),@p1013 nvarchar(4000),@p1014 nvarchar(4000),@p1015 nvarchar(4000),@p1016 nvarchar(4000),@p1017 nvarchar(4000),@p1018 nvarchar(4000),@p1019 datetime2(7),@p1020 nvarchar(4000),@p1021 nvarchar(4000),@p1022 int,@p1023 int,@p1024 int,@p1025 nvarchar(4000),@p1026 nvarchar(4000),@p1027 nvarchar(4000),@p1028 nvarchar(4000),@p1029 decimal(18,2),@p1030 nvarchar(4000),@p1031 nvarchar(4000),@p1032 decimal(18,2),@p1033 nvarchar(4000),@p1034 nvarchar(4000),@p1035 nvarchar(4000),@p1036 nvarchar(4000),@p1037 int,@p1038 nvarchar(4000),@p1039 nvarchar(4000),@p1040 nvarchar(4000),@p1041 nvarchar(4000),@p1042 nvarchar(4000),@p1043 nvarchar(4000),@p1044 nvarchar(4000),@p1045 nvarchar(4000),@p1046 nvarchar(4000),@p1047 nvarchar(4000),@p1048 int,@p1049 nvarchar(4000),@p1050 nvarchar(4000),@p1051 nvarchar(4000),@p1052 nvarchar(4000),@p1053 nvarchar(4000),@p1054 int,@p1055 nvarchar(4000),@p1056 int,@p1057 int,@p1058 datetime2(7),@p1059 datetime2(7),@p1060 datetime2(7),@p1061 nvarchar(4000),@p1062 nvarchar(4000),@p1063 nvarchar(4000),@p1064 nvarchar(4000),@p1065 nvarchar(4000),@p1066 nvarchar(4000),@p1067 nvarchar(4000),@p1068 nvarchar(4000),@p1069 nvarchar(4000),@p1070 nvarchar(4000),@p1071 nvarchar(4000),@p1072 nvarchar(4000),@p1073 nvarchar(4000),@p1074 nvarchar(4000),@p1075 datetime2(7),@p1076 nvarchar(4000),@p1077 nvarchar(4000),@p1078 int,@p1079 int,@p1080 int,@p1081 nvarchar(4000),@p1082 nvarchar(4000),@p1083 nvarchar(4000),@p1084 nvarchar(4000),@p1085 decimal(18,2),@p1086 nvarchar(4000),@p1087 nvarchar(4000),@p1088 decimal(18,2),@p1089 nvarchar(4000),@p1090 nvarchar(4000),@p1091 nvarchar(4000),@p1092 nvarchar(4000),@p1093 int,@p1094 nvarchar(4000),@p1095 nvarchar(4000),@p1096 nvarchar(4000),@p1097 nvarchar(4000),@p1098 nvarchar(4000),@p1099 nvarchar(4000),@p1100 nvarchar(4000),@p1101 nvarchar(4000),@p1102 nvarchar(4000),@p1103 nvarchar(4000),@p1104 int,@p1105 nvarchar(4000),@p1106 nvarchar(4000),@p1107 nvarchar(4000),@p1108 nvarchar(4000),@p1109 nvarchar(4000),@p1110 int,@p1111 nvarchar(4000),@p1112 int,@p1113 int,@p1114 datetime2(7),@p1115 datetime2(7),@p1116 datetime2(7),@p1117 nvarchar(4000),@p1118 nvarchar(4000),@p1119 nvarchar(4000),@p1120 nvarchar(4000),@p1121 nvarchar(4000),@p1122 nvarchar(4000),@p1123 nvarchar(4000),@p1124 nvarchar(4000),@p1125 nvarchar(4000),@p1126 nvarchar(4000),@p1127 nvarchar(4000),@p1128 nvarchar(4000),@p1129 nvarchar(4000),@p1130 nvarchar(4000),@p1131 datetime2(7),@p1132 nvarchar(4000),@p1133 nvarchar(4000),@p1134 int,@p1135 int,@p1136 int,@p1137 nvarchar(4000),@p1138 nvarchar(4000),@p1139 nvarchar(4000),@p1140 nvarchar(4000),@p1141 decimal(18,2),@p1142 nvarchar(4000),@p1143 nvarchar(4000),@p1144 decimal(18,2),@p1145 nvarchar(4000),@p1146 nvarchar(4000),@p1147 nvarchar(4000),@p1148 nvarchar(4000),@p1149 int,@p1150 nvarchar(4000),@p1151 nvarchar(4000),@p1152 nvarchar(4000),@p1153 nvarchar(4000),@p1154 nvarchar(4000),@p1155 nvarchar(4000),@p1156 nvarchar(4000),@p1157 nvarchar(4000),@p1158 nvarchar(4000),@p1159 nvarchar(4000),@p1160 int,@p1161 nvarchar(4000),@p1162 nvarchar(4000),@p1163 nvarchar(4000),@p1164 nvarchar(4000),@p1165 nvarchar(4000),@p1166 int,@p1167 nvarchar(4000),@p1168 int,@p1169 int,@p1170 datetime2(7),@p1171 datetime2(7),@p1172 datetime2(7),@p1173 nvarchar(4000),@p1174 nvarchar(4000),@p1175 nvarchar(4000),@p1176 nvarchar(4000),@p1177 nvarchar(4000),@p1178 nvarchar(4000),@p1179 nvarchar(4000),@p1180 nvarchar(4000),@p1181 nvarchar(4000),@p1182 nvarchar(4000),@p1183 nvarchar(4000),@p1184 nvarchar(4000),@p1185 nvarchar(4000),@p1186 nvarchar(4000),@p1187 datetime2(7),@p1188 nvarchar(4000),@p1189 nvarchar(4000),@p1190 int,@p1191 int,@p1192 int,@p1193 nvarchar(4000),@p1194 nvarchar(4000),@p1195 nvarchar(4000),@p1196 nvarchar(4000),@p1197 decimal(18,2),@p1198 nvarchar(4000),@p1199 nvarchar(4000),@p1200 decimal(18,2),@p1201 nvarchar(4000),@p1202 nvarchar(4000),@p1203 nvarchar(4000),@p1204 nvarchar(4000),@p1205 int,@p1206 nvarchar(4000),@p1207 nvarchar(4000),@p1208 nvarchar(4000),@p1209 nvarchar(4000),@p1210 nvarchar(4000),@p1211 nvarchar(4000),@p1212 nvarchar(4000),@p1213 nvarchar(4000),@p1214 nvarchar(4000),@p1215 nvarchar(4000),@p1216 int,@p1217 nvarchar(4000),@p1218 nvarchar(4000),@p1219 nvarchar(4000),@p1220 nvarchar(4000),@p1221 nvarchar(4000),@p1222 int,@p1223 nvarchar(4000),@p1224 int,@p1225 int,@p1226 datetime2(7),@p1227 datetime2(7),@p1228 datetime2(7),@p1229 nvarchar(4000),@p1230 nvarchar(4000),@p1231 nvarchar(4000),@p1232 nvarchar(4000),@p1233 nvarchar(4000),@p1234 nvarchar(4000),@p1235 nvarchar(4000),@p1236 nvarchar(4000),@p1237 nvarchar(4000),@p1238 nvarchar(4000),@p1239 nvarchar(4000),@p1240 nvarchar(4000),@p1241 nvarchar(4000),@p1242 nvarchar(4000),@p1243 datetime2(7),@p1244 nvarchar(4000),@p1245 nvarchar(4000),@p1246 int,@p1247 int,@p1248 int,@p1249 nvarchar(4000),@p1250 nvarchar(4000),@p1251 nvarchar(4000),@p1252 nvarchar(4000),@p1253 decimal(18,2),@p1254 nvarchar(4000),@p1255 nvarchar(4000),@p1256 decimal(18,2),@p1257 nvarchar(4000),@p1258 nvarchar(4000),@p1259 nvarchar(4000),@p1260 nvarchar(4000),@p1261 int,@p1262 nvarchar(4000),@p1263 nvarchar(4000),@p1264 nvarchar(4000),@p1265 nvarchar(4000),@p1266 nvarchar(4000),@p1267 nvarchar(4000),@p1268 nvarchar(4000),@p1269 nvarchar(4000),@p1270 nvarchar(4000),@p1271 nvarchar(4000),@p1272 int,@p1273 nvarchar(4000),@p1274 nvarchar(4000),@p1275 nvarchar(4000),@p1276 nvarchar(4000),@p1277 nvarchar(4000),@p1278 int,@p1279 nvarchar(4000),@p1280 int,@p1281 int,@p1282 datetime2(7),@p1283 datetime2(7),@p1284 datetime2(7),@p1285 nvarchar(4000),@p1286 nvarchar(4000),@p1287 nvarchar(4000),@p1288 nvarchar(4000),@p1289 nvarchar(4000),@p1290 nvarchar(4000),@p1291 nvarchar(4000),@p1292 nvarchar(4000),@p1293 nvarchar(4000),@p1294 nvarchar(4000),@p1295 nvarchar(4000),@p1296 nvarchar(4000),@p1297 nvarchar(4000),@p1298 nvarchar(4000),@p1299 datetime2(7),@p1300 nvarchar(4000),@p1301 nvarchar(4000),@p1302 int,@p1303 int,@p1304 int,@p1305 nvarchar(4000),@p1306 nvarchar(4000),@p1307 nvarchar(4000),@p1308 nvarchar(4000),@p1309 decimal(18,2),@p1310 nvarchar(4000),@p1311 nvarchar(4000),@p1312 decimal(18,2),@p1313 nvarchar(4000),@p1314 nvarchar(4000),@p1315 nvarchar(4000),@p1316 nvarchar(4000),@p1317 int,@p1318 nvarchar(4000),@p1319 nvarchar(4000),@p1320 nvarchar(4000),@p1321 nvarchar(4000),@p1322 nvarchar(4000),@p1323 nvarchar(4000),@p1324 nvarchar(4000),@p1325 nvarchar(4000),@p1326 nvarchar(4000),@p1327 nvarchar(4000),@p1328 int,@p1329 nvarchar(4000),@p1330 nvarchar(4000),@p1331 nvarchar(4000),@p1332 nvarchar(4000),@p1333 nvarchar(4000),@p1334 int,@p1335 nvarchar(4000),@p1336 int,@p1337 int,@p1338 datetime2(7),@p1339 datetime2(7),@p1340 datetime2(7),@p1341 nvarchar(4000),@p1342 nvarchar(4000),@p1343 nvarchar(4000),@p1344 nvarchar(4000),@p1345 nvarchar(4000),@p1346 nvarchar(4000),@p1347 nvarchar(4000),@p1348 nvarchar(4000),@p1349 nvarchar(4000),@p1350 nvarchar(4000),@p1351 nvarchar(4000),@p1352 nvarchar(4000),@p1353 nvarchar(4000),@p1354 nvarchar(4000),@p1355 datetime2(7),@p1356 nvarchar(4000),@p1357 nvarchar(4000),@p1358 int,@p1359 int,@p1360 int,@p1361 nvarchar(4000),@p1362 nvarchar(4000),@p1363 nvarchar(4000),@p1364 nvarchar(4000),@p1365 decimal(18,2),@p1366 nvarchar(4000),@p1367 nvarchar(4000),@p1368 decimal(18,2),@p1369 nvarchar(4000),@p1370 nvarchar(4000),@p1371 nvarchar(4000),@p1372 nvarchar(4000),@p1373 int,@p1374 nvarchar(4000),@p1375 nvarchar(4000),@p1376 nvarchar(4000),@p1377 nvarchar(4000),@p1378 nvarchar(4000),@p1379 nvarchar(4000),@p1380 nvarchar(4000),@p1381 nvarchar(4000),@p1382 nvarchar(4000),@p1383 nvarchar(4000),@p1384 int,@p1385 nvarchar(4000),@p1386 nvarchar(4000),@p1387 nvarchar(4000),@p1388 nvarchar(4000),@p1389 nvarchar(4000),@p1390 int,@p1391 nvarchar(4000),@p1392 int,@p1393 int,@p1394 datetime2(7),@p1395 datetime2(7),@p1396 datetime2(7),@p1397 nvarchar(4000),@p1398 nvarchar(4000),@p1399 nvarchar(4000),@p1400 nvarchar(4000),@p1401 nvarchar(4000),@p1402 nvarchar(4000),@p1403 nvarchar(4000),@p1404 nvarchar(4000),@p1405 nvarchar(4000),@p1406 nvarchar(4000),@p1407 nvarchar(4000),@p1408 nvarchar(4000),@p1409 nvarchar(4000),@p1410 nvarchar(4000),@p1411 datetime2(7),@p1412 nvarchar(4000),@p1413 nvarchar(4000),@p1414 int,@p1415 int,@p1416 int,@p1417 nvarchar(4000),@p1418 nvarchar(4000),@p1419 nvarchar(4000),@p1420 nvarchar(4000),@p1421 decimal(18,2),@p1422 nvarchar(4000),@p1423 nvarchar(4000),@p1424 decimal(18,2),@p1425 nvarchar(4000),@p1426 nvarchar(4000),@p1427 nvarchar(4000),@p1428 nvarchar(4000),@p1429 int,@p1430 nvarchar(4000),@p1431 nvarchar(4000),@p1432 nvarchar(4000),@p1433 nvarchar(4000),@p1434 nvarchar(4000),@p1435 nvarchar(4000),@p1436 nvarchar(4000),@p1437 nvarchar(4000),@p1438 nvarchar(4000),@p1439 nvarchar(4000),@p1440 int,@p1441 nvarchar(4000),@p1442 nvarchar(4000),@p1443 nvarchar(4000),@p1444 nvarchar(4000),@p1445 nvarchar(4000),@p1446 int,@p1447 nvarchar(4000),@p1448 int,@p1449 int,@p1450 datetime2(7),@p1451 datetime2(7),@p1452 datetime2(7),@p1453 nvarchar(4000),@p1454 nvarchar(4000),@p1455 nvarchar(4000),@p1456 nvarchar(4000),@p1457 nvarchar(4000),@p1458 nvarchar(4000),@p1459 nvarchar(4000),@p1460 nvarchar(4000),@p1461 nvarchar(4000),@p1462 nvarchar(4000),@p1463 nvarchar(4000),@p1464 nvarchar(4000),@p1465 nvarchar(4000),@p1466 nvarchar(4000),@p1467 datetime2(7),@p1468 nvarchar(4000),@p1469 nvarchar(4000),@p1470 int,@p1471 int,@p1472 int,@p1473 nvarchar(4000),@p1474 nvarchar(4000),@p1475 nvarchar(4000),@p1476 nvarchar(4000),@p1477 decimal(18,2),@p1478 nvarchar(4000),@p1479 nvarchar(4000),@p1480 decimal(18,2),@p1481 nvarchar(4000),@p1482 nvarchar(4000),@p1483 nvarchar(4000),@p1484 nvarchar(4000),@p1485 int,@p1486 nvarchar(4000),@p1487 nvarchar(4000),@p1488 nvarchar(4000),@p1489 nvarchar(4000),@p1490 nvarchar(4000),@p1491 nvarchar(4000),@p1492 nvarchar(4000),@p1493 nvarchar(4000),@p1494 nvarchar(4000),@p1495 nvarchar(4000),@p1496 int,@p1497 nvarchar(4000),@p1498 nvarchar(4000),@p1499 nvarchar(4000),@p1500 nvarchar(4000),@p1501 nvarchar(4000),@p1502 int,@p1503 nvarchar(4000),@p1504 int,@p1505 int,@p1506 datetime2(7),@p1507 datetime2(7),@p1508 datetime2(7),@p1509 nvarchar(4000),@p1510 nvarchar(4000),@p1511 nvarchar(4000),@p1512 nvarchar(4000),@p1513 nvarchar(4000),@p1514 nvarchar(4000),@p1515 nvarchar(4000),@p1516 nvarchar(4000),@p1517 nvarchar(4000),@p1518 nvarchar(4000),@p1519 nvarchar(4000),@p1520 nvarchar(4000),@p1521 nvarchar(4000),@p1522 nvarchar(4000),@p1523 datetime2(7),@p1524 nvarchar(4000),@p1525 nvarchar(4000),@p1526 int,@p1527 int,@p1528 int,@p1529 nvarchar(4000),@p1530 nvarchar(4000),@p1531 nvarchar(4000),@p1532 nvarchar(4000),@p1533 decimal(18,2),@p1534 nvarchar(4000),@p1535 nvarchar(4000),@p1536 decimal(18,2),@p1537 nvarchar(4000),@p1538 nvarchar(4000),@p1539 nvarchar(4000),@p1540 nvarchar(4000),@p1541 int,@p1542 nvarchar(4000),@p1543 nvarchar(4000),@p1544 nvarchar(4000),@p1545 nvarchar(4000),@p1546 nvarchar(4000),@p1547 nvarchar(4000),@p1548 nvarchar(4000),@p1549 nvarchar(4000),@p1550 nvarchar(4000),@p1551 nvarchar(4000),@p1552 int,@p1553 nvarchar(4000),@p1554 nvarchar(4000),@p1555 nvarchar(4000),@p1556 nvarchar(4000),@p1557 nvarchar(4000),@p1558 int,@p1559 nvarchar(4000),@p1560 int,@p1561 int,@p1562 datetime2(7),@p1563 datetime2(7),@p1564 datetime2(7),@p1565 nvarchar(4000),@p1566 nvarchar(4000),@p1567 nvarchar(4000),@p1568 nvarchar(4000),@p1569 nvarchar(4000),@p1570 nvarchar(4000),@p1571 nvarchar(4000),@p1572 nvarchar(4000),@p1573 nvarchar(4000),@p1574 nvarchar(4000),@p1575 nvarchar(4000),@p1576 nvarchar(4000),@p1577 nvarchar(4000),@p1578 nvarchar(4000),@p1579 datetime2(7),@p1580 nvarchar(4000),@p1581 nvarchar(4000),@p1582 int,@p1583 int,@p1584 int,@p1585 nvarchar(4000),@p1586 nvarchar(4000),@p1587 nvarchar(4000),@p1588 nvarchar(4000),@p1589 decimal(18,2),@p1590 nvarchar(4000),@p1591 nvarchar(4000),@p1592 decimal(18,2),@p1593 nvarchar(4000),@p1594 nvarchar(4000),@p1595 nvarchar(4000),@p1596 nvarchar(4000),@p1597 int,@p1598 nvarchar(4000),@p1599 nvarchar(4000),@p1600 nvarchar(4000),@p1601 nvarchar(4000),@p1602 nvarchar(4000),@p1603 nvarchar(4000),@p1604 nvarchar(4000),@p1605 nvarchar(4000),@p1606 nvarchar(4000),@p1607 nvarchar(4000),@p1608 int,@p1609 nvarchar(4000),@p1610 nvarchar(4000),@p1611 nvarchar(4000),@p1612 nvarchar(4000),@p1613 nvarchar(4000),@p1614 int,@p1615 nvarchar(4000),@p1616 int,@p1617 int,@p1618 datetime2(7),@p1619 datetime2(7),@p1620 datetime2(7),@p1621 nvarchar(4000),@p1622 nvarchar(4000),@p1623 nvarchar(4000),@p1624 nvarchar(4000),@p1625 nvarchar(4000),@p1626 nvarchar(4000),@p1627 nvarchar(4000),@p1628 nvarchar(4000),@p1629 nvarchar(4000),@p1630 nvarchar(4000),@p1631 nvarchar(4000),@p1632 nvarchar(4000),@p1633 nvarchar(4000),@p1634 nvarchar(4000),@p1635 datetime2(7),@p1636 nvarchar(4000),@p1637 nvarchar(4000),@p1638 int,@p1639 int,@p1640 int,@p1641 nvarchar(4000),@p1642 nvarchar(4000),@p1643 nvarchar(4000),@p1644 decimal(18,2),@p1645 decimal(18,2),@p1646 nvarchar(4000),@p1647 nvarchar(4000),@p1648 decimal(18,2),@p1649 nvarchar(4000),@p1650 nvarchar(4000),@p1651 nvarchar(4000),@p1652 nvarchar(4000),@p1653 int,@p1654 nvarchar(4000),@p1655 nvarchar(4000),@p1656 nvarchar(4000),@p1657 nvarchar(4000),@p1658 nvarchar(4000),@p1659 nvarchar(4000),@p1660 nvarchar(4000),@p1661 nvarchar(4000),@p1662 nvarchar(4000),@p1663 nvarchar(4000),@p1664 int,@p1665 nvarchar(4000),@p1666 nvarchar(4000),@p1667 nvarchar(4000),@p1668 nvarchar(4000),@p1669 nvarchar(4000),@p1670 int,@p1671 nvarchar(4000),@p1672 int,@p1673 int,@p1674 datetime2(7),@p1675 datetime2(7),@p1676 datetime2(7),@p1677 nvarchar(4000),@p1678 nvarchar(4000),@p1679 nvarchar(4000),@p1680 nvarchar(4000),@p1681 nvarchar(4000),@p1682 nvarchar(4000),@p1683 nvarchar(4000),@p1684 nvarchar(4000),@p1685 nvarchar(4000),@p1686 nvarchar(4000),@p1687 nvarchar(4000),@p1688 nvarchar(4000),@p1689 nvarchar(4000),@p1690 nvarchar(4000),@p1691 datetime2(7),@p1692 nvarchar(4000),@p1693 nvarchar(4000),@p1694 int,@p1695 int,@p1696 int,@p1697 nvarchar(4000),@p1698 nvarchar(4000),@p1699 nvarchar(4000),@p1700 nvarchar(4000),@p1701 decimal(18,2),@p1702 nvarchar(4000),@p1703 nvarchar(4000),@p1704 decimal(18,2),@p1705 nvarchar(4000),@p1706 nvarchar(4000),@p1707 nvarchar(4000),@p1708 nvarchar(4000),@p1709 int,@p1710 nvarchar(4000),@p1711 nvarchar(4000),@p1712 nvarchar(4000),@p1713 nvarchar(4000),@p1714 nvarchar(4000),@p1715 nvarchar(4000),@p1716 nvarchar(4000),@p1717 nvarchar(4000),@p1718 nvarchar(4000),@p1719 nvarchar(4000),@p1720 int,@p1721 nvarchar(4000),@p1722 nvarchar(4000),@p1723 nvarchar(4000),@p1724 nvarchar(4000),@p1725 nvarchar(4000),@p1726 int,@p1727 nvarchar(4000),@p1728 int,@p1729 int,@p1730 datetime2(7),@p1731 datetime2(7),@p1732 datetime2(7),@p1733 nvarchar(4000),@p1734 nvarchar(4000),@p1735 nvarchar(4000),@p1736 nvarchar(4000),@p1737 nvarchar(4000),@p1738 nvarchar(4000),@p1739 nvarchar(4000),@p1740 nvarchar(4000),@p1741 nvarchar(4000),@p1742 nvarchar(4000),@p1743 nvarchar(4000),@p1744 nvarchar(4000),@p1745 nvarchar(4000),@p1746 nvarchar(4000),@p1747 datetime2(7),@p1748 nvarchar(4000),@p1749 nvarchar(4000),@p1750 int,@p1751 int,@p1752 int,@p1753 nvarchar(4000),@p1754 nvarchar(4000),@p1755 nvarchar(4000),@p1756 decimal(18,2),@p1757 decimal(18,2),@p1758 nvarchar(4000),@p1759 nvarchar(4000),@p1760 decimal(18,2),@p1761 nvarchar(4000),@p1762 nvarchar(4000),@p1763 nvarchar(4000),@p1764 nvarchar(4000),@p1765 int,@p1766 nvarchar(4000),@p1767 nvarchar(4000),@p1768 nvarchar(4000),@p1769 nvarchar(4000),@p1770 nvarchar(4000),@p1771 nvarchar(4000),@p1772 nvarchar(4000),@p1773 nvarchar(4000),@p1774 nvarchar(4000),@p1775 nvarchar(4000),@p1776 int,@p1777 nvarchar(4000),@p1778 nvarchar(4000),@p1779 nvarchar(4000),@p1780 nvarchar(4000),@p1781 nvarchar(4000),@p1782 int,@p1783 nvarchar(4000),@p1784 int,@p1785 int,@p1786 datetime2(7),@p1787 datetime2(7),@p1788 datetime2(7),@p1789 nvarchar(4000),@p1790 nvarchar(4000),@p1791 nvarchar(4000),@p1792 nvarchar(4000),@p1793 nvarchar(4000),@p1794 nvarchar(4000),@p1795 nvarchar(4000),@p1796 nvarchar(4000),@p1797 nvarchar(4000),@p1798 nvarchar(4000),@p1799 nvarchar(4000),@p1800 nvarchar(4000),@p1801 nvarchar(4000),@p1802 nvarchar(4000),@p1803 datetime2(7),@p1804 nvarchar(4000),@p1805 nvarchar(4000),@p1806 int,@p1807 int,@p1808 int,@p1809 nvarchar(4000),@p1810 nvarchar(4000),@p1811 nvarchar(4000),@p1812 decimal(18,2),@p1813 decimal(18,2),@p1814 nvarchar(4000),@p1815 nvarchar(4000),@p1816 decimal(18,2),@p1817 nvarchar(4000),@p1818 nvarchar(4000),@p1819 nvarchar(4000),@p1820 nvarchar(4000),@p1821 int,@p1822 nvarchar(4000),@p1823 nvarchar(4000),@p1824 nvarchar(4000),@p1825 nvarchar(4000),@p1826 nvarchar(4000),@p1827 nvarchar(4000),@p1828 nvarchar(4000),@p1829 nvarchar(4000),@p1830 nvarchar(4000),@p1831 nvarchar(4000),@p1832 int,@p1833 nvarchar(4000),@p1834 nvarchar(4000),@p1835 nvarchar(4000),@p1836 nvarchar(4000),@p1837 nvarchar(4000),@p1838 int,@p1839 nvarchar(4000),@p1840 int,@p1841 int,@p1842 datetime2(7),@p1843 datetime2(7),@p1844 datetime2(7),@p1845 nvarchar(4000),@p1846 nvarchar(4000),@p1847 nvarchar(4000),@p1848 nvarchar(4000),@p1849 nvarchar(4000),@p1850 nvarchar(4000),@p1851 nvarchar(4000),@p1852 nvarchar(4000),@p1853 nvarchar(4000),@p1854 nvarchar(4000),@p1855 nvarchar(4000),@p1856 nvarchar(4000),@p1857 nvarchar(4000),@p1858 nvarchar(4000),@p1859 datetime2(7),@p1860 nvarchar(4000),@p1861 nvarchar(4000),@p1862 int,@p1863 int,@p1864 int,@p1865 nvarchar(4000),@p1866 nvarchar(4000),@p1867 nvarchar(4000),@p1868 decimal(18,2),@p1869 decimal(18,2),@p1870 nvarchar(4000),@p1871 nvarchar(4000),@p1872 decimal(18,2),@p1873 nvarchar(4000),@p1874 nvarchar(4000),@p1875 nvarchar(4000),@p1876 nvarchar(4000),@p1877 int,@p1878 nvarchar(4000),@p1879 nvarchar(4000),@p1880 nvarchar(4000),@p1881 nvarchar(4000),@p1882 nvarchar(4000),@p1883 nvarchar(4000),@p1884 nvarchar(4000),@p1885 nvarchar(4000),@p1886 nvarchar(4000),@p1887 nvarchar(4000),@p1888 int,@p1889 nvarchar(4000),@p1890 nvarchar(4000),@p1891 nvarchar(4000),@p1892 nvarchar(4000),@p1893 nvarchar(4000),@p1894 int,@p1895 nvarchar(4000),@p1896 int,@p1897 int,@p1898 datetime2(7),@p1899 datetime2(7),@p1900 datetime2(7),@p1901 nvarchar(4000),@p1902 nvarchar(4000),@p1903 nvarchar(4000),@p1904 nvarchar(4000),@p1905 nvarchar(4000),@p1906 nvarchar(4000),@p1907 nvarchar(4000),@p1908 nvarchar(4000),@p1909 nvarchar(4000),@p1910 nvarchar(4000),@p1911 nvarchar(4000),@p1912 nvarchar(4000),@p1913 nvarchar(4000),@p1914 nvarchar(4000),@p1915 datetime2(7),@p1916 nvarchar(4000),@p1917 nvarchar(4000),@p1918 int,@p1919 int,@p1920 int,@p1921 nvarchar(4000),@p1922 nvarchar(4000),@p1923 nvarchar(4000),@p1924 nvarchar(4000),@p1925 decimal(18,2),@p1926 nvarchar(4000),@p1927 nvarchar(4000),@p1928 decimal(18,2),@p1929 nvarchar(4000),@p1930 nvarchar(4000),@p1931 nvarchar(4000),@p1932 nvarchar(4000),@p1933 int,@p1934 nvarchar(4000),@p1935 nvarchar(4000),@p1936 nvarchar(4000),@p1937 nvarchar(4000),@p1938 nvarchar(4000),@p1939 nvarchar(4000),@p1940 nvarchar(4000),@p1941 nvarchar(4000),@p1942 nvarchar(4000),@p1943 nvarchar(4000),@p1944 int,@p1945 nvarchar(4000),@p1946 nvarchar(4000),@p1947 nvarchar(4000),@p1948 nvarchar(4000),@p1949 nvarchar(4000),@p1950 int,@p1951 nvarchar(4000),@p1952 int,@p1953 int,@p1954 datetime2(7),@p1955 datetime2(7),@p1956 datetime2(7),@p1957 nvarchar(4000),@p1958 nvarchar(4000),@p1959 nvarchar(4000),@p1960 nvarchar(4000),@p1961 nvarchar(4000),@p1962 nvarchar(4000),@p1963 nvarchar(4000),@p1964 nvarchar(4000),@p1965 nvarchar(4000),@p1966 nvarchar(4000),@p1967 nvarchar(4000),@p1968 nvarchar(4000),@p1969 nvarchar(4000),@p1970 nvarchar(4000),@p1971 datetime2(7),@p1972 nvarchar(4000),@p1973 nvarchar(4000),@p1974 int,@p1975 int,@p1976 int,@p1977 nvarchar(4000),@p1978 nvarchar(4000),@p1979 nvarchar(4000),@p1980 decimal(18,2),@p1981 decimal(18,2),@p1982 nvarchar(4000),@p1983 nvarchar(4000),@p1984 decimal(18,2),@p1985 nvarchar(4000),@p1986 nvarchar(4000),@p1987 nvarchar(4000),@p1988 nvarchar(4000),@p1989 int,@p1990 nvarchar(4000),@p1991 nvarchar(4000),@p1992 nvarchar(4000),@p1993 nvarchar(4000),@p1994 nvarchar(4000),@p1995 nvarchar(4000),@p1996 nvarchar(4000),@p1997 nvarchar(4000),@p1998 nvarchar(4000),@p1999 nvarchar(4000),@p2000 int,@p2001 nvarchar(4000),@p2002 nvarchar(4000),@p2003 nvarchar(4000),@p2004 nvarchar(4000),@p2005 nvarchar(4000),@p2006 int,@p2007 nvarchar(4000),@p2008 int,@p2009 int,@p2010 datetime2(7),@p2011 datetime2(7),@p2012 datetime2(7),@p2013 nvarchar(4000),@p2014 nvarchar(4000),@p2015 nvarchar(4000),@p2016 nvarchar(4000),@p2017 nvarchar(4000),@p2018 nvarchar(4000),@p2019 nvarchar(4000),@p2020 nvarchar(4000),@p2021 nvarchar(4000),@p2022 nvarchar(4000),@p2023 nvarchar(4000),@p2024 nvarchar(4000),@p2025 nvarchar(4000),@p2026 nvarchar(4000),@p2027 datetime2(7),@p2028 nvarchar(4000),@p2029 nvarchar(4000),@p2030 int,@p2031 int,@p2032 int,@p2033 nvarchar(4000),@p2034 nvarchar(4000),@p2035 nvarchar(4000),@p2036 decimal(18,2),@p2037 decimal(18,2),@p2038 nvarchar(4000),@p2039 nvarchar(4000),@p2040 decimal(18,2),@p2041 nvarchar(4000),@p2042 nvarchar(4000),@p2043 nvarchar(4000),@p2044 nvarchar(4000),@p2045 int,@p2046 nvarchar(4000),@p2047 nvarchar(4000),@p2048 nvarchar(4000),@p2049 nvarchar(4000),@p2050 nvarchar(4000),@p2051 nvarchar(4000),@p2052 nvarchar(4000),@p2053 nvarchar(4000),@p2054 nvarchar(4000),@p2055 nvarchar(4000),@p2056 int,@p2057 nvarchar(4000),@p2058 nvarchar(4000),@p2059 nvarchar(4000),@p2060 nvarchar(4000),@p2061 nvarchar(4000),@p2062 int,@p2063 nvarchar(4000),@p2064 int,@p2065 int,@p2066 datetime2(7),@p2067 datetime2(7),@p2068 datetime2(7),@p2069 nvarchar(4000),@p2070 nvarchar(4000),@p2071 nvarchar(4000))SET NOCOUNT ON; DECLARE @inserted0 TABLE ([item_id] int, [_Position] [int]); MERGE [raw_data] USING ( VALUES (@p0, @p1, @p2, @p3, @p4, @p5, @p6, @p7, @p8, @p9, @p10, @p11, @p12, @p13, @p14, @p15, @p16, @p17, @p18, @p19, @p20, @p21, @p22, @p23, @p24, @p25, @p26, @p27, @p28, @p29, @p30, @p31, @p32, @p33, @p34, @p35, @p36, @p37, @p38, @p39, @p40, @p41, @p42, @p43, @p44, @p45, @p46, @p47, @p48, @p49, @p50, @p51, @p52, @p53, @p54, @p55, 0), (@p56, @p57, @p58, @p59, @p60, @p61, @p62, @p63, @p64, @p65, @p66, @p67, @p68, @p69, @p70, @p71, @p72, @p73, @p74, @p75, @p76, @p77, @p78, @p79, @p80, @p81, @p82, @p83, @p84, @p85, @p86, @p87, @p88, @p89, @p90, @p91, @p92, @p93, @p94, @p95, @p96, @p97, @p98, @p99, @p100, @p101, @p102, @p103, @p104, @p105, @p106, @p107, @p108, @p109, @p110, @p111, 1), (@p112, @p113, @p114, @p115, @p116, @p117, @p118, @p119, @p120, @p121, @p122, @p123, @p124, @p125, @p126, @p127, @p128, @p129, @p130, @p131, @p132, @p133, @p134, @p135, @p136, @p137, @p138, @p139, @p140, @p141, @p142, @p143, @p144, @p145, @p146, @p147, @p148, @p149, @p150, @p151, @p152, @p153, @p154, @p155, @p156, @p157, @p158, @p159, @p160, @p161, @p162, @p163, @p164, @p165, @p166, @p167, 2), (@p168, @p169, @p170, @p171, @p172, @p173, @p174, @p175, @p176, @p177, @p178, @p179, @p180, @p181, @p182, @p183, @p184, @p185, @p186, @p187, @p188, @p189, @p190, @p191, @p192, @p193, @p194, @p195, @p196, @p197, @p198, @p199, @p200, @p201, @p202, @p203, @p204, @p205, @p206, @p207, @p208, @p209, @p210, @p211, @p212, @p213, @p214, @p215, @p216, @p217, @p218, @p219, @p220, @p221, @p222, @p223, 3), (@p224, @p225, @p226, @p227, @p228, @p229, @p230, @p231, @p232, @p233, @p234, @p235, @p236, @p237, @p238, @p239, @p240, @p241, @p242, @p243, @p244, @p245, @p246, @p247, @p248, @p249, @p250, @p251, @p252, @p253, @p254, @p255, @p256, @p257, @p258, @p259, @p260, @p261, @p262, @p263, @p264, @p265, @p266, @p267, @p268, @p269, @p270, @p271, @p272, @p273, @p274, @p275, @p276, @p277, @p278, @p279, 4), (@p280, @p281, @p282, @p283, @p284, @p285, @p286, @p287, @p288, @p289, @p290, @p291, @p292, @p293, @p294, @p295, @p296, @p297, @p298, @p299, @p300, @p301, @p302, @p303, @p304, @p305, @p306, @p307, @p308, @p309, @p310, @p311, @p312, @p313, @p314, @p315, @p316, @p317, @p318, @p319, @p320, @p321, @p322, @p323, @p324, @p325, @p326, @p327, @p328, @p329, @p330, @p331, @p332, @p333, @p334, @p335, 5), (@p336, @p337, @p338, @p339, @p340, @p341, @p342, @p343, @p344, @p345, @p346, @p347, @p348, @p349, @p350, @p351, @p352, @p353, @p354, @p355, @p356, @p357, @p358, @p359, @p360, @p361, @p362, @p363, @p364, @p365, @p366, @p367, @p368, @p369, @p370, @p371, @p372, @p373, @p374, @p375, @p376, @p377, @p378, @p379, @p380, @p381, @p382, @p383, @p384, @p385, @p386, @p387, @p388, @p389, @p390, @p391, 6), (@p392, @p393, @p394, @p395, @p396, @p397, @p398, @p399, @p400, @p401, @p402, @p403, @p404, @p405, @p406, @p407, @p408, @p409, @p410, @p411, @p412, @p413, @p414, @p415, @p416, @p417, @p418, @p419, @p420, @p421, @p422, @p423, @p424, @p425, @p426, @p427, @p428, @p429, @p430, @p431, @p432, @p433, @p434, @p435, @p436, @p437, @p438, @p439, @p440, @p441, @p442, @p443, @p444, @p445, @p446, @p447, 7), (@p448, @p449, @p450, @p451, @p452, @p453, @p454, @p455, @p456, @p457, @p458, @p459, @p460, @p461, @p462, @p463, @p464, @p465, @p466, @p467, @p468, @p469, @p470, @p471, @p472, @p473, @p474, @p475, @p476, @p477, @p478, @p479, @p480, @p481, @p482, @p483, @p484, @p485, @p486, @p487, @p488, @p489, @p490, @p491, @p492, @p493, @p494, @p495, @p496, @p497, @p498, @p499, @p500, @p501, @p502, @p503, 8), (@p504, @p505, @p506, @p507, @p508, @p509, @p510, @p511, @p512, @p513, @p514, @p515, @p516, @p517, @p518, @p519, @p520, @p521, @p522, @p523, @p524, @p525, @p526, @p527, @p528, @p529, @p530, @p531, @p532, @p533, @p534, @p535, @p536, @p537, @p538, @p539, @p540, @p541, @p542, @p543, @p544, @p545, @p546, @p547, @p548, @p549, @p550, @p551, @p552, @p553, @p554, @p555, @p556, @p557, @p558, @p559, 9), (@p560, @p561, @p562, @p563, @p564, @p565, @p566, @p567, @p568, @p569, @p570, @p571, @p572, @p573, @p574, @p575, @p576, @p577, @p578, @p579, @p580, @p581, @p582, @p583, @p584, @p585, @p586, @p587, @p588, @p589, @p590, @p591, @p592, @p593, @p594, @p595, @p596, @p597, @p598, @p599, @p600, @p601, @p602, @p603, @p604, @p605, @p606, @p607, @p608, @p609, @p610, @p611, @p612, @p613, @p614, @p615, 10), (@p616, @p617, @p618, @p619, @p620, @p621, @p622, @p623, @p624, @p625, @p626, @p627, @p628, @p629, @p630, @p631, @p632, @p633, @p634, @p635, @p636, @p637, @p638, @p639, @p640, @p641, @p642, @p643, @p644, @p645, @p646, @p647, @p648, @p649, @p650, @p651, @p652, @p653, @p654, @p655, @p656, @p657, @p658, @p659, @p660, @p661, @p662, @p663, @p664, @p665, @p666, @p667, @p668, @p669, @p670, @p671, 11), (@p672, @p673, @p674, @p675, @p676, @p677, @p678, @p679, @p680, @p681, @p682, @p683, @p684, @p685, @p686, @p687, @p688, @p689, @p690, @p691, @p692, @p693, @p694, @p695, @p696, @p697, @p698, @p699, @p700, @p701, @p702, @p703, @p704, @p705, @p706, @p707, @p708, @p709, @p710, @p711, @p712, @p713, @p714, @p715, @p716, @p717, @p718, @p719, @p720, @p721, @p722, @p723, @p724, @p725, @p726, @p727, 12), (@p728, @p729, @p730, @p731, @p732, @p733, @p734, @p735, @p736, @p737, @p738, @p739, @p740, @p741, @p742, @p743, @p744, @p745, @p746, @p747, @p748, @p749, @p750, @p751, @p752, @p753, @p754, @p755, @p756, @p757, @p758, @p759, @p760, @p761, @p762, @p763, @p764, @p765, @p766, @p767, @p768, @p769, @p770, @p771, @p772, @p773, @p774, @p775, @p776, @p777, @p778, @p779, @p780, @p781, @p782, @p783, 13), (@p784, @p785, @p786, @p787, @p788, @p789, @p790, @p791, @p792, @p793, @p794, @p795, @p796, @p797, @p798, @p799, @p800, @p801, @p802, @p803, @p804, @p805, @p806, @p807, @p808, @p809, @p810, @p811, @p812, @p813, @p814, @p815, @p816, @p817, @p818, @p819, @p820, @p821, @p822, @p823, @p824, @p825, @p826, @p827, @p828, @p829, @p830, @p831, @p832, @p833, @p834, @p835, @p836, @p837, @p838, @p839, 14), (@p840, @p841, @p842, @p843, @p844, @p845, @p846, @p847, @p848, @p849, @p850, @p851, @p852, @p853, @p854, @p855, @p856, @p857, @p858, @p859, @p860, @p861, @p862, @p863, @p864, @p865, @p866, @p867, @p868, @p869, @p870, @p871, @p872, @p873, @p874, @p875, @p876, @p877, @p878, @p879, @p880, @p881, @p882, @p883, @p884, @p885, @p886, @p887, @p888, @p889, @p890, @p891, @p892, @p893, @p894, @p895, 15), (@p896, @p897, @p898, @p899, @p900, @p901, @p902, @p903, @p904, @p905, @p906, @p907, @p908, @p909, @p910, @p911, @p912, @p913, @p914, @p915, @p916, @p917, @p918, @p919, @p920, @p921, @p922, @p923, @p924, @p925, @p926, @p927, @p928, @p929, @p930, @p931, @p932, @p933, @p934, @p935, @p936, @p937, @p938, @p939, @p940, @p941, @p942, @p943, @p944, @p945, @p946, @p947, @p948, @p949, @p950, @p951, 16), (@p952, @p953, @p954, @p955, @p956, @p957, @p958, @p959, @p960, @p961, @p962, @p963, @p964, @p965, @p966, @p967, @p968, @p969, @p970, @p971, @p972, @p973, @p974, @p975, @p976, @p977, @p978, @p979, @p980, @p981, @p982, @p983, @p984, @p985, @p986, @p987, @p988, @p989, @p990, @p991, @p992, @p993, @p994, @p995, @p996, @p997, @p998, @p999, @p1000, @p1001, @p1002, @p1003, @p1004, @p1005, @p1006, @p1007, 17), (@p1008, @p1009, @p1010, @p1011, @p1012, @p1013, @p1014, @p1015, @p1016, @p1017, @p1018, @p1019, @p1020, @p1021, @p1022, @p1023, @p1024, @p1025, @p1026, @p1027, @p1028, @p1029, @p1030, @p1031, @p1032, @p1033, @p1034, @p1035, @p1036, @p1037, @p1038, @p1039, @p1040, @p1041, @p1042, @p1043, @p1044, @p1045, @p1046, @p1047, @p1048, @p1049, @p1050, @p1051, @p1052, @p1053, @p1054, @p1055, @p1056, @p1057, @p1058, @p1059, @p1060, @p1061, @p1062, @p1063, 18), (@p1064, @p1065, @p1066, @p1067, @p1068, @p1069, @p1070, @p1071, @p1072, @p1073, @p1074, @p1075, @p1076, @p1077, @p1078, @p1079, @p1080, @p1081, @p1082, @p1083, @p1084, @p1085, @p1086, @p1087, @p1088, @p1089, @p1090, @p1091, @p1092, @p1093, @p1094, @p1095, @p1096, @p1097, @p1098, @p1099, @p1100, @p1101, @p1102, @p1103, @p1104, @p1105, @p1106, @p1107, @p1108, @p1109, @p1110, @p1111, @p1112, @p1113, @p1114, @p1115, @p1116, @p1117, @p1118, @p1119, 19), (@p1120, @p1121, @p1122, @p1123, @p1124, @p1125, @p1126, @p1127, @p1128, @p1129, @p1130, @p1131, @p1132, @p1133, @p1134, @p1135, @p1136, @p1137, @p1138, @p1139, @p1140, @p1141, @p1142, @p1143, @p1144, @p1145, @p1146, @p1147, @p1148, @p1149, @p1150, @p1151, @p1152, @p1153, @p1154, @p1155, @p1156, @p1157, @p1158, @p1159, @p1160, @p1161, @p1162, @p1163, @p1164, @p1165, @p1166, @p1167, @p1168, @p1169, @p1170, @p1171, @p1172, @p1173, @p1174, @p1175, 20), (@p1176, @p1177, @p1178, @p1179, @p1180, @p1181, @p1182, @p1183, @p1184, @p1185, @p1186, @p1187, @p1188, @p1189, @p1190, @p1191, @p1192, @p1193, @p1194, @p1195, @p1196, @p1197, @p1198, @p1199, @p1200, @p1201, @p1202, @p1203, @p1204, @p1205, @p1206, @p1207, @p1208, @p1209, @p1210, @p1211, @p1212, @p1213, @p1214, @p1215, @p1216, @p1217, @p1218, @p1219, @p1220, @p1221, @p1222, @p1223, @p1224, @p1225, @p1226, @p1227, @p1228, @p1229, @p1230, @p1231, 21), (@p1232, @p1233, @p1234, @p1235, @p1236, @p1237, @p1238, @p1239, @p1240, @p1241, @p1242, @p1243, @p1244, @p1245, @p1246, @p1247, @p1248, @p1249, @p1250, @p1251, @p1252, @p1253, @p1254, @p1255, @p1256, @p1257, @p1258, @p1259, @p1260, @p1261, @p1262, @p1263, @p1264, @p1265, @p1266, @p1267, @p1268, @p1269, @p1270, @p1271, @p1272, @p1273, @p1274, @p1275, @p1276, @p1277, @p1278, @p1279, @p1280, @p1281, @p1282, @p1283, @p1284, @p1285, @p1286, @p1287, 22), (@p1288, @p1289, @p1290, @p1291, @p1292, @p1293, @p1294, @p1295, @p1296, @p1297, @p1298, @p1299, @p1300, @p1301, @p1302, @p1303, @p1304, @p1305, @p1306, @p1307, @p1308, @p1309, @p1310, @p1311, @p1312, @p1313, @p1314, @p1315, @p1316, @p1317, @p1318, @p1319, @p1320, @p1321, @p1322, @p1323, @p1324, @p1325, @p1326, @p1327, @p1328, @p1329, @p1330, @p1331, @p1332, @p1333, @p1334, @p1335, @p1336, @p1337, @p1338, @p1339, @p1340, @p1341, @p1342, @p1343, 23), (@p1344, @p1345, @p1346, @p1347, @p1348, @p1349, @p1350, @p1351, @p1352, @p1353, @p1354, @p1355, @p1356, @p1357, @p1358, @p1359, @p1360, @p1361, @p1362, @p1363, @p1364, @p1365, @p1366, @p1367, @p1368, @p1369, @p1370, @p1371, @p1372, @p1373, @p1374, @p1375, @p1376, @p1377, @p1378, @p1379, @p1380, @p1381, @p1382, @p1383, @p1384, @p1385, @p1386, @p1387, @p1388, @p1389, @p1390, @p1391, @p1392, @p1393, @p1394, @p1395, @p1396, @p1397, @p1398, @p1399, 24), (@p1400, @p1401, @p1402, @p1403, @p1404, @p1405, @p1406, @p1407, @p1408, @p1409, @p1410, @p1411, @p1412, @p1413, @p1414, @p1415, @p1416, @p1417, @p1418, @p1419, @p1420, @p1421, @p1422, @p1423, @p1424, @p1425, @p1426, @p1427, @p1428, @p1429, @p1430, @p1431, @p1432, @p1433, @p1434, @p1435, @p1436, @p1437, @p1438, @p1439, @p1440, @p1441, @p1442, @p1443, @p1444, @p1445, @p1446, @p1447, @p1448, @p1449, @p1450, @p1451, @p1452, @p1453, @p1454, @p1455, 25), (@p1456, @p1457, @p1458, @p1459, @p1460, @p1461, @p1462, @p1463, @p1464, @p1465, @p1466, @p1467, @p1468, @p1469, @p1470, @p1471, @p1472, @p1473, @p1474, @p1475, @p1476, @p1477, @p1478, @p1479, @p1480, @p1481, @p1482, @p1483, @p1484, @p1485, @p1486, @p1487, @p1488, @p1489, @p1490, @p1491, @p1492, @p1493, @p1494, @p1495, @p1496, @p1497, @p1498, @p1499, @p1500, @p1501, @p1502, @p1503, @p1504, @p1505, @p1506, @p1507, @p1508, @p1509, @p1510, @p1511, 26), (@p1512, @p1513, @p1514, @p1515, @p1516, @p1517, @p1518, @p1519, @p1520, @p1521, @p1522, @p1523, @p1524, @p1525, @p1526, @p1527, @p1528, @p1529, @p1530, @p1531, @p1532, @p1533, @p1534, @p1535, @p1536, @p1537, @p1538, @p1539, @p1540, @p1541, @p1542, @p1543, @p1544, @p1545, @p1546, @p1547, @p1548, @p1549, @p1550, @p1551, @p1552, @p1553, @p1554, @p1555, @p1556, @p1557, @p1558, @p1559, @p1560, @p1561, @p1562, @p1563, @p1564, @p1565, @p1566, @p1567, 27), (@p1568, @p1569, @p1570, @p1571, @p1572, @p1573, @p1574, @p1575, @p1576, @p1577, @p1578, @p1579, @p1580, @p1581, @p1582, @p1583, @p1584, @p1585, @p1586, @p1587, @p1588, @p1589, @p1590, @p1591, @p1592, @p1593, @p1594, @p1595, @p1596, @p1597, @p1598, @p1599, @p1600, @p1601, @p1602, @p1603, @p1604, @p1605, @p1606, @p1607, @p1608, @p1609, @p1610, @p1611, @p1612, @p1613, @p1614, @p1615, @p1616, @p1617, @p1618, @p1619, @p1620, @p1621, @p1622, @p1623, 28), (@p1624, @p1625, @p1626, @p1627, @p1628, @p1629, @p1630, @p1631, @p1632, @p1633, @p1634, @p1635, @p1636, @p1637, @p1638, @p1639, @p1640, @p1641, @p1642, @p1643, @p1644, @p1645, @p1646, @p1647, @p1648, @p1649, @p1650, @p1651, @p1652, @p1653, @p1654, @p1655, @p1656, @p1657, @p1658, @p1659, @p1660, @p1661, @p1662, @p1663, @p1664, @p1665, @p1666, @p1667, @p1668, @p1669, @p1670, @p1671, @p1672, @p1673, @p1674, @p1675, @p1676, @p1677, @p1678, @p1679, 29), (@p1680, @p1681, @p1682, @p1683, @p1684, @p1685, @p1686, @p1687, @p1688, @p1689, @p1690, @p1691, @p1692, @p1693, @p1694, @p1695, @p1696, @p1697, @p1698, @p1699, @p1700, @p1701, @p1702, @p1703, @p1704, @p1705, @p1706, @p1707, @p1708, @p1709, @p1710, @p1711, @p1712, @p1713, @p1714, @p1715, @p1716, @p1717, @p1718, @p1719, @p1720, @p1721, @p1722, @p1723, @p1724, @p1725, @p1726, @p1727, @p1728, @p1729, @p1730, @p1731, @p1732, @p1733, @p1734, @p1735, 30), (@p1736, @p1737, @p1738, @p1739, @p1740, @p1741, @p1742, @p1743, @p1744, @p1745, @p1746, @p1747, @p1748, @p1749, @p1750, @p1751, @p1752, @p1753, @p1754, @p1755, @p1756, @p1757, @p1758, @p1759, @p1760, @p1761, @p1762, @p1763, @p1764, @p1765, @p1766, @p1767, @p1768, @p1769, @p1770, @p1771, @p1772, @p1773, @p1774, @p1775, @p1776, @p1777, @p1778, @p1779, @p1780, @p1781, @p1782, @p1783, @p1784, @p1785, @p1786, @p1787, @p1788, @p1789, @p1790, @p1791, 31), (@p1792, @p1793, @p1794, @p1795, @p1796, @p1797, @p1798, @p1799, @p1800, @p1801, @p1802, @p1803, @p1804, @p1805, @p1806, @p1807, @p1808, @p1809, @p1810, @p1811, @p1812, @p1813, @p1814, @p1815, @p1816, @p1817, @p1818, @p1819, @p1820, @p1821, @p1822, @p1823, @p1824, @p1825, @p1826, @p1827, @p1828, @p1829, @p1830, @p1831, @p1832, @p1833, @p1834, @p1835, @p1836, @p1837, @p1838, @p1839, @p1840, @p1841, @p1842, @p1843, @p1844, @p1845, @p1846, @p1847, 32), (@p1848, @p1849, @p1850, @p1851, @p1852, @p1853, @p1854, @p1855, @p1856, @p1857, @p1858, @p1859, @p1860, @p1861, @p1862, @p1863, @p1864, @p1865, @p1866, @p1867, @p1868, @p1869, @p1870, @p1871, @p1872, @p1873, @p1874, @p1875, @p1876, @p1877, @p1878, @p1879, @p1880, @p1881, @p1882, @p1883, @p1884, @p1885, @p1886, @p1887, @p1888, @p1889, @p1890, @p1891, @p1892, @p1893, @p1894, @p1895, @p1896, @p1897, @p1898, @p1899, @p1900, @p1901, @p1902, @p1903, 33), (@p1904, @p1905, @p1906, @p1907, @p1908, @p1909, @p1910, @p1911, @p1912, @p1913, @p1914, @p1915, @p1916, @p1917, @p1918, @p1919, @p1920, @p1921, @p1922, @p1923, @p1924, @p1925, @p1926, @p1927, @p1928, @p1929, @p1930, @p1931, @p1932, @p1933, @p1934, @p1935, @p1936, @p1937, @p1938, @p1939, @p1940, @p1941, @p1942, @p1943, @p1944, @p1945, @p1946, @p1947, @p1948, @p1949, @p1950, @p1951, @p1952, @p1953, @p1954, @p1955, @p1956, @p1957, @p1958, @p1959, 34), (@p1960, @p1961, @p1962, @p1963, @p1964, @p1965, @p1966, @p1967, @p1968, @p1969, @p1970, @p1971, @p1972, @p1973, @p1974, @p1975, @p1976, @p1977, @p1978, @p1979, @p1980, @p1981, @p1982, @p1983, @p1984, @p1985, @p1986, @p1987, @p1988, @p1989, @p1990, @p1991, @p1992, @p1993, @p1994, @p1995, @p1996, @p1997, @p1998, @p1999, @p2000, @p2001, @p2002, @p2003, @p2004, @p2005, @p2006, @p2007, @p2008, @p2009, @p2010, @p2011, @p2012, @p2013, @p2014, @p2015, 35), (@p2016, @p2017, @p2018, @p2019, @p2020, @p2021, @p2022, @p2023, @p2024, @p2025, @p2026, @p2027, @p2028, @p2029, @p2030, @p2031, @p2032, @p2033, @p2034, @p2035, @p2036, @p2037, @p2038, @p2039, @p2040, @p2041, @p2042, @p2043, @p2044, @p2045, @p2046, @p2047, @p2048, @p2049, @p2050, @p2051, @p2052, @p2053, @p2054, @p2055, @p2056, @p2057, @p2058, @p2059, @p2060, @p2061, @p2062, @p2063, @p2064, @p2065, @p2066, @p2067, @p2068, @p2069, @p2070, @p2071, 36)) AS i ([addressee_cntry_cd], [addressee_city], [addressee_district], [addressee_email], [addressee_full_address], [addressee_home_address], [addressee_name], [addressee_postcode], [addressee_province], [addressee_subdistrict], [addressee_tel], [create_table], [delivery_code], [delivery_recipient_name], [delivery_relation_id], [delivery_status_id], [dest_outlet_id], [dest_outlet_port], [document_number], [item_barcode], [item_cod], [item_gross_weight], [item_height], [item_length], [item_price], [item_width], [lat], [log_id], [long], [outlet_id], [outlet_port], [podUrl], [remark], [scan_cntry_cd], [scan_cntry_postcode], [sender_cntry_cd], [sender_district], [sender_email], [sender_full_address], [sender_home_address], [member_id], [sender_name], [sender_postcode], [sender_province], [sender_subdistrict], [sender_tel], [server_id], [signatureUrl], [state], [status_code], [status_dtm], [timestamp], [transmit_dtm], [user_id], [wckt_id], [wkstn_no], _Position) ON 1=0 WHEN NOT MATCHED THEN INSERT ([addressee_cntry_cd], [addressee_city], [addressee_district], [addressee_email], [addressee_full_address], [addressee_home_address], [addressee_name], [addressee_postcode], [addressee_province], [addressee_subdistrict], [addressee_tel], [create_table], [delivery_code], [delivery_recipient_name], [delivery_relation_id], [delivery_status_id], [dest_outlet_id], [dest_outlet_port], [document_number], [item_barcode], [item_cod], [item_gross_weight], [item_height], [item_length], [item_price], [item_width], [lat], [log_id], [long], [outlet_id], [outlet_port], [podUrl], [remark], [scan_cntry_cd], [scan_cntry_postcode], [sender_cntry_cd], [sender_district], [sender_email], [sender_full_address], [sender_home_address], [member_id], [sender_name], [sender_postcode], [sender_province], [sender_subdistrict], [sender_tel], [server_id], [signatureUrl], [state], [status_code], [status_dtm], [timestamp], [transmit_dtm], [user_id], [wckt_id], [wkstn_no]) VALUES (i.[addressee_cntry_cd], i.[addressee_city], i.[addressee_district], i.[addressee_email], i.[addressee_full_address], i.[addressee_home_address], i.[addressee_name], i.[addressee_postcode], i.[addressee_province], i.[addressee_subdistrict], i.[addressee_tel], i.[create_table], i.[delivery_code], i.[delivery_recipient_name], i.[delivery_relation_id], i.[delivery_status_id], i.[dest_outlet_id], i.[dest_outlet_port], i.[document_number], i.[item_barcode], i.[item_cod], i.[item_gross_weight], i.[item_height], i.[item_length], i.[item_price], i.[item_width], i.[lat], i.[log_id], i.[long], i.[outlet_id], i.[outlet_port], i.[podUrl], i.[remark], i.[scan_cntry_cd], i.[scan_cntry_postcode], i.[sender_cntry_cd], i.[sender_district], i.[sender_email], i.[sender_full_address], i.[sender_home_address], i.[member_id], i.[sender_name], i.[sender_postcode], i.[sender_province], i.[sender_subdistrict], i.[sender_tel], i.[server_id], i.[signatureUrl], i.[state], i.[status_code], i.[status_dtm], i.[timestamp], i.[transmit_dtm], i.[user_id], i.[wckt_id], i.[wkstn_no]) OUTPUT INSERTED.[item_id], i._Position INTO @inserted0;  SELECT [t].[item_id] FROM [raw_data] t INNER JOIN @inserted0 i ON ([t].[item_id] = [i].[item_id]) ORDER BY [i].[_Position];  ",4,4,0,430,10,4
"(@p0 nvarchar(4000),@p1 nvarchar(4000),@p2 nvarchar(4000),@p3 nvarchar(4000),@p4 nvarchar(4000),@p5 nvarchar(4000),@p6 nvarchar(4000),@p7 nvarchar(4000),@p8 nvarchar(4000),@p9 nvarchar(4000),@p10 nvarchar(4000),@p11 datetime2(7),@p12 nvarchar(4000),@p13 nvarchar(4000),@p14 int,@p15 int,@p16 int,@p17 nvarchar(4000),@p18 nvarchar(4000),@p19 nvarchar(4000),@p20 decimal(18,2),@p21 decimal(18,2),@p22 nvarchar(4000),@p23 nvarchar(4000),@p24 decimal(18,2),@p25 nvarchar(4000),@p26 nvarchar(4000),@p27 nvarchar(4000),@p28 nvarchar(4000),@p29 int,@p30 nvarchar(4000),@p31 nvarchar(4000),@p32 nvarchar(4000),@p33 nvarchar(4000),@p34 nvarchar(4000),@p35 nvarchar(4000),@p36 nvarchar(4000),@p37 nvarchar(4000),@p38 nvarchar(4000),@p39 nvarchar(4000),@p40 int,@p41 nvarchar(4000),@p42 nvarchar(4000),@p43 nvarchar(4000),@p44 nvarchar(4000),@p45 nvarchar(4000),@p46 int,@p47 nvarchar(4000),@p48 int,@p49 int,@p50 datetime2(7),@p51 datetime2(7),@p52 datetime2(7),@p53 nvarchar(4000),@p54 nvarchar(4000),@p55 nvarchar(4000),@p56 nvarchar(4000),@p57 nvarchar(4000),@p58 nvarchar(4000),@p59 nvarchar(4000),@p60 nvarchar(4000),@p61 nvarchar(4000),@p62 nvarchar(4000),@p63 nvarchar(4000),@p64 nvarchar(4000),@p65 nvarchar(4000),@p66 nvarchar(4000),@p67 datetime2(7),@p68 nvarchar(4000),@p69 nvarchar(4000),@p70 int,@p71 int,@p72 int,@p73 nvarchar(4000),@p74 nvarchar(4000),@p75 nvarchar(4000),@p76 decimal(18,2),@p77 decimal(18,2),@p78 nvarchar(4000),@p79 nvarchar(4000),@p80 decimal(18,2),@p81 nvarchar(4000),@p82 nvarchar(4000),@p83 nvarchar(4000),@p84 nvarchar(4000),@p85 int,@p86 nvarchar(4000),@p87 nvarchar(4000),@p88 nvarchar(4000),@p89 nvarchar(4000),@p90 nvarchar(4000),@p91 nvarchar(4000),@p92 nvarchar(4000),@p93 nvarchar(4000),@p94 nvarchar(4000),@p95 nvarchar(4000),@p96 int,@p97 nvarchar(4000),@p98 nvarchar(4000),@p99 nvarchar(4000),@p100 nvarchar(4000),@p101 nvarchar(4000),@p102 int,@p103 nvarchar(4000),@p104 int,@p105 int,@p106 datetime2(7),@p107 datetime2(7),@p108 datetime2(7),@p109 nvarchar(4000),@p110 nvarchar(4000),@p111 nvarchar(4000),@p112 nvarchar(4000),@p113 nvarchar(4000),@p114 nvarchar(4000),@p115 nvarchar(4000),@p116 nvarchar(4000),@p117 nvarchar(4000),@p118 nvarchar(4000),@p119 nvarchar(4000),@p120 nvarchar(4000),@p121 nvarchar(4000),@p122 nvarchar(4000),@p123 datetime2(7),@p124 nvarchar(4000),@p125 nvarchar(4000),@p126 int,@p127 int,@p128 int,@p129 nvarchar(4000),@p130 nvarchar(4000),@p131 nvarchar(4000),@p132 nvarchar(4000),@p133 decimal(18,2),@p134 nvarchar(4000),@p135 nvarchar(4000),@p136 decimal(18,2),@p137 nvarchar(4000),@p138 nvarchar(4000),@p139 nvarchar(4000),@p140 nvarchar(4000),@p141 int,@p142 nvarchar(4000),@p143 nvarchar(4000),@p144 nvarchar(4000),@p145 nvarchar(4000),@p146 nvarchar(4000),@p147 nvarchar(4000),@p148 nvarchar(4000),@p149 nvarchar(4000),@p150 nvarchar(4000),@p151 nvarchar(4000),@p152 int,@p153 nvarchar(4000),@p154 nvarchar(4000),@p155 nvarchar(4000),@p156 nvarchar(4000),@p157 nvarchar(4000),@p158 int,@p159 nvarchar(4000),@p160 int,@p161 int,@p162 datetime2(7),@p163 datetime2(7),@p164 datetime2(7),@p165 nvarchar(4000),@p166 nvarchar(4000),@p167 nvarchar(4000),@p168 nvarchar(4000),@p169 nvarchar(4000),@p170 nvarchar(4000),@p171 nvarchar(4000),@p172 nvarchar(4000),@p173 nvarchar(4000),@p174 nvarchar(4000),@p175 nvarchar(4000),@p176 nvarchar(4000),@p177 nvarchar(4000),@p178 nvarchar(4000),@p179 datetime2(7),@p180 nvarchar(4000),@p181 nvarchar(4000),@p182 int,@p183 int,@p184 int,@p185 nvarchar(4000),@p186 nvarchar(4000),@p187 nvarchar(4000),@p188 decimal(18,2),@p189 decimal(18,2),@p190 nvarchar(4000),@p191 nvarchar(4000),@p192 decimal(18,2),@p193 nvarchar(4000),@p194 nvarchar(4000),@p195 nvarchar(4000),@p196 nvarchar(4000),@p197 int,@p198 nvarchar(4000),@p199 nvarchar(4000),@p200 nvarchar(4000),@p201 nvarchar(4000),@p202 nvarchar(4000),@p203 nvarchar(4000),@p204 nvarchar(4000),@p205 nvarchar(4000),@p206 nvarchar(4000),@p207 nvarchar(4000),@p208 int,@p209 nvarchar(4000),@p210 nvarchar(4000),@p211 nvarchar(4000),@p212 nvarchar(4000),@p213 nvarchar(4000),@p214 int,@p215 nvarchar(4000),@p216 int,@p217 int,@p218 datetime2(7),@p219 datetime2(7),@p220 datetime2(7),@p221 nvarchar(4000),@p222 nvarchar(4000),@p223 nvarchar(4000),@p224 nvarchar(4000),@p225 nvarchar(4000),@p226 nvarchar(4000),@p227 nvarchar(4000),@p228 nvarchar(4000),@p229 nvarchar(4000),@p230 nvarchar(4000),@p231 nvarchar(4000),@p232 nvarchar(4000),@p233 nvarchar(4000),@p234 nvarchar(4000),@p235 datetime2(7),@p236 nvarchar(4000),@p237 nvarchar(4000),@p238 int,@p239 int,@p240 int,@p241 nvarchar(4000),@p242 nvarchar(4000),@p243 nvarchar(4000),@p244 decimal(18,2),@p245 decimal(18,2),@p246 nvarchar(4000),@p247 nvarchar(4000),@p248 decimal(18,2),@p249 nvarchar(4000),@p250 nvarchar(4000),@p251 nvarchar(4000),@p252 nvarchar(4000),@p253 int,@p254 nvarchar(4000),@p255 nvarchar(4000),@p256 nvarchar(4000),@p257 nvarchar(4000),@p258 nvarchar(4000),@p259 nvarchar(4000),@p260 nvarchar(4000),@p261 nvarchar(4000),@p262 nvarchar(4000),@p263 nvarchar(4000),@p264 int,@p265 nvarchar(4000),@p266 nvarchar(4000),@p267 nvarchar(4000),@p268 nvarchar(4000),@p269 nvarchar(4000),@p270 int,@p271 nvarchar(4000),@p272 int,@p273 int,@p274 datetime2(7),@p275 datetime2(7),@p276 datetime2(7),@p277 nvarchar(4000),@p278 nvarchar(4000),@p279 nvarchar(4000),@p280 nvarchar(4000),@p281 nvarchar(4000),@p282 nvarchar(4000),@p283 nvarchar(4000),@p284 nvarchar(4000),@p285 nvarchar(4000),@p286 nvarchar(4000),@p287 nvarchar(4000),@p288 nvarchar(4000),@p289 nvarchar(4000),@p290 nvarchar(4000),@p291 datetime2(7),@p292 nvarchar(4000),@p293 nvarchar(4000),@p294 int,@p295 int,@p296 int,@p297 nvarchar(4000),@p298 nvarchar(4000),@p299 nvarchar(4000),@p300 decimal(18,2),@p301 decimal(18,2),@p302 nvarchar(4000),@p303 nvarchar(4000),@p304 decimal(18,2),@p305 nvarchar(4000),@p306 nvarchar(4000),@p307 nvarchar(4000),@p308 nvarchar(4000),@p309 int,@p310 nvarchar(4000),@p311 nvarchar(4000),@p312 nvarchar(4000),@p313 nvarchar(4000),@p314 nvarchar(4000),@p315 nvarchar(4000),@p316 nvarchar(4000),@p317 nvarchar(4000),@p318 nvarchar(4000),@p319 nvarchar(4000),@p320 int,@p321 nvarchar(4000),@p322 nvarchar(4000),@p323 nvarchar(4000),@p324 nvarchar(4000),@p325 nvarchar(4000),@p326 int,@p327 nvarchar(4000),@p328 int,@p329 int,@p330 datetime2(7),@p331 datetime2(7),@p332 datetime2(7),@p333 nvarchar(4000),@p334 nvarchar(4000),@p335 nvarchar(4000),@p336 nvarchar(4000),@p337 nvarchar(4000),@p338 nvarchar(4000),@p339 nvarchar(4000),@p340 nvarchar(4000),@p341 nvarchar(4000),@p342 nvarchar(4000),@p343 nvarchar(4000),@p344 nvarchar(4000),@p345 nvarchar(4000),@p346 nvarchar(4000),@p347 datetime2(7),@p348 nvarchar(4000),@p349 nvarchar(4000),@p350 int,@p351 int,@p352 int,@p353 nvarchar(4000),@p354 nvarchar(4000),@p355 nvarchar(4000),@p356 decimal(18,2),@p357 decimal(18,2),@p358 nvarchar(4000),@p359 nvarchar(4000),@p360 decimal(18,2),@p361 nvarchar(4000),@p362 nvarchar(4000),@p363 nvarchar(4000),@p364 nvarchar(4000),@p365 int,@p366 nvarchar(4000),@p367 nvarchar(4000),@p368 nvarchar(4000),@p369 nvarchar(4000),@p370 nvarchar(4000),@p371 nvarchar(4000),@p372 nvarchar(4000),@p373 nvarchar(4000),@p374 nvarchar(4000),@p375 nvarchar(4000),@p376 int,@p377 nvarchar(4000),@p378 nvarchar(4000),@p379 nvarchar(4000),@p380 nvarchar(4000),@p381 nvarchar(4000),@p382 int,@p383 nvarchar(4000),@p384 int,@p385 int,@p386 datetime2(7),@p387 datetime2(7),@p388 datetime2(7),@p389 nvarchar(4000),@p390 nvarchar(4000),@p391 nvarchar(4000),@p392 nvarchar(4000),@p393 nvarchar(4000),@p394 nvarchar(4000),@p395 nvarchar(4000),@p396 nvarchar(4000),@p397 nvarchar(4000),@p398 nvarchar(4000),@p399 nvarchar(4000),@p400 nvarchar(4000),@p401 nvarchar(4000),@p402 nvarchar(4000),@p403 datetime2(7),@p404 nvarchar(4000),@p405 nvarchar(4000),@p406 int,@p407 int,@p408 int,@p409 nvarchar(4000),@p410 nvarchar(4000),@p411 nvarchar(4000),@p412 decimal(18,2),@p413 decimal(18,2),@p414 nvarchar(4000),@p415 nvarchar(4000),@p416 decimal(18,2),@p417 nvarchar(4000),@p418 nvarchar(4000),@p419 nvarchar(4000),@p420 nvarchar(4000),@p421 int,@p422 nvarchar(4000),@p423 nvarchar(4000),@p424 nvarchar(4000),@p425 nvarchar(4000),@p426 nvarchar(4000),@p427 nvarchar(4000),@p428 nvarchar(4000),@p429 nvarchar(4000),@p430 nvarchar(4000),@p431 nvarchar(4000),@p432 int,@p433 nvarchar(4000),@p434 nvarchar(4000),@p435 nvarchar(4000),@p436 nvarchar(4000),@p437 nvarchar(4000),@p438 int,@p439 nvarchar(4000),@p440 int,@p441 int,@p442 datetime2(7),@p443 datetime2(7),@p444 datetime2(7),@p445 nvarchar(4000),@p446 nvarchar(4000),@p447 nvarchar(4000),@p448 nvarchar(4000),@p449 nvarchar(4000),@p450 nvarchar(4000),@p451 nvarchar(4000),@p452 nvarchar(4000),@p453 nvarchar(4000),@p454 nvarchar(4000),@p455 nvarchar(4000),@p456 nvarchar(4000),@p457 nvarchar(4000),@p458 nvarchar(4000),@p459 datetime2(7),@p460 nvarchar(4000),@p461 nvarchar(4000),@p462 int,@p463 int,@p464 int,@p465 nvarchar(4000),@p466 nvarchar(4000),@p467 nvarchar(4000),@p468 decimal(18,2),@p469 decimal(18,2),@p470 nvarchar(4000),@p471 nvarchar(4000),@p472 decimal(18,2),@p473 nvarchar(4000),@p474 nvarchar(4000),@p475 nvarchar(4000),@p476 nvarchar(4000),@p477 int,@p478 nvarchar(4000),@p479 nvarchar(4000),@p480 nvarchar(4000),@p481 nvarchar(4000),@p482 nvarchar(4000),@p483 nvarchar(4000),@p484 nvarchar(4000),@p485 nvarchar(4000),@p486 nvarchar(4000),@p487 nvarchar(4000),@p488 int,@p489 nvarchar(4000),@p490 nvarchar(4000),@p491 nvarchar(4000),@p492 nvarchar(4000),@p493 nvarchar(4000),@p494 int,@p495 nvarchar(4000),@p496 int,@p497 int,@p498 datetime2(7),@p499 datetime2(7),@p500 datetime2(7),@p501 nvarchar(4000),@p502 nvarchar(4000),@p503 nvarchar(4000),@p504 nvarchar(4000),@p505 nvarchar(4000),@p506 nvarchar(4000),@p507 nvarchar(4000),@p508 nvarchar(4000),@p509 nvarchar(4000),@p510 nvarchar(4000),@p511 nvarchar(4000),@p512 nvarchar(4000),@p513 nvarchar(4000),@p514 nvarchar(4000),@p515 datetime2(7),@p516 nvarchar(4000),@p517 nvarchar(4000),@p518 int,@p519 int,@p520 int,@p521 nvarchar(4000),@p522 nvarchar(4000),@p523 nvarchar(4000),@p524 decimal(18,2),@p525 decimal(18,2),@p526 nvarchar(4000),@p527 nvarchar(4000),@p528 decimal(18,2),@p529 nvarchar(4000),@p530 nvarchar(4000),@p531 nvarchar(4000),@p532 nvarchar(4000),@p533 int,@p534 nvarchar(4000),@p535 nvarchar(4000),@p536 nvarchar(4000),@p537 nvarchar(4000),@p538 nvarchar(4000),@p539 nvarchar(4000),@p540 nvarchar(4000),@p541 nvarchar(4000),@p542 nvarchar(4000),@p543 nvarchar(4000),@p544 int,@p545 nvarchar(4000),@p546 nvarchar(4000),@p547 nvarchar(4000),@p548 nvarchar(4000),@p549 nvarchar(4000),@p550 int,@p551 nvarchar(4000),@p552 int,@p553 int,@p554 datetime2(7),@p555 datetime2(7),@p556 datetime2(7),@p557 nvarchar(4000),@p558 nvarchar(4000),@p559 nvarchar(4000),@p560 nvarchar(4000),@p561 nvarchar(4000),@p562 nvarchar(4000),@p563 nvarchar(4000),@p564 nvarchar(4000),@p565 nvarchar(4000),@p566 nvarchar(4000),@p567 nvarchar(4000),@p568 nvarchar(4000),@p569 nvarchar(4000),@p570 nvarchar(4000),@p571 datetime2(7),@p572 nvarchar(4000),@p573 nvarchar(4000),@p574 int,@p575 int,@p576 int,@p577 nvarchar(4000),@p578 nvarchar(4000),@p579 nvarchar(4000),@p580 decimal(18,2),@p581 decimal(18,2),@p582 nvarchar(4000),@p583 nvarchar(4000),@p584 decimal(18,2),@p585 nvarchar(4000),@p586 nvarchar(4000),@p587 nvarchar(4000),@p588 nvarchar(4000),@p589 int,@p590 nvarchar(4000),@p591 nvarchar(4000),@p592 nvarchar(4000),@p593 nvarchar(4000),@p594 nvarchar(4000),@p595 nvarchar(4000),@p596 nvarchar(4000),@p597 nvarchar(4000),@p598 nvarchar(4000),@p599 nvarchar(4000),@p600 int,@p601 nvarchar(4000),@p602 nvarchar(4000),@p603 nvarchar(4000),@p604 nvarchar(4000),@p605 nvarchar(4000),@p606 int,@p607 nvarchar(4000),@p608 int,@p609 int,@p610 datetime2(7),@p611 datetime2(7),@p612 datetime2(7),@p613 nvarchar(4000),@p614 nvarchar(4000),@p615 nvarchar(4000),@p616 nvarchar(4000),@p617 nvarchar(4000),@p618 nvarchar(4000),@p619 nvarchar(4000),@p620 nvarchar(4000),@p621 nvarchar(4000),@p622 nvarchar(4000),@p623 nvarchar(4000),@p624 nvarchar(4000),@p625 nvarchar(4000),@p626 nvarchar(4000),@p627 datetime2(7),@p628 nvarchar(4000),@p629 nvarchar(4000),@p630 int,@p631 int,@p632 int,@p633 nvarchar(4000),@p634 nvarchar(4000),@p635 nvarchar(4000),@p636 nvarchar(4000),@p637 decimal(18,2),@p638 nvarchar(4000),@p639 nvarchar(4000),@p640 decimal(18,2),@p641 nvarchar(4000),@p642 nvarchar(4000),@p643 nvarchar(4000),@p644 nvarchar(4000),@p645 int,@p646 nvarchar(4000),@p647 nvarchar(4000),@p648 nvarchar(4000),@p649 nvarchar(4000),@p650 nvarchar(4000),@p651 nvarchar(4000),@p652 nvarchar(4000),@p653 nvarchar(4000),@p654 nvarchar(4000),@p655 nvarchar(4000),@p656 int,@p657 nvarchar(4000),@p658 nvarchar(4000),@p659 nvarchar(4000),@p660 nvarchar(4000),@p661 nvarchar(4000),@p662 int,@p663 nvarchar(4000),@p664 int,@p665 int,@p666 datetime2(7),@p667 datetime2(7),@p668 datetime2(7),@p669 nvarchar(4000),@p670 nvarchar(4000),@p671 nvarchar(4000),@p672 nvarchar(4000),@p673 nvarchar(4000),@p674 nvarchar(4000),@p675 nvarchar(4000),@p676 nvarchar(4000),@p677 nvarchar(4000),@p678 nvarchar(4000),@p679 nvarchar(4000),@p680 nvarchar(4000),@p681 nvarchar(4000),@p682 nvarchar(4000),@p683 datetime2(7),@p684 nvarchar(4000),@p685 nvarchar(4000),@p686 int,@p687 int,@p688 int,@p689 nvarchar(4000),@p690 nvarchar(4000),@p691 nvarchar(4000),@p692 nvarchar(4000),@p693 decimal(18,2),@p694 nvarchar(4000),@p695 nvarchar(4000),@p696 decimal(18,2),@p697 nvarchar(4000),@p698 nvarchar(4000),@p699 nvarchar(4000),@p700 nvarchar(4000),@p701 int,@p702 nvarchar(4000),@p703 nvarchar(4000),@p704 nvarchar(4000),@p705 nvarchar(4000),@p706 nvarchar(4000),@p707 nvarchar(4000),@p708 nvarchar(4000),@p709 nvarchar(4000),@p710 nvarchar(4000),@p711 nvarchar(4000),@p712 int,@p713 nvarchar(4000),@p714 nvarchar(4000),@p715 nvarchar(4000),@p716 nvarchar(4000),@p717 nvarchar(4000),@p718 int,@p719 nvarchar(4000),@p720 int,@p721 int,@p722 datetime2(7),@p723 datetime2(7),@p724 datetime2(7),@p725 nvarchar(4000),@p726 nvarchar(4000),@p727 nvarchar(4000),@p728 nvarchar(4000),@p729 nvarchar(4000),@p730 nvarchar(4000),@p731 nvarchar(4000),@p732 nvarchar(4000),@p733 nvarchar(4000),@p734 nvarchar(4000),@p735 nvarchar(4000),@p736 nvarchar(4000),@p737 nvarchar(4000),@p738 nvarchar(4000),@p739 datetime2(7),@p740 nvarchar(4000),@p741 nvarchar(4000),@p742 int,@p743 int,@p744 int,@p745 nvarchar(4000),@p746 nvarchar(4000),@p747 nvarchar(4000),@p748 decimal(18,2),@p749 decimal(18,2),@p750 nvarchar(4000),@p751 nvarchar(4000),@p752 decimal(18,2),@p753 nvarchar(4000),@p754 nvarchar(4000),@p755 nvarchar(4000),@p756 nvarchar(4000),@p757 int,@p758 nvarchar(4000),@p759 nvarchar(4000),@p760 nvarchar(4000),@p761 nvarchar(4000),@p762 nvarchar(4000),@p763 nvarchar(4000),@p764 nvarchar(4000),@p765 nvarchar(4000),@p766 nvarchar(4000),@p767 nvarchar(4000),@p768 int,@p769 nvarchar(4000),@p770 nvarchar(4000),@p771 nvarchar(4000),@p772 nvarchar(4000),@p773 nvarchar(4000),@p774 int,@p775 nvarchar(4000),@p776 int,@p777 int,@p778 datetime2(7),@p779 datetime2(7),@p780 datetime2(7),@p781 nvarchar(4000),@p782 nvarchar(4000),@p783 nvarchar(4000),@p784 nvarchar(4000),@p785 nvarchar(4000),@p786 nvarchar(4000),@p787 nvarchar(4000),@p788 nvarchar(4000),@p789 nvarchar(4000),@p790 nvarchar(4000),@p791 nvarchar(4000),@p792 nvarchar(4000),@p793 nvarchar(4000),@p794 nvarchar(4000),@p795 datetime2(7),@p796 nvarchar(4000),@p797 nvarchar(4000),@p798 int,@p799 int,@p800 int,@p801 nvarchar(4000),@p802 nvarchar(4000),@p803 nvarchar(4000),@p804 decimal(18,2),@p805 decimal(18,2),@p806 nvarchar(4000),@p807 nvarchar(4000),@p808 decimal(18,2),@p809 nvarchar(4000),@p810 nvarchar(4000),@p811 nvarchar(4000),@p812 nvarchar(4000),@p813 int,@p814 nvarchar(4000),@p815 nvarchar(4000),@p816 nvarchar(4000),@p817 nvarchar(4000),@p818 nvarchar(4000),@p819 nvarchar(4000),@p820 nvarchar(4000),@p821 nvarchar(4000),@p822 nvarchar(4000),@p823 nvarchar(4000),@p824 int,@p825 nvarchar(4000),@p826 nvarchar(4000),@p827 nvarchar(4000),@p828 nvarchar(4000),@p829 nvarchar(4000),@p830 int,@p831 nvarchar(4000),@p832 int,@p833 int,@p834 datetime2(7),@p835 datetime2(7),@p836 datetime2(7),@p837 nvarchar(4000),@p838 nvarchar(4000),@p839 nvarchar(4000),@p840 nvarchar(4000),@p841 nvarchar(4000),@p842 nvarchar(4000),@p843 nvarchar(4000),@p844 nvarchar(4000),@p845 nvarchar(4000),@p846 nvarchar(4000),@p847 nvarchar(4000),@p848 nvarchar(4000),@p849 nvarchar(4000),@p850 nvarchar(4000),@p851 datetime2(7),@p852 nvarchar(4000),@p853 nvarchar(4000),@p854 int,@p855 int,@p856 int,@p857 nvarchar(4000),@p858 nvarchar(4000),@p859 nvarchar(4000),@p860 decimal(18,2),@p861 decimal(18,2),@p862 nvarchar(4000),@p863 nvarchar(4000),@p864 decimal(18,2),@p865 nvarchar(4000),@p866 nvarchar(4000),@p867 nvarchar(4000),@p868 nvarchar(4000),@p869 int,@p870 nvarchar(4000),@p871 nvarchar(4000),@p872 nvarchar(4000),@p873 nvarchar(4000),@p874 nvarchar(4000),@p875 nvarchar(4000),@p876 nvarchar(4000),@p877 nvarchar(4000),@p878 nvarchar(4000),@p879 nvarchar(4000),@p880 int,@p881 nvarchar(4000),@p882 nvarchar(4000),@p883 nvarchar(4000),@p884 nvarchar(4000),@p885 nvarchar(4000),@p886 int,@p887 nvarchar(4000),@p888 int,@p889 int,@p890 datetime2(7),@p891 datetime2(7),@p892 datetime2(7),@p893 nvarchar(4000),@p894 nvarchar(4000),@p895 nvarchar(4000),@p896 nvarchar(4000),@p897 nvarchar(4000),@p898 nvarchar(4000),@p899 nvarchar(4000),@p900 nvarchar(4000),@p901 nvarchar(4000),@p902 nvarchar(4000),@p903 nvarchar(4000),@p904 nvarchar(4000),@p905 nvarchar(4000),@p906 nvarchar(4000),@p907 datetime2(7),@p908 nvarchar(4000),@p909 nvarchar(4000),@p910 int,@p911 int,@p912 int,@p913 nvarchar(4000),@p914 nvarchar(4000),@p915 nvarchar(4000),@p916 nvarchar(4000),@p917 decimal(18,2),@p918 nvarchar(4000),@p919 nvarchar(4000),@p920 decimal(18,2),@p921 nvarchar(4000),@p922 nvarchar(4000),@p923 nvarchar(4000),@p924 nvarchar(4000),@p925 int,@p926 nvarchar(4000),@p927 nvarchar(4000),@p928 nvarchar(4000),@p929 nvarchar(4000),@p930 nvarchar(4000),@p931 nvarchar(4000),@p932 nvarchar(4000),@p933 nvarchar(4000),@p934 nvarchar(4000),@p935 nvarchar(4000),@p936 int,@p937 nvarchar(4000),@p938 nvarchar(4000),@p939 nvarchar(4000),@p940 nvarchar(4000),@p941 nvarchar(4000),@p942 int,@p943 nvarchar(4000),@p944 int,@p945 int,@p946 datetime2(7),@p947 datetime2(7),@p948 datetime2(7),@p949 nvarchar(4000),@p950 nvarchar(4000),@p951 nvarchar(4000),@p952 nvarchar(4000),@p953 nvarchar(4000),@p954 nvarchar(4000),@p955 nvarchar(4000),@p956 nvarchar(4000),@p957 nvarchar(4000),@p958 nvarchar(4000),@p959 nvarchar(4000),@p960 nvarchar(4000),@p961 nvarchar(4000),@p962 nvarchar(4000),@p963 datetime2(7),@p964 nvarchar(4000),@p965 nvarchar(4000),@p966 int,@p967 int,@p968 int,@p969 nvarchar(4000),@p970 nvarchar(4000),@p971 nvarchar(4000),@p972 decimal(18,2),@p973 decimal(18,2),@p974 nvarchar(4000),@p975 nvarchar(4000),@p976 decimal(18,2),@p977 nvarchar(4000),@p978 nvarchar(4000),@p979 nvarchar(4000),@p980 nvarchar(4000),@p981 int,@p982 nvarchar(4000),@p983 nvarchar(4000),@p984 nvarchar(4000),@p985 nvarchar(4000),@p986 nvarchar(4000),@p987 nvarchar(4000),@p988 nvarchar(4000),@p989 nvarchar(4000),@p990 nvarchar(4000),@p991 nvarchar(4000),@p992 int,@p993 nvarchar(4000),@p994 nvarchar(4000),@p995 nvarchar(4000),@p996 nvarchar(4000),@p997 nvarchar(4000),@p998 int,@p999 nvarchar(4000),@p1000 int,@p1001 int,@p1002 datetime2(7),@p1003 datetime2(7),@p1004 datetime2(7),@p1005 nvarchar(4000),@p1006 nvarchar(4000),@p1007 nvarchar(4000),@p1008 nvarchar(4000),@p1009 nvarchar(4000),@p1010 nvarchar(4000),@p1011 nvarchar(4000),@p1012 nvarchar(4000),@p1013 nvarchar(4000),@p1014 nvarchar(4000),@p1015 nvarchar(4000),@p1016 nvarchar(4000),@p1017 nvarchar(4000),@p1018 nvarchar(4000),@p1019 datetime2(7),@p1020 nvarchar(4000),@p1021 nvarchar(4000),@p1022 int,@p1023 int,@p1024 int,@p1025 nvarchar(4000),@p1026 nvarchar(4000),@p1027 nvarchar(4000),@p1028 nvarchar(4000),@p1029 decimal(18,2),@p1030 nvarchar(4000),@p1031 nvarchar(4000),@p1032 decimal(18,2),@p1033 nvarchar(4000),@p1034 nvarchar(4000),@p1035 nvarchar(4000),@p1036 nvarchar(4000),@p1037 int,@p1038 nvarchar(4000),@p1039 nvarchar(4000),@p1040 nvarchar(4000),@p1041 nvarchar(4000),@p1042 nvarchar(4000),@p1043 nvarchar(4000),@p1044 nvarchar(4000),@p1045 nvarchar(4000),@p1046 nvarchar(4000),@p1047 nvarchar(4000),@p1048 int,@p1049 nvarchar(4000),@p1050 nvarchar(4000),@p1051 nvarchar(4000),@p1052 nvarchar(4000),@p1053 nvarchar(4000),@p1054 int,@p1055 nvarchar(4000),@p1056 int,@p1057 int,@p1058 datetime2(7),@p1059 datetime2(7),@p1060 datetime2(7),@p1061 nvarchar(4000),@p1062 nvarchar(4000),@p1063 nvarchar(4000),@p1064 nvarchar(4000),@p1065 nvarchar(4000),@p1066 nvarchar(4000),@p1067 nvarchar(4000),@p1068 nvarchar(4000),@p1069 nvarchar(4000),@p1070 nvarchar(4000),@p1071 nvarchar(4000),@p1072 nvarchar(4000),@p1073 nvarchar(4000),@p1074 nvarchar(4000),@p1075 datetime2(7),@p1076 nvarchar(4000),@p1077 nvarchar(4000),@p1078 int,@p1079 int,@p1080 int,@p1081 nvarchar(4000),@p1082 nvarchar(4000),@p1083 nvarchar(4000),@p1084 decimal(18,2),@p1085 decimal(18,2),@p1086 nvarchar(4000),@p1087 nvarchar(4000),@p1088 decimal(18,2),@p1089 nvarchar(4000),@p1090 nvarchar(4000),@p1091 nvarchar(4000),@p1092 nvarchar(4000),@p1093 int,@p1094 nvarchar(4000),@p1095 nvarchar(4000),@p1096 nvarchar(4000),@p1097 nvarchar(4000),@p1098 nvarchar(4000),@p1099 nvarchar(4000),@p1100 nvarchar(4000),@p1101 nvarchar(4000),@p1102 nvarchar(4000),@p1103 nvarchar(4000),@p1104 int,@p1105 nvarchar(4000),@p1106 nvarchar(4000),@p1107 nvarchar(4000),@p1108 nvarchar(4000),@p1109 nvarchar(4000),@p1110 int,@p1111 nvarchar(4000),@p1112 int,@p1113 int,@p1114 datetime2(7),@p1115 datetime2(7),@p1116 datetime2(7),@p1117 nvarchar(4000),@p1118 nvarchar(4000),@p1119 nvarchar(4000),@p1120 nvarchar(4000),@p1121 nvarchar(4000),@p1122 nvarchar(4000),@p1123 nvarchar(4000),@p1124 nvarchar(4000),@p1125 nvarchar(4000),@p1126 nvarchar(4000),@p1127 nvarchar(4000),@p1128 nvarchar(4000),@p1129 nvarchar(4000),@p1130 nvarchar(4000),@p1131 datetime2(7),@p1132 nvarchar(4000),@p1133 nvarchar(4000),@p1134 int,@p1135 int,@p1136 int,@p1137 nvarchar(4000),@p1138 nvarchar(4000),@p1139 nvarchar(4000),@p1140 decimal(18,2),@p1141 decimal(18,2),@p1142 nvarchar(4000),@p1143 nvarchar(4000),@p1144 decimal(18,2),@p1145 nvarchar(4000),@p1146 nvarchar(4000),@p1147 nvarchar(4000),@p1148 nvarchar(4000),@p1149 int,@p1150 nvarchar(4000),@p1151 nvarchar(4000),@p1152 nvarchar(4000),@p1153 nvarchar(4000),@p1154 nvarchar(4000),@p1155 nvarchar(4000),@p1156 nvarchar(4000),@p1157 nvarchar(4000),@p1158 nvarchar(4000),@p1159 nvarchar(4000),@p1160 int,@p1161 nvarchar(4000),@p1162 nvarchar(4000),@p1163 nvarchar(4000),@p1164 nvarchar(4000),@p1165 nvarchar(4000),@p1166 int,@p1167 nvarchar(4000),@p1168 int,@p1169 int,@p1170 datetime2(7),@p1171 datetime2(7),@p1172 datetime2(7),@p1173 nvarchar(4000),@p1174 nvarchar(4000),@p1175 nvarchar(4000),@p1176 nvarchar(4000),@p1177 nvarchar(4000),@p1178 nvarchar(4000),@p1179 nvarchar(4000),@p1180 nvarchar(4000),@p1181 nvarchar(4000),@p1182 nvarchar(4000),@p1183 nvarchar(4000),@p1184 nvarchar(4000),@p1185 nvarchar(4000),@p1186 nvarchar(4000),@p1187 datetime2(7),@p1188 nvarchar(4000),@p1189 nvarchar(4000),@p1190 int,@p1191 int,@p1192 int,@p1193 nvarchar(4000),@p1194 nvarchar(4000),@p1195 nvarchar(4000),@p1196 decimal(18,2),@p1197 decimal(18,2),@p1198 nvarchar(4000),@p1199 nvarchar(4000),@p1200 decimal(18,2),@p1201 nvarchar(4000),@p1202 nvarchar(4000),@p1203 nvarchar(4000),@p1204 nvarchar(4000),@p1205 int,@p1206 nvarchar(4000),@p1207 nvarchar(4000),@p1208 nvarchar(4000),@p1209 nvarchar(4000),@p1210 nvarchar(4000),@p1211 nvarchar(4000),@p1212 nvarchar(4000),@p1213 nvarchar(4000),@p1214 nvarchar(4000),@p1215 nvarchar(4000),@p1216 int,@p1217 nvarchar(4000),@p1218 nvarchar(4000),@p1219 nvarchar(4000),@p1220 nvarchar(4000),@p1221 nvarchar(4000),@p1222 int,@p1223 nvarchar(4000),@p1224 int,@p1225 int,@p1226 datetime2(7),@p1227 datetime2(7),@p1228 datetime2(7),@p1229 nvarchar(4000),@p1230 nvarchar(4000),@p1231 nvarchar(4000),@p1232 nvarchar(4000),@p1233 nvarchar(4000),@p1234 nvarchar(4000),@p1235 nvarchar(4000),@p1236 nvarchar(4000),@p1237 nvarchar(4000),@p1238 nvarchar(4000),@p1239 nvarchar(4000),@p1240 nvarchar(4000),@p1241 nvarchar(4000),@p1242 nvarchar(4000),@p1243 datetime2(7),@p1244 nvarchar(4000),@p1245 nvarchar(4000),@p1246 int,@p1247 int,@p1248 int,@p1249 nvarchar(4000),@p1250 nvarchar(4000),@p1251 nvarchar(4000),@p1252 nvarchar(4000),@p1253 decimal(18,2),@p1254 nvarchar(4000),@p1255 nvarchar(4000),@p1256 decimal(18,2),@p1257 nvarchar(4000),@p1258 nvarchar(4000),@p1259 nvarchar(4000),@p1260 nvarchar(4000),@p1261 int,@p1262 nvarchar(4000),@p1263 nvarchar(4000),@p1264 nvarchar(4000),@p1265 nvarchar(4000),@p1266 nvarchar(4000),@p1267 nvarchar(4000),@p1268 nvarchar(4000),@p1269 nvarchar(4000),@p1270 nvarchar(4000),@p1271 nvarchar(4000),@p1272 int,@p1273 nvarchar(4000),@p1274 nvarchar(4000),@p1275 nvarchar(4000),@p1276 nvarchar(4000),@p1277 nvarchar(4000),@p1278 int,@p1279 nvarchar(4000),@p1280 int,@p1281 int,@p1282 datetime2(7),@p1283 datetime2(7),@p1284 datetime2(7),@p1285 nvarchar(4000),@p1286 nvarchar(4000),@p1287 nvarchar(4000),@p1288 nvarchar(4000),@p1289 nvarchar(4000),@p1290 nvarchar(4000),@p1291 nvarchar(4000),@p1292 nvarchar(4000),@p1293 nvarchar(4000),@p1294 nvarchar(4000),@p1295 nvarchar(4000),@p1296 nvarchar(4000),@p1297 nvarchar(4000),@p1298 nvarchar(4000),@p1299 datetime2(7),@p1300 nvarchar(4000),@p1301 nvarchar(4000),@p1302 int,@p1303 int,@p1304 int,@p1305 nvarchar(4000),@p1306 nvarchar(4000),@p1307 nvarchar(4000),@p1308 nvarchar(4000),@p1309 decimal(18,2),@p1310 nvarchar(4000),@p1311 nvarchar(4000),@p1312 decimal(18,2),@p1313 nvarchar(4000),@p1314 nvarchar(4000),@p1315 nvarchar(4000),@p1316 nvarchar(4000),@p1317 int,@p1318 nvarchar(4000),@p1319 nvarchar(4000),@p1320 nvarchar(4000),@p1321 nvarchar(4000),@p1322 nvarchar(4000),@p1323 nvarchar(4000),@p1324 nvarchar(4000),@p1325 nvarchar(4000),@p1326 nvarchar(4000),@p1327 nvarchar(4000),@p1328 int,@p1329 nvarchar(4000),@p1330 nvarchar(4000),@p1331 nvarchar(4000),@p1332 nvarchar(4000),@p1333 nvarchar(4000),@p1334 int,@p1335 nvarchar(4000),@p1336 int,@p1337 int,@p1338 datetime2(7),@p1339 datetime2(7),@p1340 datetime2(7),@p1341 nvarchar(4000),@p1342 nvarchar(4000),@p1343 nvarchar(4000),@p1344 nvarchar(4000),@p1345 nvarchar(4000),@p1346 nvarchar(4000),@p1347 nvarchar(4000),@p1348 nvarchar(4000),@p1349 nvarchar(4000),@p1350 nvarchar(4000),@p1351 nvarchar(4000),@p1352 nvarchar(4000),@p1353 nvarchar(4000),@p1354 nvarchar(4000),@p1355 datetime2(7),@p1356 nvarchar(4000),@p1357 nvarchar(4000),@p1358 int,@p1359 int,@p1360 int,@p1361 nvarchar(4000),@p1362 nvarchar(4000),@p1363 nvarchar(4000),@p1364 decimal(18,2),@p1365 decimal(18,2),@p1366 nvarchar(4000),@p1367 nvarchar(4000),@p1368 decimal(18,2),@p1369 nvarchar(4000),@p1370 nvarchar(4000),@p1371 nvarchar(4000),@p1372 nvarchar(4000),@p1373 int,@p1374 nvarchar(4000),@p1375 nvarchar(4000),@p1376 nvarchar(4000),@p1377 nvarchar(4000),@p1378 nvarchar(4000),@p1379 nvarchar(4000),@p1380 nvarchar(4000),@p1381 nvarchar(4000),@p1382 nvarchar(4000),@p1383 nvarchar(4000),@p1384 int,@p1385 nvarchar(4000),@p1386 nvarchar(4000),@p1387 nvarchar(4000),@p1388 nvarchar(4000),@p1389 nvarchar(4000),@p1390 int,@p1391 nvarchar(4000),@p1392 int,@p1393 int,@p1394 datetime2(7),@p1395 datetime2(7),@p1396 datetime2(7),@p1397 nvarchar(4000),@p1398 nvarchar(4000),@p1399 nvarchar(4000),@p1400 nvarchar(4000),@p1401 nvarchar(4000),@p1402 nvarchar(4000),@p1403 nvarchar(4000),@p1404 nvarchar(4000),@p1405 nvarchar(4000),@p1406 nvarchar(4000),@p1407 nvarchar(4000),@p1408 nvarchar(4000),@p1409 nvarchar(4000),@p1410 nvarchar(4000),@p1411 datetime2(7),@p1412 nvarchar(4000),@p1413 nvarchar(4000),@p1414 int,@p1415 int,@p1416 int,@p1417 nvarchar(4000),@p1418 nvarchar(4000),@p1419 nvarchar(4000),@p1420 nvarchar(4000),@p1421 decimal(18,2),@p1422 nvarchar(4000),@p1423 nvarchar(4000),@p1424 decimal(18,2),@p1425 nvarchar(4000),@p1426 nvarchar(4000),@p1427 nvarchar(4000),@p1428 nvarchar(4000),@p1429 int,@p1430 nvarchar(4000),@p1431 nvarchar(4000),@p1432 nvarchar(4000),@p1433 nvarchar(4000),@p1434 nvarchar(4000),@p1435 nvarchar(4000),@p1436 nvarchar(4000),@p1437 nvarchar(4000),@p1438 nvarchar(4000),@p1439 nvarchar(4000),@p1440 int,@p1441 nvarchar(4000),@p1442 nvarchar(4000),@p1443 nvarchar(4000),@p1444 nvarchar(4000),@p1445 nvarchar(4000),@p1446 int,@p1447 nvarchar(4000),@p1448 int,@p1449 int,@p1450 datetime2(7),@p1451 datetime2(7),@p1452 datetime2(7),@p1453 nvarchar(4000),@p1454 nvarchar(4000),@p1455 nvarchar(4000),@p1456 nvarchar(4000),@p1457 nvarchar(4000),@p1458 nvarchar(4000),@p1459 nvarchar(4000),@p1460 nvarchar(4000),@p1461 nvarchar(4000),@p1462 nvarchar(4000),@p1463 nvarchar(4000),@p1464 nvarchar(4000),@p1465 nvarchar(4000),@p1466 nvarchar(4000),@p1467 datetime2(7),@p1468 nvarchar(4000),@p1469 nvarchar(4000),@p1470 int,@p1471 int,@p1472 int,@p1473 nvarchar(4000),@p1474 nvarchar(4000),@p1475 nvarchar(4000),@p1476 nvarchar(4000),@p1477 decimal(18,2),@p1478 nvarchar(4000),@p1479 nvarchar(4000),@p1480 decimal(18,2),@p1481 nvarchar(4000),@p1482 nvarchar(4000),@p1483 nvarchar(4000),@p1484 nvarchar(4000),@p1485 int,@p1486 nvarchar(4000),@p1487 nvarchar(4000),@p1488 nvarchar(4000),@p1489 nvarchar(4000),@p1490 nvarchar(4000),@p1491 nvarchar(4000),@p1492 nvarchar(4000),@p1493 nvarchar(4000),@p1494 nvarchar(4000),@p1495 nvarchar(4000),@p1496 int,@p1497 nvarchar(4000),@p1498 nvarchar(4000),@p1499 nvarchar(4000),@p1500 nvarchar(4000),@p1501 nvarchar(4000),@p1502 int,@p1503 nvarchar(4000),@p1504 int,@p1505 int,@p1506 datetime2(7),@p1507 datetime2(7),@p1508 datetime2(7),@p1509 nvarchar(4000),@p1510 nvarchar(4000),@p1511 nvarchar(4000),@p1512 nvarchar(4000),@p1513 nvarchar(4000),@p1514 nvarchar(4000),@p1515 nvarchar(4000),@p1516 nvarchar(4000),@p1517 nvarchar(4000),@p1518 nvarchar(4000),@p1519 nvarchar(4000),@p1520 nvarchar(4000),@p1521 nvarchar(4000),@p1522 nvarchar(4000),@p1523 datetime2(7),@p1524 nvarchar(4000),@p1525 nvarchar(4000),@p1526 int,@p1527 int,@p1528 int,@p1529 nvarchar(4000),@p1530 nvarchar(4000),@p1531 nvarchar(4000),@p1532 nvarchar(4000),@p1533 decimal(18,2),@p1534 nvarchar(4000),@p1535 nvarchar(4000),@p1536 decimal(18,2),@p1537 nvarchar(4000),@p1538 nvarchar(4000),@p1539 nvarchar(4000),@p1540 nvarchar(4000),@p1541 int,@p1542 nvarchar(4000),@p1543 nvarchar(4000),@p1544 nvarchar(4000),@p1545 nvarchar(4000),@p1546 nvarchar(4000),@p1547 nvarchar(4000),@p1548 nvarchar(4000),@p1549 nvarchar(4000),@p1550 nvarchar(4000),@p1551 nvarchar(4000),@p1552 int,@p1553 nvarchar(4000),@p1554 nvarchar(4000),@p1555 nvarchar(4000),@p1556 nvarchar(4000),@p1557 nvarchar(4000),@p1558 int,@p1559 nvarchar(4000),@p1560 int,@p1561 int,@p1562 datetime2(7),@p1563 datetime2(7),@p1564 datetime2(7),@p1565 nvarchar(4000),@p1566 nvarchar(4000),@p1567 nvarchar(4000),@p1568 nvarchar(4000),@p1569 nvarchar(4000),@p1570 nvarchar(4000),@p1571 nvarchar(4000),@p1572 nvarchar(4000),@p1573 nvarchar(4000),@p1574 nvarchar(4000),@p1575 nvarchar(4000),@p1576 nvarchar(4000),@p1577 nvarchar(4000),@p1578 nvarchar(4000),@p1579 datetime2(7),@p1580 nvarchar(4000),@p1581 nvarchar(4000),@p1582 int,@p1583 int,@p1584 int,@p1585 nvarchar(4000),@p1586 nvarchar(4000),@p1587 nvarchar(4000),@p1588 decimal(18,2),@p1589 decimal(18,2),@p1590 nvarchar(4000),@p1591 nvarchar(4000),@p1592 decimal(18,2),@p1593 nvarchar(4000),@p1594 nvarchar(4000),@p1595 nvarchar(4000),@p1596 nvarchar(4000),@p1597 int,@p1598 nvarchar(4000),@p1599 nvarchar(4000),@p1600 nvarchar(4000),@p1601 nvarchar(4000),@p1602 nvarchar(4000),@p1603 nvarchar(4000),@p1604 nvarchar(4000),@p1605 nvarchar(4000),@p1606 nvarchar(4000),@p1607 nvarchar(4000),@p1608 int,@p1609 nvarchar(4000),@p1610 nvarchar(4000),@p1611 nvarchar(4000),@p1612 nvarchar(4000),@p1613 nvarchar(4000),@p1614 int,@p1615 nvarchar(4000),@p1616 int,@p1617 int,@p1618 datetime2(7),@p1619 datetime2(7),@p1620 datetime2(7),@p1621 nvarchar(4000),@p1622 nvarchar(4000),@p1623 nvarchar(4000),@p1624 nvarchar(4000),@p1625 nvarchar(4000),@p1626 nvarchar(4000),@p1627 nvarchar(4000),@p1628 nvarchar(4000),@p1629 nvarchar(4000),@p1630 nvarchar(4000),@p1631 nvarchar(4000),@p1632 nvarchar(4000),@p1633 nvarchar(4000),@p1634 nvarchar(4000),@p1635 datetime2(7),@p1636 nvarchar(4000),@p1637 nvarchar(4000),@p1638 int,@p1639 int,@p1640 int,@p1641 nvarchar(4000),@p1642 nvarchar(4000),@p1643 nvarchar(4000),@p1644 decimal(18,2),@p1645 decimal(18,2),@p1646 nvarchar(4000),@p1647 nvarchar(4000),@p1648 decimal(18,2),@p1649 nvarchar(4000),@p1650 nvarchar(4000),@p1651 nvarchar(4000),@p1652 nvarchar(4000),@p1653 int,@p1654 nvarchar(4000),@p1655 nvarchar(4000),@p1656 nvarchar(4000),@p1657 nvarchar(4000),@p1658 nvarchar(4000),@p1659 nvarchar(4000),@p1660 nvarchar(4000),@p1661 nvarchar(4000),@p1662 nvarchar(4000),@p1663 nvarchar(4000),@p1664 int,@p1665 nvarchar(4000),@p1666 nvarchar(4000),@p1667 nvarchar(4000),@p1668 nvarchar(4000),@p1669 nvarchar(4000),@p1670 int,@p1671 nvarchar(4000),@p1672 int,@p1673 int,@p1674 datetime2(7),@p1675 datetime2(7),@p1676 datetime2(7),@p1677 nvarchar(4000),@p1678 nvarchar(4000),@p1679 nvarchar(4000),@p1680 nvarchar(4000),@p1681 nvarchar(4000),@p1682 nvarchar(4000),@p1683 nvarchar(4000),@p1684 nvarchar(4000),@p1685 nvarchar(4000),@p1686 nvarchar(4000),@p1687 nvarchar(4000),@p1688 nvarchar(4000),@p1689 nvarchar(4000),@p1690 nvarchar(4000),@p1691 datetime2(7),@p1692 nvarchar(4000),@p1693 nvarchar(4000),@p1694 int,@p1695 int,@p1696 int,@p1697 nvarchar(4000),@p1698 nvarchar(4000),@p1699 nvarchar(4000),@p1700 decimal(18,2),@p1701 decimal(18,2),@p1702 nvarchar(4000),@p1703 nvarchar(4000),@p1704 decimal(18,2),@p1705 nvarchar(4000),@p1706 nvarchar(4000),@p1707 nvarchar(4000),@p1708 nvarchar(4000),@p1709 int,@p1710 nvarchar(4000),@p1711 nvarchar(4000),@p1712 nvarchar(4000),@p1713 nvarchar(4000),@p1714 nvarchar(4000),@p1715 nvarchar(4000),@p1716 nvarchar(4000),@p1717 nvarchar(4000),@p1718 nvarchar(4000),@p1719 nvarchar(4000),@p1720 int,@p1721 nvarchar(4000),@p1722 nvarchar(4000),@p1723 nvarchar(4000),@p1724 nvarchar(4000),@p1725 nvarchar(4000),@p1726 int,@p1727 nvarchar(4000),@p1728 int,@p1729 int,@p1730 datetime2(7),@p1731 datetime2(7),@p1732 datetime2(7),@p1733 nvarchar(4000),@p1734 nvarchar(4000),@p1735 nvarchar(4000),@p1736 nvarchar(4000),@p1737 nvarchar(4000),@p1738 nvarchar(4000),@p1739 nvarchar(4000),@p1740 nvarchar(4000),@p1741 nvarchar(4000),@p1742 nvarchar(4000),@p1743 nvarchar(4000),@p1744 nvarchar(4000),@p1745 nvarchar(4000),@p1746 nvarchar(4000),@p1747 datetime2(7),@p1748 nvarchar(4000),@p1749 nvarchar(4000),@p1750 int,@p1751 int,@p1752 int,@p1753 nvarchar(4000),@p1754 nvarchar(4000),@p1755 nvarchar(4000),@p1756 decimal(18,2),@p1757 decimal(18,2),@p1758 nvarchar(4000),@p1759 nvarchar(4000),@p1760 decimal(18,2),@p1761 nvarchar(4000),@p1762 nvarchar(4000),@p1763 nvarchar(4000),@p1764 nvarchar(4000),@p1765 int,@p1766 nvarchar(4000),@p1767 nvarchar(4000),@p1768 nvarchar(4000),@p1769 nvarchar(4000),@p1770 nvarchar(4000),@p1771 nvarchar(4000),@p1772 nvarchar(4000),@p1773 nvarchar(4000),@p1774 nvarchar(4000),@p1775 nvarchar(4000),@p1776 int,@p1777 nvarchar(4000),@p1778 nvarchar(4000),@p1779 nvarchar(4000),@p1780 nvarchar(4000),@p1781 nvarchar(4000),@p1782 int,@p1783 nvarchar(4000),@p1784 int,@p1785 int,@p1786 datetime2(7),@p1787 datetime2(7),@p1788 datetime2(7),@p1789 nvarchar(4000),@p1790 nvarchar(4000),@p1791 nvarchar(4000),@p1792 nvarchar(4000),@p1793 nvarchar(4000),@p1794 nvarchar(4000),@p1795 nvarchar(4000),@p1796 nvarchar(4000),@p1797 nvarchar(4000),@p1798 nvarchar(4000),@p1799 nvarchar(4000),@p1800 nvarchar(4000),@p1801 nvarchar(4000),@p1802 nvarchar(4000),@p1803 datetime2(7),@p1804 nvarchar(4000),@p1805 nvarchar(4000),@p1806 int,@p1807 int,@p1808 int,@p1809 nvarchar(4000),@p1810 nvarchar(4000),@p1811 nvarchar(4000),@p1812 decimal(18,2),@p1813 decimal(18,2),@p1814 nvarchar(4000),@p1815 nvarchar(4000),@p1816 decimal(18,2),@p1817 nvarchar(4000),@p1818 nvarchar(4000),@p1819 nvarchar(4000),@p1820 nvarchar(4000),@p1821 int,@p1822 nvarchar(4000),@p1823 nvarchar(4000),@p1824 nvarchar(4000),@p1825 nvarchar(4000),@p1826 nvarchar(4000),@p1827 nvarchar(4000),@p1828 nvarchar(4000),@p1829 nvarchar(4000),@p1830 nvarchar(4000),@p1831 nvarchar(4000),@p1832 int,@p1833 nvarchar(4000),@p1834 nvarchar(4000),@p1835 nvarchar(4000),@p1836 nvarchar(4000),@p1837 nvarchar(4000),@p1838 int,@p1839 nvarchar(4000),@p1840 int,@p1841 int,@p1842 datetime2(7),@p1843 datetime2(7),@p1844 datetime2(7),@p1845 nvarchar(4000),@p1846 nvarchar(4000),@p1847 nvarchar(4000),@p1848 nvarchar(4000),@p1849 nvarchar(4000),@p1850 nvarchar(4000),@p1851 nvarchar(4000),@p1852 nvarchar(4000),@p1853 nvarchar(4000),@p1854 nvarchar(4000),@p1855 nvarchar(4000),@p1856 nvarchar(4000),@p1857 nvarchar(4000),@p1858 nvarchar(4000),@p1859 datetime2(7),@p1860 nvarchar(4000),@p1861 nvarchar(4000),@p1862 int,@p1863 int,@p1864 int,@p1865 nvarchar(4000),@p1866 nvarchar(4000),@p1867 nvarchar(4000),@p1868 decimal(18,2),@p1869 decimal(18,2),@p1870 nvarchar(4000),@p1871 nvarchar(4000),@p1872 decimal(18,2),@p1873 nvarchar(4000),@p1874 nvarchar(4000),@p1875 nvarchar(4000),@p1876 nvarchar(4000),@p1877 int,@p1878 nvarchar(4000),@p1879 nvarchar(4000),@p1880 nvarchar(4000),@p1881 nvarchar(4000),@p1882 nvarchar(4000),@p1883 nvarchar(4000),@p1884 nvarchar(4000),@p1885 nvarchar(4000),@p1886 nvarchar(4000),@p1887 nvarchar(4000),@p1888 int,@p1889 nvarchar(4000),@p1890 nvarchar(4000),@p1891 nvarchar(4000),@p1892 nvarchar(4000),@p1893 nvarchar(4000),@p1894 int,@p1895 nvarchar(4000),@p1896 int,@p1897 int,@p1898 datetime2(7),@p1899 datetime2(7),@p1900 datetime2(7),@p1901 nvarchar(4000),@p1902 nvarchar(4000),@p1903 nvarchar(4000),@p1904 nvarchar(4000),@p1905 nvarchar(4000),@p1906 nvarchar(4000),@p1907 nvarchar(4000),@p1908 nvarchar(4000),@p1909 nvarchar(4000),@p1910 nvarchar(4000),@p1911 nvarchar(4000),@p1912 nvarchar(4000),@p1913 nvarchar(4000),@p1914 nvarchar(4000),@p1915 datetime2(7),@p1916 nvarchar(4000),@p1917 nvarchar(4000),@p1918 int,@p1919 int,@p1920 int,@p1921 nvarchar(4000),@p1922 nvarchar(4000),@p1923 nvarchar(4000),@p1924 decimal(18,2),@p1925 decimal(18,2),@p1926 nvarchar(4000),@p1927 nvarchar(4000),@p1928 decimal(18,2),@p1929 nvarchar(4000),@p1930 nvarchar(4000),@p1931 nvarchar(4000),@p1932 nvarchar(4000),@p1933 int,@p1934 nvarchar(4000),@p1935 nvarchar(4000),@p1936 nvarchar(4000),@p1937 nvarchar(4000),@p1938 nvarchar(4000),@p1939 nvarchar(4000),@p1940 nvarchar(4000),@p1941 nvarchar(4000),@p1942 nvarchar(4000),@p1943 nvarchar(4000),@p1944 int,@p1945 nvarchar(4000),@p1946 nvarchar(4000),@p1947 nvarchar(4000),@p1948 nvarchar(4000),@p1949 nvarchar(4000),@p1950 int,@p1951 nvarchar(4000),@p1952 int,@p1953 int,@p1954 datetime2(7),@p1955 datetime2(7),@p1956 datetime2(7),@p1957 nvarchar(4000),@p1958 nvarchar(4000),@p1959 nvarchar(4000),@p1960 nvarchar(4000),@p1961 nvarchar(4000),@p1962 nvarchar(4000),@p1963 nvarchar(4000),@p1964 nvarchar(4000),@p1965 nvarchar(4000),@p1966 nvarchar(4000),@p1967 nvarchar(4000),@p1968 nvarchar(4000),@p1969 nvarchar(4000),@p1970 nvarchar(4000),@p1971 datetime2(7),@p1972 nvarchar(4000),@p1973 nvarchar(4000),@p1974 int,@p1975 int,@p1976 int,@p1977 nvarchar(4000),@p1978 nvarchar(4000),@p1979 nvarchar(4000),@p1980 decimal(18,2),@p1981 decimal(18,2),@p1982 nvarchar(4000),@p1983 nvarchar(4000),@p1984 decimal(18,2),@p1985 nvarchar(4000),@p1986 nvarchar(4000),@p1987 nvarchar(4000),@p1988 nvarchar(4000),@p1989 int,@p1990 nvarchar(4000),@p1991 nvarchar(4000),@p1992 nvarchar(4000),@p1993 nvarchar(4000),@p1994 nvarchar(4000),@p1995 nvarchar(4000),@p1996 nvarchar(4000),@p1997 nvarchar(4000),@p1998 nvarchar(4000),@p1999 nvarchar(4000),@p2000 int,@p2001 nvarchar(4000),@p2002 nvarchar(4000),@p2003 nvarchar(4000),@p2004 nvarchar(4000),@p2005 nvarchar(4000),@p2006 int,@p2007 nvarchar(4000),@p2008 int,@p2009 int,@p2010 datetime2(7),@p2011 datetime2(7),@p2012 datetime2(7),@p2013 nvarchar(4000),@p2014 nvarchar(4000),@p2015 nvarchar(4000),@p2016 nvarchar(4000),@p2017 nvarchar(4000),@p2018 nvarchar(4000),@p2019 nvarchar(4000),@p2020 nvarchar(4000),@p2021 nvarchar(4000),@p2022 nvarchar(4000),@p2023 nvarchar(4000),@p2024 nvarchar(4000),@p2025 nvarchar(4000),@p2026 nvarchar(4000),@p2027 datetime2(7),@p2028 nvarchar(4000),@p2029 nvarchar(4000),@p2030 int,@p2031 int,@p2032 int,@p2033 nvarchar(4000),@p2034 nvarchar(4000),@p2035 nvarchar(4000),@p2036 decimal(18,2),@p2037 decimal(18,2),@p2038 nvarchar(4000),@p2039 nvarchar(4000),@p2040 decimal(18,2),@p2041 nvarchar(4000),@p2042 nvarchar(4000),@p2043 nvarchar(4000),@p2044 nvarchar(4000),@p2045 int,@p2046 nvarchar(4000),@p2047 nvarchar(4000),@p2048 nvarchar(4000),@p2049 nvarchar(4000),@p2050 nvarchar(4000),@p2051 nvarchar(4000),@p2052 nvarchar(4000),@p2053 nvarchar(4000),@p2054 nvarchar(4000),@p2055 nvarchar(4000),@p2056 int,@p2057 nvarchar(4000),@p2058 nvarchar(4000),@p2059 nvarchar(4000),@p2060 nvarchar(4000),@p2061 nvarchar(4000),@p2062 int,@p2063 nvarchar(4000),@p2064 int,@p2065 int,@p2066 datetime2(7),@p2067 datetime2(7),@p2068 datetime2(7),@p2069 nvarchar(4000),@p2070 nvarchar(4000),@p2071 nvarchar(4000))SET NOCOUNT ON; DECLARE @inserted0 TABLE ([item_id] int, [_Position] [int]); MERGE [raw_data] USING ( VALUES (@p0, @p1, @p2, @p3, @p4, @p5, @p6, @p7, @p8, @p9, @p10, @p11, @p12, @p13, @p14, @p15, @p16, @p17, @p18, @p19, @p20, @p21, @p22, @p23, @p24, @p25, @p26, @p27, @p28, @p29, @p30, @p31, @p32, @p33, @p34, @p35, @p36, @p37, @p38, @p39, @p40, @p41, @p42, @p43, @p44, @p45, @p46, @p47, @p48, @p49, @p50, @p51, @p52, @p53, @p54, @p55, 0), (@p56, @p57, @p58, @p59, @p60, @p61, @p62, @p63, @p64, @p65, @p66, @p67, @p68, @p69, @p70, @p71, @p72, @p73, @p74, @p75, @p76, @p77, @p78, @p79, @p80, @p81, @p82, @p83, @p84, @p85, @p86, @p87, @p88, @p89, @p90, @p91, @p92, @p93, @p94, @p95, @p96, @p97, @p98, @p99, @p100, @p101, @p102, @p103, @p104, @p105, @p106, @p107, @p108, @p109, @p110, @p111, 1), (@p112, @p113, @p114, @p115, @p116, @p117, @p118, @p119, @p120, @p121, @p122, @p123, @p124, @p125, @p126, @p127, @p128, @p129, @p130, @p131, @p132, @p133, @p134, @p135, @p136, @p137, @p138, @p139, @p140, @p141, @p142, @p143, @p144, @p145, @p146, @p147, @p148, @p149, @p150, @p151, @p152, @p153, @p154, @p155, @p156, @p157, @p158, @p159, @p160, @p161, @p162, @p163, @p164, @p165, @p166, @p167, 2), (@p168, @p169, @p170, @p171, @p172, @p173, @p174, @p175, @p176, @p177, @p178, @p179, @p180, @p181, @p182, @p183, @p184, @p185, @p186, @p187, @p188, @p189, @p190, @p191, @p192, @p193, @p194, @p195, @p196, @p197, @p198, @p199, @p200, @p201, @p202, @p203, @p204, @p205, @p206, @p207, @p208, @p209, @p210, @p211, @p212, @p213, @p214, @p215, @p216, @p217, @p218, @p219, @p220, @p221, @p222, @p223, 3), (@p224, @p225, @p226, @p227, @p228, @p229, @p230, @p231, @p232, @p233, @p234, @p235, @p236, @p237, @p238, @p239, @p240, @p241, @p242, @p243, @p244, @p245, @p246, @p247, @p248, @p249, @p250, @p251, @p252, @p253, @p254, @p255, @p256, @p257, @p258, @p259, @p260, @p261, @p262, @p263, @p264, @p265, @p266, @p267, @p268, @p269, @p270, @p271, @p272, @p273, @p274, @p275, @p276, @p277, @p278, @p279, 4), (@p280, @p281, @p282, @p283, @p284, @p285, @p286, @p287, @p288, @p289, @p290, @p291, @p292, @p293, @p294, @p295, @p296, @p297, @p298, @p299, @p300, @p301, @p302, @p303, @p304, @p305, @p306, @p307, @p308, @p309, @p310, @p311, @p312, @p313, @p314, @p315, @p316, @p317, @p318, @p319, @p320, @p321, @p322, @p323, @p324, @p325, @p326, @p327, @p328, @p329, @p330, @p331, @p332, @p333, @p334, @p335, 5), (@p336, @p337, @p338, @p339, @p340, @p341, @p342, @p343, @p344, @p345, @p346, @p347, @p348, @p349, @p350, @p351, @p352, @p353, @p354, @p355, @p356, @p357, @p358, @p359, @p360, @p361, @p362, @p363, @p364, @p365, @p366, @p367, @p368, @p369, @p370, @p371, @p372, @p373, @p374, @p375, @p376, @p377, @p378, @p379, @p380, @p381, @p382, @p383, @p384, @p385, @p386, @p387, @p388, @p389, @p390, @p391, 6), (@p392, @p393, @p394, @p395, @p396, @p397, @p398, @p399, @p400, @p401, @p402, @p403, @p404, @p405, @p406, @p407, @p408, @p409, @p410, @p411, @p412, @p413, @p414, @p415, @p416, @p417, @p418, @p419, @p420, @p421, @p422, @p423, @p424, @p425, @p426, @p427, @p428, @p429, @p430, @p431, @p432, @p433, @p434, @p435, @p436, @p437, @p438, @p439, @p440, @p441, @p442, @p443, @p444, @p445, @p446, @p447, 7), (@p448, @p449, @p450, @p451, @p452, @p453, @p454, @p455, @p456, @p457, @p458, @p459, @p460, @p461, @p462, @p463, @p464, @p465, @p466, @p467, @p468, @p469, @p470, @p471, @p472, @p473, @p474, @p475, @p476, @p477, @p478, @p479, @p480, @p481, @p482, @p483, @p484, @p485, @p486, @p487, @p488, @p489, @p490, @p491, @p492, @p493, @p494, @p495, @p496, @p497, @p498, @p499, @p500, @p501, @p502, @p503, 8), (@p504, @p505, @p506, @p507, @p508, @p509, @p510, @p511, @p512, @p513, @p514, @p515, @p516, @p517, @p518, @p519, @p520, @p521, @p522, @p523, @p524, @p525, @p526, @p527, @p528, @p529, @p530, @p531, @p532, @p533, @p534, @p535, @p536, @p537, @p538, @p539, @p540, @p541, @p542, @p543, @p544, @p545, @p546, @p547, @p548, @p549, @p550, @p551, @p552, @p553, @p554, @p555, @p556, @p557, @p558, @p559, 9), (@p560, @p561, @p562, @p563, @p564, @p565, @p566, @p567, @p568, @p569, @p570, @p571, @p572, @p573, @p574, @p575, @p576, @p577, @p578, @p579, @p580, @p581, @p582, @p583, @p584, @p585, @p586, @p587, @p588, @p589, @p590, @p591, @p592, @p593, @p594, @p595, @p596, @p597, @p598, @p599, @p600, @p601, @p602, @p603, @p604, @p605, @p606, @p607, @p608, @p609, @p610, @p611, @p612, @p613, @p614, @p615, 10), (@p616, @p617, @p618, @p619, @p620, @p621, @p622, @p623, @p624, @p625, @p626, @p627, @p628, @p629, @p630, @p631, @p632, @p633, @p634, @p635, @p636, @p637, @p638, @p639, @p640, @p641, @p642, @p643, @p644, @p645, @p646, @p647, @p648, @p649, @p650, @p651, @p652, @p653, @p654, @p655, @p656, @p657, @p658, @p659, @p660, @p661, @p662, @p663, @p664, @p665, @p666, @p667, @p668, @p669, @p670, @p671, 11), (@p672, @p673, @p674, @p675, @p676, @p677, @p678, @p679, @p680, @p681, @p682, @p683, @p684, @p685, @p686, @p687, @p688, @p689, @p690, @p691, @p692, @p693, @p694, @p695, @p696, @p697, @p698, @p699, @p700, @p701, @p702, @p703, @p704, @p705, @p706, @p707, @p708, @p709, @p710, @p711, @p712, @p713, @p714, @p715, @p716, @p717, @p718, @p719, @p720, @p721, @p722, @p723, @p724, @p725, @p726, @p727, 12), (@p728, @p729, @p730, @p731, @p732, @p733, @p734, @p735, @p736, @p737, @p738, @p739, @p740, @p741, @p742, @p743, @p744, @p745, @p746, @p747, @p748, @p749, @p750, @p751, @p752, @p753, @p754, @p755, @p756, @p757, @p758, @p759, @p760, @p761, @p762, @p763, @p764, @p765, @p766, @p767, @p768, @p769, @p770, @p771, @p772, @p773, @p774, @p775, @p776, @p777, @p778, @p779, @p780, @p781, @p782, @p783, 13), (@p784, @p785, @p786, @p787, @p788, @p789, @p790, @p791, @p792, @p793, @p794, @p795, @p796, @p797, @p798, @p799, @p800, @p801, @p802, @p803, @p804, @p805, @p806, @p807, @p808, @p809, @p810, @p811, @p812, @p813, @p814, @p815, @p816, @p817, @p818, @p819, @p820, @p821, @p822, @p823, @p824, @p825, @p826, @p827, @p828, @p829, @p830, @p831, @p832, @p833, @p834, @p835, @p836, @p837, @p838, @p839, 14), (@p840, @p841, @p842, @p843, @p844, @p845, @p846, @p847, @p848, @p849, @p850, @p851, @p852, @p853, @p854, @p855, @p856, @p857, @p858, @p859, @p860, @p861, @p862, @p863, @p864, @p865, @p866, @p867, @p868, @p869, @p870, @p871, @p872, @p873, @p874, @p875, @p876, @p877, @p878, @p879, @p880, @p881, @p882, @p883, @p884, @p885, @p886, @p887, @p888, @p889, @p890, @p891, @p892, @p893, @p894, @p895, 15), (@p896, @p897, @p898, @p899, @p900, @p901, @p902, @p903, @p904, @p905, @p906, @p907, @p908, @p909, @p910, @p911, @p912, @p913, @p914, @p915, @p916, @p917, @p918, @p919, @p920, @p921, @p922, @p923, @p924, @p925, @p926, @p927, @p928, @p929, @p930, @p931, @p932, @p933, @p934, @p935, @p936, @p937, @p938, @p939, @p940, @p941, @p942, @p943, @p944, @p945, @p946, @p947, @p948, @p949, @p950, @p951, 16), (@p952, @p953, @p954, @p955, @p956, @p957, @p958, @p959, @p960, @p961, @p962, @p963, @p964, @p965, @p966, @p967, @p968, @p969, @p970, @p971, @p972, @p973, @p974, @p975, @p976, @p977, @p978, @p979, @p980, @p981, @p982, @p983, @p984, @p985, @p986, @p987, @p988, @p989, @p990, @p991, @p992, @p993, @p994, @p995, @p996, @p997, @p998, @p999, @p1000, @p1001, @p1002, @p1003, @p1004, @p1005, @p1006, @p1007, 17), (@p1008, @p1009, @p1010, @p1011, @p1012, @p1013, @p1014, @p1015, @p1016, @p1017, @p1018, @p1019, @p1020, @p1021, @p1022, @p1023, @p1024, @p1025, @p1026, @p1027, @p1028, @p1029, @p1030, @p1031, @p1032, @p1033, @p1034, @p1035, @p1036, @p1037, @p1038, @p1039, @p1040, @p1041, @p1042, @p1043, @p1044, @p1045, @p1046, @p1047, @p1048, @p1049, @p1050, @p1051, @p1052, @p1053, @p1054, @p1055, @p1056, @p1057, @p1058, @p1059, @p1060, @p1061, @p1062, @p1063, 18), (@p1064, @p1065, @p1066, @p1067, @p1068, @p1069, @p1070, @p1071, @p1072, @p1073, @p1074, @p1075, @p1076, @p1077, @p1078, @p1079, @p1080, @p1081, @p1082, @p1083, @p1084, @p1085, @p1086, @p1087, @p1088, @p1089, @p1090, @p1091, @p1092, @p1093, @p1094, @p1095, @p1096, @p1097, @p1098, @p1099, @p1100, @p1101, @p1102, @p1103, @p1104, @p1105, @p1106, @p1107, @p1108, @p1109, @p1110, @p1111, @p1112, @p1113, @p1114, @p1115, @p1116, @p1117, @p1118, @p1119, 19), (@p1120, @p1121, @p1122, @p1123, @p1124, @p1125, @p1126, @p1127, @p1128, @p1129, @p1130, @p1131, @p1132, @p1133, @p1134, @p1135, @p1136, @p1137, @p1138, @p1139, @p1140, @p1141, @p1142, @p1143, @p1144, @p1145, @p1146, @p1147, @p1148, @p1149, @p1150, @p1151, @p1152, @p1153, @p1154, @p1155, @p1156, @p1157, @p1158, @p1159, @p1160, @p1161, @p1162, @p1163, @p1164, @p1165, @p1166, @p1167, @p1168, @p1169, @p1170, @p1171, @p1172, @p1173, @p1174, @p1175, 20), (@p1176, @p1177, @p1178, @p1179, @p1180, @p1181, @p1182, @p1183, @p1184, @p1185, @p1186, @p1187, @p1188, @p1189, @p1190, @p1191, @p1192, @p1193, @p1194, @p1195, @p1196, @p1197, @p1198, @p1199, @p1200, @p1201, @p1202, @p1203, @p1204, @p1205, @p1206, @p1207, @p1208, @p1209, @p1210, @p1211, @p1212, @p1213, @p1214, @p1215, @p1216, @p1217, @p1218, @p1219, @p1220, @p1221, @p1222, @p1223, @p1224, @p1225, @p1226, @p1227, @p1228, @p1229, @p1230, @p1231, 21), (@p1232, @p1233, @p1234, @p1235, @p1236, @p1237, @p1238, @p1239, @p1240, @p1241, @p1242, @p1243, @p1244, @p1245, @p1246, @p1247, @p1248, @p1249, @p1250, @p1251, @p1252, @p1253, @p1254, @p1255, @p1256, @p1257, @p1258, @p1259, @p1260, @p1261, @p1262, @p1263, @p1264, @p1265, @p1266, @p1267, @p1268, @p1269, @p1270, @p1271, @p1272, @p1273, @p1274, @p1275, @p1276, @p1277, @p1278, @p1279, @p1280, @p1281, @p1282, @p1283, @p1284, @p1285, @p1286, @p1287, 22), (@p1288, @p1289, @p1290, @p1291, @p1292, @p1293, @p1294, @p1295, @p1296, @p1297, @p1298, @p1299, @p1300, @p1301, @p1302, @p1303, @p1304, @p1305, @p1306, @p1307, @p1308, @p1309, @p1310, @p1311, @p1312, @p1313, @p1314, @p1315, @p1316, @p1317, @p1318, @p1319, @p1320, @p1321, @p1322, @p1323, @p1324, @p1325, @p1326, @p1327, @p1328, @p1329, @p1330, @p1331, @p1332, @p1333, @p1334, @p1335, @p1336, @p1337, @p1338, @p1339, @p1340, @p1341, @p1342, @p1343, 23), (@p1344, @p1345, @p1346, @p1347, @p1348, @p1349, @p1350, @p1351, @p1352, @p1353, @p1354, @p1355, @p1356, @p1357, @p1358, @p1359, @p1360, @p1361, @p1362, @p1363, @p1364, @p1365, @p1366, @p1367, @p1368, @p1369, @p1370, @p1371, @p1372, @p1373, @p1374, @p1375, @p1376, @p1377, @p1378, @p1379, @p1380, @p1381, @p1382, @p1383, @p1384, @p1385, @p1386, @p1387, @p1388, @p1389, @p1390, @p1391, @p1392, @p1393, @p1394, @p1395, @p1396, @p1397, @p1398, @p1399, 24), (@p1400, @p1401, @p1402, @p1403, @p1404, @p1405, @p1406, @p1407, @p1408, @p1409, @p1410, @p1411, @p1412, @p1413, @p1414, @p1415, @p1416, @p1417, @p1418, @p1419, @p1420, @p1421, @p1422, @p1423, @p1424, @p1425, @p1426, @p1427, @p1428, @p1429, @p1430, @p1431, @p1432, @p1433, @p1434, @p1435, @p1436, @p1437, @p1438, @p1439, @p1440, @p1441, @p1442, @p1443, @p1444, @p1445, @p1446, @p1447, @p1448, @p1449, @p1450, @p1451, @p1452, @p1453, @p1454, @p1455, 25), (@p1456, @p1457, @p1458, @p1459, @p1460, @p1461, @p1462, @p1463, @p1464, @p1465, @p1466, @p1467, @p1468, @p1469, @p1470, @p1471, @p1472, @p1473, @p1474, @p1475, @p1476, @p1477, @p1478, @p1479, @p1480, @p1481, @p1482, @p1483, @p1484, @p1485, @p1486, @p1487, @p1488, @p1489, @p1490, @p1491, @p1492, @p1493, @p1494, @p1495, @p1496, @p1497, @p1498, @p1499, @p1500, @p1501, @p1502, @p1503, @p1504, @p1505, @p1506, @p1507, @p1508, @p1509, @p1510, @p1511, 26), (@p1512, @p1513, @p1514, @p1515, @p1516, @p1517, @p1518, @p1519, @p1520, @p1521, @p1522, @p1523, @p1524, @p1525, @p1526, @p1527, @p1528, @p1529, @p1530, @p1531, @p1532, @p1533, @p1534, @p1535, @p1536, @p1537, @p1538, @p1539, @p1540, @p1541, @p1542, @p1543, @p1544, @p1545, @p1546, @p1547, @p1548, @p1549, @p1550, @p1551, @p1552, @p1553, @p1554, @p1555, @p1556, @p1557, @p1558, @p1559, @p1560, @p1561, @p1562, @p1563, @p1564, @p1565, @p1566, @p1567, 27), (@p1568, @p1569, @p1570, @p1571, @p1572, @p1573, @p1574, @p1575, @p1576, @p1577, @p1578, @p1579, @p1580, @p1581, @p1582, @p1583, @p1584, @p1585, @p1586, @p1587, @p1588, @p1589, @p1590, @p1591, @p1592, @p1593, @p1594, @p1595, @p1596, @p1597, @p1598, @p1599, @p1600, @p1601, @p1602, @p1603, @p1604, @p1605, @p1606, @p1607, @p1608, @p1609, @p1610, @p1611, @p1612, @p1613, @p1614, @p1615, @p1616, @p1617, @p1618, @p1619, @p1620, @p1621, @p1622, @p1623, 28), (@p1624, @p1625, @p1626, @p1627, @p1628, @p1629, @p1630, @p1631, @p1632, @p1633, @p1634, @p1635, @p1636, @p1637, @p1638, @p1639, @p1640, @p1641, @p1642, @p1643, @p1644, @p1645, @p1646, @p1647, @p1648, @p1649, @p1650, @p1651, @p1652, @p1653, @p1654, @p1655, @p1656, @p1657, @p1658, @p1659, @p1660, @p1661, @p1662, @p1663, @p1664, @p1665, @p1666, @p1667, @p1668, @p1669, @p1670, @p1671, @p1672, @p1673, @p1674, @p1675, @p1676, @p1677, @p1678, @p1679, 29), (@p1680, @p1681, @p1682, @p1683, @p1684, @p1685, @p1686, @p1687, @p1688, @p1689, @p1690, @p1691, @p1692, @p1693, @p1694, @p1695, @p1696, @p1697, @p1698, @p1699, @p1700, @p1701, @p1702, @p1703, @p1704, @p1705, @p1706, @p1707, @p1708, @p1709, @p1710, @p1711, @p1712, @p1713, @p1714, @p1715, @p1716, @p1717, @p1718, @p1719, @p1720, @p1721, @p1722, @p1723, @p1724, @p1725, @p1726, @p1727, @p1728, @p1729, @p1730, @p1731, @p1732, @p1733, @p1734, @p1735, 30), (@p1736, @p1737, @p1738, @p1739, @p1740, @p1741, @p1742, @p1743, @p1744, @p1745, @p1746, @p1747, @p1748, @p1749, @p1750, @p1751, @p1752, @p1753, @p1754, @p1755, @p1756, @p1757, @p1758, @p1759, @p1760, @p1761, @p1762, @p1763, @p1764, @p1765, @p1766, @p1767, @p1768, @p1769, @p1770, @p1771, @p1772, @p1773, @p1774, @p1775, @p1776, @p1777, @p1778, @p1779, @p1780, @p1781, @p1782, @p1783, @p1784, @p1785, @p1786, @p1787, @p1788, @p1789, @p1790, @p1791, 31), (@p1792, @p1793, @p1794, @p1795, @p1796, @p1797, @p1798, @p1799, @p1800, @p1801, @p1802, @p1803, @p1804, @p1805, @p1806, @p1807, @p1808, @p1809, @p1810, @p1811, @p1812, @p1813, @p1814, @p1815, @p1816, @p1817, @p1818, @p1819, @p1820, @p1821, @p1822, @p1823, @p1824, @p1825, @p1826, @p1827, @p1828, @p1829, @p1830, @p1831, @p1832, @p1833, @p1834, @p1835, @p1836, @p1837, @p1838, @p1839, @p1840, @p1841, @p1842, @p1843, @p1844, @p1845, @p1846, @p1847, 32), (@p1848, @p1849, @p1850, @p1851, @p1852, @p1853, @p1854, @p1855, @p1856, @p1857, @p1858, @p1859, @p1860, @p1861, @p1862, @p1863, @p1864, @p1865, @p1866, @p1867, @p1868, @p1869, @p1870, @p1871, @p1872, @p1873, @p1874, @p1875, @p1876, @p1877, @p1878, @p1879, @p1880, @p1881, @p1882, @p1883, @p1884, @p1885, @p1886, @p1887, @p1888, @p1889, @p1890, @p1891, @p1892, @p1893, @p1894, @p1895, @p1896, @p1897, @p1898, @p1899, @p1900, @p1901, @p1902, @p1903, 33), (@p1904, @p1905, @p1906, @p1907, @p1908, @p1909, @p1910, @p1911, @p1912, @p1913, @p1914, @p1915, @p1916, @p1917, @p1918, @p1919, @p1920, @p1921, @p1922, @p1923, @p1924, @p1925, @p1926, @p1927, @p1928, @p1929, @p1930, @p1931, @p1932, @p1933, @p1934, @p1935, @p1936, @p1937, @p1938, @p1939, @p1940, @p1941, @p1942, @p1943, @p1944, @p1945, @p1946, @p1947, @p1948, @p1949, @p1950, @p1951, @p1952, @p1953, @p1954, @p1955, @p1956, @p1957, @p1958, @p1959, 34), (@p1960, @p1961, @p1962, @p1963, @p1964, @p1965, @p1966, @p1967, @p1968, @p1969, @p1970, @p1971, @p1972, @p1973, @p1974, @p1975, @p1976, @p1977, @p1978, @p1979, @p1980, @p1981, @p1982, @p1983, @p1984, @p1985, @p1986, @p1987, @p1988, @p1989, @p1990, @p1991, @p1992, @p1993, @p1994, @p1995, @p1996, @p1997, @p1998, @p1999, @p2000, @p2001, @p2002, @p2003, @p2004, @p2005, @p2006, @p2007, @p2008, @p2009, @p2010, @p2011, @p2012, @p2013, @p2014, @p2015, 35), (@p2016, @p2017, @p2018, @p2019, @p2020, @p2021, @p2022, @p2023, @p2024, @p2025, @p2026, @p2027, @p2028, @p2029, @p2030, @p2031, @p2032, @p2033, @p2034, @p2035, @p2036, @p2037, @p2038, @p2039, @p2040, @p2041, @p2042, @p2043, @p2044, @p2045, @p2046, @p2047, @p2048, @p2049, @p2050, @p2051, @p2052, @p2053, @p2054, @p2055, @p2056, @p2057, @p2058, @p2059, @p2060, @p2061, @p2062, @p2063, @p2064, @p2065, @p2066, @p2067, @p2068, @p2069, @p2070, @p2071, 36)) AS i ([addressee_cntry_cd], [addressee_city], [addressee_district], [addressee_email], [addressee_full_address], [addressee_home_address], [addressee_name], [addressee_postcode], [addressee_province], [addressee_subdistrict], [addressee_tel], [create_table], [delivery_code], [delivery_recipient_name], [delivery_relation_id], [delivery_status_id], [dest_outlet_id], [dest_outlet_port], [document_number], [item_barcode], [item_cod], [item_gross_weight], [item_height], [item_length], [item_price], [item_width], [lat], [log_id], [long], [outlet_id], [outlet_port], [podUrl], [remark], [scan_cntry_cd], [scan_cntry_postcode], [sender_cntry_cd], [sender_district], [sender_email], [sender_full_address], [sender_home_address], [member_id], [sender_name], [sender_postcode], [sender_province], [sender_subdistrict], [sender_tel], [server_id], [signatureUrl], [state], [status_code], [status_dtm], [timestamp], [transmit_dtm], [user_id], [wckt_id], [wkstn_no], _Position) ON 1=0 WHEN NOT MATCHED THEN INSERT ([addressee_cntry_cd], [addressee_city], [addressee_district], [addressee_email], [addressee_full_address], [addressee_home_address], [addressee_name], [addressee_postcode], [addressee_province], [addressee_subdistrict], [addressee_tel], [create_table], [delivery_code], [delivery_recipient_name], [delivery_relation_id], [delivery_status_id], [dest_outlet_id], [dest_outlet_port], [document_number], [item_barcode], [item_cod], [item_gross_weight], [item_height], [item_length], [item_price], [item_width], [lat], [log_id], [long], [outlet_id], [outlet_port], [podUrl], [remark], [scan_cntry_cd], [scan_cntry_postcode], [sender_cntry_cd], [sender_district], [sender_email], [sender_full_address], [sender_home_address], [member_id], [sender_name], [sender_postcode], [sender_province], [sender_subdistrict], [sender_tel], [server_id], [signatureUrl], [state], [status_code], [status_dtm], [timestamp], [transmit_dtm], [user_id], [wckt_id], [wkstn_no]) VALUES (i.[addressee_cntry_cd], i.[addressee_city], i.[addressee_district], i.[addressee_email], i.[addressee_full_address], i.[addressee_home_address], i.[addressee_name], i.[addressee_postcode], i.[addressee_province], i.[addressee_subdistrict], i.[addressee_tel], i.[create_table], i.[delivery_code], i.[delivery_recipient_name], i.[delivery_relation_id], i.[delivery_status_id], i.[dest_outlet_id], i.[dest_outlet_port], i.[document_number], i.[item_barcode], i.[item_cod], i.[item_gross_weight], i.[item_height], i.[item_length], i.[item_price], i.[item_width], i.[lat], i.[log_id], i.[long], i.[outlet_id], i.[outlet_port], i.[podUrl], i.[remark], i.[scan_cntry_cd], i.[scan_cntry_postcode], i.[sender_cntry_cd], i.[sender_district], i.[sender_email], i.[sender_full_address], i.[sender_home_address], i.[member_id], i.[sender_name], i.[sender_postcode], i.[sender_province], i.[sender_subdistrict], i.[sender_tel], i.[server_id], i.[signatureUrl], i.[state], i.[status_code], i.[status_dtm], i.[timestamp], i.[transmit_dtm], i.[user_id], i.[wckt_id], i.[wkstn_no]) OUTPUT INSERTED.[item_id], i._Position INTO @inserted0;  SELECT [t].[item_id] FROM [raw_data] t INNER JOIN @inserted0 i ON ([t].[item_id] = [i].[item_id]) ORDER BY [i].[_Position];  ",4,4,0,430,3,4
"(@p0 nvarchar(4000),@p1 nvarchar(4000),@p2 nvarchar(4000),@p3 nvarchar(4000),@p4 nvarchar(4000),@p5 nvarchar(4000),@p6 nvarchar(4000),@p7 nvarchar(4000),@p8 nvarchar(4000),@p9 nvarchar(4000),@p10 nvarchar(4000),@p11 datetime2(7),@p12 nvarchar(4000),@p13 nvarchar(4000),@p14 int,@p15 int,@p16 int,@p17 nvarchar(4000),@p18 nvarchar(4000),@p19 nvarchar(4000),@p20 decimal(18,2),@p21 decimal(18,2),@p22 nvarchar(4000),@p23 nvarchar(4000),@p24 decimal(18,2),@p25 nvarchar(4000),@p26 nvarchar(4000),@p27 nvarchar(4000),@p28 nvarchar(4000),@p29 int,@p30 nvarchar(4000),@p31 nvarchar(4000),@p32 nvarchar(4000),@p33 nvarchar(4000),@p34 nvarchar(4000),@p35 nvarchar(4000),@p36 nvarchar(4000),@p37 nvarchar(4000),@p38 nvarchar(4000),@p39 nvarchar(4000),@p40 int,@p41 nvarchar(4000),@p42 nvarchar(4000),@p43 nvarchar(4000),@p44 nvarchar(4000),@p45 nvarchar(4000),@p46 int,@p47 nvarchar(4000),@p48 int,@p49 int,@p50 datetime2(7),@p51 datetime2(7),@p52 datetime2(7),@p53 nvarchar(4000),@p54 nvarchar(4000),@p55 nvarchar(4000),@p56 nvarchar(4000),@p57 nvarchar(4000),@p58 nvarchar(4000),@p59 nvarchar(4000),@p60 nvarchar(4000),@p61 nvarchar(4000),@p62 nvarchar(4000),@p63 nvarchar(4000),@p64 nvarchar(4000),@p65 nvarchar(4000),@p66 nvarchar(4000),@p67 datetime2(7),@p68 nvarchar(4000),@p69 nvarchar(4000),@p70 int,@p71 int,@p72 int,@p73 nvarchar(4000),@p74 nvarchar(4000),@p75 nvarchar(4000),@p76 decimal(18,2),@p77 decimal(18,2),@p78 nvarchar(4000),@p79 nvarchar(4000),@p80 decimal(18,2),@p81 nvarchar(4000),@p82 nvarchar(4000),@p83 nvarchar(4000),@p84 nvarchar(4000),@p85 int,@p86 nvarchar(4000),@p87 nvarchar(4000),@p88 nvarchar(4000),@p89 nvarchar(4000),@p90 nvarchar(4000),@p91 nvarchar(4000),@p92 nvarchar(4000),@p93 nvarchar(4000),@p94 nvarchar(4000),@p95 nvarchar(4000),@p96 int,@p97 nvarchar(4000),@p98 nvarchar(4000),@p99 nvarchar(4000),@p100 nvarchar(4000),@p101 nvarchar(4000),@p102 int,@p103 nvarchar(4000),@p104 int,@p105 int,@p106 datetime2(7),@p107 datetime2(7),@p108 datetime2(7),@p109 nvarchar(4000),@p110 nvarchar(4000),@p111 nvarchar(4000),@p112 nvarchar(4000),@p113 nvarchar(4000),@p114 nvarchar(4000),@p115 nvarchar(4000),@p116 nvarchar(4000),@p117 nvarchar(4000),@p118 nvarchar(4000),@p119 nvarchar(4000),@p120 nvarchar(4000),@p121 nvarchar(4000),@p122 nvarchar(4000),@p123 datetime2(7),@p124 nvarchar(4000),@p125 nvarchar(4000),@p126 int,@p127 int,@p128 int,@p129 nvarchar(4000),@p130 nvarchar(4000),@p131 nvarchar(4000),@p132 decimal(18,2),@p133 decimal(18,2),@p134 nvarchar(4000),@p135 nvarchar(4000),@p136 decimal(18,2),@p137 nvarchar(4000),@p138 nvarchar(4000),@p139 nvarchar(4000),@p140 nvarchar(4000),@p141 int,@p142 nvarchar(4000),@p143 nvarchar(4000),@p144 nvarchar(4000),@p145 nvarchar(4000),@p146 nvarchar(4000),@p147 nvarchar(4000),@p148 nvarchar(4000),@p149 nvarchar(4000),@p150 nvarchar(4000),@p151 nvarchar(4000),@p152 int,@p153 nvarchar(4000),@p154 nvarchar(4000),@p155 nvarchar(4000),@p156 nvarchar(4000),@p157 nvarchar(4000),@p158 int,@p159 nvarchar(4000),@p160 int,@p161 int,@p162 datetime2(7),@p163 datetime2(7),@p164 datetime2(7),@p165 nvarchar(4000),@p166 nvarchar(4000),@p167 nvarchar(4000),@p168 nvarchar(4000),@p169 nvarchar(4000),@p170 nvarchar(4000),@p171 nvarchar(4000),@p172 nvarchar(4000),@p173 nvarchar(4000),@p174 nvarchar(4000),@p175 nvarchar(4000),@p176 nvarchar(4000),@p177 nvarchar(4000),@p178 nvarchar(4000),@p179 datetime2(7),@p180 nvarchar(4000),@p181 nvarchar(4000),@p182 int,@p183 int,@p184 int,@p185 nvarchar(4000),@p186 nvarchar(4000),@p187 nvarchar(4000),@p188 decimal(18,2),@p189 decimal(18,2),@p190 nvarchar(4000),@p191 nvarchar(4000),@p192 decimal(18,2),@p193 nvarchar(4000),@p194 nvarchar(4000),@p195 nvarchar(4000),@p196 nvarchar(4000),@p197 int,@p198 nvarchar(4000),@p199 nvarchar(4000),@p200 nvarchar(4000),@p201 nvarchar(4000),@p202 nvarchar(4000),@p203 nvarchar(4000),@p204 nvarchar(4000),@p205 nvarchar(4000),@p206 nvarchar(4000),@p207 nvarchar(4000),@p208 int,@p209 nvarchar(4000),@p210 nvarchar(4000),@p211 nvarchar(4000),@p212 nvarchar(4000),@p213 nvarchar(4000),@p214 int,@p215 nvarchar(4000),@p216 int,@p217 int,@p218 datetime2(7),@p219 datetime2(7),@p220 datetime2(7),@p221 nvarchar(4000),@p222 nvarchar(4000),@p223 nvarchar(4000),@p224 nvarchar(4000),@p225 nvarchar(4000),@p226 nvarchar(4000),@p227 nvarchar(4000),@p228 nvarchar(4000),@p229 nvarchar(4000),@p230 nvarchar(4000),@p231 nvarchar(4000),@p232 nvarchar(4000),@p233 nvarchar(4000),@p234 nvarchar(4000),@p235 datetime2(7),@p236 nvarchar(4000),@p237 nvarchar(4000),@p238 int,@p239 int,@p240 int,@p241 nvarchar(4000),@p242 nvarchar(4000),@p243 nvarchar(4000),@p244 decimal(18,2),@p245 decimal(18,2),@p246 nvarchar(4000),@p247 nvarchar(4000),@p248 decimal(18,2),@p249 nvarchar(4000),@p250 nvarchar(4000),@p251 nvarchar(4000),@p252 nvarchar(4000),@p253 int,@p254 nvarchar(4000),@p255 nvarchar(4000),@p256 nvarchar(4000),@p257 nvarchar(4000),@p258 nvarchar(4000),@p259 nvarchar(4000),@p260 nvarchar(4000),@p261 nvarchar(4000),@p262 nvarchar(4000),@p263 nvarchar(4000),@p264 int,@p265 nvarchar(4000),@p266 nvarchar(4000),@p267 nvarchar(4000),@p268 nvarchar(4000),@p269 nvarchar(4000),@p270 int,@p271 nvarchar(4000),@p272 int,@p273 int,@p274 datetime2(7),@p275 datetime2(7),@p276 datetime2(7),@p277 nvarchar(4000),@p278 nvarchar(4000),@p279 nvarchar(4000),@p280 nvarchar(4000),@p281 nvarchar(4000),@p282 nvarchar(4000),@p283 nvarchar(4000),@p284 nvarchar(4000),@p285 nvarchar(4000),@p286 nvarchar(4000),@p287 nvarchar(4000),@p288 nvarchar(4000),@p289 nvarchar(4000),@p290 nvarchar(4000),@p291 datetime2(7),@p292 nvarchar(4000),@p293 nvarchar(4000),@p294 int,@p295 int,@p296 int,@p297 nvarchar(4000),@p298 nvarchar(4000),@p299 nvarchar(4000),@p300 decimal(18,2),@p301 decimal(18,2),@p302 nvarchar(4000),@p303 nvarchar(4000),@p304 decimal(18,2),@p305 nvarchar(4000),@p306 nvarchar(4000),@p307 nvarchar(4000),@p308 nvarchar(4000),@p309 int,@p310 nvarchar(4000),@p311 nvarchar(4000),@p312 nvarchar(4000),@p313 nvarchar(4000),@p314 nvarchar(4000),@p315 nvarchar(4000),@p316 nvarchar(4000),@p317 nvarchar(4000),@p318 nvarchar(4000),@p319 nvarchar(4000),@p320 int,@p321 nvarchar(4000),@p322 nvarchar(4000),@p323 nvarchar(4000),@p324 nvarchar(4000),@p325 nvarchar(4000),@p326 int,@p327 nvarchar(4000),@p328 int,@p329 int,@p330 datetime2(7),@p331 datetime2(7),@p332 datetime2(7),@p333 nvarchar(4000),@p334 nvarchar(4000),@p335 nvarchar(4000),@p336 nvarchar(4000),@p337 nvarchar(4000),@p338 nvarchar(4000),@p339 nvarchar(4000),@p340 nvarchar(4000),@p341 nvarchar(4000),@p342 nvarchar(4000),@p343 nvarchar(4000),@p344 nvarchar(4000),@p345 nvarchar(4000),@p346 nvarchar(4000),@p347 datetime2(7),@p348 nvarchar(4000),@p349 nvarchar(4000),@p350 int,@p351 int,@p352 int,@p353 nvarchar(4000),@p354 nvarchar(4000),@p355 nvarchar(4000),@p356 decimal(18,2),@p357 decimal(18,2),@p358 nvarchar(4000),@p359 nvarchar(4000),@p360 decimal(18,2),@p361 nvarchar(4000),@p362 nvarchar(4000),@p363 nvarchar(4000),@p364 nvarchar(4000),@p365 int,@p366 nvarchar(4000),@p367 nvarchar(4000),@p368 nvarchar(4000),@p369 nvarchar(4000),@p370 nvarchar(4000),@p371 nvarchar(4000),@p372 nvarchar(4000),@p373 nvarchar(4000),@p374 nvarchar(4000),@p375 nvarchar(4000),@p376 int,@p377 nvarchar(4000),@p378 nvarchar(4000),@p379 nvarchar(4000),@p380 nvarchar(4000),@p381 nvarchar(4000),@p382 int,@p383 nvarchar(4000),@p384 int,@p385 int,@p386 datetime2(7),@p387 datetime2(7),@p388 datetime2(7),@p389 nvarchar(4000),@p390 nvarchar(4000),@p391 nvarchar(4000),@p392 nvarchar(4000),@p393 nvarchar(4000),@p394 nvarchar(4000),@p395 nvarchar(4000),@p396 nvarchar(4000),@p397 nvarchar(4000),@p398 nvarchar(4000),@p399 nvarchar(4000),@p400 nvarchar(4000),@p401 nvarchar(4000),@p402 nvarchar(4000),@p403 datetime2(7),@p404 nvarchar(4000),@p405 nvarchar(4000),@p406 int,@p407 int,@p408 int,@p409 nvarchar(4000),@p410 nvarchar(4000),@p411 nvarchar(4000),@p412 decimal(18,2),@p413 decimal(18,2),@p414 nvarchar(4000),@p415 nvarchar(4000),@p416 decimal(18,2),@p417 nvarchar(4000),@p418 nvarchar(4000),@p419 nvarchar(4000),@p420 nvarchar(4000),@p421 int,@p422 nvarchar(4000),@p423 nvarchar(4000),@p424 nvarchar(4000),@p425 nvarchar(4000),@p426 nvarchar(4000),@p427 nvarchar(4000),@p428 nvarchar(4000),@p429 nvarchar(4000),@p430 nvarchar(4000),@p431 nvarchar(4000),@p432 int,@p433 nvarchar(4000),@p434 nvarchar(4000),@p435 nvarchar(4000),@p436 nvarchar(4000),@p437 nvarchar(4000),@p438 int,@p439 nvarchar(4000),@p440 int,@p441 int,@p442 datetime2(7),@p443 datetime2(7),@p444 datetime2(7),@p445 nvarchar(4000),@p446 nvarchar(4000),@p447 nvarchar(4000),@p448 nvarchar(4000),@p449 nvarchar(4000),@p450 nvarchar(4000),@p451 nvarchar(4000),@p452 nvarchar(4000),@p453 nvarchar(4000),@p454 nvarchar(4000),@p455 nvarchar(4000),@p456 nvarchar(4000),@p457 nvarchar(4000),@p458 nvarchar(4000),@p459 datetime2(7),@p460 nvarchar(4000),@p461 nvarchar(4000),@p462 int,@p463 int,@p464 int,@p465 nvarchar(4000),@p466 nvarchar(4000),@p467 nvarchar(4000),@p468 nvarchar(4000),@p469 decimal(18,2),@p470 nvarchar(4000),@p471 nvarchar(4000),@p472 decimal(18,2),@p473 nvarchar(4000),@p474 nvarchar(4000),@p475 nvarchar(4000),@p476 nvarchar(4000),@p477 int,@p478 nvarchar(4000),@p479 nvarchar(4000),@p480 nvarchar(4000),@p481 nvarchar(4000),@p482 nvarchar(4000),@p483 nvarchar(4000),@p484 nvarchar(4000),@p485 nvarchar(4000),@p486 nvarchar(4000),@p487 nvarchar(4000),@p488 int,@p489 nvarchar(4000),@p490 nvarchar(4000),@p491 nvarchar(4000),@p492 nvarchar(4000),@p493 nvarchar(4000),@p494 int,@p495 nvarchar(4000),@p496 int,@p497 int,@p498 datetime2(7),@p499 datetime2(7),@p500 datetime2(7),@p501 nvarchar(4000),@p502 nvarchar(4000),@p503 nvarchar(4000),@p504 nvarchar(4000),@p505 nvarchar(4000),@p506 nvarchar(4000),@p507 nvarchar(4000),@p508 nvarchar(4000),@p509 nvarchar(4000),@p510 nvarchar(4000),@p511 nvarchar(4000),@p512 nvarchar(4000),@p513 nvarchar(4000),@p514 nvarchar(4000),@p515 datetime2(7),@p516 nvarchar(4000),@p517 nvarchar(4000),@p518 int,@p519 int,@p520 int,@p521 nvarchar(4000),@p522 nvarchar(4000),@p523 nvarchar(4000),@p524 nvarchar(4000),@p525 decimal(18,2),@p526 nvarchar(4000),@p527 nvarchar(4000),@p528 decimal(18,2),@p529 nvarchar(4000),@p530 nvarchar(4000),@p531 nvarchar(4000),@p532 nvarchar(4000),@p533 int,@p534 nvarchar(4000),@p535 nvarchar(4000),@p536 nvarchar(4000),@p537 nvarchar(4000),@p538 nvarchar(4000),@p539 nvarchar(4000),@p540 nvarchar(4000),@p541 nvarchar(4000),@p542 nvarchar(4000),@p543 nvarchar(4000),@p544 int,@p545 nvarchar(4000),@p546 nvarchar(4000),@p547 nvarchar(4000),@p548 nvarchar(4000),@p549 nvarchar(4000),@p550 int,@p551 nvarchar(4000),@p552 int,@p553 int,@p554 datetime2(7),@p555 datetime2(7),@p556 datetime2(7),@p557 nvarchar(4000),@p558 nvarchar(4000),@p559 nvarchar(4000),@p560 nvarchar(4000),@p561 nvarchar(4000),@p562 nvarchar(4000),@p563 nvarchar(4000),@p564 nvarchar(4000),@p565 nvarchar(4000),@p566 nvarchar(4000),@p567 nvarchar(4000),@p568 nvarchar(4000),@p569 nvarchar(4000),@p570 nvarchar(4000),@p571 datetime2(7),@p572 nvarchar(4000),@p573 nvarchar(4000),@p574 int,@p575 int,@p576 int,@p577 nvarchar(4000),@p578 nvarchar(4000),@p579 nvarchar(4000),@p580 nvarchar(4000),@p581 decimal(18,2),@p582 nvarchar(4000),@p583 nvarchar(4000),@p584 decimal(18,2),@p585 nvarchar(4000),@p586 nvarchar(4000),@p587 nvarchar(4000),@p588 nvarchar(4000),@p589 int,@p590 nvarchar(4000),@p591 nvarchar(4000),@p592 nvarchar(4000),@p593 nvarchar(4000),@p594 nvarchar(4000),@p595 nvarchar(4000),@p596 nvarchar(4000),@p597 nvarchar(4000),@p598 nvarchar(4000),@p599 nvarchar(4000),@p600 int,@p601 nvarchar(4000),@p602 nvarchar(4000),@p603 nvarchar(4000),@p604 nvarchar(4000),@p605 nvarchar(4000),@p606 int,@p607 nvarchar(4000),@p608 int,@p609 int,@p610 datetime2(7),@p611 datetime2(7),@p612 datetime2(7),@p613 nvarchar(4000),@p614 nvarchar(4000),@p615 nvarchar(4000),@p616 nvarchar(4000),@p617 nvarchar(4000),@p618 nvarchar(4000),@p619 nvarchar(4000),@p620 nvarchar(4000),@p621 nvarchar(4000),@p622 nvarchar(4000),@p623 nvarchar(4000),@p624 nvarchar(4000),@p625 nvarchar(4000),@p626 nvarchar(4000),@p627 datetime2(7),@p628 nvarchar(4000),@p629 nvarchar(4000),@p630 int,@p631 int,@p632 int,@p633 nvarchar(4000),@p634 nvarchar(4000),@p635 nvarchar(4000),@p636 nvarchar(4000),@p637 decimal(18,2),@p638 nvarchar(4000),@p639 nvarchar(4000),@p640 decimal(18,2),@p641 nvarchar(4000),@p642 nvarchar(4000),@p643 nvarchar(4000),@p644 nvarchar(4000),@p645 int,@p646 nvarchar(4000),@p647 nvarchar(4000),@p648 nvarchar(4000),@p649 nvarchar(4000),@p650 nvarchar(4000),@p651 nvarchar(4000),@p652 nvarchar(4000),@p653 nvarchar(4000),@p654 nvarchar(4000),@p655 nvarchar(4000),@p656 int,@p657 nvarchar(4000),@p658 nvarchar(4000),@p659 nvarchar(4000),@p660 nvarchar(4000),@p661 nvarchar(4000),@p662 int,@p663 nvarchar(4000),@p664 int,@p665 int,@p666 datetime2(7),@p667 datetime2(7),@p668 datetime2(7),@p669 nvarchar(4000),@p670 nvarchar(4000),@p671 nvarchar(4000),@p672 nvarchar(4000),@p673 nvarchar(4000),@p674 nvarchar(4000),@p675 nvarchar(4000),@p676 nvarchar(4000),@p677 nvarchar(4000),@p678 nvarchar(4000),@p679 nvarchar(4000),@p680 nvarchar(4000),@p681 nvarchar(4000),@p682 nvarchar(4000),@p683 datetime2(7),@p684 nvarchar(4000),@p685 nvarchar(4000),@p686 int,@p687 int,@p688 int,@p689 nvarchar(4000),@p690 nvarchar(4000),@p691 nvarchar(4000),@p692 nvarchar(4000),@p693 decimal(18,2),@p694 nvarchar(4000),@p695 nvarchar(4000),@p696 decimal(18,2),@p697 nvarchar(4000),@p698 nvarchar(4000),@p699 nvarchar(4000),@p700 nvarchar(4000),@p701 int,@p702 nvarchar(4000),@p703 nvarchar(4000),@p704 nvarchar(4000),@p705 nvarchar(4000),@p706 nvarchar(4000),@p707 nvarchar(4000),@p708 nvarchar(4000),@p709 nvarchar(4000),@p710 nvarchar(4000),@p711 nvarchar(4000),@p712 int,@p713 nvarchar(4000),@p714 nvarchar(4000),@p715 nvarchar(4000),@p716 nvarchar(4000),@p717 nvarchar(4000),@p718 int,@p719 nvarchar(4000),@p720 int,@p721 int,@p722 datetime2(7),@p723 datetime2(7),@p724 datetime2(7),@p725 nvarchar(4000),@p726 nvarchar(4000),@p727 nvarchar(4000),@p728 nvarchar(4000),@p729 nvarchar(4000),@p730 nvarchar(4000),@p731 nvarchar(4000),@p732 nvarchar(4000),@p733 nvarchar(4000),@p734 nvarchar(4000),@p735 nvarchar(4000),@p736 nvarchar(4000),@p737 nvarchar(4000),@p738 nvarchar(4000),@p739 datetime2(7),@p740 nvarchar(4000),@p741 nvarchar(4000),@p742 int,@p743 int,@p744 int,@p745 nvarchar(4000),@p746 nvarchar(4000),@p747 nvarchar(4000),@p748 nvarchar(4000),@p749 decimal(18,2),@p750 nvarchar(4000),@p751 nvarchar(4000),@p752 decimal(18,2),@p753 nvarchar(4000),@p754 nvarchar(4000),@p755 nvarchar(4000),@p756 nvarchar(4000),@p757 int,@p758 nvarchar(4000),@p759 nvarchar(4000),@p760 nvarchar(4000),@p761 nvarchar(4000),@p762 nvarchar(4000),@p763 nvarchar(4000),@p764 nvarchar(4000),@p765 nvarchar(4000),@p766 nvarchar(4000),@p767 nvarchar(4000),@p768 int,@p769 nvarchar(4000),@p770 nvarchar(4000),@p771 nvarchar(4000),@p772 nvarchar(4000),@p773 nvarchar(4000),@p774 int,@p775 nvarchar(4000),@p776 int,@p777 int,@p778 datetime2(7),@p779 datetime2(7),@p780 datetime2(7),@p781 nvarchar(4000),@p782 nvarchar(4000),@p783 nvarchar(4000),@p784 nvarchar(4000),@p785 nvarchar(4000),@p786 nvarchar(4000),@p787 nvarchar(4000),@p788 nvarchar(4000),@p789 nvarchar(4000),@p790 nvarchar(4000),@p791 nvarchar(4000),@p792 nvarchar(4000),@p793 nvarchar(4000),@p794 nvarchar(4000),@p795 datetime2(7),@p796 nvarchar(4000),@p797 nvarchar(4000),@p798 int,@p799 int,@p800 int,@p801 nvarchar(4000),@p802 nvarchar(4000),@p803 nvarchar(4000),@p804 nvarchar(4000),@p805 decimal(18,2),@p806 nvarchar(4000),@p807 nvarchar(4000),@p808 decimal(18,2),@p809 nvarchar(4000),@p810 nvarchar(4000),@p811 nvarchar(4000),@p812 nvarchar(4000),@p813 int,@p814 nvarchar(4000),@p815 nvarchar(4000),@p816 nvarchar(4000),@p817 nvarchar(4000),@p818 nvarchar(4000),@p819 nvarchar(4000),@p820 nvarchar(4000),@p821 nvarchar(4000),@p822 nvarchar(4000),@p823 nvarchar(4000),@p824 int,@p825 nvarchar(4000),@p826 nvarchar(4000),@p827 nvarchar(4000),@p828 nvarchar(4000),@p829 nvarchar(4000),@p830 int,@p831 nvarchar(4000),@p832 int,@p833 int,@p834 datetime2(7),@p835 datetime2(7),@p836 datetime2(7),@p837 nvarchar(4000),@p838 nvarchar(4000),@p839 nvarchar(4000),@p840 nvarchar(4000),@p841 nvarchar(4000),@p842 nvarchar(4000),@p843 nvarchar(4000),@p844 nvarchar(4000),@p845 nvarchar(4000),@p846 nvarchar(4000),@p847 nvarchar(4000),@p848 nvarchar(4000),@p849 nvarchar(4000),@p850 nvarchar(4000),@p851 datetime2(7),@p852 nvarchar(4000),@p853 nvarchar(4000),@p854 int,@p855 int,@p856 int,@p857 nvarchar(4000),@p858 nvarchar(4000),@p859 nvarchar(4000),@p860 nvarchar(4000),@p861 decimal(18,2),@p862 nvarchar(4000),@p863 nvarchar(4000),@p864 decimal(18,2),@p865 nvarchar(4000),@p866 nvarchar(4000),@p867 nvarchar(4000),@p868 nvarchar(4000),@p869 int,@p870 nvarchar(4000),@p871 nvarchar(4000),@p872 nvarchar(4000),@p873 nvarchar(4000),@p874 nvarchar(4000),@p875 nvarchar(4000),@p876 nvarchar(4000),@p877 nvarchar(4000),@p878 nvarchar(4000),@p879 nvarchar(4000),@p880 int,@p881 nvarchar(4000),@p882 nvarchar(4000),@p883 nvarchar(4000),@p884 nvarchar(4000),@p885 nvarchar(4000),@p886 int,@p887 nvarchar(4000),@p888 int,@p889 int,@p890 datetime2(7),@p891 datetime2(7),@p892 datetime2(7),@p893 nvarchar(4000),@p894 nvarchar(4000),@p895 nvarchar(4000),@p896 nvarchar(4000),@p897 nvarchar(4000),@p898 nvarchar(4000),@p899 nvarchar(4000),@p900 nvarchar(4000),@p901 nvarchar(4000),@p902 nvarchar(4000),@p903 nvarchar(4000),@p904 nvarchar(4000),@p905 nvarchar(4000),@p906 nvarchar(4000),@p907 datetime2(7),@p908 nvarchar(4000),@p909 nvarchar(4000),@p910 int,@p911 int,@p912 int,@p913 nvarchar(4000),@p914 nvarchar(4000),@p915 nvarchar(4000),@p916 decimal(18,2),@p917 decimal(18,2),@p918 nvarchar(4000),@p919 nvarchar(4000),@p920 decimal(18,2),@p921 nvarchar(4000),@p922 nvarchar(4000),@p923 nvarchar(4000),@p924 nvarchar(4000),@p925 int,@p926 nvarchar(4000),@p927 nvarchar(4000),@p928 nvarchar(4000),@p929 nvarchar(4000),@p930 nvarchar(4000),@p931 nvarchar(4000),@p932 nvarchar(4000),@p933 nvarchar(4000),@p934 nvarchar(4000),@p935 nvarchar(4000),@p936 int,@p937 nvarchar(4000),@p938 nvarchar(4000),@p939 nvarchar(4000),@p940 nvarchar(4000),@p941 nvarchar(4000),@p942 int,@p943 nvarchar(4000),@p944 int,@p945 int,@p946 datetime2(7),@p947 datetime2(7),@p948 datetime2(7),@p949 nvarchar(4000),@p950 nvarchar(4000),@p951 nvarchar(4000),@p952 nvarchar(4000),@p953 nvarchar(4000),@p954 nvarchar(4000),@p955 nvarchar(4000),@p956 nvarchar(4000),@p957 nvarchar(4000),@p958 nvarchar(4000),@p959 nvarchar(4000),@p960 nvarchar(4000),@p961 nvarchar(4000),@p962 nvarchar(4000),@p963 datetime2(7),@p964 nvarchar(4000),@p965 nvarchar(4000),@p966 int,@p967 int,@p968 int,@p969 nvarchar(4000),@p970 nvarchar(4000),@p971 nvarchar(4000),@p972 decimal(18,2),@p973 decimal(18,2),@p974 nvarchar(4000),@p975 nvarchar(4000),@p976 decimal(18,2),@p977 nvarchar(4000),@p978 nvarchar(4000),@p979 nvarchar(4000),@p980 nvarchar(4000),@p981 int,@p982 nvarchar(4000),@p983 nvarchar(4000),@p984 nvarchar(4000),@p985 nvarchar(4000),@p986 nvarchar(4000),@p987 nvarchar(4000),@p988 nvarchar(4000),@p989 nvarchar(4000),@p990 nvarchar(4000),@p991 nvarchar(4000),@p992 int,@p993 nvarchar(4000),@p994 nvarchar(4000),@p995 nvarchar(4000),@p996 nvarchar(4000),@p997 nvarchar(4000),@p998 int,@p999 nvarchar(4000),@p1000 int,@p1001 int,@p1002 datetime2(7),@p1003 datetime2(7),@p1004 datetime2(7),@p1005 nvarchar(4000),@p1006 nvarchar(4000),@p1007 nvarchar(4000),@p1008 nvarchar(4000),@p1009 nvarchar(4000),@p1010 nvarchar(4000),@p1011 nvarchar(4000),@p1012 nvarchar(4000),@p1013 nvarchar(4000),@p1014 nvarchar(4000),@p1015 nvarchar(4000),@p1016 nvarchar(4000),@p1017 nvarchar(4000),@p1018 nvarchar(4000),@p1019 datetime2(7),@p1020 nvarchar(4000),@p1021 nvarchar(4000),@p1022 int,@p1023 int,@p1024 int,@p1025 nvarchar(4000),@p1026 nvarchar(4000),@p1027 nvarchar(4000),@p1028 decimal(18,2),@p1029 decimal(18,2),@p1030 nvarchar(4000),@p1031 nvarchar(4000),@p1032 decimal(18,2),@p1033 nvarchar(4000),@p1034 nvarchar(4000),@p1035 nvarchar(4000),@p1036 nvarchar(4000),@p1037 int,@p1038 nvarchar(4000),@p1039 nvarchar(4000),@p1040 nvarchar(4000),@p1041 nvarchar(4000),@p1042 nvarchar(4000),@p1043 nvarchar(4000),@p1044 nvarchar(4000),@p1045 nvarchar(4000),@p1046 nvarchar(4000),@p1047 nvarchar(4000),@p1048 int,@p1049 nvarchar(4000),@p1050 nvarchar(4000),@p1051 nvarchar(4000),@p1052 nvarchar(4000),@p1053 nvarchar(4000),@p1054 int,@p1055 nvarchar(4000),@p1056 int,@p1057 int,@p1058 datetime2(7),@p1059 datetime2(7),@p1060 datetime2(7),@p1061 nvarchar(4000),@p1062 nvarchar(4000),@p1063 nvarchar(4000),@p1064 nvarchar(4000),@p1065 nvarchar(4000),@p1066 nvarchar(4000),@p1067 nvarchar(4000),@p1068 nvarchar(4000),@p1069 nvarchar(4000),@p1070 nvarchar(4000),@p1071 nvarchar(4000),@p1072 nvarchar(4000),@p1073 nvarchar(4000),@p1074 nvarchar(4000),@p1075 datetime2(7),@p1076 nvarchar(4000),@p1077 nvarchar(4000),@p1078 int,@p1079 int,@p1080 int,@p1081 nvarchar(4000),@p1082 nvarchar(4000),@p1083 nvarchar(4000),@p1084 decimal(18,2),@p1085 decimal(18,2),@p1086 nvarchar(4000),@p1087 nvarchar(4000),@p1088 decimal(18,2),@p1089 nvarchar(4000),@p1090 nvarchar(4000),@p1091 nvarchar(4000),@p1092 nvarchar(4000),@p1093 int,@p1094 nvarchar(4000),@p1095 nvarchar(4000),@p1096 nvarchar(4000),@p1097 nvarchar(4000),@p1098 nvarchar(4000),@p1099 nvarchar(4000),@p1100 nvarchar(4000),@p1101 nvarchar(4000),@p1102 nvarchar(4000),@p1103 nvarchar(4000),@p1104 int,@p1105 nvarchar(4000),@p1106 nvarchar(4000),@p1107 nvarchar(4000),@p1108 nvarchar(4000),@p1109 nvarchar(4000),@p1110 int,@p1111 nvarchar(4000),@p1112 int,@p1113 int,@p1114 datetime2(7),@p1115 datetime2(7),@p1116 datetime2(7),@p1117 nvarchar(4000),@p1118 nvarchar(4000),@p1119 nvarchar(4000),@p1120 nvarchar(4000),@p1121 nvarchar(4000),@p1122 nvarchar(4000),@p1123 nvarchar(4000),@p1124 nvarchar(4000),@p1125 nvarchar(4000),@p1126 nvarchar(4000),@p1127 nvarchar(4000),@p1128 nvarchar(4000),@p1129 nvarchar(4000),@p1130 nvarchar(4000),@p1131 datetime2(7),@p1132 nvarchar(4000),@p1133 nvarchar(4000),@p1134 int,@p1135 int,@p1136 int,@p1137 nvarchar(4000),@p1138 nvarchar(4000),@p1139 nvarchar(4000),@p1140 decimal(18,2),@p1141 decimal(18,2),@p1142 nvarchar(4000),@p1143 nvarchar(4000),@p1144 decimal(18,2),@p1145 nvarchar(4000),@p1146 nvarchar(4000),@p1147 nvarchar(4000),@p1148 nvarchar(4000),@p1149 int,@p1150 nvarchar(4000),@p1151 nvarchar(4000),@p1152 nvarchar(4000),@p1153 nvarchar(4000),@p1154 nvarchar(4000),@p1155 nvarchar(4000),@p1156 nvarchar(4000),@p1157 nvarchar(4000),@p1158 nvarchar(4000),@p1159 nvarchar(4000),@p1160 int,@p1161 nvarchar(4000),@p1162 nvarchar(4000),@p1163 nvarchar(4000),@p1164 nvarchar(4000),@p1165 nvarchar(4000),@p1166 int,@p1167 nvarchar(4000),@p1168 int,@p1169 int,@p1170 datetime2(7),@p1171 datetime2(7),@p1172 datetime2(7),@p1173 nvarchar(4000),@p1174 nvarchar(4000),@p1175 nvarchar(4000),@p1176 nvarchar(4000),@p1177 nvarchar(4000),@p1178 nvarchar(4000),@p1179 nvarchar(4000),@p1180 nvarchar(4000),@p1181 nvarchar(4000),@p1182 nvarchar(4000),@p1183 nvarchar(4000),@p1184 nvarchar(4000),@p1185 nvarchar(4000),@p1186 nvarchar(4000),@p1187 datetime2(7),@p1188 nvarchar(4000),@p1189 nvarchar(4000),@p1190 int,@p1191 int,@p1192 int,@p1193 nvarchar(4000),@p1194 nvarchar(4000),@p1195 nvarchar(4000),@p1196 decimal(18,2),@p1197 decimal(18,2),@p1198 nvarchar(4000),@p1199 nvarchar(4000),@p1200 decimal(18,2),@p1201 nvarchar(4000),@p1202 nvarchar(4000),@p1203 nvarchar(4000),@p1204 nvarchar(4000),@p1205 int,@p1206 nvarchar(4000),@p1207 nvarchar(4000),@p1208 nvarchar(4000),@p1209 nvarchar(4000),@p1210 nvarchar(4000),@p1211 nvarchar(4000),@p1212 nvarchar(4000),@p1213 nvarchar(4000),@p1214 nvarchar(4000),@p1215 nvarchar(4000),@p1216 int,@p1217 nvarchar(4000),@p1218 nvarchar(4000),@p1219 nvarchar(4000),@p1220 nvarchar(4000),@p1221 nvarchar(4000),@p1222 int,@p1223 nvarchar(4000),@p1224 int,@p1225 int,@p1226 datetime2(7),@p1227 datetime2(7),@p1228 datetime2(7),@p1229 nvarchar(4000),@p1230 nvarchar(4000),@p1231 nvarchar(4000),@p1232 nvarchar(4000),@p1233 nvarchar(4000),@p1234 nvarchar(4000),@p1235 nvarchar(4000),@p1236 nvarchar(4000),@p1237 nvarchar(4000),@p1238 nvarchar(4000),@p1239 nvarchar(4000),@p1240 nvarchar(4000),@p1241 nvarchar(4000),@p1242 nvarchar(4000),@p1243 datetime2(7),@p1244 nvarchar(4000),@p1245 nvarchar(4000),@p1246 int,@p1247 int,@p1248 int,@p1249 nvarchar(4000),@p1250 nvarchar(4000),@p1251 nvarchar(4000),@p1252 decimal(18,2),@p1253 decimal(18,2),@p1254 nvarchar(4000),@p1255 nvarchar(4000),@p1256 decimal(18,2),@p1257 nvarchar(4000),@p1258 nvarchar(4000),@p1259 nvarchar(4000),@p1260 nvarchar(4000),@p1261 int,@p1262 nvarchar(4000),@p1263 nvarchar(4000),@p1264 nvarchar(4000),@p1265 nvarchar(4000),@p1266 nvarchar(4000),@p1267 nvarchar(4000),@p1268 nvarchar(4000),@p1269 nvarchar(4000),@p1270 nvarchar(4000),@p1271 nvarchar(4000),@p1272 int,@p1273 nvarchar(4000),@p1274 nvarchar(4000),@p1275 nvarchar(4000),@p1276 nvarchar(4000),@p1277 nvarchar(4000),@p1278 int,@p1279 nvarchar(4000),@p1280 int,@p1281 int,@p1282 datetime2(7),@p1283 datetime2(7),@p1284 datetime2(7),@p1285 nvarchar(4000),@p1286 nvarchar(4000),@p1287 nvarchar(4000),@p1288 nvarchar(4000),@p1289 nvarchar(4000),@p1290 nvarchar(4000),@p1291 nvarchar(4000),@p1292 nvarchar(4000),@p1293 nvarchar(4000),@p1294 nvarchar(4000),@p1295 nvarchar(4000),@p1296 nvarchar(4000),@p1297 nvarchar(4000),@p1298 nvarchar(4000),@p1299 datetime2(7),@p1300 nvarchar(4000),@p1301 nvarchar(4000),@p1302 int,@p1303 int,@p1304 int,@p1305 nvarchar(4000),@p1306 nvarchar(4000),@p1307 nvarchar(4000),@p1308 decimal(18,2),@p1309 decimal(18,2),@p1310 nvarchar(4000),@p1311 nvarchar(4000),@p1312 decimal(18,2),@p1313 nvarchar(4000),@p1314 nvarchar(4000),@p1315 nvarchar(4000),@p1316 nvarchar(4000),@p1317 int,@p1318 nvarchar(4000),@p1319 nvarchar(4000),@p1320 nvarchar(4000),@p1321 nvarchar(4000),@p1322 nvarchar(4000),@p1323 nvarchar(4000),@p1324 nvarchar(4000),@p1325 nvarchar(4000),@p1326 nvarchar(4000),@p1327 nvarchar(4000),@p1328 int,@p1329 nvarchar(4000),@p1330 nvarchar(4000),@p1331 nvarchar(4000),@p1332 nvarchar(4000),@p1333 nvarchar(4000),@p1334 int,@p1335 nvarchar(4000),@p1336 int,@p1337 int,@p1338 datetime2(7),@p1339 datetime2(7),@p1340 datetime2(7),@p1341 nvarchar(4000),@p1342 nvarchar(4000),@p1343 nvarchar(4000),@p1344 nvarchar(4000),@p1345 nvarchar(4000),@p1346 nvarchar(4000),@p1347 nvarchar(4000),@p1348 nvarchar(4000),@p1349 nvarchar(4000),@p1350 nvarchar(4000),@p1351 nvarchar(4000),@p1352 nvarchar(4000),@p1353 nvarchar(4000),@p1354 nvarchar(4000),@p1355 datetime2(7),@p1356 nvarchar(4000),@p1357 nvarchar(4000),@p1358 int,@p1359 int,@p1360 int,@p1361 nvarchar(4000),@p1362 nvarchar(4000),@p1363 nvarchar(4000),@p1364 decimal(18,2),@p1365 decimal(18,2),@p1366 nvarchar(4000),@p1367 nvarchar(4000),@p1368 decimal(18,2),@p1369 nvarchar(4000),@p1370 nvarchar(4000),@p1371 nvarchar(4000),@p1372 nvarchar(4000),@p1373 int,@p1374 nvarchar(4000),@p1375 nvarchar(4000),@p1376 nvarchar(4000),@p1377 nvarchar(4000),@p1378 nvarchar(4000),@p1379 nvarchar(4000),@p1380 nvarchar(4000),@p1381 nvarchar(4000),@p1382 nvarchar(4000),@p1383 nvarchar(4000),@p1384 int,@p1385 nvarchar(4000),@p1386 nvarchar(4000),@p1387 nvarchar(4000),@p1388 nvarchar(4000),@p1389 nvarchar(4000),@p1390 int,@p1391 nvarchar(4000),@p1392 int,@p1393 int,@p1394 datetime2(7),@p1395 datetime2(7),@p1396 datetime2(7),@p1397 nvarchar(4000),@p1398 nvarchar(4000),@p1399 nvarchar(4000),@p1400 nvarchar(4000),@p1401 nvarchar(4000),@p1402 nvarchar(4000),@p1403 nvarchar(4000),@p1404 nvarchar(4000),@p1405 nvarchar(4000),@p1406 nvarchar(4000),@p1407 nvarchar(4000),@p1408 nvarchar(4000),@p1409 nvarchar(4000),@p1410 nvarchar(4000),@p1411 datetime2(7),@p1412 nvarchar(4000),@p1413 nvarchar(4000),@p1414 int,@p1415 int,@p1416 int,@p1417 nvarchar(4000),@p1418 nvarchar(4000),@p1419 nvarchar(4000),@p1420 nvarchar(4000),@p1421 decimal(18,2),@p1422 nvarchar(4000),@p1423 nvarchar(4000),@p1424 decimal(18,2),@p1425 nvarchar(4000),@p1426 nvarchar(4000),@p1427 nvarchar(4000),@p1428 nvarchar(4000),@p1429 int,@p1430 nvarchar(4000),@p1431 nvarchar(4000),@p1432 nvarchar(4000),@p1433 nvarchar(4000),@p1434 nvarchar(4000),@p1435 nvarchar(4000),@p1436 nvarchar(4000),@p1437 nvarchar(4000),@p1438 nvarchar(4000),@p1439 nvarchar(4000),@p1440 int,@p1441 nvarchar(4000),@p1442 nvarchar(4000),@p1443 nvarchar(4000),@p1444 nvarchar(4000),@p1445 nvarchar(4000),@p1446 int,@p1447 nvarchar(4000),@p1448 int,@p1449 int,@p1450 datetime2(7),@p1451 datetime2(7),@p1452 datetime2(7),@p1453 nvarchar(4000),@p1454 nvarchar(4000),@p1455 nvarchar(4000),@p1456 nvarchar(4000),@p1457 nvarchar(4000),@p1458 nvarchar(4000),@p1459 nvarchar(4000),@p1460 nvarchar(4000),@p1461 nvarchar(4000),@p1462 nvarchar(4000),@p1463 nvarchar(4000),@p1464 nvarchar(4000),@p1465 nvarchar(4000),@p1466 nvarchar(4000),@p1467 datetime2(7),@p1468 nvarchar(4000),@p1469 nvarchar(4000),@p1470 int,@p1471 int,@p1472 int,@p1473 nvarchar(4000),@p1474 nvarchar(4000),@p1475 nvarchar(4000),@p1476 nvarchar(4000),@p1477 decimal(18,2),@p1478 nvarchar(4000),@p1479 nvarchar(4000),@p1480 decimal(18,2),@p1481 nvarchar(4000),@p1482 nvarchar(4000),@p1483 nvarchar(4000),@p1484 nvarchar(4000),@p1485 int,@p1486 nvarchar(4000),@p1487 nvarchar(4000),@p1488 nvarchar(4000),@p1489 nvarchar(4000),@p1490 nvarchar(4000),@p1491 nvarchar(4000),@p1492 nvarchar(4000),@p1493 nvarchar(4000),@p1494 nvarchar(4000),@p1495 nvarchar(4000),@p1496 int,@p1497 nvarchar(4000),@p1498 nvarchar(4000),@p1499 nvarchar(4000),@p1500 nvarchar(4000),@p1501 nvarchar(4000),@p1502 int,@p1503 nvarchar(4000),@p1504 int,@p1505 int,@p1506 datetime2(7),@p1507 datetime2(7),@p1508 datetime2(7),@p1509 nvarchar(4000),@p1510 nvarchar(4000),@p1511 nvarchar(4000),@p1512 nvarchar(4000),@p1513 nvarchar(4000),@p1514 nvarchar(4000),@p1515 nvarchar(4000),@p1516 nvarchar(4000),@p1517 nvarchar(4000),@p1518 nvarchar(4000),@p1519 nvarchar(4000),@p1520 nvarchar(4000),@p1521 nvarchar(4000),@p1522 nvarchar(4000),@p1523 datetime2(7),@p1524 nvarchar(4000),@p1525 nvarchar(4000),@p1526 int,@p1527 int,@p1528 int,@p1529 nvarchar(4000),@p1530 nvarchar(4000),@p1531 nvarchar(4000),@p1532 nvarchar(4000),@p1533 decimal(18,2),@p1534 nvarchar(4000),@p1535 nvarchar(4000),@p1536 decimal(18,2),@p1537 nvarchar(4000),@p1538 nvarchar(4000),@p1539 nvarchar(4000),@p1540 nvarchar(4000),@p1541 int,@p1542 nvarchar(4000),@p1543 nvarchar(4000),@p1544 nvarchar(4000),@p1545 nvarchar(4000),@p1546 nvarchar(4000),@p1547 nvarchar(4000),@p1548 nvarchar(4000),@p1549 nvarchar(4000),@p1550 nvarchar(4000),@p1551 nvarchar(4000),@p1552 int,@p1553 nvarchar(4000),@p1554 nvarchar(4000),@p1555 nvarchar(4000),@p1556 nvarchar(4000),@p1557 nvarchar(4000),@p1558 int,@p1559 nvarchar(4000),@p1560 int,@p1561 int,@p1562 datetime2(7),@p1563 datetime2(7),@p1564 datetime2(7),@p1565 nvarchar(4000),@p1566 nvarchar(4000),@p1567 nvarchar(4000),@p1568 nvarchar(4000),@p1569 nvarchar(4000),@p1570 nvarchar(4000),@p1571 nvarchar(4000),@p1572 nvarchar(4000),@p1573 nvarchar(4000),@p1574 nvarchar(4000),@p1575 nvarchar(4000),@p1576 nvarchar(4000),@p1577 nvarchar(4000),@p1578 nvarchar(4000),@p1579 datetime2(7),@p1580 nvarchar(4000),@p1581 nvarchar(4000),@p1582 int,@p1583 int,@p1584 int,@p1585 nvarchar(4000),@p1586 nvarchar(4000),@p1587 nvarchar(4000),@p1588 nvarchar(4000),@p1589 decimal(18,2),@p1590 nvarchar(4000),@p1591 nvarchar(4000),@p1592 decimal(18,2),@p1593 nvarchar(4000),@p1594 nvarchar(4000),@p1595 nvarchar(4000),@p1596 nvarchar(4000),@p1597 int,@p1598 nvarchar(4000),@p1599 nvarchar(4000),@p1600 nvarchar(4000),@p1601 nvarchar(4000),@p1602 nvarchar(4000),@p1603 nvarchar(4000),@p1604 nvarchar(4000),@p1605 nvarchar(4000),@p1606 nvarchar(4000),@p1607 nvarchar(4000),@p1608 int,@p1609 nvarchar(4000),@p1610 nvarchar(4000),@p1611 nvarchar(4000),@p1612 nvarchar(4000),@p1613 nvarchar(4000),@p1614 int,@p1615 nvarchar(4000),@p1616 int,@p1617 int,@p1618 datetime2(7),@p1619 datetime2(7),@p1620 datetime2(7),@p1621 nvarchar(4000),@p1622 nvarchar(4000),@p1623 nvarchar(4000),@p1624 nvarchar(4000),@p1625 nvarchar(4000),@p1626 nvarchar(4000),@p1627 nvarchar(4000),@p1628 nvarchar(4000),@p1629 nvarchar(4000),@p1630 nvarchar(4000),@p1631 nvarchar(4000),@p1632 nvarchar(4000),@p1633 nvarchar(4000),@p1634 nvarchar(4000),@p1635 datetime2(7),@p1636 nvarchar(4000),@p1637 nvarchar(4000),@p1638 int,@p1639 int,@p1640 int,@p1641 nvarchar(4000),@p1642 nvarchar(4000),@p1643 nvarchar(4000),@p1644 nvarchar(4000),@p1645 decimal(18,2),@p1646 nvarchar(4000),@p1647 nvarchar(4000),@p1648 decimal(18,2),@p1649 nvarchar(4000),@p1650 nvarchar(4000),@p1651 nvarchar(4000),@p1652 nvarchar(4000),@p1653 int,@p1654 nvarchar(4000),@p1655 nvarchar(4000),@p1656 nvarchar(4000),@p1657 nvarchar(4000),@p1658 nvarchar(4000),@p1659 nvarchar(4000),@p1660 nvarchar(4000),@p1661 nvarchar(4000),@p1662 nvarchar(4000),@p1663 nvarchar(4000),@p1664 int,@p1665 nvarchar(4000),@p1666 nvarchar(4000),@p1667 nvarchar(4000),@p1668 nvarchar(4000),@p1669 nvarchar(4000),@p1670 int,@p1671 nvarchar(4000),@p1672 int,@p1673 int,@p1674 datetime2(7),@p1675 datetime2(7),@p1676 datetime2(7),@p1677 nvarchar(4000),@p1678 nvarchar(4000),@p1679 nvarchar(4000),@p1680 nvarchar(4000),@p1681 nvarchar(4000),@p1682 nvarchar(4000),@p1683 nvarchar(4000),@p1684 nvarchar(4000),@p1685 nvarchar(4000),@p1686 nvarchar(4000),@p1687 nvarchar(4000),@p1688 nvarchar(4000),@p1689 nvarchar(4000),@p1690 nvarchar(4000),@p1691 datetime2(7),@p1692 nvarchar(4000),@p1693 nvarchar(4000),@p1694 int,@p1695 int,@p1696 int,@p1697 nvarchar(4000),@p1698 nvarchar(4000),@p1699 nvarchar(4000),@p1700 nvarchar(4000),@p1701 decimal(18,2),@p1702 nvarchar(4000),@p1703 nvarchar(4000),@p1704 decimal(18,2),@p1705 nvarchar(4000),@p1706 nvarchar(4000),@p1707 nvarchar(4000),@p1708 nvarchar(4000),@p1709 int,@p1710 nvarchar(4000),@p1711 nvarchar(4000),@p1712 nvarchar(4000),@p1713 nvarchar(4000),@p1714 nvarchar(4000),@p1715 nvarchar(4000),@p1716 nvarchar(4000),@p1717 nvarchar(4000),@p1718 nvarchar(4000),@p1719 nvarchar(4000),@p1720 int,@p1721 nvarchar(4000),@p1722 nvarchar(4000),@p1723 nvarchar(4000),@p1724 nvarchar(4000),@p1725 nvarchar(4000),@p1726 int,@p1727 nvarchar(4000),@p1728 int,@p1729 int,@p1730 datetime2(7),@p1731 datetime2(7),@p1732 datetime2(7),@p1733 nvarchar(4000),@p1734 nvarchar(4000),@p1735 nvarchar(4000),@p1736 nvarchar(4000),@p1737 nvarchar(4000),@p1738 nvarchar(4000),@p1739 nvarchar(4000),@p1740 nvarchar(4000),@p1741 nvarchar(4000),@p1742 nvarchar(4000),@p1743 nvarchar(4000),@p1744 nvarchar(4000),@p1745 nvarchar(4000),@p1746 nvarchar(4000),@p1747 datetime2(7),@p1748 nvarchar(4000),@p1749 nvarchar(4000),@p1750 int,@p1751 int,@p1752 int,@p1753 nvarchar(4000),@p1754 nvarchar(4000),@p1755 nvarchar(4000),@p1756 nvarchar(4000),@p1757 decimal(18,2),@p1758 nvarchar(4000),@p1759 nvarchar(4000),@p1760 decimal(18,2),@p1761 nvarchar(4000),@p1762 nvarchar(4000),@p1763 nvarchar(4000),@p1764 nvarchar(4000),@p1765 int,@p1766 nvarchar(4000),@p1767 nvarchar(4000),@p1768 nvarchar(4000),@p1769 nvarchar(4000),@p1770 nvarchar(4000),@p1771 nvarchar(4000),@p1772 nvarchar(4000),@p1773 nvarchar(4000),@p1774 nvarchar(4000),@p1775 nvarchar(4000),@p1776 int,@p1777 nvarchar(4000),@p1778 nvarchar(4000),@p1779 nvarchar(4000),@p1780 nvarchar(4000),@p1781 nvarchar(4000),@p1782 int,@p1783 nvarchar(4000),@p1784 int,@p1785 int,@p1786 datetime2(7),@p1787 datetime2(7),@p1788 datetime2(7),@p1789 nvarchar(4000),@p1790 nvarchar(4000),@p1791 nvarchar(4000),@p1792 nvarchar(4000),@p1793 nvarchar(4000),@p1794 nvarchar(4000),@p1795 nvarchar(4000),@p1796 nvarchar(4000),@p1797 nvarchar(4000),@p1798 nvarchar(4000),@p1799 nvarchar(4000),@p1800 nvarchar(4000),@p1801 nvarchar(4000),@p1802 nvarchar(4000),@p1803 datetime2(7),@p1804 nvarchar(4000),@p1805 nvarchar(4000),@p1806 int,@p1807 int,@p1808 int,@p1809 nvarchar(4000),@p1810 nvarchar(4000),@p1811 nvarchar(4000),@p1812 nvarchar(4000),@p1813 decimal(18,2),@p1814 nvarchar(4000),@p1815 nvarchar(4000),@p1816 decimal(18,2),@p1817 nvarchar(4000),@p1818 nvarchar(4000),@p1819 nvarchar(4000),@p1820 nvarchar(4000),@p1821 int,@p1822 nvarchar(4000),@p1823 nvarchar(4000),@p1824 nvarchar(4000),@p1825 nvarchar(4000),@p1826 nvarchar(4000),@p1827 nvarchar(4000),@p1828 nvarchar(4000),@p1829 nvarchar(4000),@p1830 nvarchar(4000),@p1831 nvarchar(4000),@p1832 int,@p1833 nvarchar(4000),@p1834 nvarchar(4000),@p1835 nvarchar(4000),@p1836 nvarchar(4000),@p1837 nvarchar(4000),@p1838 int,@p1839 nvarchar(4000),@p1840 int,@p1841 int,@p1842 datetime2(7),@p1843 datetime2(7),@p1844 datetime2(7),@p1845 nvarchar(4000),@p1846 nvarchar(4000),@p1847 nvarchar(4000),@p1848 nvarchar(4000),@p1849 nvarchar(4000),@p1850 nvarchar(4000),@p1851 nvarchar(4000),@p1852 nvarchar(4000),@p1853 nvarchar(4000),@p1854 nvarchar(4000),@p1855 nvarchar(4000),@p1856 nvarchar(4000),@p1857 nvarchar(4000),@p1858 nvarchar(4000),@p1859 datetime2(7),@p1860 nvarchar(4000),@p1861 nvarchar(4000),@p1862 int,@p1863 int,@p1864 int,@p1865 nvarchar(4000),@p1866 nvarchar(4000),@p1867 nvarchar(4000),@p1868 nvarchar(4000),@p1869 decimal(18,2),@p1870 nvarchar(4000),@p1871 nvarchar(4000),@p1872 decimal(18,2),@p1873 nvarchar(4000),@p1874 nvarchar(4000),@p1875 nvarchar(4000),@p1876 nvarchar(4000),@p1877 int,@p1878 nvarchar(4000),@p1879 nvarchar(4000),@p1880 nvarchar(4000),@p1881 nvarchar(4000),@p1882 nvarchar(4000),@p1883 nvarchar(4000),@p1884 nvarchar(4000),@p1885 nvarchar(4000),@p1886 nvarchar(4000),@p1887 nvarchar(4000),@p1888 int,@p1889 nvarchar(4000),@p1890 nvarchar(4000),@p1891 nvarchar(4000),@p1892 nvarchar(4000),@p1893 nvarchar(4000),@p1894 int,@p1895 nvarchar(4000),@p1896 int,@p1897 int,@p1898 datetime2(7),@p1899 datetime2(7),@p1900 datetime2(7),@p1901 nvarchar(4000),@p1902 nvarchar(4000),@p1903 nvarchar(4000),@p1904 nvarchar(4000),@p1905 nvarchar(4000),@p1906 nvarchar(4000),@p1907 nvarchar(4000),@p1908 nvarchar(4000),@p1909 nvarchar(4000),@p1910 nvarchar(4000),@p1911 nvarchar(4000),@p1912 nvarchar(4000),@p1913 nvarchar(4000),@p1914 nvarchar(4000),@p1915 datetime2(7),@p1916 nvarchar(4000),@p1917 nvarchar(4000),@p1918 int,@p1919 int,@p1920 int,@p1921 nvarchar(4000),@p1922 nvarchar(4000),@p1923 nvarchar(4000),@p1924 nvarchar(4000),@p1925 decimal(18,2),@p1926 nvarchar(4000),@p1927 nvarchar(4000),@p1928 decimal(18,2),@p1929 nvarchar(4000),@p1930 nvarchar(4000),@p1931 nvarchar(4000),@p1932 nvarchar(4000),@p1933 int,@p1934 nvarchar(4000),@p1935 nvarchar(4000),@p1936 nvarchar(4000),@p1937 nvarchar(4000),@p1938 nvarchar(4000),@p1939 nvarchar(4000),@p1940 nvarchar(4000),@p1941 nvarchar(4000),@p1942 nvarchar(4000),@p1943 nvarchar(4000),@p1944 int,@p1945 nvarchar(4000),@p1946 nvarchar(4000),@p1947 nvarchar(4000),@p1948 nvarchar(4000),@p1949 nvarchar(4000),@p1950 int,@p1951 nvarchar(4000),@p1952 int,@p1953 int,@p1954 datetime2(7),@p1955 datetime2(7),@p1956 datetime2(7),@p1957 nvarchar(4000),@p1958 nvarchar(4000),@p1959 nvarchar(4000),@p1960 nvarchar(4000),@p1961 nvarchar(4000),@p1962 nvarchar(4000),@p1963 nvarchar(4000),@p1964 nvarchar(4000),@p1965 nvarchar(4000),@p1966 nvarchar(4000),@p1967 nvarchar(4000),@p1968 nvarchar(4000),@p1969 nvarchar(4000),@p1970 nvarchar(4000),@p1971 datetime2(7),@p1972 nvarchar(4000),@p1973 nvarchar(4000),@p1974 int,@p1975 int,@p1976 int,@p1977 nvarchar(4000),@p1978 nvarchar(4000),@p1979 nvarchar(4000),@p1980 nvarchar(4000),@p1981 decimal(18,2),@p1982 nvarchar(4000),@p1983 nvarchar(4000),@p1984 decimal(18,2),@p1985 nvarchar(4000),@p1986 nvarchar(4000),@p1987 nvarchar(4000),@p1988 nvarchar(4000),@p1989 int,@p1990 nvarchar(4000),@p1991 nvarchar(4000),@p1992 nvarchar(4000),@p1993 nvarchar(4000),@p1994 nvarchar(4000),@p1995 nvarchar(4000),@p1996 nvarchar(4000),@p1997 nvarchar(4000),@p1998 nvarchar(4000),@p1999 nvarchar(4000),@p2000 int,@p2001 nvarchar(4000),@p2002 nvarchar(4000),@p2003 nvarchar(4000),@p2004 nvarchar(4000),@p2005 nvarchar(4000),@p2006 int,@p2007 nvarchar(4000),@p2008 int,@p2009 int,@p2010 datetime2(7),@p2011 datetime2(7),@p2012 datetime2(7),@p2013 nvarchar(4000),@p2014 nvarchar(4000),@p2015 nvarchar(4000),@p2016 nvarchar(4000),@p2017 nvarchar(4000),@p2018 nvarchar(4000),@p2019 nvarchar(4000),@p2020 nvarchar(4000),@p2021 nvarchar(4000),@p2022 nvarchar(4000),@p2023 nvarchar(4000),@p2024 nvarchar(4000),@p2025 nvarchar(4000),@p2026 nvarchar(4000),@p2027 datetime2(7),@p2028 nvarchar(4000),@p2029 nvarchar(4000),@p2030 int,@p2031 int,@p2032 int,@p2033 nvarchar(4000),@p2034 nvarchar(4000),@p2035 nvarchar(4000),@p2036 nvarchar(4000),@p2037 decimal(18,2),@p2038 nvarchar(4000),@p2039 nvarchar(4000),@p2040 decimal(18,2),@p2041 nvarchar(4000),@p2042 nvarchar(4000),@p2043 nvarchar(4000),@p2044 nvarchar(4000),@p2045 int,@p2046 nvarchar(4000),@p2047 nvarchar(4000),@p2048 nvarchar(4000),@p2049 nvarchar(4000),@p2050 nvarchar(4000),@p2051 nvarchar(4000),@p2052 nvarchar(4000),@p2053 nvarchar(4000),@p2054 nvarchar(4000),@p2055 nvarchar(4000),@p2056 int,@p2057 nvarchar(4000),@p2058 nvarchar(4000),@p2059 nvarchar(4000),@p2060 nvarchar(4000),@p2061 nvarchar(4000),@p2062 int,@p2063 nvarchar(4000),@p2064 int,@p2065 int,@p2066 datetime2(7),@p2067 datetime2(7),@p2068 datetime2(7),@p2069 nvarchar(4000),@p2070 nvarchar(4000),@p2071 nvarchar(4000))SET NOCOUNT ON; DECLARE @inserted0 TABLE ([item_id] int, [_Position] [int]); MERGE [raw_data] USING ( VALUES (@p0, @p1, @p2, @p3, @p4, @p5, @p6, @p7, @p8, @p9, @p10, @p11, @p12, @p13, @p14, @p15, @p16, @p17, @p18, @p19, @p20, @p21, @p22, @p23, @p24, @p25, @p26, @p27, @p28, @p29, @p30, @p31, @p32, @p33, @p34, @p35, @p36, @p37, @p38, @p39, @p40, @p41, @p42, @p43, @p44, @p45, @p46, @p47, @p48, @p49, @p50, @p51, @p52, @p53, @p54, @p55, 0), (@p56, @p57, @p58, @p59, @p60, @p61, @p62, @p63, @p64, @p65, @p66, @p67, @p68, @p69, @p70, @p71, @p72, @p73, @p74, @p75, @p76, @p77, @p78, @p79, @p80, @p81, @p82, @p83, @p84, @p85, @p86, @p87, @p88, @p89, @p90, @p91, @p92, @p93, @p94, @p95, @p96, @p97, @p98, @p99, @p100, @p101, @p102, @p103, @p104, @p105, @p106, @p107, @p108, @p109, @p110, @p111, 1), (@p112, @p113, @p114, @p115, @p116, @p117, @p118, @p119, @p120, @p121, @p122, @p123, @p124, @p125, @p126, @p127, @p128, @p129, @p130, @p131, @p132, @p133, @p134, @p135, @p136, @p137, @p138, @p139, @p140, @p141, @p142, @p143, @p144, @p145, @p146, @p147, @p148, @p149, @p150, @p151, @p152, @p153, @p154, @p155, @p156, @p157, @p158, @p159, @p160, @p161, @p162, @p163, @p164, @p165, @p166, @p167, 2), (@p168, @p169, @p170, @p171, @p172, @p173, @p174, @p175, @p176, @p177, @p178, @p179, @p180, @p181, @p182, @p183, @p184, @p185, @p186, @p187, @p188, @p189, @p190, @p191, @p192, @p193, @p194, @p195, @p196, @p197, @p198, @p199, @p200, @p201, @p202, @p203, @p204, @p205, @p206, @p207, @p208, @p209, @p210, @p211, @p212, @p213, @p214, @p215, @p216, @p217, @p218, @p219, @p220, @p221, @p222, @p223, 3), (@p224, @p225, @p226, @p227, @p228, @p229, @p230, @p231, @p232, @p233, @p234, @p235, @p236, @p237, @p238, @p239, @p240, @p241, @p242, @p243, @p244, @p245, @p246, @p247, @p248, @p249, @p250, @p251, @p252, @p253, @p254, @p255, @p256, @p257, @p258, @p259, @p260, @p261, @p262, @p263, @p264, @p265, @p266, @p267, @p268, @p269, @p270, @p271, @p272, @p273, @p274, @p275, @p276, @p277, @p278, @p279, 4), (@p280, @p281, @p282, @p283, @p284, @p285, @p286, @p287, @p288, @p289, @p290, @p291, @p292, @p293, @p294, @p295, @p296, @p297, @p298, @p299, @p300, @p301, @p302, @p303, @p304, @p305, @p306, @p307, @p308, @p309, @p310, @p311, @p312, @p313, @p314, @p315, @p316, @p317, @p318, @p319, @p320, @p321, @p322, @p323, @p324, @p325, @p326, @p327, @p328, @p329, @p330, @p331, @p332, @p333, @p334, @p335, 5), (@p336, @p337, @p338, @p339, @p340, @p341, @p342, @p343, @p344, @p345, @p346, @p347, @p348, @p349, @p350, @p351, @p352, @p353, @p354, @p355, @p356, @p357, @p358, @p359, @p360, @p361, @p362, @p363, @p364, @p365, @p366, @p367, @p368, @p369, @p370, @p371, @p372, @p373, @p374, @p375, @p376, @p377, @p378, @p379, @p380, @p381, @p382, @p383, @p384, @p385, @p386, @p387, @p388, @p389, @p390, @p391, 6), (@p392, @p393, @p394, @p395, @p396, @p397, @p398, @p399, @p400, @p401, @p402, @p403, @p404, @p405, @p406, @p407, @p408, @p409, @p410, @p411, @p412, @p413, @p414, @p415, @p416, @p417, @p418, @p419, @p420, @p421, @p422, @p423, @p424, @p425, @p426, @p427, @p428, @p429, @p430, @p431, @p432, @p433, @p434, @p435, @p436, @p437, @p438, @p439, @p440, @p441, @p442, @p443, @p444, @p445, @p446, @p447, 7), (@p448, @p449, @p450, @p451, @p452, @p453, @p454, @p455, @p456, @p457, @p458, @p459, @p460, @p461, @p462, @p463, @p464, @p465, @p466, @p467, @p468, @p469, @p470, @p471, @p472, @p473, @p474, @p475, @p476, @p477, @p478, @p479, @p480, @p481, @p482, @p483, @p484, @p485, @p486, @p487, @p488, @p489, @p490, @p491, @p492, @p493, @p494, @p495, @p496, @p497, @p498, @p499, @p500, @p501, @p502, @p503, 8), (@p504, @p505, @p506, @p507, @p508, @p509, @p510, @p511, @p512, @p513, @p514, @p515, @p516, @p517, @p518, @p519, @p520, @p521, @p522, @p523, @p524, @p525, @p526, @p527, @p528, @p529, @p530, @p531, @p532, @p533, @p534, @p535, @p536, @p537, @p538, @p539, @p540, @p541, @p542, @p543, @p544, @p545, @p546, @p547, @p548, @p549, @p550, @p551, @p552, @p553, @p554, @p555, @p556, @p557, @p558, @p559, 9), (@p560, @p561, @p562, @p563, @p564, @p565, @p566, @p567, @p568, @p569, @p570, @p571, @p572, @p573, @p574, @p575, @p576, @p577, @p578, @p579, @p580, @p581, @p582, @p583, @p584, @p585, @p586, @p587, @p588, @p589, @p590, @p591, @p592, @p593, @p594, @p595, @p596, @p597, @p598, @p599, @p600, @p601, @p602, @p603, @p604, @p605, @p606, @p607, @p608, @p609, @p610, @p611, @p612, @p613, @p614, @p615, 10), (@p616, @p617, @p618, @p619, @p620, @p621, @p622, @p623, @p624, @p625, @p626, @p627, @p628, @p629, @p630, @p631, @p632, @p633, @p634, @p635, @p636, @p637, @p638, @p639, @p640, @p641, @p642, @p643, @p644, @p645, @p646, @p647, @p648, @p649, @p650, @p651, @p652, @p653, @p654, @p655, @p656, @p657, @p658, @p659, @p660, @p661, @p662, @p663, @p664, @p665, @p666, @p667, @p668, @p669, @p670, @p671, 11), (@p672, @p673, @p674, @p675, @p676, @p677, @p678, @p679, @p680, @p681, @p682, @p683, @p684, @p685, @p686, @p687, @p688, @p689, @p690, @p691, @p692, @p693, @p694, @p695, @p696, @p697, @p698, @p699, @p700, @p701, @p702, @p703, @p704, @p705, @p706, @p707, @p708, @p709, @p710, @p711, @p712, @p713, @p714, @p715, @p716, @p717, @p718, @p719, @p720, @p721, @p722, @p723, @p724, @p725, @p726, @p727, 12), (@p728, @p729, @p730, @p731, @p732, @p733, @p734, @p735, @p736, @p737, @p738, @p739, @p740, @p741, @p742, @p743, @p744, @p745, @p746, @p747, @p748, @p749, @p750, @p751, @p752, @p753, @p754, @p755, @p756, @p757, @p758, @p759, @p760, @p761, @p762, @p763, @p764, @p765, @p766, @p767, @p768, @p769, @p770, @p771, @p772, @p773, @p774, @p775, @p776, @p777, @p778, @p779, @p780, @p781, @p782, @p783, 13), (@p784, @p785, @p786, @p787, @p788, @p789, @p790, @p791, @p792, @p793, @p794, @p795, @p796, @p797, @p798, @p799, @p800, @p801, @p802, @p803, @p804, @p805, @p806, @p807, @p808, @p809, @p810, @p811, @p812, @p813, @p814, @p815, @p816, @p817, @p818, @p819, @p820, @p821, @p822, @p823, @p824, @p825, @p826, @p827, @p828, @p829, @p830, @p831, @p832, @p833, @p834, @p835, @p836, @p837, @p838, @p839, 14), (@p840, @p841, @p842, @p843, @p844, @p845, @p846, @p847, @p848, @p849, @p850, @p851, @p852, @p853, @p854, @p855, @p856, @p857, @p858, @p859, @p860, @p861, @p862, @p863, @p864, @p865, @p866, @p867, @p868, @p869, @p870, @p871, @p872, @p873, @p874, @p875, @p876, @p877, @p878, @p879, @p880, @p881, @p882, @p883, @p884, @p885, @p886, @p887, @p888, @p889, @p890, @p891, @p892, @p893, @p894, @p895, 15), (@p896, @p897, @p898, @p899, @p900, @p901, @p902, @p903, @p904, @p905, @p906, @p907, @p908, @p909, @p910, @p911, @p912, @p913, @p914, @p915, @p916, @p917, @p918, @p919, @p920, @p921, @p922, @p923, @p924, @p925, @p926, @p927, @p928, @p929, @p930, @p931, @p932, @p933, @p934, @p935, @p936, @p937, @p938, @p939, @p940, @p941, @p942, @p943, @p944, @p945, @p946, @p947, @p948, @p949, @p950, @p951, 16), (@p952, @p953, @p954, @p955, @p956, @p957, @p958, @p959, @p960, @p961, @p962, @p963, @p964, @p965, @p966, @p967, @p968, @p969, @p970, @p971, @p972, @p973, @p974, @p975, @p976, @p977, @p978, @p979, @p980, @p981, @p982, @p983, @p984, @p985, @p986, @p987, @p988, @p989, @p990, @p991, @p992, @p993, @p994, @p995, @p996, @p997, @p998, @p999, @p1000, @p1001, @p1002, @p1003, @p1004, @p1005, @p1006, @p1007, 17), (@p1008, @p1009, @p1010, @p1011, @p1012, @p1013, @p1014, @p1015, @p1016, @p1017, @p1018, @p1019, @p1020, @p1021, @p1022, @p1023, @p1024, @p1025, @p1026, @p1027, @p1028, @p1029, @p1030, @p1031, @p1032, @p1033, @p1034, @p1035, @p1036, @p1037, @p1038, @p1039, @p1040, @p1041, @p1042, @p1043, @p1044, @p1045, @p1046, @p1047, @p1048, @p1049, @p1050, @p1051, @p1052, @p1053, @p1054, @p1055, @p1056, @p1057, @p1058, @p1059, @p1060, @p1061, @p1062, @p1063, 18), (@p1064, @p1065, @p1066, @p1067, @p1068, @p1069, @p1070, @p1071, @p1072, @p1073, @p1074, @p1075, @p1076, @p1077, @p1078, @p1079, @p1080, @p1081, @p1082, @p1083, @p1084, @p1085, @p1086, @p1087, @p1088, @p1089, @p1090, @p1091, @p1092, @p1093, @p1094, @p1095, @p1096, @p1097, @p1098, @p1099, @p1100, @p1101, @p1102, @p1103, @p1104, @p1105, @p1106, @p1107, @p1108, @p1109, @p1110, @p1111, @p1112, @p1113, @p1114, @p1115, @p1116, @p1117, @p1118, @p1119, 19), (@p1120, @p1121, @p1122, @p1123, @p1124, @p1125, @p1126, @p1127, @p1128, @p1129, @p1130, @p1131, @p1132, @p1133, @p1134, @p1135, @p1136, @p1137, @p1138, @p1139, @p1140, @p1141, @p1142, @p1143, @p1144, @p1145, @p1146, @p1147, @p1148, @p1149, @p1150, @p1151, @p1152, @p1153, @p1154, @p1155, @p1156, @p1157, @p1158, @p1159, @p1160, @p1161, @p1162, @p1163, @p1164, @p1165, @p1166, @p1167, @p1168, @p1169, @p1170, @p1171, @p1172, @p1173, @p1174, @p1175, 20), (@p1176, @p1177, @p1178, @p1179, @p1180, @p1181, @p1182, @p1183, @p1184, @p1185, @p1186, @p1187, @p1188, @p1189, @p1190, @p1191, @p1192, @p1193, @p1194, @p1195, @p1196, @p1197, @p1198, @p1199, @p1200, @p1201, @p1202, @p1203, @p1204, @p1205, @p1206, @p1207, @p1208, @p1209, @p1210, @p1211, @p1212, @p1213, @p1214, @p1215, @p1216, @p1217, @p1218, @p1219, @p1220, @p1221, @p1222, @p1223, @p1224, @p1225, @p1226, @p1227, @p1228, @p1229, @p1230, @p1231, 21), (@p1232, @p1233, @p1234, @p1235, @p1236, @p1237, @p1238, @p1239, @p1240, @p1241, @p1242, @p1243, @p1244, @p1245, @p1246, @p1247, @p1248, @p1249, @p1250, @p1251, @p1252, @p1253, @p1254, @p1255, @p1256, @p1257, @p1258, @p1259, @p1260, @p1261, @p1262, @p1263, @p1264, @p1265, @p1266, @p1267, @p1268, @p1269, @p1270, @p1271, @p1272, @p1273, @p1274, @p1275, @p1276, @p1277, @p1278, @p1279, @p1280, @p1281, @p1282, @p1283, @p1284, @p1285, @p1286, @p1287, 22), (@p1288, @p1289, @p1290, @p1291, @p1292, @p1293, @p1294, @p1295, @p1296, @p1297, @p1298, @p1299, @p1300, @p1301, @p1302, @p1303, @p1304, @p1305, @p1306, @p1307, @p1308, @p1309, @p1310, @p1311, @p1312, @p1313, @p1314, @p1315, @p1316, @p1317, @p1318, @p1319, @p1320, @p1321, @p1322, @p1323, @p1324, @p1325, @p1326, @p1327, @p1328, @p1329, @p1330, @p1331, @p1332, @p1333, @p1334, @p1335, @p1336, @p1337, @p1338, @p1339, @p1340, @p1341, @p1342, @p1343, 23), (@p1344, @p1345, @p1346, @p1347, @p1348, @p1349, @p1350, @p1351, @p1352, @p1353, @p1354, @p1355, @p1356, @p1357, @p1358, @p1359, @p1360, @p1361, @p1362, @p1363, @p1364, @p1365, @p1366, @p1367, @p1368, @p1369, @p1370, @p1371, @p1372, @p1373, @p1374, @p1375, @p1376, @p1377, @p1378, @p1379, @p1380, @p1381, @p1382, @p1383, @p1384, @p1385, @p1386, @p1387, @p1388, @p1389, @p1390, @p1391, @p1392, @p1393, @p1394, @p1395, @p1396, @p1397, @p1398, @p1399, 24), (@p1400, @p1401, @p1402, @p1403, @p1404, @p1405, @p1406, @p1407, @p1408, @p1409, @p1410, @p1411, @p1412, @p1413, @p1414, @p1415, @p1416, @p1417, @p1418, @p1419, @p1420, @p1421, @p1422, @p1423, @p1424, @p1425, @p1426, @p1427, @p1428, @p1429, @p1430, @p1431, @p1432, @p1433, @p1434, @p1435, @p1436, @p1437, @p1438, @p1439, @p1440, @p1441, @p1442, @p1443, @p1444, @p1445, @p1446, @p1447, @p1448, @p1449, @p1450, @p1451, @p1452, @p1453, @p1454, @p1455, 25), (@p1456, @p1457, @p1458, @p1459, @p1460, @p1461, @p1462, @p1463, @p1464, @p1465, @p1466, @p1467, @p1468, @p1469, @p1470, @p1471, @p1472, @p1473, @p1474, @p1475, @p1476, @p1477, @p1478, @p1479, @p1480, @p1481, @p1482, @p1483, @p1484, @p1485, @p1486, @p1487, @p1488, @p1489, @p1490, @p1491, @p1492, @p1493, @p1494, @p1495, @p1496, @p1497, @p1498, @p1499, @p1500, @p1501, @p1502, @p1503, @p1504, @p1505, @p1506, @p1507, @p1508, @p1509, @p1510, @p1511, 26), (@p1512, @p1513, @p1514, @p1515, @p1516, @p1517, @p1518, @p1519, @p1520, @p1521, @p1522, @p1523, @p1524, @p1525, @p1526, @p1527, @p1528, @p1529, @p1530, @p1531, @p1532, @p1533, @p1534, @p1535, @p1536, @p1537, @p1538, @p1539, @p1540, @p1541, @p1542, @p1543, @p1544, @p1545, @p1546, @p1547, @p1548, @p1549, @p1550, @p1551, @p1552, @p1553, @p1554, @p1555, @p1556, @p1557, @p1558, @p1559, @p1560, @p1561, @p1562, @p1563, @p1564, @p1565, @p1566, @p1567, 27), (@p1568, @p1569, @p1570, @p1571, @p1572, @p1573, @p1574, @p1575, @p1576, @p1577, @p1578, @p1579, @p1580, @p1581, @p1582, @p1583, @p1584, @p1585, @p1586, @p1587, @p1588, @p1589, @p1590, @p1591, @p1592, @p1593, @p1594, @p1595, @p1596, @p1597, @p1598, @p1599, @p1600, @p1601, @p1602, @p1603, @p1604, @p1605, @p1606, @p1607, @p1608, @p1609, @p1610, @p1611, @p1612, @p1613, @p1614, @p1615, @p1616, @p1617, @p1618, @p1619, @p1620, @p1621, @p1622, @p1623, 28), (@p1624, @p1625, @p1626, @p1627, @p1628, @p1629, @p1630, @p1631, @p1632, @p1633, @p1634, @p1635, @p1636, @p1637, @p1638, @p1639, @p1640, @p1641, @p1642, @p1643, @p1644, @p1645, @p1646, @p1647, @p1648, @p1649, @p1650, @p1651, @p1652, @p1653, @p1654, @p1655, @p1656, @p1657, @p1658, @p1659, @p1660, @p1661, @p1662, @p1663, @p1664, @p1665, @p1666, @p1667, @p1668, @p1669, @p1670, @p1671, @p1672, @p1673, @p1674, @p1675, @p1676, @p1677, @p1678, @p1679, 29), (@p1680, @p1681, @p1682, @p1683, @p1684, @p1685, @p1686, @p1687, @p1688, @p1689, @p1690, @p1691, @p1692, @p1693, @p1694, @p1695, @p1696, @p1697, @p1698, @p1699, @p1700, @p1701, @p1702, @p1703, @p1704, @p1705, @p1706, @p1707, @p1708, @p1709, @p1710, @p1711, @p1712, @p1713, @p1714, @p1715, @p1716, @p1717, @p1718, @p1719, @p1720, @p1721, @p1722, @p1723, @p1724, @p1725, @p1726, @p1727, @p1728, @p1729, @p1730, @p1731, @p1732, @p1733, @p1734, @p1735, 30), (@p1736, @p1737, @p1738, @p1739, @p1740, @p1741, @p1742, @p1743, @p1744, @p1745, @p1746, @p1747, @p1748, @p1749, @p1750, @p1751, @p1752, @p1753, @p1754, @p1755, @p1756, @p1757, @p1758, @p1759, @p1760, @p1761, @p1762, @p1763, @p1764, @p1765, @p1766, @p1767, @p1768, @p1769, @p1770, @p1771, @p1772, @p1773, @p1774, @p1775, @p1776, @p1777, @p1778, @p1779, @p1780, @p1781, @p1782, @p1783, @p1784, @p1785, @p1786, @p1787, @p1788, @p1789, @p1790, @p1791, 31), (@p1792, @p1793, @p1794, @p1795, @p1796, @p1797, @p1798, @p1799, @p1800, @p1801, @p1802, @p1803, @p1804, @p1805, @p1806, @p1807, @p1808, @p1809, @p1810, @p1811, @p1812, @p1813, @p1814, @p1815, @p1816, @p1817, @p1818, @p1819, @p1820, @p1821, @p1822, @p1823, @p1824, @p1825, @p1826, @p1827, @p1828, @p1829, @p1830, @p1831, @p1832, @p1833, @p1834, @p1835, @p1836, @p1837, @p1838, @p1839, @p1840, @p1841, @p1842, @p1843, @p1844, @p1845, @p1846, @p1847, 32), (@p1848, @p1849, @p1850, @p1851, @p1852, @p1853, @p1854, @p1855, @p1856, @p1857, @p1858, @p1859, @p1860, @p1861, @p1862, @p1863, @p1864, @p1865, @p1866, @p1867, @p1868, @p1869, @p1870, @p1871, @p1872, @p1873, @p1874, @p1875, @p1876, @p1877, @p1878, @p1879, @p1880, @p1881, @p1882, @p1883, @p1884, @p1885, @p1886, @p1887, @p1888, @p1889, @p1890, @p1891, @p1892, @p1893, @p1894, @p1895, @p1896, @p1897, @p1898, @p1899, @p1900, @p1901, @p1902, @p1903, 33), (@p1904, @p1905, @p1906, @p1907, @p1908, @p1909, @p1910, @p1911, @p1912, @p1913, @p1914, @p1915, @p1916, @p1917, @p1918, @p1919, @p1920, @p1921, @p1922, @p1923, @p1924, @p1925, @p1926, @p1927, @p1928, @p1929, @p1930, @p1931, @p1932, @p1933, @p1934, @p1935, @p1936, @p1937, @p1938, @p1939, @p1940, @p1941, @p1942, @p1943, @p1944, @p1945, @p1946, @p1947, @p1948, @p1949, @p1950, @p1951, @p1952, @p1953, @p1954, @p1955, @p1956, @p1957, @p1958, @p1959, 34), (@p1960, @p1961, @p1962, @p1963, @p1964, @p1965, @p1966, @p1967, @p1968, @p1969, @p1970, @p1971, @p1972, @p1973, @p1974, @p1975, @p1976, @p1977, @p1978, @p1979, @p1980, @p1981, @p1982, @p1983, @p1984, @p1985, @p1986, @p1987, @p1988, @p1989, @p1990, @p1991, @p1992, @p1993, @p1994, @p1995, @p1996, @p1997, @p1998, @p1999, @p2000, @p2001, @p2002, @p2003, @p2004, @p2005, @p2006, @p2007, @p2008, @p2009, @p2010, @p2011, @p2012, @p2013, @p2014, @p2015, 35), (@p2016, @p2017, @p2018, @p2019, @p2020, @p2021, @p2022, @p2023, @p2024, @p2025, @p2026, @p2027, @p2028, @p2029, @p2030, @p2031, @p2032, @p2033, @p2034, @p2035, @p2036, @p2037, @p2038, @p2039, @p2040, @p2041, @p2042, @p2043, @p2044, @p2045, @p2046, @p2047, @p2048, @p2049, @p2050, @p2051, @p2052, @p2053, @p2054, @p2055, @p2056, @p2057, @p2058, @p2059, @p2060, @p2061, @p2062, @p2063, @p2064, @p2065, @p2066, @p2067, @p2068, @p2069, @p2070, @p2071, 36)) AS i ([addressee_cntry_cd], [addressee_city], [addressee_district], [addressee_email], [addressee_full_address], [addressee_home_address], [addressee_name], [addressee_postcode], [addressee_province], [addressee_subdistrict], [addressee_tel], [create_table], [delivery_code], [delivery_recipient_name], [delivery_relation_id], [delivery_status_id], [dest_outlet_id], [dest_outlet_port], [document_number], [item_barcode], [item_cod], [item_gross_weight], [item_height], [item_length], [item_price], [item_width], [lat], [log_id], [long], [outlet_id], [outlet_port], [podUrl], [remark], [scan_cntry_cd], [scan_cntry_postcode], [sender_cntry_cd], [sender_district], [sender_email], [sender_full_address], [sender_home_address], [member_id], [sender_name], [sender_postcode], [sender_province], [sender_subdistrict], [sender_tel], [server_id], [signatureUrl], [state], [status_code], [status_dtm], [timestamp], [transmit_dtm], [user_id], [wckt_id], [wkstn_no], _Position) ON 1=0 WHEN NOT MATCHED THEN INSERT ([addressee_cntry_cd], [addressee_city], [addressee_district], [addressee_email], [addressee_full_address], [addressee_home_address], [addressee_name], [addressee_postcode], [addressee_province], [addressee_subdistrict], [addressee_tel], [create_table], [delivery_code], [delivery_recipient_name], [delivery_relation_id], [delivery_status_id], [dest_outlet_id], [dest_outlet_port], [document_number], [item_barcode], [item_cod], [item_gross_weight], [item_height], [item_length], [item_price], [item_width], [lat], [log_id], [long], [outlet_id], [outlet_port], [podUrl], [remark], [scan_cntry_cd], [scan_cntry_postcode], [sender_cntry_cd], [sender_district], [sender_email], [sender_full_address], [sender_home_address], [member_id], [sender_name], [sender_postcode], [sender_province], [sender_subdistrict], [sender_tel], [server_id], [signatureUrl], [state], [status_code], [status_dtm], [timestamp], [transmit_dtm], [user_id], [wckt_id], [wkstn_no]) VALUES (i.[addressee_cntry_cd], i.[addressee_city], i.[addressee_district], i.[addressee_email], i.[addressee_full_address], i.[addressee_home_address], i.[addressee_name], i.[addressee_postcode], i.[addressee_province], i.[addressee_subdistrict], i.[addressee_tel], i.[create_table], i.[delivery_code], i.[delivery_recipient_name], i.[delivery_relation_id], i.[delivery_status_id], i.[dest_outlet_id], i.[dest_outlet_port], i.[document_number], i.[item_barcode], i.[item_cod], i.[item_gross_weight], i.[item_height], i.[item_length], i.[item_price], i.[item_width], i.[lat], i.[log_id], i.[long], i.[outlet_id], i.[outlet_port], i.[podUrl], i.[remark], i.[scan_cntry_cd], i.[scan_cntry_postcode], i.[sender_cntry_cd], i.[sender_district], i.[sender_email], i.[sender_full_address], i.[sender_home_address], i.[member_id], i.[sender_name], i.[sender_postcode], i.[sender_province], i.[sender_subdistrict], i.[sender_tel], i.[server_id], i.[signatureUrl], i.[state], i.[status_code], i.[status_dtm], i.[timestamp], i.[transmit_dtm], i.[user_id], i.[wckt_id], i.[wkstn_no]) OUTPUT INSERTED.[item_id], i._Position INTO @inserted0;  SELECT [t].[item_id] FROM [raw_data] t INNER JOIN @inserted0 i ON ([t].[item_id] = [i].[item_id]) ORDER BY [i].[_Position];  ",4,4,0,430,5,4
"(@p0 nvarchar(4000),@p1 nvarchar(4000),@p2 nvarchar(4000),@p3 nvarchar(4000),@p4 nvarchar(4000),@p5 nvarchar(4000),@p6 nvarchar(4000),@p7 nvarchar(4000),@p8 nvarchar(4000),@p9 nvarchar(4000),@p10 nvarchar(4000),@p11 datetime2(7),@p12 nvarchar(4000),@p13 nvarchar(4000),@p14 int,@p15 int,@p16 int,@p17 nvarchar(4000),@p18 nvarchar(4000),@p19 nvarchar(4000),@p20 nvarchar(4000),@p21 decimal(18,2),@p22 nvarchar(4000),@p23 nvarchar(4000),@p24 decimal(18,2),@p25 nvarchar(4000),@p26 nvarchar(4000),@p27 nvarchar(4000),@p28 nvarchar(4000),@p29 int,@p30 nvarchar(4000),@p31 nvarchar(4000),@p32 nvarchar(4000),@p33 nvarchar(4000),@p34 nvarchar(4000),@p35 nvarchar(4000),@p36 nvarchar(4000),@p37 nvarchar(4000),@p38 nvarchar(4000),@p39 nvarchar(4000),@p40 int,@p41 nvarchar(4000),@p42 nvarchar(4000),@p43 nvarchar(4000),@p44 nvarchar(4000),@p45 nvarchar(4000),@p46 int,@p47 nvarchar(4000),@p48 int,@p49 int,@p50 datetime2(7),@p51 datetime2(7),@p52 datetime2(7),@p53 nvarchar(4000),@p54 nvarchar(4000),@p55 nvarchar(4000),@p56 nvarchar(4000),@p57 nvarchar(4000),@p58 nvarchar(4000),@p59 nvarchar(4000),@p60 nvarchar(4000),@p61 nvarchar(4000),@p62 nvarchar(4000),@p63 nvarchar(4000),@p64 nvarchar(4000),@p65 nvarchar(4000),@p66 nvarchar(4000),@p67 datetime2(7),@p68 nvarchar(4000),@p69 nvarchar(4000),@p70 int,@p71 int,@p72 int,@p73 nvarchar(4000),@p74 nvarchar(4000),@p75 nvarchar(4000),@p76 nvarchar(4000),@p77 decimal(18,2),@p78 nvarchar(4000),@p79 nvarchar(4000),@p80 decimal(18,2),@p81 nvarchar(4000),@p82 nvarchar(4000),@p83 nvarchar(4000),@p84 nvarchar(4000),@p85 int,@p86 nvarchar(4000),@p87 nvarchar(4000),@p88 nvarchar(4000),@p89 nvarchar(4000),@p90 nvarchar(4000),@p91 nvarchar(4000),@p92 nvarchar(4000),@p93 nvarchar(4000),@p94 nvarchar(4000),@p95 nvarchar(4000),@p96 int,@p97 nvarchar(4000),@p98 nvarchar(4000),@p99 nvarchar(4000),@p100 nvarchar(4000),@p101 nvarchar(4000),@p102 int,@p103 nvarchar(4000),@p104 int,@p105 int,@p106 datetime2(7),@p107 datetime2(7),@p108 datetime2(7),@p109 nvarchar(4000),@p110 nvarchar(4000),@p111 nvarchar(4000),@p112 nvarchar(4000),@p113 nvarchar(4000),@p114 nvarchar(4000),@p115 nvarchar(4000),@p116 nvarchar(4000),@p117 nvarchar(4000),@p118 nvarchar(4000),@p119 nvarchar(4000),@p120 nvarchar(4000),@p121 nvarchar(4000),@p122 nvarchar(4000),@p123 datetime2(7),@p124 nvarchar(4000),@p125 nvarchar(4000),@p126 int,@p127 int,@p128 int,@p129 nvarchar(4000),@p130 nvarchar(4000),@p131 nvarchar(4000),@p132 nvarchar(4000),@p133 decimal(18,2),@p134 nvarchar(4000),@p135 nvarchar(4000),@p136 decimal(18,2),@p137 nvarchar(4000),@p138 nvarchar(4000),@p139 nvarchar(4000),@p140 nvarchar(4000),@p141 int,@p142 nvarchar(4000),@p143 nvarchar(4000),@p144 nvarchar(4000),@p145 nvarchar(4000),@p146 nvarchar(4000),@p147 nvarchar(4000),@p148 nvarchar(4000),@p149 nvarchar(4000),@p150 nvarchar(4000),@p151 nvarchar(4000),@p152 int,@p153 nvarchar(4000),@p154 nvarchar(4000),@p155 nvarchar(4000),@p156 nvarchar(4000),@p157 nvarchar(4000),@p158 int,@p159 nvarchar(4000),@p160 int,@p161 int,@p162 datetime2(7),@p163 datetime2(7),@p164 datetime2(7),@p165 nvarchar(4000),@p166 nvarchar(4000),@p167 nvarchar(4000),@p168 nvarchar(4000),@p169 nvarchar(4000),@p170 nvarchar(4000),@p171 nvarchar(4000),@p172 nvarchar(4000),@p173 nvarchar(4000),@p174 nvarchar(4000),@p175 nvarchar(4000),@p176 nvarchar(4000),@p177 nvarchar(4000),@p178 nvarchar(4000),@p179 datetime2(7),@p180 nvarchar(4000),@p181 nvarchar(4000),@p182 int,@p183 int,@p184 int,@p185 nvarchar(4000),@p186 nvarchar(4000),@p187 nvarchar(4000),@p188 nvarchar(4000),@p189 decimal(18,2),@p190 nvarchar(4000),@p191 nvarchar(4000),@p192 decimal(18,2),@p193 nvarchar(4000),@p194 nvarchar(4000),@p195 nvarchar(4000),@p196 nvarchar(4000),@p197 int,@p198 nvarchar(4000),@p199 nvarchar(4000),@p200 nvarchar(4000),@p201 nvarchar(4000),@p202 nvarchar(4000),@p203 nvarchar(4000),@p204 nvarchar(4000),@p205 nvarchar(4000),@p206 nvarchar(4000),@p207 nvarchar(4000),@p208 int,@p209 nvarchar(4000),@p210 nvarchar(4000),@p211 nvarchar(4000),@p212 nvarchar(4000),@p213 nvarchar(4000),@p214 int,@p215 nvarchar(4000),@p216 int,@p217 int,@p218 datetime2(7),@p219 datetime2(7),@p220 datetime2(7),@p221 nvarchar(4000),@p222 nvarchar(4000),@p223 nvarchar(4000),@p224 nvarchar(4000),@p225 nvarchar(4000),@p226 nvarchar(4000),@p227 nvarchar(4000),@p228 nvarchar(4000),@p229 nvarchar(4000),@p230 nvarchar(4000),@p231 nvarchar(4000),@p232 nvarchar(4000),@p233 nvarchar(4000),@p234 nvarchar(4000),@p235 datetime2(7),@p236 nvarchar(4000),@p237 nvarchar(4000),@p238 int,@p239 int,@p240 int,@p241 nvarchar(4000),@p242 nvarchar(4000),@p243 nvarchar(4000),@p244 nvarchar(4000),@p245 decimal(18,2),@p246 nvarchar(4000),@p247 nvarchar(4000),@p248 decimal(18,2),@p249 nvarchar(4000),@p250 nvarchar(4000),@p251 nvarchar(4000),@p252 nvarchar(4000),@p253 int,@p254 nvarchar(4000),@p255 nvarchar(4000),@p256 nvarchar(4000),@p257 nvarchar(4000),@p258 nvarchar(4000),@p259 nvarchar(4000),@p260 nvarchar(4000),@p261 nvarchar(4000),@p262 nvarchar(4000),@p263 nvarchar(4000),@p264 int,@p265 nvarchar(4000),@p266 nvarchar(4000),@p267 nvarchar(4000),@p268 nvarchar(4000),@p269 nvarchar(4000),@p270 int,@p271 nvarchar(4000),@p272 int,@p273 int,@p274 datetime2(7),@p275 datetime2(7),@p276 datetime2(7),@p277 nvarchar(4000),@p278 nvarchar(4000),@p279 nvarchar(4000),@p280 nvarchar(4000),@p281 nvarchar(4000),@p282 nvarchar(4000),@p283 nvarchar(4000),@p284 nvarchar(4000),@p285 nvarchar(4000),@p286 nvarchar(4000),@p287 nvarchar(4000),@p288 nvarchar(4000),@p289 nvarchar(4000),@p290 nvarchar(4000),@p291 datetime2(7),@p292 nvarchar(4000),@p293 nvarchar(4000),@p294 int,@p295 int,@p296 int,@p297 nvarchar(4000),@p298 nvarchar(4000),@p299 nvarchar(4000),@p300 nvarchar(4000),@p301 decimal(18,2),@p302 nvarchar(4000),@p303 nvarchar(4000),@p304 decimal(18,2),@p305 nvarchar(4000),@p306 nvarchar(4000),@p307 nvarchar(4000),@p308 nvarchar(4000),@p309 int,@p310 nvarchar(4000),@p311 nvarchar(4000),@p312 nvarchar(4000),@p313 nvarchar(4000),@p314 nvarchar(4000),@p315 nvarchar(4000),@p316 nvarchar(4000),@p317 nvarchar(4000),@p318 nvarchar(4000),@p319 nvarchar(4000),@p320 int,@p321 nvarchar(4000),@p322 nvarchar(4000),@p323 nvarchar(4000),@p324 nvarchar(4000),@p325 nvarchar(4000),@p326 int,@p327 nvarchar(4000),@p328 int,@p329 int,@p330 datetime2(7),@p331 datetime2(7),@p332 datetime2(7),@p333 nvarchar(4000),@p334 nvarchar(4000),@p335 nvarchar(4000),@p336 nvarchar(4000),@p337 nvarchar(4000),@p338 nvarchar(4000),@p339 nvarchar(4000),@p340 nvarchar(4000),@p341 nvarchar(4000),@p342 nvarchar(4000),@p343 nvarchar(4000),@p344 nvarchar(4000),@p345 nvarchar(4000),@p346 nvarchar(4000),@p347 datetime2(7),@p348 nvarchar(4000),@p349 nvarchar(4000),@p350 int,@p351 int,@p352 int,@p353 nvarchar(4000),@p354 nvarchar(4000),@p355 nvarchar(4000),@p356 nvarchar(4000),@p357 decimal(18,2),@p358 nvarchar(4000),@p359 nvarchar(4000),@p360 decimal(18,2),@p361 nvarchar(4000),@p362 nvarchar(4000),@p363 nvarchar(4000),@p364 nvarchar(4000),@p365 int,@p366 nvarchar(4000),@p367 nvarchar(4000),@p368 nvarchar(4000),@p369 nvarchar(4000),@p370 nvarchar(4000),@p371 nvarchar(4000),@p372 nvarchar(4000),@p373 nvarchar(4000),@p374 nvarchar(4000),@p375 nvarchar(4000),@p376 int,@p377 nvarchar(4000),@p378 nvarchar(4000),@p379 nvarchar(4000),@p380 nvarchar(4000),@p381 nvarchar(4000),@p382 int,@p383 nvarchar(4000),@p384 int,@p385 int,@p386 datetime2(7),@p387 datetime2(7),@p388 datetime2(7),@p389 nvarchar(4000),@p390 nvarchar(4000),@p391 nvarchar(4000),@p392 nvarchar(4000),@p393 nvarchar(4000),@p394 nvarchar(4000),@p395 nvarchar(4000),@p396 nvarchar(4000),@p397 nvarchar(4000),@p398 nvarchar(4000),@p399 nvarchar(4000),@p400 nvarchar(4000),@p401 nvarchar(4000),@p402 nvarchar(4000),@p403 datetime2(7),@p404 nvarchar(4000),@p405 nvarchar(4000),@p406 int,@p407 int,@p408 int,@p409 nvarchar(4000),@p410 nvarchar(4000),@p411 nvarchar(4000),@p412 nvarchar(4000),@p413 decimal(18,2),@p414 nvarchar(4000),@p415 nvarchar(4000),@p416 decimal(18,2),@p417 nvarchar(4000),@p418 nvarchar(4000),@p419 nvarchar(4000),@p420 nvarchar(4000),@p421 int,@p422 nvarchar(4000),@p423 nvarchar(4000),@p424 nvarchar(4000),@p425 nvarchar(4000),@p426 nvarchar(4000),@p427 nvarchar(4000),@p428 nvarchar(4000),@p429 nvarchar(4000),@p430 nvarchar(4000),@p431 nvarchar(4000),@p432 int,@p433 nvarchar(4000),@p434 nvarchar(4000),@p435 nvarchar(4000),@p436 nvarchar(4000),@p437 nvarchar(4000),@p438 int,@p439 nvarchar(4000),@p440 int,@p441 int,@p442 datetime2(7),@p443 datetime2(7),@p444 datetime2(7),@p445 nvarchar(4000),@p446 nvarchar(4000),@p447 nvarchar(4000),@p448 nvarchar(4000),@p449 nvarchar(4000),@p450 nvarchar(4000),@p451 nvarchar(4000),@p452 nvarchar(4000),@p453 nvarchar(4000),@p454 nvarchar(4000),@p455 nvarchar(4000),@p456 nvarchar(4000),@p457 nvarchar(4000),@p458 nvarchar(4000),@p459 datetime2(7),@p460 nvarchar(4000),@p461 nvarchar(4000),@p462 int,@p463 int,@p464 int,@p465 nvarchar(4000),@p466 nvarchar(4000),@p467 nvarchar(4000),@p468 nvarchar(4000),@p469 decimal(18,2),@p470 nvarchar(4000),@p471 nvarchar(4000),@p472 decimal(18,2),@p473 nvarchar(4000),@p474 nvarchar(4000),@p475 nvarchar(4000),@p476 nvarchar(4000),@p477 int,@p478 nvarchar(4000),@p479 nvarchar(4000),@p480 nvarchar(4000),@p481 nvarchar(4000),@p482 nvarchar(4000),@p483 nvarchar(4000),@p484 nvarchar(4000),@p485 nvarchar(4000),@p486 nvarchar(4000),@p487 nvarchar(4000),@p488 int,@p489 nvarchar(4000),@p490 nvarchar(4000),@p491 nvarchar(4000),@p492 nvarchar(4000),@p493 nvarchar(4000),@p494 int,@p495 nvarchar(4000),@p496 int,@p497 int,@p498 datetime2(7),@p499 datetime2(7),@p500 datetime2(7),@p501 nvarchar(4000),@p502 nvarchar(4000),@p503 nvarchar(4000),@p504 nvarchar(4000),@p505 nvarchar(4000),@p506 nvarchar(4000),@p507 nvarchar(4000),@p508 nvarchar(4000),@p509 nvarchar(4000),@p510 nvarchar(4000),@p511 nvarchar(4000),@p512 nvarchar(4000),@p513 nvarchar(4000),@p514 nvarchar(4000),@p515 datetime2(7),@p516 nvarchar(4000),@p517 nvarchar(4000),@p518 int,@p519 int,@p520 int,@p521 nvarchar(4000),@p522 nvarchar(4000),@p523 nvarchar(4000),@p524 nvarchar(4000),@p525 decimal(18,2),@p526 nvarchar(4000),@p527 nvarchar(4000),@p528 decimal(18,2),@p529 nvarchar(4000),@p530 nvarchar(4000),@p531 nvarchar(4000),@p532 nvarchar(4000),@p533 int,@p534 nvarchar(4000),@p535 nvarchar(4000),@p536 nvarchar(4000),@p537 nvarchar(4000),@p538 nvarchar(4000),@p539 nvarchar(4000),@p540 nvarchar(4000),@p541 nvarchar(4000),@p542 nvarchar(4000),@p543 nvarchar(4000),@p544 int,@p545 nvarchar(4000),@p546 nvarchar(4000),@p547 nvarchar(4000),@p548 nvarchar(4000),@p549 nvarchar(4000),@p550 int,@p551 nvarchar(4000),@p552 int,@p553 int,@p554 datetime2(7),@p555 datetime2(7),@p556 datetime2(7),@p557 nvarchar(4000),@p558 nvarchar(4000),@p559 nvarchar(4000),@p560 nvarchar(4000),@p561 nvarchar(4000),@p562 nvarchar(4000),@p563 nvarchar(4000),@p564 nvarchar(4000),@p565 nvarchar(4000),@p566 nvarchar(4000),@p567 nvarchar(4000),@p568 nvarchar(4000),@p569 nvarchar(4000),@p570 nvarchar(4000),@p571 datetime2(7),@p572 nvarchar(4000),@p573 nvarchar(4000),@p574 int,@p575 int,@p576 int,@p577 nvarchar(4000),@p578 nvarchar(4000),@p579 nvarchar(4000),@p580 decimal(18,2),@p581 decimal(18,2),@p582 nvarchar(4000),@p583 nvarchar(4000),@p584 decimal(18,2),@p585 nvarchar(4000),@p586 nvarchar(4000),@p587 nvarchar(4000),@p588 nvarchar(4000),@p589 int,@p590 nvarchar(4000),@p591 nvarchar(4000),@p592 nvarchar(4000),@p593 nvarchar(4000),@p594 nvarchar(4000),@p595 nvarchar(4000),@p596 nvarchar(4000),@p597 nvarchar(4000),@p598 nvarchar(4000),@p599 nvarchar(4000),@p600 int,@p601 nvarchar(4000),@p602 nvarchar(4000),@p603 nvarchar(4000),@p604 nvarchar(4000),@p605 nvarchar(4000),@p606 int,@p607 nvarchar(4000),@p608 int,@p609 int,@p610 datetime2(7),@p611 datetime2(7),@p612 datetime2(7),@p613 nvarchar(4000),@p614 nvarchar(4000),@p615 nvarchar(4000),@p616 nvarchar(4000),@p617 nvarchar(4000),@p618 nvarchar(4000),@p619 nvarchar(4000),@p620 nvarchar(4000),@p621 nvarchar(4000),@p622 nvarchar(4000),@p623 nvarchar(4000),@p624 nvarchar(4000),@p625 nvarchar(4000),@p626 nvarchar(4000),@p627 datetime2(7),@p628 nvarchar(4000),@p629 nvarchar(4000),@p630 int,@p631 int,@p632 int,@p633 nvarchar(4000),@p634 nvarchar(4000),@p635 nvarchar(4000),@p636 nvarchar(4000),@p637 decimal(18,2),@p638 nvarchar(4000),@p639 nvarchar(4000),@p640 decimal(18,2),@p641 nvarchar(4000),@p642 nvarchar(4000),@p643 nvarchar(4000),@p644 nvarchar(4000),@p645 int,@p646 nvarchar(4000),@p647 nvarchar(4000),@p648 nvarchar(4000),@p649 nvarchar(4000),@p650 nvarchar(4000),@p651 nvarchar(4000),@p652 nvarchar(4000),@p653 nvarchar(4000),@p654 nvarchar(4000),@p655 nvarchar(4000),@p656 int,@p657 nvarchar(4000),@p658 nvarchar(4000),@p659 nvarchar(4000),@p660 nvarchar(4000),@p661 nvarchar(4000),@p662 int,@p663 nvarchar(4000),@p664 int,@p665 int,@p666 datetime2(7),@p667 datetime2(7),@p668 datetime2(7),@p669 nvarchar(4000),@p670 nvarchar(4000),@p671 nvarchar(4000),@p672 nvarchar(4000),@p673 nvarchar(4000),@p674 nvarchar(4000),@p675 nvarchar(4000),@p676 nvarchar(4000),@p677 nvarchar(4000),@p678 nvarchar(4000),@p679 nvarchar(4000),@p680 nvarchar(4000),@p681 nvarchar(4000),@p682 nvarchar(4000),@p683 datetime2(7),@p684 nvarchar(4000),@p685 nvarchar(4000),@p686 int,@p687 int,@p688 int,@p689 nvarchar(4000),@p690 nvarchar(4000),@p691 nvarchar(4000),@p692 nvarchar(4000),@p693 decimal(18,2),@p694 nvarchar(4000),@p695 nvarchar(4000),@p696 decimal(18,2),@p697 nvarchar(4000),@p698 nvarchar(4000),@p699 nvarchar(4000),@p700 nvarchar(4000),@p701 int,@p702 nvarchar(4000),@p703 nvarchar(4000),@p704 nvarchar(4000),@p705 nvarchar(4000),@p706 nvarchar(4000),@p707 nvarchar(4000),@p708 nvarchar(4000),@p709 nvarchar(4000),@p710 nvarchar(4000),@p711 nvarchar(4000),@p712 int,@p713 nvarchar(4000),@p714 nvarchar(4000),@p715 nvarchar(4000),@p716 nvarchar(4000),@p717 nvarchar(4000),@p718 int,@p719 nvarchar(4000),@p720 int,@p721 int,@p722 datetime2(7),@p723 datetime2(7),@p724 datetime2(7),@p725 nvarchar(4000),@p726 nvarchar(4000),@p727 nvarchar(4000),@p728 nvarchar(4000),@p729 nvarchar(4000),@p730 nvarchar(4000),@p731 nvarchar(4000),@p732 nvarchar(4000),@p733 nvarchar(4000),@p734 nvarchar(4000),@p735 nvarchar(4000),@p736 nvarchar(4000),@p737 nvarchar(4000),@p738 nvarchar(4000),@p739 datetime2(7),@p740 nvarchar(4000),@p741 nvarchar(4000),@p742 int,@p743 int,@p744 int,@p745 nvarchar(4000),@p746 nvarchar(4000),@p747 nvarchar(4000),@p748 nvarchar(4000),@p749 decimal(18,2),@p750 nvarchar(4000),@p751 nvarchar(4000),@p752 decimal(18,2),@p753 nvarchar(4000),@p754 nvarchar(4000),@p755 nvarchar(4000),@p756 nvarchar(4000),@p757 int,@p758 nvarchar(4000),@p759 nvarchar(4000),@p760 nvarchar(4000),@p761 nvarchar(4000),@p762 nvarchar(4000),@p763 nvarchar(4000),@p764 nvarchar(4000),@p765 nvarchar(4000),@p766 nvarchar(4000),@p767 nvarchar(4000),@p768 int,@p769 nvarchar(4000),@p770 nvarchar(4000),@p771 nvarchar(4000),@p772 nvarchar(4000),@p773 nvarchar(4000),@p774 int,@p775 nvarchar(4000),@p776 int,@p777 int,@p778 datetime2(7),@p779 datetime2(7),@p780 datetime2(7),@p781 nvarchar(4000),@p782 nvarchar(4000),@p783 nvarchar(4000),@p784 nvarchar(4000),@p785 nvarchar(4000),@p786 nvarchar(4000),@p787 nvarchar(4000),@p788 nvarchar(4000),@p789 nvarchar(4000),@p790 nvarchar(4000),@p791 nvarchar(4000),@p792 nvarchar(4000),@p793 nvarchar(4000),@p794 nvarchar(4000),@p795 datetime2(7),@p796 nvarchar(4000),@p797 nvarchar(4000),@p798 int,@p799 int,@p800 int,@p801 nvarchar(4000),@p802 nvarchar(4000),@p803 nvarchar(4000),@p804 nvarchar(4000),@p805 decimal(18,2),@p806 nvarchar(4000),@p807 nvarchar(4000),@p808 decimal(18,2),@p809 nvarchar(4000),@p810 nvarchar(4000),@p811 nvarchar(4000),@p812 nvarchar(4000),@p813 int,@p814 nvarchar(4000),@p815 nvarchar(4000),@p816 nvarchar(4000),@p817 nvarchar(4000),@p818 nvarchar(4000),@p819 nvarchar(4000),@p820 nvarchar(4000),@p821 nvarchar(4000),@p822 nvarchar(4000),@p823 nvarchar(4000),@p824 int,@p825 nvarchar(4000),@p826 nvarchar(4000),@p827 nvarchar(4000),@p828 nvarchar(4000),@p829 nvarchar(4000),@p830 int,@p831 nvarchar(4000),@p832 int,@p833 int,@p834 datetime2(7),@p835 datetime2(7),@p836 datetime2(7),@p837 nvarchar(4000),@p838 nvarchar(4000),@p839 nvarchar(4000),@p840 nvarchar(4000),@p841 nvarchar(4000),@p842 nvarchar(4000),@p843 nvarchar(4000),@p844 nvarchar(4000),@p845 nvarchar(4000),@p846 nvarchar(4000),@p847 nvarchar(4000),@p848 nvarchar(4000),@p849 nvarchar(4000),@p850 nvarchar(4000),@p851 datetime2(7),@p852 nvarchar(4000),@p853 nvarchar(4000),@p854 int,@p855 int,@p856 int,@p857 nvarchar(4000),@p858 nvarchar(4000),@p859 nvarchar(4000),@p860 nvarchar(4000),@p861 decimal(18,2),@p862 nvarchar(4000),@p863 nvarchar(4000),@p864 decimal(18,2),@p865 nvarchar(4000),@p866 nvarchar(4000),@p867 nvarchar(4000),@p868 nvarchar(4000),@p869 int,@p870 nvarchar(4000),@p871 nvarchar(4000),@p872 nvarchar(4000),@p873 nvarchar(4000),@p874 nvarchar(4000),@p875 nvarchar(4000),@p876 nvarchar(4000),@p877 nvarchar(4000),@p878 nvarchar(4000),@p879 nvarchar(4000),@p880 int,@p881 nvarchar(4000),@p882 nvarchar(4000),@p883 nvarchar(4000),@p884 nvarchar(4000),@p885 nvarchar(4000),@p886 int,@p887 nvarchar(4000),@p888 int,@p889 int,@p890 datetime2(7),@p891 datetime2(7),@p892 datetime2(7),@p893 nvarchar(4000),@p894 nvarchar(4000),@p895 nvarchar(4000),@p896 nvarchar(4000),@p897 nvarchar(4000),@p898 nvarchar(4000),@p899 nvarchar(4000),@p900 nvarchar(4000),@p901 nvarchar(4000),@p902 nvarchar(4000),@p903 nvarchar(4000),@p904 nvarchar(4000),@p905 nvarchar(4000),@p906 nvarchar(4000),@p907 datetime2(7),@p908 nvarchar(4000),@p909 nvarchar(4000),@p910 int,@p911 int,@p912 int,@p913 nvarchar(4000),@p914 nvarchar(4000),@p915 nvarchar(4000),@p916 nvarchar(4000),@p917 decimal(18,2),@p918 nvarchar(4000),@p919 nvarchar(4000),@p920 decimal(18,2),@p921 nvarchar(4000),@p922 nvarchar(4000),@p923 nvarchar(4000),@p924 nvarchar(4000),@p925 int,@p926 nvarchar(4000),@p927 nvarchar(4000),@p928 nvarchar(4000),@p929 nvarchar(4000),@p930 nvarchar(4000),@p931 nvarchar(4000),@p932 nvarchar(4000),@p933 nvarchar(4000),@p934 nvarchar(4000),@p935 nvarchar(4000),@p936 int,@p937 nvarchar(4000),@p938 nvarchar(4000),@p939 nvarchar(4000),@p940 nvarchar(4000),@p941 nvarchar(4000),@p942 int,@p943 nvarchar(4000),@p944 int,@p945 int,@p946 datetime2(7),@p947 datetime2(7),@p948 datetime2(7),@p949 nvarchar(4000),@p950 nvarchar(4000),@p951 nvarchar(4000),@p952 nvarchar(4000),@p953 nvarchar(4000),@p954 nvarchar(4000),@p955 nvarchar(4000),@p956 nvarchar(4000),@p957 nvarchar(4000),@p958 nvarchar(4000),@p959 nvarchar(4000),@p960 nvarchar(4000),@p961 nvarchar(4000),@p962 nvarchar(4000),@p963 datetime2(7),@p964 nvarchar(4000),@p965 nvarchar(4000),@p966 int,@p967 int,@p968 int,@p969 nvarchar(4000),@p970 nvarchar(4000),@p971 nvarchar(4000),@p972 nvarchar(4000),@p973 decimal(18,2),@p974 nvarchar(4000),@p975 nvarchar(4000),@p976 decimal(18,2),@p977 nvarchar(4000),@p978 nvarchar(4000),@p979 nvarchar(4000),@p980 nvarchar(4000),@p981 int,@p982 nvarchar(4000),@p983 nvarchar(4000),@p984 nvarchar(4000),@p985 nvarchar(4000),@p986 nvarchar(4000),@p987 nvarchar(4000),@p988 nvarchar(4000),@p989 nvarchar(4000),@p990 nvarchar(4000),@p991 nvarchar(4000),@p992 int,@p993 nvarchar(4000),@p994 nvarchar(4000),@p995 nvarchar(4000),@p996 nvarchar(4000),@p997 nvarchar(4000),@p998 int,@p999 nvarchar(4000),@p1000 int,@p1001 int,@p1002 datetime2(7),@p1003 datetime2(7),@p1004 datetime2(7),@p1005 nvarchar(4000),@p1006 nvarchar(4000),@p1007 nvarchar(4000),@p1008 nvarchar(4000),@p1009 nvarchar(4000),@p1010 nvarchar(4000),@p1011 nvarchar(4000),@p1012 nvarchar(4000),@p1013 nvarchar(4000),@p1014 nvarchar(4000),@p1015 nvarchar(4000),@p1016 nvarchar(4000),@p1017 nvarchar(4000),@p1018 nvarchar(4000),@p1019 datetime2(7),@p1020 nvarchar(4000),@p1021 nvarchar(4000),@p1022 int,@p1023 int,@p1024 int,@p1025 nvarchar(4000),@p1026 nvarchar(4000),@p1027 nvarchar(4000),@p1028 nvarchar(4000),@p1029 decimal(18,2),@p1030 nvarchar(4000),@p1031 nvarchar(4000),@p1032 decimal(18,2),@p1033 nvarchar(4000),@p1034 nvarchar(4000),@p1035 nvarchar(4000),@p1036 nvarchar(4000),@p1037 int,@p1038 nvarchar(4000),@p1039 nvarchar(4000),@p1040 nvarchar(4000),@p1041 nvarchar(4000),@p1042 nvarchar(4000),@p1043 nvarchar(4000),@p1044 nvarchar(4000),@p1045 nvarchar(4000),@p1046 nvarchar(4000),@p1047 nvarchar(4000),@p1048 int,@p1049 nvarchar(4000),@p1050 nvarchar(4000),@p1051 nvarchar(4000),@p1052 nvarchar(4000),@p1053 nvarchar(4000),@p1054 int,@p1055 nvarchar(4000),@p1056 int,@p1057 int,@p1058 datetime2(7),@p1059 datetime2(7),@p1060 datetime2(7),@p1061 nvarchar(4000),@p1062 nvarchar(4000),@p1063 nvarchar(4000),@p1064 nvarchar(4000),@p1065 nvarchar(4000),@p1066 nvarchar(4000),@p1067 nvarchar(4000),@p1068 nvarchar(4000),@p1069 nvarchar(4000),@p1070 nvarchar(4000),@p1071 nvarchar(4000),@p1072 nvarchar(4000),@p1073 nvarchar(4000),@p1074 nvarchar(4000),@p1075 datetime2(7),@p1076 nvarchar(4000),@p1077 nvarchar(4000),@p1078 int,@p1079 int,@p1080 int,@p1081 nvarchar(4000),@p1082 nvarchar(4000),@p1083 nvarchar(4000),@p1084 nvarchar(4000),@p1085 decimal(18,2),@p1086 nvarchar(4000),@p1087 nvarchar(4000),@p1088 decimal(18,2),@p1089 nvarchar(4000),@p1090 nvarchar(4000),@p1091 nvarchar(4000),@p1092 nvarchar(4000),@p1093 int,@p1094 nvarchar(4000),@p1095 nvarchar(4000),@p1096 nvarchar(4000),@p1097 nvarchar(4000),@p1098 nvarchar(4000),@p1099 nvarchar(4000),@p1100 nvarchar(4000),@p1101 nvarchar(4000),@p1102 nvarchar(4000),@p1103 nvarchar(4000),@p1104 int,@p1105 nvarchar(4000),@p1106 nvarchar(4000),@p1107 nvarchar(4000),@p1108 nvarchar(4000),@p1109 nvarchar(4000),@p1110 int,@p1111 nvarchar(4000),@p1112 int,@p1113 int,@p1114 datetime2(7),@p1115 datetime2(7),@p1116 datetime2(7),@p1117 nvarchar(4000),@p1118 nvarchar(4000),@p1119 nvarchar(4000),@p1120 nvarchar(4000),@p1121 nvarchar(4000),@p1122 nvarchar(4000),@p1123 nvarchar(4000),@p1124 nvarchar(4000),@p1125 nvarchar(4000),@p1126 nvarchar(4000),@p1127 nvarchar(4000),@p1128 nvarchar(4000),@p1129 nvarchar(4000),@p1130 nvarchar(4000),@p1131 datetime2(7),@p1132 nvarchar(4000),@p1133 nvarchar(4000),@p1134 int,@p1135 int,@p1136 int,@p1137 nvarchar(4000),@p1138 nvarchar(4000),@p1139 nvarchar(4000),@p1140 decimal(18,2),@p1141 decimal(18,2),@p1142 nvarchar(4000),@p1143 nvarchar(4000),@p1144 decimal(18,2),@p1145 nvarchar(4000),@p1146 nvarchar(4000),@p1147 nvarchar(4000),@p1148 nvarchar(4000),@p1149 int,@p1150 nvarchar(4000),@p1151 nvarchar(4000),@p1152 nvarchar(4000),@p1153 nvarchar(4000),@p1154 nvarchar(4000),@p1155 nvarchar(4000),@p1156 nvarchar(4000),@p1157 nvarchar(4000),@p1158 nvarchar(4000),@p1159 nvarchar(4000),@p1160 int,@p1161 nvarchar(4000),@p1162 nvarchar(4000),@p1163 nvarchar(4000),@p1164 nvarchar(4000),@p1165 nvarchar(4000),@p1166 int,@p1167 nvarchar(4000),@p1168 int,@p1169 int,@p1170 datetime2(7),@p1171 datetime2(7),@p1172 datetime2(7),@p1173 nvarchar(4000),@p1174 nvarchar(4000),@p1175 nvarchar(4000),@p1176 nvarchar(4000),@p1177 nvarchar(4000),@p1178 nvarchar(4000),@p1179 nvarchar(4000),@p1180 nvarchar(4000),@p1181 nvarchar(4000),@p1182 nvarchar(4000),@p1183 nvarchar(4000),@p1184 nvarchar(4000),@p1185 nvarchar(4000),@p1186 nvarchar(4000),@p1187 datetime2(7),@p1188 nvarchar(4000),@p1189 nvarchar(4000),@p1190 int,@p1191 int,@p1192 int,@p1193 nvarchar(4000),@p1194 nvarchar(4000),@p1195 nvarchar(4000),@p1196 nvarchar(4000),@p1197 decimal(18,2),@p1198 nvarchar(4000),@p1199 nvarchar(4000),@p1200 decimal(18,2),@p1201 nvarchar(4000),@p1202 nvarchar(4000),@p1203 nvarchar(4000),@p1204 nvarchar(4000),@p1205 int,@p1206 nvarchar(4000),@p1207 nvarchar(4000),@p1208 nvarchar(4000),@p1209 nvarchar(4000),@p1210 nvarchar(4000),@p1211 nvarchar(4000),@p1212 nvarchar(4000),@p1213 nvarchar(4000),@p1214 nvarchar(4000),@p1215 nvarchar(4000),@p1216 int,@p1217 nvarchar(4000),@p1218 nvarchar(4000),@p1219 nvarchar(4000),@p1220 nvarchar(4000),@p1221 nvarchar(4000),@p1222 int,@p1223 nvarchar(4000),@p1224 int,@p1225 int,@p1226 datetime2(7),@p1227 datetime2(7),@p1228 datetime2(7),@p1229 nvarchar(4000),@p1230 nvarchar(4000),@p1231 nvarchar(4000),@p1232 nvarchar(4000),@p1233 nvarchar(4000),@p1234 nvarchar(4000),@p1235 nvarchar(4000),@p1236 nvarchar(4000),@p1237 nvarchar(4000),@p1238 nvarchar(4000),@p1239 nvarchar(4000),@p1240 nvarchar(4000),@p1241 nvarchar(4000),@p1242 nvarchar(4000),@p1243 datetime2(7),@p1244 nvarchar(4000),@p1245 nvarchar(4000),@p1246 int,@p1247 int,@p1248 int,@p1249 nvarchar(4000),@p1250 nvarchar(4000),@p1251 nvarchar(4000),@p1252 nvarchar(4000),@p1253 decimal(18,2),@p1254 nvarchar(4000),@p1255 nvarchar(4000),@p1256 decimal(18,2),@p1257 nvarchar(4000),@p1258 nvarchar(4000),@p1259 nvarchar(4000),@p1260 nvarchar(4000),@p1261 int,@p1262 nvarchar(4000),@p1263 nvarchar(4000),@p1264 nvarchar(4000),@p1265 nvarchar(4000),@p1266 nvarchar(4000),@p1267 nvarchar(4000),@p1268 nvarchar(4000),@p1269 nvarchar(4000),@p1270 nvarchar(4000),@p1271 nvarchar(4000),@p1272 int,@p1273 nvarchar(4000),@p1274 nvarchar(4000),@p1275 nvarchar(4000),@p1276 nvarchar(4000),@p1277 nvarchar(4000),@p1278 int,@p1279 nvarchar(4000),@p1280 int,@p1281 int,@p1282 datetime2(7),@p1283 datetime2(7),@p1284 datetime2(7),@p1285 nvarchar(4000),@p1286 nvarchar(4000),@p1287 nvarchar(4000),@p1288 nvarchar(4000),@p1289 nvarchar(4000),@p1290 nvarchar(4000),@p1291 nvarchar(4000),@p1292 nvarchar(4000),@p1293 nvarchar(4000),@p1294 nvarchar(4000),@p1295 nvarchar(4000),@p1296 nvarchar(4000),@p1297 nvarchar(4000),@p1298 nvarchar(4000),@p1299 datetime2(7),@p1300 nvarchar(4000),@p1301 nvarchar(4000),@p1302 int,@p1303 int,@p1304 int,@p1305 nvarchar(4000),@p1306 nvarchar(4000),@p1307 nvarchar(4000),@p1308 decimal(18,2),@p1309 decimal(18,2),@p1310 nvarchar(4000),@p1311 nvarchar(4000),@p1312 decimal(18,2),@p1313 nvarchar(4000),@p1314 nvarchar(4000),@p1315 nvarchar(4000),@p1316 nvarchar(4000),@p1317 int,@p1318 nvarchar(4000),@p1319 nvarchar(4000),@p1320 nvarchar(4000),@p1321 nvarchar(4000),@p1322 nvarchar(4000),@p1323 nvarchar(4000),@p1324 nvarchar(4000),@p1325 nvarchar(4000),@p1326 nvarchar(4000),@p1327 nvarchar(4000),@p1328 int,@p1329 nvarchar(4000),@p1330 nvarchar(4000),@p1331 nvarchar(4000),@p1332 nvarchar(4000),@p1333 nvarchar(4000),@p1334 int,@p1335 nvarchar(4000),@p1336 int,@p1337 int,@p1338 datetime2(7),@p1339 datetime2(7),@p1340 datetime2(7),@p1341 nvarchar(4000),@p1342 nvarchar(4000),@p1343 nvarchar(4000),@p1344 nvarchar(4000),@p1345 nvarchar(4000),@p1346 nvarchar(4000),@p1347 nvarchar(4000),@p1348 nvarchar(4000),@p1349 nvarchar(4000),@p1350 nvarchar(4000),@p1351 nvarchar(4000),@p1352 nvarchar(4000),@p1353 nvarchar(4000),@p1354 nvarchar(4000),@p1355 datetime2(7),@p1356 nvarchar(4000),@p1357 nvarchar(4000),@p1358 int,@p1359 int,@p1360 int,@p1361 nvarchar(4000),@p1362 nvarchar(4000),@p1363 nvarchar(4000),@p1364 nvarchar(4000),@p1365 decimal(18,2),@p1366 nvarchar(4000),@p1367 nvarchar(4000),@p1368 decimal(18,2),@p1369 nvarchar(4000),@p1370 nvarchar(4000),@p1371 nvarchar(4000),@p1372 nvarchar(4000),@p1373 int,@p1374 nvarchar(4000),@p1375 nvarchar(4000),@p1376 nvarchar(4000),@p1377 nvarchar(4000),@p1378 nvarchar(4000),@p1379 nvarchar(4000),@p1380 nvarchar(4000),@p1381 nvarchar(4000),@p1382 nvarchar(4000),@p1383 nvarchar(4000),@p1384 int,@p1385 nvarchar(4000),@p1386 nvarchar(4000),@p1387 nvarchar(4000),@p1388 nvarchar(4000),@p1389 nvarchar(4000),@p1390 int,@p1391 nvarchar(4000),@p1392 int,@p1393 int,@p1394 datetime2(7),@p1395 datetime2(7),@p1396 datetime2(7),@p1397 nvarchar(4000),@p1398 nvarchar(4000),@p1399 nvarchar(4000),@p1400 nvarchar(4000),@p1401 nvarchar(4000),@p1402 nvarchar(4000),@p1403 nvarchar(4000),@p1404 nvarchar(4000),@p1405 nvarchar(4000),@p1406 nvarchar(4000),@p1407 nvarchar(4000),@p1408 nvarchar(4000),@p1409 nvarchar(4000),@p1410 nvarchar(4000),@p1411 datetime2(7),@p1412 nvarchar(4000),@p1413 nvarchar(4000),@p1414 int,@p1415 int,@p1416 int,@p1417 nvarchar(4000),@p1418 nvarchar(4000),@p1419 nvarchar(4000),@p1420 nvarchar(4000),@p1421 decimal(18,2),@p1422 nvarchar(4000),@p1423 nvarchar(4000),@p1424 decimal(18,2),@p1425 nvarchar(4000),@p1426 nvarchar(4000),@p1427 nvarchar(4000),@p1428 nvarchar(4000),@p1429 int,@p1430 nvarchar(4000),@p1431 nvarchar(4000),@p1432 nvarchar(4000),@p1433 nvarchar(4000),@p1434 nvarchar(4000),@p1435 nvarchar(4000),@p1436 nvarchar(4000),@p1437 nvarchar(4000),@p1438 nvarchar(4000),@p1439 nvarchar(4000),@p1440 int,@p1441 nvarchar(4000),@p1442 nvarchar(4000),@p1443 nvarchar(4000),@p1444 nvarchar(4000),@p1445 nvarchar(4000),@p1446 int,@p1447 nvarchar(4000),@p1448 int,@p1449 int,@p1450 datetime2(7),@p1451 datetime2(7),@p1452 datetime2(7),@p1453 nvarchar(4000),@p1454 nvarchar(4000),@p1455 nvarchar(4000),@p1456 nvarchar(4000),@p1457 nvarchar(4000),@p1458 nvarchar(4000),@p1459 nvarchar(4000),@p1460 nvarchar(4000),@p1461 nvarchar(4000),@p1462 nvarchar(4000),@p1463 nvarchar(4000),@p1464 nvarchar(4000),@p1465 nvarchar(4000),@p1466 nvarchar(4000),@p1467 datetime2(7),@p1468 nvarchar(4000),@p1469 nvarchar(4000),@p1470 int,@p1471 int,@p1472 int,@p1473 nvarchar(4000),@p1474 nvarchar(4000),@p1475 nvarchar(4000),@p1476 nvarchar(4000),@p1477 decimal(18,2),@p1478 nvarchar(4000),@p1479 nvarchar(4000),@p1480 decimal(18,2),@p1481 nvarchar(4000),@p1482 nvarchar(4000),@p1483 nvarchar(4000),@p1484 nvarchar(4000),@p1485 int,@p1486 nvarchar(4000),@p1487 nvarchar(4000),@p1488 nvarchar(4000),@p1489 nvarchar(4000),@p1490 nvarchar(4000),@p1491 nvarchar(4000),@p1492 nvarchar(4000),@p1493 nvarchar(4000),@p1494 nvarchar(4000),@p1495 nvarchar(4000),@p1496 int,@p1497 nvarchar(4000),@p1498 nvarchar(4000),@p1499 nvarchar(4000),@p1500 nvarchar(4000),@p1501 nvarchar(4000),@p1502 int,@p1503 nvarchar(4000),@p1504 int,@p1505 int,@p1506 datetime2(7),@p1507 datetime2(7),@p1508 datetime2(7),@p1509 nvarchar(4000),@p1510 nvarchar(4000),@p1511 nvarchar(4000),@p1512 nvarchar(4000),@p1513 nvarchar(4000),@p1514 nvarchar(4000),@p1515 nvarchar(4000),@p1516 nvarchar(4000),@p1517 nvarchar(4000),@p1518 nvarchar(4000),@p1519 nvarchar(4000),@p1520 nvarchar(4000),@p1521 nvarchar(4000),@p1522 nvarchar(4000),@p1523 datetime2(7),@p1524 nvarchar(4000),@p1525 nvarchar(4000),@p1526 int,@p1527 int,@p1528 int,@p1529 nvarchar(4000),@p1530 nvarchar(4000),@p1531 nvarchar(4000),@p1532 nvarchar(4000),@p1533 decimal(18,2),@p1534 nvarchar(4000),@p1535 nvarchar(4000),@p1536 decimal(18,2),@p1537 nvarchar(4000),@p1538 nvarchar(4000),@p1539 nvarchar(4000),@p1540 nvarchar(4000),@p1541 int,@p1542 nvarchar(4000),@p1543 nvarchar(4000),@p1544 nvarchar(4000),@p1545 nvarchar(4000),@p1546 nvarchar(4000),@p1547 nvarchar(4000),@p1548 nvarchar(4000),@p1549 nvarchar(4000),@p1550 nvarchar(4000),@p1551 nvarchar(4000),@p1552 int,@p1553 nvarchar(4000),@p1554 nvarchar(4000),@p1555 nvarchar(4000),@p1556 nvarchar(4000),@p1557 nvarchar(4000),@p1558 int,@p1559 nvarchar(4000),@p1560 int,@p1561 int,@p1562 datetime2(7),@p1563 datetime2(7),@p1564 datetime2(7),@p1565 nvarchar(4000),@p1566 nvarchar(4000),@p1567 nvarchar(4000),@p1568 nvarchar(4000),@p1569 nvarchar(4000),@p1570 nvarchar(4000),@p1571 nvarchar(4000),@p1572 nvarchar(4000),@p1573 nvarchar(4000),@p1574 nvarchar(4000),@p1575 nvarchar(4000),@p1576 nvarchar(4000),@p1577 nvarchar(4000),@p1578 nvarchar(4000),@p1579 datetime2(7),@p1580 nvarchar(4000),@p1581 nvarchar(4000),@p1582 int,@p1583 int,@p1584 int,@p1585 nvarchar(4000),@p1586 nvarchar(4000),@p1587 nvarchar(4000),@p1588 nvarchar(4000),@p1589 decimal(18,2),@p1590 nvarchar(4000),@p1591 nvarchar(4000),@p1592 decimal(18,2),@p1593 nvarchar(4000),@p1594 nvarchar(4000),@p1595 nvarchar(4000),@p1596 nvarchar(4000),@p1597 int,@p1598 nvarchar(4000),@p1599 nvarchar(4000),@p1600 nvarchar(4000),@p1601 nvarchar(4000),@p1602 nvarchar(4000),@p1603 nvarchar(4000),@p1604 nvarchar(4000),@p1605 nvarchar(4000),@p1606 nvarchar(4000),@p1607 nvarchar(4000),@p1608 int,@p1609 nvarchar(4000),@p1610 nvarchar(4000),@p1611 nvarchar(4000),@p1612 nvarchar(4000),@p1613 nvarchar(4000),@p1614 int,@p1615 nvarchar(4000),@p1616 int,@p1617 int,@p1618 datetime2(7),@p1619 datetime2(7),@p1620 datetime2(7),@p1621 nvarchar(4000),@p1622 nvarchar(4000),@p1623 nvarchar(4000),@p1624 nvarchar(4000),@p1625 nvarchar(4000),@p1626 nvarchar(4000),@p1627 nvarchar(4000),@p1628 nvarchar(4000),@p1629 nvarchar(4000),@p1630 nvarchar(4000),@p1631 nvarchar(4000),@p1632 nvarchar(4000),@p1633 nvarchar(4000),@p1634 nvarchar(4000),@p1635 datetime2(7),@p1636 nvarchar(4000),@p1637 nvarchar(4000),@p1638 int,@p1639 int,@p1640 int,@p1641 nvarchar(4000),@p1642 nvarchar(4000),@p1643 nvarchar(4000),@p1644 nvarchar(4000),@p1645 decimal(18,2),@p1646 nvarchar(4000),@p1647 nvarchar(4000),@p1648 decimal(18,2),@p1649 nvarchar(4000),@p1650 nvarchar(4000),@p1651 nvarchar(4000),@p1652 nvarchar(4000),@p1653 int,@p1654 nvarchar(4000),@p1655 nvarchar(4000),@p1656 nvarchar(4000),@p1657 nvarchar(4000),@p1658 nvarchar(4000),@p1659 nvarchar(4000),@p1660 nvarchar(4000),@p1661 nvarchar(4000),@p1662 nvarchar(4000),@p1663 nvarchar(4000),@p1664 int,@p1665 nvarchar(4000),@p1666 nvarchar(4000),@p1667 nvarchar(4000),@p1668 nvarchar(4000),@p1669 nvarchar(4000),@p1670 int,@p1671 nvarchar(4000),@p1672 int,@p1673 int,@p1674 datetime2(7),@p1675 datetime2(7),@p1676 datetime2(7),@p1677 nvarchar(4000),@p1678 nvarchar(4000),@p1679 nvarchar(4000),@p1680 nvarchar(4000),@p1681 nvarchar(4000),@p1682 nvarchar(4000),@p1683 nvarchar(4000),@p1684 nvarchar(4000),@p1685 nvarchar(4000),@p1686 nvarchar(4000),@p1687 nvarchar(4000),@p1688 nvarchar(4000),@p1689 nvarchar(4000),@p1690 nvarchar(4000),@p1691 datetime2(7),@p1692 nvarchar(4000),@p1693 nvarchar(4000),@p1694 int,@p1695 int,@p1696 int,@p1697 nvarchar(4000),@p1698 nvarchar(4000),@p1699 nvarchar(4000),@p1700 nvarchar(4000),@p1701 decimal(18,2),@p1702 nvarchar(4000),@p1703 nvarchar(4000),@p1704 decimal(18,2),@p1705 nvarchar(4000),@p1706 nvarchar(4000),@p1707 nvarchar(4000),@p1708 nvarchar(4000),@p1709 int,@p1710 nvarchar(4000),@p1711 nvarchar(4000),@p1712 nvarchar(4000),@p1713 nvarchar(4000),@p1714 nvarchar(4000),@p1715 nvarchar(4000),@p1716 nvarchar(4000),@p1717 nvarchar(4000),@p1718 nvarchar(4000),@p1719 nvarchar(4000),@p1720 int,@p1721 nvarchar(4000),@p1722 nvarchar(4000),@p1723 nvarchar(4000),@p1724 nvarchar(4000),@p1725 nvarchar(4000),@p1726 int,@p1727 nvarchar(4000),@p1728 int,@p1729 int,@p1730 datetime2(7),@p1731 datetime2(7),@p1732 datetime2(7),@p1733 nvarchar(4000),@p1734 nvarchar(4000),@p1735 nvarchar(4000),@p1736 nvarchar(4000),@p1737 nvarchar(4000),@p1738 nvarchar(4000),@p1739 nvarchar(4000),@p1740 nvarchar(4000),@p1741 nvarchar(4000),@p1742 nvarchar(4000),@p1743 nvarchar(4000),@p1744 nvarchar(4000),@p1745 nvarchar(4000),@p1746 nvarchar(4000),@p1747 datetime2(7),@p1748 nvarchar(4000),@p1749 nvarchar(4000),@p1750 int,@p1751 int,@p1752 int,@p1753 nvarchar(4000),@p1754 nvarchar(4000),@p1755 nvarchar(4000),@p1756 nvarchar(4000),@p1757 decimal(18,2),@p1758 nvarchar(4000),@p1759 nvarchar(4000),@p1760 decimal(18,2),@p1761 nvarchar(4000),@p1762 nvarchar(4000),@p1763 nvarchar(4000),@p1764 nvarchar(4000),@p1765 int,@p1766 nvarchar(4000),@p1767 nvarchar(4000),@p1768 nvarchar(4000),@p1769 nvarchar(4000),@p1770 nvarchar(4000),@p1771 nvarchar(4000),@p1772 nvarchar(4000),@p1773 nvarchar(4000),@p1774 nvarchar(4000),@p1775 nvarchar(4000),@p1776 int,@p1777 nvarchar(4000),@p1778 nvarchar(4000),@p1779 nvarchar(4000),@p1780 nvarchar(4000),@p1781 nvarchar(4000),@p1782 int,@p1783 nvarchar(4000),@p1784 int,@p1785 int,@p1786 datetime2(7),@p1787 datetime2(7),@p1788 datetime2(7),@p1789 nvarchar(4000),@p1790 nvarchar(4000),@p1791 nvarchar(4000),@p1792 nvarchar(4000),@p1793 nvarchar(4000),@p1794 nvarchar(4000),@p1795 nvarchar(4000),@p1796 nvarchar(4000),@p1797 nvarchar(4000),@p1798 nvarchar(4000),@p1799 nvarchar(4000),@p1800 nvarchar(4000),@p1801 nvarchar(4000),@p1802 nvarchar(4000),@p1803 datetime2(7),@p1804 nvarchar(4000),@p1805 nvarchar(4000),@p1806 int,@p1807 int,@p1808 int,@p1809 nvarchar(4000),@p1810 nvarchar(4000),@p1811 nvarchar(4000),@p1812 nvarchar(4000),@p1813 decimal(18,2),@p1814 nvarchar(4000),@p1815 nvarchar(4000),@p1816 decimal(18,2),@p1817 nvarchar(4000),@p1818 nvarchar(4000),@p1819 nvarchar(4000),@p1820 nvarchar(4000),@p1821 int,@p1822 nvarchar(4000),@p1823 nvarchar(4000),@p1824 nvarchar(4000),@p1825 nvarchar(4000),@p1826 nvarchar(4000),@p1827 nvarchar(4000),@p1828 nvarchar(4000),@p1829 nvarchar(4000),@p1830 nvarchar(4000),@p1831 nvarchar(4000),@p1832 int,@p1833 nvarchar(4000),@p1834 nvarchar(4000),@p1835 nvarchar(4000),@p1836 nvarchar(4000),@p1837 nvarchar(4000),@p1838 int,@p1839 nvarchar(4000),@p1840 int,@p1841 int,@p1842 datetime2(7),@p1843 datetime2(7),@p1844 datetime2(7),@p1845 nvarchar(4000),@p1846 nvarchar(4000),@p1847 nvarchar(4000),@p1848 nvarchar(4000),@p1849 nvarchar(4000),@p1850 nvarchar(4000),@p1851 nvarchar(4000),@p1852 nvarchar(4000),@p1853 nvarchar(4000),@p1854 nvarchar(4000),@p1855 nvarchar(4000),@p1856 nvarchar(4000),@p1857 nvarchar(4000),@p1858 nvarchar(4000),@p1859 datetime2(7),@p1860 nvarchar(4000),@p1861 nvarchar(4000),@p1862 int,@p1863 int,@p1864 int,@p1865 nvarchar(4000),@p1866 nvarchar(4000),@p1867 nvarchar(4000),@p1868 nvarchar(4000),@p1869 decimal(18,2),@p1870 nvarchar(4000),@p1871 nvarchar(4000),@p1872 decimal(18,2),@p1873 nvarchar(4000),@p1874 nvarchar(4000),@p1875 nvarchar(4000),@p1876 nvarchar(4000),@p1877 int,@p1878 nvarchar(4000),@p1879 nvarchar(4000),@p1880 nvarchar(4000),@p1881 nvarchar(4000),@p1882 nvarchar(4000),@p1883 nvarchar(4000),@p1884 nvarchar(4000),@p1885 nvarchar(4000),@p1886 nvarchar(4000),@p1887 nvarchar(4000),@p1888 int,@p1889 nvarchar(4000),@p1890 nvarchar(4000),@p1891 nvarchar(4000),@p1892 nvarchar(4000),@p1893 nvarchar(4000),@p1894 int,@p1895 nvarchar(4000),@p1896 int,@p1897 int,@p1898 datetime2(7),@p1899 datetime2(7),@p1900 datetime2(7),@p1901 nvarchar(4000),@p1902 nvarchar(4000),@p1903 nvarchar(4000),@p1904 nvarchar(4000),@p1905 nvarchar(4000),@p1906 nvarchar(4000),@p1907 nvarchar(4000),@p1908 nvarchar(4000),@p1909 nvarchar(4000),@p1910 nvarchar(4000),@p1911 nvarchar(4000),@p1912 nvarchar(4000),@p1913 nvarchar(4000),@p1914 nvarchar(4000),@p1915 datetime2(7),@p1916 nvarchar(4000),@p1917 nvarchar(4000),@p1918 int,@p1919 int,@p1920 int,@p1921 nvarchar(4000),@p1922 nvarchar(4000),@p1923 nvarchar(4000),@p1924 nvarchar(4000),@p1925 decimal(18,2),@p1926 nvarchar(4000),@p1927 nvarchar(4000),@p1928 decimal(18,2),@p1929 nvarchar(4000),@p1930 nvarchar(4000),@p1931 nvarchar(4000),@p1932 nvarchar(4000),@p1933 int,@p1934 nvarchar(4000),@p1935 nvarchar(4000),@p1936 nvarchar(4000),@p1937 nvarchar(4000),@p1938 nvarchar(4000),@p1939 nvarchar(4000),@p1940 nvarchar(4000),@p1941 nvarchar(4000),@p1942 nvarchar(4000),@p1943 nvarchar(4000),@p1944 int,@p1945 nvarchar(4000),@p1946 nvarchar(4000),@p1947 nvarchar(4000),@p1948 nvarchar(4000),@p1949 nvarchar(4000),@p1950 int,@p1951 nvarchar(4000),@p1952 int,@p1953 int,@p1954 datetime2(7),@p1955 datetime2(7),@p1956 datetime2(7),@p1957 nvarchar(4000),@p1958 nvarchar(4000),@p1959 nvarchar(4000),@p1960 nvarchar(4000),@p1961 nvarchar(4000),@p1962 nvarchar(4000),@p1963 nvarchar(4000),@p1964 nvarchar(4000),@p1965 nvarchar(4000),@p1966 nvarchar(4000),@p1967 nvarchar(4000),@p1968 nvarchar(4000),@p1969 nvarchar(4000),@p1970 nvarchar(4000),@p1971 datetime2(7),@p1972 nvarchar(4000),@p1973 nvarchar(4000),@p1974 int,@p1975 int,@p1976 int,@p1977 nvarchar(4000),@p1978 nvarchar(4000),@p1979 nvarchar(4000),@p1980 nvarchar(4000),@p1981 decimal(18,2),@p1982 nvarchar(4000),@p1983 nvarchar(4000),@p1984 decimal(18,2),@p1985 nvarchar(4000),@p1986 nvarchar(4000),@p1987 nvarchar(4000),@p1988 nvarchar(4000),@p1989 int,@p1990 nvarchar(4000),@p1991 nvarchar(4000),@p1992 nvarchar(4000),@p1993 nvarchar(4000),@p1994 nvarchar(4000),@p1995 nvarchar(4000),@p1996 nvarchar(4000),@p1997 nvarchar(4000),@p1998 nvarchar(4000),@p1999 nvarchar(4000),@p2000 int,@p2001 nvarchar(4000),@p2002 nvarchar(4000),@p2003 nvarchar(4000),@p2004 nvarchar(4000),@p2005 nvarchar(4000),@p2006 int,@p2007 nvarchar(4000),@p2008 int,@p2009 int,@p2010 datetime2(7),@p2011 datetime2(7),@p2012 datetime2(7),@p2013 nvarchar(4000),@p2014 nvarchar(4000),@p2015 nvarchar(4000),@p2016 nvarchar(4000),@p2017 nvarchar(4000),@p2018 nvarchar(4000),@p2019 nvarchar(4000),@p2020 nvarchar(4000),@p2021 nvarchar(4000),@p2022 nvarchar(4000),@p2023 nvarchar(4000),@p2024 nvarchar(4000),@p2025 nvarchar(4000),@p2026 nvarchar(4000),@p2027 datetime2(7),@p2028 nvarchar(4000),@p2029 nvarchar(4000),@p2030 int,@p2031 int,@p2032 int,@p2033 nvarchar(4000),@p2034 nvarchar(4000),@p2035 nvarchar(4000),@p2036 nvarchar(4000),@p2037 decimal(18,2),@p2038 nvarchar(4000),@p2039 nvarchar(4000),@p2040 decimal(18,2),@p2041 nvarchar(4000),@p2042 nvarchar(4000),@p2043 nvarchar(4000),@p2044 nvarchar(4000),@p2045 int,@p2046 nvarchar(4000),@p2047 nvarchar(4000),@p2048 nvarchar(4000),@p2049 nvarchar(4000),@p2050 nvarchar(4000),@p2051 nvarchar(4000),@p2052 nvarchar(4000),@p2053 nvarchar(4000),@p2054 nvarchar(4000),@p2055 nvarchar(4000),@p2056 int,@p2057 nvarchar(4000),@p2058 nvarchar(4000),@p2059 nvarchar(4000),@p2060 nvarchar(4000),@p2061 nvarchar(4000),@p2062 int,@p2063 nvarchar(4000),@p2064 int,@p2065 int,@p2066 datetime2(7),@p2067 datetime2(7),@p2068 datetime2(7),@p2069 nvarchar(4000),@p2070 nvarchar(4000),@p2071 nvarchar(4000))SET NOCOUNT ON; DECLARE @inserted0 TABLE ([item_id] int, [_Position] [int]); MERGE [raw_data] USING ( VALUES (@p0, @p1, @p2, @p3, @p4, @p5, @p6, @p7, @p8, @p9, @p10, @p11, @p12, @p13, @p14, @p15, @p16, @p17, @p18, @p19, @p20, @p21, @p22, @p23, @p24, @p25, @p26, @p27, @p28, @p29, @p30, @p31, @p32, @p33, @p34, @p35, @p36, @p37, @p38, @p39, @p40, @p41, @p42, @p43, @p44, @p45, @p46, @p47, @p48, @p49, @p50, @p51, @p52, @p53, @p54, @p55, 0), (@p56, @p57, @p58, @p59, @p60, @p61, @p62, @p63, @p64, @p65, @p66, @p67, @p68, @p69, @p70, @p71, @p72, @p73, @p74, @p75, @p76, @p77, @p78, @p79, @p80, @p81, @p82, @p83, @p84, @p85, @p86, @p87, @p88, @p89, @p90, @p91, @p92, @p93, @p94, @p95, @p96, @p97, @p98, @p99, @p100, @p101, @p102, @p103, @p104, @p105, @p106, @p107, @p108, @p109, @p110, @p111, 1), (@p112, @p113, @p114, @p115, @p116, @p117, @p118, @p119, @p120, @p121, @p122, @p123, @p124, @p125, @p126, @p127, @p128, @p129, @p130, @p131, @p132, @p133, @p134, @p135, @p136, @p137, @p138, @p139, @p140, @p141, @p142, @p143, @p144, @p145, @p146, @p147, @p148, @p149, @p150, @p151, @p152, @p153, @p154, @p155, @p156, @p157, @p158, @p159, @p160, @p161, @p162, @p163, @p164, @p165, @p166, @p167, 2), (@p168, @p169, @p170, @p171, @p172, @p173, @p174, @p175, @p176, @p177, @p178, @p179, @p180, @p181, @p182, @p183, @p184, @p185, @p186, @p187, @p188, @p189, @p190, @p191, @p192, @p193, @p194, @p195, @p196, @p197, @p198, @p199, @p200, @p201, @p202, @p203, @p204, @p205, @p206, @p207, @p208, @p209, @p210, @p211, @p212, @p213, @p214, @p215, @p216, @p217, @p218, @p219, @p220, @p221, @p222, @p223, 3), (@p224, @p225, @p226, @p227, @p228, @p229, @p230, @p231, @p232, @p233, @p234, @p235, @p236, @p237, @p238, @p239, @p240, @p241, @p242, @p243, @p244, @p245, @p246, @p247, @p248, @p249, @p250, @p251, @p252, @p253, @p254, @p255, @p256, @p257, @p258, @p259, @p260, @p261, @p262, @p263, @p264, @p265, @p266, @p267, @p268, @p269, @p270, @p271, @p272, @p273, @p274, @p275, @p276, @p277, @p278, @p279, 4), (@p280, @p281, @p282, @p283, @p284, @p285, @p286, @p287, @p288, @p289, @p290, @p291, @p292, @p293, @p294, @p295, @p296, @p297, @p298, @p299, @p300, @p301, @p302, @p303, @p304, @p305, @p306, @p307, @p308, @p309, @p310, @p311, @p312, @p313, @p314, @p315, @p316, @p317, @p318, @p319, @p320, @p321, @p322, @p323, @p324, @p325, @p326, @p327, @p328, @p329, @p330, @p331, @p332, @p333, @p334, @p335, 5), (@p336, @p337, @p338, @p339, @p340, @p341, @p342, @p343, @p344, @p345, @p346, @p347, @p348, @p349, @p350, @p351, @p352, @p353, @p354, @p355, @p356, @p357, @p358, @p359, @p360, @p361, @p362, @p363, @p364, @p365, @p366, @p367, @p368, @p369, @p370, @p371, @p372, @p373, @p374, @p375, @p376, @p377, @p378, @p379, @p380, @p381, @p382, @p383, @p384, @p385, @p386, @p387, @p388, @p389, @p390, @p391, 6), (@p392, @p393, @p394, @p395, @p396, @p397, @p398, @p399, @p400, @p401, @p402, @p403, @p404, @p405, @p406, @p407, @p408, @p409, @p410, @p411, @p412, @p413, @p414, @p415, @p416, @p417, @p418, @p419, @p420, @p421, @p422, @p423, @p424, @p425, @p426, @p427, @p428, @p429, @p430, @p431, @p432, @p433, @p434, @p435, @p436, @p437, @p438, @p439, @p440, @p441, @p442, @p443, @p444, @p445, @p446, @p447, 7), (@p448, @p449, @p450, @p451, @p452, @p453, @p454, @p455, @p456, @p457, @p458, @p459, @p460, @p461, @p462, @p463, @p464, @p465, @p466, @p467, @p468, @p469, @p470, @p471, @p472, @p473, @p474, @p475, @p476, @p477, @p478, @p479, @p480, @p481, @p482, @p483, @p484, @p485, @p486, @p487, @p488, @p489, @p490, @p491, @p492, @p493, @p494, @p495, @p496, @p497, @p498, @p499, @p500, @p501, @p502, @p503, 8), (@p504, @p505, @p506, @p507, @p508, @p509, @p510, @p511, @p512, @p513, @p514, @p515, @p516, @p517, @p518, @p519, @p520, @p521, @p522, @p523, @p524, @p525, @p526, @p527, @p528, @p529, @p530, @p531, @p532, @p533, @p534, @p535, @p536, @p537, @p538, @p539, @p540, @p541, @p542, @p543, @p544, @p545, @p546, @p547, @p548, @p549, @p550, @p551, @p552, @p553, @p554, @p555, @p556, @p557, @p558, @p559, 9), (@p560, @p561, @p562, @p563, @p564, @p565, @p566, @p567, @p568, @p569, @p570, @p571, @p572, @p573, @p574, @p575, @p576, @p577, @p578, @p579, @p580, @p581, @p582, @p583, @p584, @p585, @p586, @p587, @p588, @p589, @p590, @p591, @p592, @p593, @p594, @p595, @p596, @p597, @p598, @p599, @p600, @p601, @p602, @p603, @p604, @p605, @p606, @p607, @p608, @p609, @p610, @p611, @p612, @p613, @p614, @p615, 10), (@p616, @p617, @p618, @p619, @p620, @p621, @p622, @p623, @p624, @p625, @p626, @p627, @p628, @p629, @p630, @p631, @p632, @p633, @p634, @p635, @p636, @p637, @p638, @p639, @p640, @p641, @p642, @p643, @p644, @p645, @p646, @p647, @p648, @p649, @p650, @p651, @p652, @p653, @p654, @p655, @p656, @p657, @p658, @p659, @p660, @p661, @p662, @p663, @p664, @p665, @p666, @p667, @p668, @p669, @p670, @p671, 11), (@p672, @p673, @p674, @p675, @p676, @p677, @p678, @p679, @p680, @p681, @p682, @p683, @p684, @p685, @p686, @p687, @p688, @p689, @p690, @p691, @p692, @p693, @p694, @p695, @p696, @p697, @p698, @p699, @p700, @p701, @p702, @p703, @p704, @p705, @p706, @p707, @p708, @p709, @p710, @p711, @p712, @p713, @p714, @p715, @p716, @p717, @p718, @p719, @p720, @p721, @p722, @p723, @p724, @p725, @p726, @p727, 12), (@p728, @p729, @p730, @p731, @p732, @p733, @p734, @p735, @p736, @p737, @p738, @p739, @p740, @p741, @p742, @p743, @p744, @p745, @p746, @p747, @p748, @p749, @p750, @p751, @p752, @p753, @p754, @p755, @p756, @p757, @p758, @p759, @p760, @p761, @p762, @p763, @p764, @p765, @p766, @p767, @p768, @p769, @p770, @p771, @p772, @p773, @p774, @p775, @p776, @p777, @p778, @p779, @p780, @p781, @p782, @p783, 13), (@p784, @p785, @p786, @p787, @p788, @p789, @p790, @p791, @p792, @p793, @p794, @p795, @p796, @p797, @p798, @p799, @p800, @p801, @p802, @p803, @p804, @p805, @p806, @p807, @p808, @p809, @p810, @p811, @p812, @p813, @p814, @p815, @p816, @p817, @p818, @p819, @p820, @p821, @p822, @p823, @p824, @p825, @p826, @p827, @p828, @p829, @p830, @p831, @p832, @p833, @p834, @p835, @p836, @p837, @p838, @p839, 14), (@p840, @p841, @p842, @p843, @p844, @p845, @p846, @p847, @p848, @p849, @p850, @p851, @p852, @p853, @p854, @p855, @p856, @p857, @p858, @p859, @p860, @p861, @p862, @p863, @p864, @p865, @p866, @p867, @p868, @p869, @p870, @p871, @p872, @p873, @p874, @p875, @p876, @p877, @p878, @p879, @p880, @p881, @p882, @p883, @p884, @p885, @p886, @p887, @p888, @p889, @p890, @p891, @p892, @p893, @p894, @p895, 15), (@p896, @p897, @p898, @p899, @p900, @p901, @p902, @p903, @p904, @p905, @p906, @p907, @p908, @p909, @p910, @p911, @p912, @p913, @p914, @p915, @p916, @p917, @p918, @p919, @p920, @p921, @p922, @p923, @p924, @p925, @p926, @p927, @p928, @p929, @p930, @p931, @p932, @p933, @p934, @p935, @p936, @p937, @p938, @p939, @p940, @p941, @p942, @p943, @p944, @p945, @p946, @p947, @p948, @p949, @p950, @p951, 16), (@p952, @p953, @p954, @p955, @p956, @p957, @p958, @p959, @p960, @p961, @p962, @p963, @p964, @p965, @p966, @p967, @p968, @p969, @p970, @p971, @p972, @p973, @p974, @p975, @p976, @p977, @p978, @p979, @p980, @p981, @p982, @p983, @p984, @p985, @p986, @p987, @p988, @p989, @p990, @p991, @p992, @p993, @p994, @p995, @p996, @p997, @p998, @p999, @p1000, @p1001, @p1002, @p1003, @p1004, @p1005, @p1006, @p1007, 17), (@p1008, @p1009, @p1010, @p1011, @p1012, @p1013, @p1014, @p1015, @p1016, @p1017, @p1018, @p1019, @p1020, @p1021, @p1022, @p1023, @p1024, @p1025, @p1026, @p1027, @p1028, @p1029, @p1030, @p1031, @p1032, @p1033, @p1034, @p1035, @p1036, @p1037, @p1038, @p1039, @p1040, @p1041, @p1042, @p1043, @p1044, @p1045, @p1046, @p1047, @p1048, @p1049, @p1050, @p1051, @p1052, @p1053, @p1054, @p1055, @p1056, @p1057, @p1058, @p1059, @p1060, @p1061, @p1062, @p1063, 18), (@p1064, @p1065, @p1066, @p1067, @p1068, @p1069, @p1070, @p1071, @p1072, @p1073, @p1074, @p1075, @p1076, @p1077, @p1078, @p1079, @p1080, @p1081, @p1082, @p1083, @p1084, @p1085, @p1086, @p1087, @p1088, @p1089, @p1090, @p1091, @p1092, @p1093, @p1094, @p1095, @p1096, @p1097, @p1098, @p1099, @p1100, @p1101, @p1102, @p1103, @p1104, @p1105, @p1106, @p1107, @p1108, @p1109, @p1110, @p1111, @p1112, @p1113, @p1114, @p1115, @p1116, @p1117, @p1118, @p1119, 19), (@p1120, @p1121, @p1122, @p1123, @p1124, @p1125, @p1126, @p1127, @p1128, @p1129, @p1130, @p1131, @p1132, @p1133, @p1134, @p1135, @p1136, @p1137, @p1138, @p1139, @p1140, @p1141, @p1142, @p1143, @p1144, @p1145, @p1146, @p1147, @p1148, @p1149, @p1150, @p1151, @p1152, @p1153, @p1154, @p1155, @p1156, @p1157, @p1158, @p1159, @p1160, @p1161, @p1162, @p1163, @p1164, @p1165, @p1166, @p1167, @p1168, @p1169, @p1170, @p1171, @p1172, @p1173, @p1174, @p1175, 20), (@p1176, @p1177, @p1178, @p1179, @p1180, @p1181, @p1182, @p1183, @p1184, @p1185, @p1186, @p1187, @p1188, @p1189, @p1190, @p1191, @p1192, @p1193, @p1194, @p1195, @p1196, @p1197, @p1198, @p1199, @p1200, @p1201, @p1202, @p1203, @p1204, @p1205, @p1206, @p1207, @p1208, @p1209, @p1210, @p1211, @p1212, @p1213, @p1214, @p1215, @p1216, @p1217, @p1218, @p1219, @p1220, @p1221, @p1222, @p1223, @p1224, @p1225, @p1226, @p1227, @p1228, @p1229, @p1230, @p1231, 21), (@p1232, @p1233, @p1234, @p1235, @p1236, @p1237, @p1238, @p1239, @p1240, @p1241, @p1242, @p1243, @p1244, @p1245, @p1246, @p1247, @p1248, @p1249, @p1250, @p1251, @p1252, @p1253, @p1254, @p1255, @p1256, @p1257, @p1258, @p1259, @p1260, @p1261, @p1262, @p1263, @p1264, @p1265, @p1266, @p1267, @p1268, @p1269, @p1270, @p1271, @p1272, @p1273, @p1274, @p1275, @p1276, @p1277, @p1278, @p1279, @p1280, @p1281, @p1282, @p1283, @p1284, @p1285, @p1286, @p1287, 22), (@p1288, @p1289, @p1290, @p1291, @p1292, @p1293, @p1294, @p1295, @p1296, @p1297, @p1298, @p1299, @p1300, @p1301, @p1302, @p1303, @p1304, @p1305, @p1306, @p1307, @p1308, @p1309, @p1310, @p1311, @p1312, @p1313, @p1314, @p1315, @p1316, @p1317, @p1318, @p1319, @p1320, @p1321, @p1322, @p1323, @p1324, @p1325, @p1326, @p1327, @p1328, @p1329, @p1330, @p1331, @p1332, @p1333, @p1334, @p1335, @p1336, @p1337, @p1338, @p1339, @p1340, @p1341, @p1342, @p1343, 23), (@p1344, @p1345, @p1346, @p1347, @p1348, @p1349, @p1350, @p1351, @p1352, @p1353, @p1354, @p1355, @p1356, @p1357, @p1358, @p1359, @p1360, @p1361, @p1362, @p1363, @p1364, @p1365, @p1366, @p1367, @p1368, @p1369, @p1370, @p1371, @p1372, @p1373, @p1374, @p1375, @p1376, @p1377, @p1378, @p1379, @p1380, @p1381, @p1382, @p1383, @p1384, @p1385, @p1386, @p1387, @p1388, @p1389, @p1390, @p1391, @p1392, @p1393, @p1394, @p1395, @p1396, @p1397, @p1398, @p1399, 24), (@p1400, @p1401, @p1402, @p1403, @p1404, @p1405, @p1406, @p1407, @p1408, @p1409, @p1410, @p1411, @p1412, @p1413, @p1414, @p1415, @p1416, @p1417, @p1418, @p1419, @p1420, @p1421, @p1422, @p1423, @p1424, @p1425, @p1426, @p1427, @p1428, @p1429, @p1430, @p1431, @p1432, @p1433, @p1434, @p1435, @p1436, @p1437, @p1438, @p1439, @p1440, @p1441, @p1442, @p1443, @p1444, @p1445, @p1446, @p1447, @p1448, @p1449, @p1450, @p1451, @p1452, @p1453, @p1454, @p1455, 25), (@p1456, @p1457, @p1458, @p1459, @p1460, @p1461, @p1462, @p1463, @p1464, @p1465, @p1466, @p1467, @p1468, @p1469, @p1470, @p1471, @p1472, @p1473, @p1474, @p1475, @p1476, @p1477, @p1478, @p1479, @p1480, @p1481, @p1482, @p1483, @p1484, @p1485, @p1486, @p1487, @p1488, @p1489, @p1490, @p1491, @p1492, @p1493, @p1494, @p1495, @p1496, @p1497, @p1498, @p1499, @p1500, @p1501, @p1502, @p1503, @p1504, @p1505, @p1506, @p1507, @p1508, @p1509, @p1510, @p1511, 26), (@p1512, @p1513, @p1514, @p1515, @p1516, @p1517, @p1518, @p1519, @p1520, @p1521, @p1522, @p1523, @p1524, @p1525, @p1526, @p1527, @p1528, @p1529, @p1530, @p1531, @p1532, @p1533, @p1534, @p1535, @p1536, @p1537, @p1538, @p1539, @p1540, @p1541, @p1542, @p1543, @p1544, @p1545, @p1546, @p1547, @p1548, @p1549, @p1550, @p1551, @p1552, @p1553, @p1554, @p1555, @p1556, @p1557, @p1558, @p1559, @p1560, @p1561, @p1562, @p1563, @p1564, @p1565, @p1566, @p1567, 27), (@p1568, @p1569, @p1570, @p1571, @p1572, @p1573, @p1574, @p1575, @p1576, @p1577, @p1578, @p1579, @p1580, @p1581, @p1582, @p1583, @p1584, @p1585, @p1586, @p1587, @p1588, @p1589, @p1590, @p1591, @p1592, @p1593, @p1594, @p1595, @p1596, @p1597, @p1598, @p1599, @p1600, @p1601, @p1602, @p1603, @p1604, @p1605, @p1606, @p1607, @p1608, @p1609, @p1610, @p1611, @p1612, @p1613, @p1614, @p1615, @p1616, @p1617, @p1618, @p1619, @p1620, @p1621, @p1622, @p1623, 28), (@p1624, @p1625, @p1626, @p1627, @p1628, @p1629, @p1630, @p1631, @p1632, @p1633, @p1634, @p1635, @p1636, @p1637, @p1638, @p1639, @p1640, @p1641, @p1642, @p1643, @p1644, @p1645, @p1646, @p1647, @p1648, @p1649, @p1650, @p1651, @p1652, @p1653, @p1654, @p1655, @p1656, @p1657, @p1658, @p1659, @p1660, @p1661, @p1662, @p1663, @p1664, @p1665, @p1666, @p1667, @p1668, @p1669, @p1670, @p1671, @p1672, @p1673, @p1674, @p1675, @p1676, @p1677, @p1678, @p1679, 29), (@p1680, @p1681, @p1682, @p1683, @p1684, @p1685, @p1686, @p1687, @p1688, @p1689, @p1690, @p1691, @p1692, @p1693, @p1694, @p1695, @p1696, @p1697, @p1698, @p1699, @p1700, @p1701, @p1702, @p1703, @p1704, @p1705, @p1706, @p1707, @p1708, @p1709, @p1710, @p1711, @p1712, @p1713, @p1714, @p1715, @p1716, @p1717, @p1718, @p1719, @p1720, @p1721, @p1722, @p1723, @p1724, @p1725, @p1726, @p1727, @p1728, @p1729, @p1730, @p1731, @p1732, @p1733, @p1734, @p1735, 30), (@p1736, @p1737, @p1738, @p1739, @p1740, @p1741, @p1742, @p1743, @p1744, @p1745, @p1746, @p1747, @p1748, @p1749, @p1750, @p1751, @p1752, @p1753, @p1754, @p1755, @p1756, @p1757, @p1758, @p1759, @p1760, @p1761, @p1762, @p1763, @p1764, @p1765, @p1766, @p1767, @p1768, @p1769, @p1770, @p1771, @p1772, @p1773, @p1774, @p1775, @p1776, @p1777, @p1778, @p1779, @p1780, @p1781, @p1782, @p1783, @p1784, @p1785, @p1786, @p1787, @p1788, @p1789, @p1790, @p1791, 31), (@p1792, @p1793, @p1794, @p1795, @p1796, @p1797, @p1798, @p1799, @p1800, @p1801, @p1802, @p1803, @p1804, @p1805, @p1806, @p1807, @p1808, @p1809, @p1810, @p1811, @p1812, @p1813, @p1814, @p1815, @p1816, @p1817, @p1818, @p1819, @p1820, @p1821, @p1822, @p1823, @p1824, @p1825, @p1826, @p1827, @p1828, @p1829, @p1830, @p1831, @p1832, @p1833, @p1834, @p1835, @p1836, @p1837, @p1838, @p1839, @p1840, @p1841, @p1842, @p1843, @p1844, @p1845, @p1846, @p1847, 32), (@p1848, @p1849, @p1850, @p1851, @p1852, @p1853, @p1854, @p1855, @p1856, @p1857, @p1858, @p1859, @p1860, @p1861, @p1862, @p1863, @p1864, @p1865, @p1866, @p1867, @p1868, @p1869, @p1870, @p1871, @p1872, @p1873, @p1874, @p1875, @p1876, @p1877, @p1878, @p1879, @p1880, @p1881, @p1882, @p1883, @p1884, @p1885, @p1886, @p1887, @p1888, @p1889, @p1890, @p1891, @p1892, @p1893, @p1894, @p1895, @p1896, @p1897, @p1898, @p1899, @p1900, @p1901, @p1902, @p1903, 33), (@p1904, @p1905, @p1906, @p1907, @p1908, @p1909, @p1910, @p1911, @p1912, @p1913, @p1914, @p1915, @p1916, @p1917, @p1918, @p1919, @p1920, @p1921, @p1922, @p1923, @p1924, @p1925, @p1926, @p1927, @p1928, @p1929, @p1930, @p1931, @p1932, @p1933, @p1934, @p1935, @p1936, @p1937, @p1938, @p1939, @p1940, @p1941, @p1942, @p1943, @p1944, @p1945, @p1946, @p1947, @p1948, @p1949, @p1950, @p1951, @p1952, @p1953, @p1954, @p1955, @p1956, @p1957, @p1958, @p1959, 34), (@p1960, @p1961, @p1962, @p1963, @p1964, @p1965, @p1966, @p1967, @p1968, @p1969, @p1970, @p1971, @p1972, @p1973, @p1974, @p1975, @p1976, @p1977, @p1978, @p1979, @p1980, @p1981, @p1982, @p1983, @p1984, @p1985, @p1986, @p1987, @p1988, @p1989, @p1990, @p1991, @p1992, @p1993, @p1994, @p1995, @p1996, @p1997, @p1998, @p1999, @p2000, @p2001, @p2002, @p2003, @p2004, @p2005, @p2006, @p2007, @p2008, @p2009, @p2010, @p2011, @p2012, @p2013, @p2014, @p2015, 35), (@p2016, @p2017, @p2018, @p2019, @p2020, @p2021, @p2022, @p2023, @p2024, @p2025, @p2026, @p2027, @p2028, @p2029, @p2030, @p2031, @p2032, @p2033, @p2034, @p2035, @p2036, @p2037, @p2038, @p2039, @p2040, @p2041, @p2042, @p2043, @p2044, @p2045, @p2046, @p2047, @p2048, @p2049, @p2050, @p2051, @p2052, @p2053, @p2054, @p2055, @p2056, @p2057, @p2058, @p2059, @p2060, @p2061, @p2062, @p2063, @p2064, @p2065, @p2066, @p2067, @p2068, @p2069, @p2070, @p2071, 36)) AS i ([addressee_cntry_cd], [addressee_city], [addressee_district], [addressee_email], [addressee_full_address], [addressee_home_address], [addressee_name], [addressee_postcode], [addressee_province], [addressee_subdistrict], [addressee_tel], [create_table], [delivery_code], [delivery_recipient_name], [delivery_relation_id], [delivery_status_id], [dest_outlet_id], [dest_outlet_port], [document_number], [item_barcode], [item_cod], [item_gross_weight], [item_height], [item_length], [item_price], [item_width], [lat], [log_id], [long], [outlet_id], [outlet_port], [podUrl], [remark], [scan_cntry_cd], [scan_cntry_postcode], [sender_cntry_cd], [sender_district], [sender_email], [sender_full_address], [sender_home_address], [member_id], [sender_name], [sender_postcode], [sender_province], [sender_subdistrict], [sender_tel], [server_id], [signatureUrl], [state], [status_code], [status_dtm], [timestamp], [transmit_dtm], [user_id], [wckt_id], [wkstn_no], _Position) ON 1=0 WHEN NOT MATCHED THEN INSERT ([addressee_cntry_cd], [addressee_city], [addressee_district], [addressee_email], [addressee_full_address], [addressee_home_address], [addressee_name], [addressee_postcode], [addressee_province], [addressee_subdistrict], [addressee_tel], [create_table], [delivery_code], [delivery_recipient_name], [delivery_relation_id], [delivery_status_id], [dest_outlet_id], [dest_outlet_port], [document_number], [item_barcode], [item_cod], [item_gross_weight], [item_height], [item_length], [item_price], [item_width], [lat], [log_id], [long], [outlet_id], [outlet_port], [podUrl], [remark], [scan_cntry_cd], [scan_cntry_postcode], [sender_cntry_cd], [sender_district], [sender_email], [sender_full_address], [sender_home_address], [member_id], [sender_name], [sender_postcode], [sender_province], [sender_subdistrict], [sender_tel], [server_id], [signatureUrl], [state], [status_code], [status_dtm], [timestamp], [transmit_dtm], [user_id], [wckt_id], [wkstn_no]) VALUES (i.[addressee_cntry_cd], i.[addressee_city], i.[addressee_district], i.[addressee_email], i.[addressee_full_address], i.[addressee_home_address], i.[addressee_name], i.[addressee_postcode], i.[addressee_province], i.[addressee_subdistrict], i.[addressee_tel], i.[create_table], i.[delivery_code], i.[delivery_recipient_name], i.[delivery_relation_id], i.[delivery_status_id], i.[dest_outlet_id], i.[dest_outlet_port], i.[document_number], i.[item_barcode], i.[item_cod], i.[item_gross_weight], i.[item_height], i.[item_length], i.[item_price], i.[item_width], i.[lat], i.[log_id], i.[long], i.[outlet_id], i.[outlet_port], i.[podUrl], i.[remark], i.[scan_cntry_cd], i.[scan_cntry_postcode], i.[sender_cntry_cd], i.[sender_district], i.[sender_email], i.[sender_full_address], i.[sender_home_address], i.[member_id], i.[sender_name], i.[sender_postcode], i.[sender_province], i.[sender_subdistrict], i.[sender_tel], i.[server_id], i.[signatureUrl], i.[state], i.[status_code], i.[status_dtm], i.[timestamp], i.[transmit_dtm], i.[user_id], i.[wckt_id], i.[wkstn_no]) OUTPUT INSERTED.[item_id], i._Position INTO @inserted0;  SELECT [t].[item_id] FROM [raw_data] t INNER JOIN @inserted0 i ON ([t].[item_id] = [i].[item_id]) ORDER BY [i].[_Position];  ",4,4,0,438,3,4
"(@p0 nvarchar(4000),@p1 nvarchar(4000),@p2 nvarchar(4000),@p3 nvarchar(4000),@p4 nvarchar(4000),@p5 nvarchar(4000),@p6 nvarchar(4000),@p7 nvarchar(4000),@p8 nvarchar(4000),@p9 nvarchar(4000),@p10 nvarchar(4000),@p11 datetime2(7),@p12 nvarchar(4000),@p13 nvarchar(4000),@p14 int,@p15 int,@p16 int,@p17 nvarchar(4000),@p18 nvarchar(4000),@p19 nvarchar(4000),@p20 decimal(18,2),@p21 decimal(18,2),@p22 nvarchar(4000),@p23 nvarchar(4000),@p24 decimal(18,2),@p25 nvarchar(4000),@p26 nvarchar(4000),@p27 nvarchar(4000),@p28 nvarchar(4000),@p29 int,@p30 nvarchar(4000),@p31 nvarchar(4000),@p32 nvarchar(4000),@p33 nvarchar(4000),@p34 nvarchar(4000),@p35 nvarchar(4000),@p36 nvarchar(4000),@p37 nvarchar(4000),@p38 nvarchar(4000),@p39 nvarchar(4000),@p40 int,@p41 nvarchar(4000),@p42 nvarchar(4000),@p43 nvarchar(4000),@p44 nvarchar(4000),@p45 nvarchar(4000),@p46 int,@p47 nvarchar(4000),@p48 int,@p49 int,@p50 datetime2(7),@p51 datetime2(7),@p52 datetime2(7),@p53 nvarchar(4000),@p54 nvarchar(4000),@p55 nvarchar(4000),@p56 nvarchar(4000),@p57 nvarchar(4000),@p58 nvarchar(4000),@p59 nvarchar(4000),@p60 nvarchar(4000),@p61 nvarchar(4000),@p62 nvarchar(4000),@p63 nvarchar(4000),@p64 nvarchar(4000),@p65 nvarchar(4000),@p66 nvarchar(4000),@p67 datetime2(7),@p68 nvarchar(4000),@p69 nvarchar(4000),@p70 int,@p71 int,@p72 int,@p73 nvarchar(4000),@p74 nvarchar(4000),@p75 nvarchar(4000),@p76 decimal(18,2),@p77 decimal(18,2),@p78 nvarchar(4000),@p79 nvarchar(4000),@p80 decimal(18,2),@p81 nvarchar(4000),@p82 nvarchar(4000),@p83 nvarchar(4000),@p84 nvarchar(4000),@p85 int,@p86 nvarchar(4000),@p87 nvarchar(4000),@p88 nvarchar(4000),@p89 nvarchar(4000),@p90 nvarchar(4000),@p91 nvarchar(4000),@p92 nvarchar(4000),@p93 nvarchar(4000),@p94 nvarchar(4000),@p95 nvarchar(4000),@p96 int,@p97 nvarchar(4000),@p98 nvarchar(4000),@p99 nvarchar(4000),@p100 nvarchar(4000),@p101 nvarchar(4000),@p102 int,@p103 nvarchar(4000),@p104 int,@p105 int,@p106 datetime2(7),@p107 datetime2(7),@p108 datetime2(7),@p109 nvarchar(4000),@p110 nvarchar(4000),@p111 nvarchar(4000),@p112 nvarchar(4000),@p113 nvarchar(4000),@p114 nvarchar(4000),@p115 nvarchar(4000),@p116 nvarchar(4000),@p117 nvarchar(4000),@p118 nvarchar(4000),@p119 nvarchar(4000),@p120 nvarchar(4000),@p121 nvarchar(4000),@p122 nvarchar(4000),@p123 datetime2(7),@p124 nvarchar(4000),@p125 nvarchar(4000),@p126 int,@p127 int,@p128 int,@p129 nvarchar(4000),@p130 nvarchar(4000),@p131 nvarchar(4000),@p132 decimal(18,2),@p133 decimal(18,2),@p134 nvarchar(4000),@p135 nvarchar(4000),@p136 decimal(18,2),@p137 nvarchar(4000),@p138 nvarchar(4000),@p139 nvarchar(4000),@p140 nvarchar(4000),@p141 int,@p142 nvarchar(4000),@p143 nvarchar(4000),@p144 nvarchar(4000),@p145 nvarchar(4000),@p146 nvarchar(4000),@p147 nvarchar(4000),@p148 nvarchar(4000),@p149 nvarchar(4000),@p150 nvarchar(4000),@p151 nvarchar(4000),@p152 int,@p153 nvarchar(4000),@p154 nvarchar(4000),@p155 nvarchar(4000),@p156 nvarchar(4000),@p157 nvarchar(4000),@p158 int,@p159 nvarchar(4000),@p160 int,@p161 int,@p162 datetime2(7),@p163 datetime2(7),@p164 datetime2(7),@p165 nvarchar(4000),@p166 nvarchar(4000),@p167 nvarchar(4000),@p168 nvarchar(4000),@p169 nvarchar(4000),@p170 nvarchar(4000),@p171 nvarchar(4000),@p172 nvarchar(4000),@p173 nvarchar(4000),@p174 nvarchar(4000),@p175 nvarchar(4000),@p176 nvarchar(4000),@p177 nvarchar(4000),@p178 nvarchar(4000),@p179 datetime2(7),@p180 nvarchar(4000),@p181 nvarchar(4000),@p182 int,@p183 int,@p184 int,@p185 nvarchar(4000),@p186 nvarchar(4000),@p187 nvarchar(4000),@p188 decimal(18,2),@p189 decimal(18,2),@p190 nvarchar(4000),@p191 nvarchar(4000),@p192 decimal(18,2),@p193 nvarchar(4000),@p194 nvarchar(4000),@p195 nvarchar(4000),@p196 nvarchar(4000),@p197 int,@p198 nvarchar(4000),@p199 nvarchar(4000),@p200 nvarchar(4000),@p201 nvarchar(4000),@p202 nvarchar(4000),@p203 nvarchar(4000),@p204 nvarchar(4000),@p205 nvarchar(4000),@p206 nvarchar(4000),@p207 nvarchar(4000),@p208 int,@p209 nvarchar(4000),@p210 nvarchar(4000),@p211 nvarchar(4000),@p212 nvarchar(4000),@p213 nvarchar(4000),@p214 int,@p215 nvarchar(4000),@p216 int,@p217 int,@p218 datetime2(7),@p219 datetime2(7),@p220 datetime2(7),@p221 nvarchar(4000),@p222 nvarchar(4000),@p223 nvarchar(4000),@p224 nvarchar(4000),@p225 nvarchar(4000),@p226 nvarchar(4000),@p227 nvarchar(4000),@p228 nvarchar(4000),@p229 nvarchar(4000),@p230 nvarchar(4000),@p231 nvarchar(4000),@p232 nvarchar(4000),@p233 nvarchar(4000),@p234 nvarchar(4000),@p235 datetime2(7),@p236 nvarchar(4000),@p237 nvarchar(4000),@p238 int,@p239 int,@p240 int,@p241 nvarchar(4000),@p242 nvarchar(4000),@p243 nvarchar(4000),@p244 decimal(18,2),@p245 decimal(18,2),@p246 nvarchar(4000),@p247 nvarchar(4000),@p248 decimal(18,2),@p249 nvarchar(4000),@p250 nvarchar(4000),@p251 nvarchar(4000),@p252 nvarchar(4000),@p253 int,@p254 nvarchar(4000),@p255 nvarchar(4000),@p256 nvarchar(4000),@p257 nvarchar(4000),@p258 nvarchar(4000),@p259 nvarchar(4000),@p260 nvarchar(4000),@p261 nvarchar(4000),@p262 nvarchar(4000),@p263 nvarchar(4000),@p264 int,@p265 nvarchar(4000),@p266 nvarchar(4000),@p267 nvarchar(4000),@p268 nvarchar(4000),@p269 nvarchar(4000),@p270 int,@p271 nvarchar(4000),@p272 int,@p273 int,@p274 datetime2(7),@p275 datetime2(7),@p276 datetime2(7),@p277 nvarchar(4000),@p278 nvarchar(4000),@p279 nvarchar(4000),@p280 nvarchar(4000),@p281 nvarchar(4000),@p282 nvarchar(4000),@p283 nvarchar(4000),@p284 nvarchar(4000),@p285 nvarchar(4000),@p286 nvarchar(4000),@p287 nvarchar(4000),@p288 nvarchar(4000),@p289 nvarchar(4000),@p290 nvarchar(4000),@p291 datetime2(7),@p292 nvarchar(4000),@p293 nvarchar(4000),@p294 int,@p295 int,@p296 int,@p297 nvarchar(4000),@p298 nvarchar(4000),@p299 nvarchar(4000),@p300 decimal(18,2),@p301 decimal(18,2),@p302 nvarchar(4000),@p303 nvarchar(4000),@p304 decimal(18,2),@p305 nvarchar(4000),@p306 nvarchar(4000),@p307 nvarchar(4000),@p308 nvarchar(4000),@p309 int,@p310 nvarchar(4000),@p311 nvarchar(4000),@p312 nvarchar(4000),@p313 nvarchar(4000),@p314 nvarchar(4000),@p315 nvarchar(4000),@p316 nvarchar(4000),@p317 nvarchar(4000),@p318 nvarchar(4000),@p319 nvarchar(4000),@p320 int,@p321 nvarchar(4000),@p322 nvarchar(4000),@p323 nvarchar(4000),@p324 nvarchar(4000),@p325 nvarchar(4000),@p326 int,@p327 nvarchar(4000),@p328 int,@p329 int,@p330 datetime2(7),@p331 datetime2(7),@p332 datetime2(7),@p333 nvarchar(4000),@p334 nvarchar(4000),@p335 nvarchar(4000),@p336 nvarchar(4000),@p337 nvarchar(4000),@p338 nvarchar(4000),@p339 nvarchar(4000),@p340 nvarchar(4000),@p341 nvarchar(4000),@p342 nvarchar(4000),@p343 nvarchar(4000),@p344 nvarchar(4000),@p345 nvarchar(4000),@p346 nvarchar(4000),@p347 datetime2(7),@p348 nvarchar(4000),@p349 nvarchar(4000),@p350 int,@p351 int,@p352 int,@p353 nvarchar(4000),@p354 nvarchar(4000),@p355 nvarchar(4000),@p356 decimal(18,2),@p357 decimal(18,2),@p358 nvarchar(4000),@p359 nvarchar(4000),@p360 decimal(18,2),@p361 nvarchar(4000),@p362 nvarchar(4000),@p363 nvarchar(4000),@p364 nvarchar(4000),@p365 int,@p366 nvarchar(4000),@p367 nvarchar(4000),@p368 nvarchar(4000),@p369 nvarchar(4000),@p370 nvarchar(4000),@p371 nvarchar(4000),@p372 nvarchar(4000),@p373 nvarchar(4000),@p374 nvarchar(4000),@p375 nvarchar(4000),@p376 int,@p377 nvarchar(4000),@p378 nvarchar(4000),@p379 nvarchar(4000),@p380 nvarchar(4000),@p381 nvarchar(4000),@p382 int,@p383 nvarchar(4000),@p384 int,@p385 int,@p386 datetime2(7),@p387 datetime2(7),@p388 datetime2(7),@p389 nvarchar(4000),@p390 nvarchar(4000),@p391 nvarchar(4000),@p392 nvarchar(4000),@p393 nvarchar(4000),@p394 nvarchar(4000),@p395 nvarchar(4000),@p396 nvarchar(4000),@p397 nvarchar(4000),@p398 nvarchar(4000),@p399 nvarchar(4000),@p400 nvarchar(4000),@p401 nvarchar(4000),@p402 nvarchar(4000),@p403 datetime2(7),@p404 nvarchar(4000),@p405 nvarchar(4000),@p406 int,@p407 int,@p408 int,@p409 nvarchar(4000),@p410 nvarchar(4000),@p411 nvarchar(4000),@p412 decimal(18,2),@p413 decimal(18,2),@p414 nvarchar(4000),@p415 nvarchar(4000),@p416 decimal(18,2),@p417 nvarchar(4000),@p418 nvarchar(4000),@p419 nvarchar(4000),@p420 nvarchar(4000),@p421 int,@p422 nvarchar(4000),@p423 nvarchar(4000),@p424 nvarchar(4000),@p425 nvarchar(4000),@p426 nvarchar(4000),@p427 nvarchar(4000),@p428 nvarchar(4000),@p429 nvarchar(4000),@p430 nvarchar(4000),@p431 nvarchar(4000),@p432 int,@p433 nvarchar(4000),@p434 nvarchar(4000),@p435 nvarchar(4000),@p436 nvarchar(4000),@p437 nvarchar(4000),@p438 int,@p439 nvarchar(4000),@p440 int,@p441 int,@p442 datetime2(7),@p443 datetime2(7),@p444 datetime2(7),@p445 nvarchar(4000),@p446 nvarchar(4000),@p447 nvarchar(4000),@p448 nvarchar(4000),@p449 nvarchar(4000),@p450 nvarchar(4000),@p451 nvarchar(4000),@p452 nvarchar(4000),@p453 nvarchar(4000),@p454 nvarchar(4000),@p455 nvarchar(4000),@p456 nvarchar(4000),@p457 nvarchar(4000),@p458 nvarchar(4000),@p459 datetime2(7),@p460 nvarchar(4000),@p461 nvarchar(4000),@p462 int,@p463 int,@p464 int,@p465 nvarchar(4000),@p466 nvarchar(4000),@p467 nvarchar(4000),@p468 decimal(18,2),@p469 decimal(18,2),@p470 nvarchar(4000),@p471 nvarchar(4000),@p472 decimal(18,2),@p473 nvarchar(4000),@p474 nvarchar(4000),@p475 nvarchar(4000),@p476 nvarchar(4000),@p477 int,@p478 nvarchar(4000),@p479 nvarchar(4000),@p480 nvarchar(4000),@p481 nvarchar(4000),@p482 nvarchar(4000),@p483 nvarchar(4000),@p484 nvarchar(4000),@p485 nvarchar(4000),@p486 nvarchar(4000),@p487 nvarchar(4000),@p488 int,@p489 nvarchar(4000),@p490 nvarchar(4000),@p491 nvarchar(4000),@p492 nvarchar(4000),@p493 nvarchar(4000),@p494 int,@p495 nvarchar(4000),@p496 int,@p497 int,@p498 datetime2(7),@p499 datetime2(7),@p500 datetime2(7),@p501 nvarchar(4000),@p502 nvarchar(4000),@p503 nvarchar(4000),@p504 nvarchar(4000),@p505 nvarchar(4000),@p506 nvarchar(4000),@p507 nvarchar(4000),@p508 nvarchar(4000),@p509 nvarchar(4000),@p510 nvarchar(4000),@p511 nvarchar(4000),@p512 nvarchar(4000),@p513 nvarchar(4000),@p514 nvarchar(4000),@p515 datetime2(7),@p516 nvarchar(4000),@p517 nvarchar(4000),@p518 int,@p519 int,@p520 int,@p521 nvarchar(4000),@p522 nvarchar(4000),@p523 nvarchar(4000),@p524 decimal(18,2),@p525 decimal(18,2),@p526 nvarchar(4000),@p527 nvarchar(4000),@p528 decimal(18,2),@p529 nvarchar(4000),@p530 nvarchar(4000),@p531 nvarchar(4000),@p532 nvarchar(4000),@p533 int,@p534 nvarchar(4000),@p535 nvarchar(4000),@p536 nvarchar(4000),@p537 nvarchar(4000),@p538 nvarchar(4000),@p539 nvarchar(4000),@p540 nvarchar(4000),@p541 nvarchar(4000),@p542 nvarchar(4000),@p543 nvarchar(4000),@p544 int,@p545 nvarchar(4000),@p546 nvarchar(4000),@p547 nvarchar(4000),@p548 nvarchar(4000),@p549 nvarchar(4000),@p550 int,@p551 nvarchar(4000),@p552 int,@p553 int,@p554 datetime2(7),@p555 datetime2(7),@p556 datetime2(7),@p557 nvarchar(4000),@p558 nvarchar(4000),@p559 nvarchar(4000),@p560 nvarchar(4000),@p561 nvarchar(4000),@p562 nvarchar(4000),@p563 nvarchar(4000),@p564 nvarchar(4000),@p565 nvarchar(4000),@p566 nvarchar(4000),@p567 nvarchar(4000),@p568 nvarchar(4000),@p569 nvarchar(4000),@p570 nvarchar(4000),@p571 datetime2(7),@p572 nvarchar(4000),@p573 nvarchar(4000),@p574 int,@p575 int,@p576 int,@p577 nvarchar(4000),@p578 nvarchar(4000),@p579 nvarchar(4000),@p580 decimal(18,2),@p581 decimal(18,2),@p582 nvarchar(4000),@p583 nvarchar(4000),@p584 decimal(18,2),@p585 nvarchar(4000),@p586 nvarchar(4000),@p587 nvarchar(4000),@p588 nvarchar(4000),@p589 int,@p590 nvarchar(4000),@p591 nvarchar(4000),@p592 nvarchar(4000),@p593 nvarchar(4000),@p594 nvarchar(4000),@p595 nvarchar(4000),@p596 nvarchar(4000),@p597 nvarchar(4000),@p598 nvarchar(4000),@p599 nvarchar(4000),@p600 int,@p601 nvarchar(4000),@p602 nvarchar(4000),@p603 nvarchar(4000),@p604 nvarchar(4000),@p605 nvarchar(4000),@p606 int,@p607 nvarchar(4000),@p608 int,@p609 int,@p610 datetime2(7),@p611 datetime2(7),@p612 datetime2(7),@p613 nvarchar(4000),@p614 nvarchar(4000),@p615 nvarchar(4000),@p616 nvarchar(4000),@p617 nvarchar(4000),@p618 nvarchar(4000),@p619 nvarchar(4000),@p620 nvarchar(4000),@p621 nvarchar(4000),@p622 nvarchar(4000),@p623 nvarchar(4000),@p624 nvarchar(4000),@p625 nvarchar(4000),@p626 nvarchar(4000),@p627 datetime2(7),@p628 nvarchar(4000),@p629 nvarchar(4000),@p630 int,@p631 int,@p632 int,@p633 nvarchar(4000),@p634 nvarchar(4000),@p635 nvarchar(4000),@p636 decimal(18,2),@p637 decimal(18,2),@p638 nvarchar(4000),@p639 nvarchar(4000),@p640 decimal(18,2),@p641 nvarchar(4000),@p642 nvarchar(4000),@p643 nvarchar(4000),@p644 nvarchar(4000),@p645 int,@p646 nvarchar(4000),@p647 nvarchar(4000),@p648 nvarchar(4000),@p649 nvarchar(4000),@p650 nvarchar(4000),@p651 nvarchar(4000),@p652 nvarchar(4000),@p653 nvarchar(4000),@p654 nvarchar(4000),@p655 nvarchar(4000),@p656 int,@p657 nvarchar(4000),@p658 nvarchar(4000),@p659 nvarchar(4000),@p660 nvarchar(4000),@p661 nvarchar(4000),@p662 int,@p663 nvarchar(4000),@p664 int,@p665 int,@p666 datetime2(7),@p667 datetime2(7),@p668 datetime2(7),@p669 nvarchar(4000),@p670 nvarchar(4000),@p671 nvarchar(4000),@p672 nvarchar(4000),@p673 nvarchar(4000),@p674 nvarchar(4000),@p675 nvarchar(4000),@p676 nvarchar(4000),@p677 nvarchar(4000),@p678 nvarchar(4000),@p679 nvarchar(4000),@p680 nvarchar(4000),@p681 nvarchar(4000),@p682 nvarchar(4000),@p683 datetime2(7),@p684 nvarchar(4000),@p685 nvarchar(4000),@p686 int,@p687 int,@p688 int,@p689 nvarchar(4000),@p690 nvarchar(4000),@p691 nvarchar(4000),@p692 decimal(18,2),@p693 decimal(18,2),@p694 nvarchar(4000),@p695 nvarchar(4000),@p696 decimal(18,2),@p697 nvarchar(4000),@p698 nvarchar(4000),@p699 nvarchar(4000),@p700 nvarchar(4000),@p701 int,@p702 nvarchar(4000),@p703 nvarchar(4000),@p704 nvarchar(4000),@p705 nvarchar(4000),@p706 nvarchar(4000),@p707 nvarchar(4000),@p708 nvarchar(4000),@p709 nvarchar(4000),@p710 nvarchar(4000),@p711 nvarchar(4000),@p712 int,@p713 nvarchar(4000),@p714 nvarchar(4000),@p715 nvarchar(4000),@p716 nvarchar(4000),@p717 nvarchar(4000),@p718 int,@p719 nvarchar(4000),@p720 int,@p721 int,@p722 datetime2(7),@p723 datetime2(7),@p724 datetime2(7),@p725 nvarchar(4000),@p726 nvarchar(4000),@p727 nvarchar(4000),@p728 nvarchar(4000),@p729 nvarchar(4000),@p730 nvarchar(4000),@p731 nvarchar(4000),@p732 nvarchar(4000),@p733 nvarchar(4000),@p734 nvarchar(4000),@p735 nvarchar(4000),@p736 nvarchar(4000),@p737 nvarchar(4000),@p738 nvarchar(4000),@p739 datetime2(7),@p740 nvarchar(4000),@p741 nvarchar(4000),@p742 int,@p743 int,@p744 int,@p745 nvarchar(4000),@p746 nvarchar(4000),@p747 nvarchar(4000),@p748 decimal(18,2),@p749 decimal(18,2),@p750 nvarchar(4000),@p751 nvarchar(4000),@p752 decimal(18,2),@p753 nvarchar(4000),@p754 nvarchar(4000),@p755 nvarchar(4000),@p756 nvarchar(4000),@p757 int,@p758 nvarchar(4000),@p759 nvarchar(4000),@p760 nvarchar(4000),@p761 nvarchar(4000),@p762 nvarchar(4000),@p763 nvarchar(4000),@p764 nvarchar(4000),@p765 nvarchar(4000),@p766 nvarchar(4000),@p767 nvarchar(4000),@p768 int,@p769 nvarchar(4000),@p770 nvarchar(4000),@p771 nvarchar(4000),@p772 nvarchar(4000),@p773 nvarchar(4000),@p774 int,@p775 nvarchar(4000),@p776 int,@p777 int,@p778 datetime2(7),@p779 datetime2(7),@p780 datetime2(7),@p781 nvarchar(4000),@p782 nvarchar(4000),@p783 nvarchar(4000),@p784 nvarchar(4000),@p785 nvarchar(4000),@p786 nvarchar(4000),@p787 nvarchar(4000),@p788 nvarchar(4000),@p789 nvarchar(4000),@p790 nvarchar(4000),@p791 nvarchar(4000),@p792 nvarchar(4000),@p793 nvarchar(4000),@p794 nvarchar(4000),@p795 datetime2(7),@p796 nvarchar(4000),@p797 nvarchar(4000),@p798 int,@p799 int,@p800 int,@p801 nvarchar(4000),@p802 nvarchar(4000),@p803 nvarchar(4000),@p804 decimal(18,2),@p805 decimal(18,2),@p806 nvarchar(4000),@p807 nvarchar(4000),@p808 decimal(18,2),@p809 nvarchar(4000),@p810 nvarchar(4000),@p811 nvarchar(4000),@p812 nvarchar(4000),@p813 int,@p814 nvarchar(4000),@p815 nvarchar(4000),@p816 nvarchar(4000),@p817 nvarchar(4000),@p818 nvarchar(4000),@p819 nvarchar(4000),@p820 nvarchar(4000),@p821 nvarchar(4000),@p822 nvarchar(4000),@p823 nvarchar(4000),@p824 int,@p825 nvarchar(4000),@p826 nvarchar(4000),@p827 nvarchar(4000),@p828 nvarchar(4000),@p829 nvarchar(4000),@p830 int,@p831 nvarchar(4000),@p832 int,@p833 int,@p834 datetime2(7),@p835 datetime2(7),@p836 datetime2(7),@p837 nvarchar(4000),@p838 nvarchar(4000),@p839 nvarchar(4000),@p840 nvarchar(4000),@p841 nvarchar(4000),@p842 nvarchar(4000),@p843 nvarchar(4000),@p844 nvarchar(4000),@p845 nvarchar(4000),@p846 nvarchar(4000),@p847 nvarchar(4000),@p848 nvarchar(4000),@p849 nvarchar(4000),@p850 nvarchar(4000),@p851 datetime2(7),@p852 nvarchar(4000),@p853 nvarchar(4000),@p854 int,@p855 int,@p856 int,@p857 nvarchar(4000),@p858 nvarchar(4000),@p859 nvarchar(4000),@p860 nvarchar(4000),@p861 decimal(18,2),@p862 nvarchar(4000),@p863 nvarchar(4000),@p864 decimal(18,2),@p865 nvarchar(4000),@p866 nvarchar(4000),@p867 nvarchar(4000),@p868 nvarchar(4000),@p869 int,@p870 nvarchar(4000),@p871 nvarchar(4000),@p872 nvarchar(4000),@p873 nvarchar(4000),@p874 nvarchar(4000),@p875 nvarchar(4000),@p876 nvarchar(4000),@p877 nvarchar(4000),@p878 nvarchar(4000),@p879 nvarchar(4000),@p880 int,@p881 nvarchar(4000),@p882 nvarchar(4000),@p883 nvarchar(4000),@p884 nvarchar(4000),@p885 nvarchar(4000),@p886 int,@p887 nvarchar(4000),@p888 int,@p889 int,@p890 datetime2(7),@p891 datetime2(7),@p892 datetime2(7),@p893 nvarchar(4000),@p894 nvarchar(4000),@p895 nvarchar(4000),@p896 nvarchar(4000),@p897 nvarchar(4000),@p898 nvarchar(4000),@p899 nvarchar(4000),@p900 nvarchar(4000),@p901 nvarchar(4000),@p902 nvarchar(4000),@p903 nvarchar(4000),@p904 nvarchar(4000),@p905 nvarchar(4000),@p906 nvarchar(4000),@p907 datetime2(7),@p908 nvarchar(4000),@p909 nvarchar(4000),@p910 int,@p911 int,@p912 int,@p913 nvarchar(4000),@p914 nvarchar(4000),@p915 nvarchar(4000),@p916 nvarchar(4000),@p917 decimal(18,2),@p918 nvarchar(4000),@p919 nvarchar(4000),@p920 decimal(18,2),@p921 nvarchar(4000),@p922 nvarchar(4000),@p923 nvarchar(4000),@p924 nvarchar(4000),@p925 int,@p926 nvarchar(4000),@p927 nvarchar(4000),@p928 nvarchar(4000),@p929 nvarchar(4000),@p930 nvarchar(4000),@p931 nvarchar(4000),@p932 nvarchar(4000),@p933 nvarchar(4000),@p934 nvarchar(4000),@p935 nvarchar(4000),@p936 int,@p937 nvarchar(4000),@p938 nvarchar(4000),@p939 nvarchar(4000),@p940 nvarchar(4000),@p941 nvarchar(4000),@p942 int,@p943 nvarchar(4000),@p944 int,@p945 int,@p946 datetime2(7),@p947 datetime2(7),@p948 datetime2(7),@p949 nvarchar(4000),@p950 nvarchar(4000),@p951 nvarchar(4000),@p952 nvarchar(4000),@p953 nvarchar(4000),@p954 nvarchar(4000),@p955 nvarchar(4000),@p956 nvarchar(4000),@p957 nvarchar(4000),@p958 nvarchar(4000),@p959 nvarchar(4000),@p960 nvarchar(4000),@p961 nvarchar(4000),@p962 nvarchar(4000),@p963 datetime2(7),@p964 nvarchar(4000),@p965 nvarchar(4000),@p966 int,@p967 int,@p968 int,@p969 nvarchar(4000),@p970 nvarchar(4000),@p971 nvarchar(4000),@p972 nvarchar(4000),@p973 decimal(18,2),@p974 nvarchar(4000),@p975 nvarchar(4000),@p976 decimal(18,2),@p977 nvarchar(4000),@p978 nvarchar(4000),@p979 nvarchar(4000),@p980 nvarchar(4000),@p981 int,@p982 nvarchar(4000),@p983 nvarchar(4000),@p984 nvarchar(4000),@p985 nvarchar(4000),@p986 nvarchar(4000),@p987 nvarchar(4000),@p988 nvarchar(4000),@p989 nvarchar(4000),@p990 nvarchar(4000),@p991 nvarchar(4000),@p992 int,@p993 nvarchar(4000),@p994 nvarchar(4000),@p995 nvarchar(4000),@p996 nvarchar(4000),@p997 nvarchar(4000),@p998 int,@p999 nvarchar(4000),@p1000 int,@p1001 int,@p1002 datetime2(7),@p1003 datetime2(7),@p1004 datetime2(7),@p1005 nvarchar(4000),@p1006 nvarchar(4000),@p1007 nvarchar(4000),@p1008 nvarchar(4000),@p1009 nvarchar(4000),@p1010 nvarchar(4000),@p1011 nvarchar(4000),@p1012 nvarchar(4000),@p1013 nvarchar(4000),@p1014 nvarchar(4000),@p1015 nvarchar(4000),@p1016 nvarchar(4000),@p1017 nvarchar(4000),@p1018 nvarchar(4000),@p1019 datetime2(7),@p1020 nvarchar(4000),@p1021 nvarchar(4000),@p1022 int,@p1023 int,@p1024 int,@p1025 nvarchar(4000),@p1026 nvarchar(4000),@p1027 nvarchar(4000),@p1028 nvarchar(4000),@p1029 decimal(18,2),@p1030 nvarchar(4000),@p1031 nvarchar(4000),@p1032 decimal(18,2),@p1033 nvarchar(4000),@p1034 nvarchar(4000),@p1035 nvarchar(4000),@p1036 nvarchar(4000),@p1037 int,@p1038 nvarchar(4000),@p1039 nvarchar(4000),@p1040 nvarchar(4000),@p1041 nvarchar(4000),@p1042 nvarchar(4000),@p1043 nvarchar(4000),@p1044 nvarchar(4000),@p1045 nvarchar(4000),@p1046 nvarchar(4000),@p1047 nvarchar(4000),@p1048 int,@p1049 nvarchar(4000),@p1050 nvarchar(4000),@p1051 nvarchar(4000),@p1052 nvarchar(4000),@p1053 nvarchar(4000),@p1054 int,@p1055 nvarchar(4000),@p1056 int,@p1057 int,@p1058 datetime2(7),@p1059 datetime2(7),@p1060 datetime2(7),@p1061 nvarchar(4000),@p1062 nvarchar(4000),@p1063 nvarchar(4000),@p1064 nvarchar(4000),@p1065 nvarchar(4000),@p1066 nvarchar(4000),@p1067 nvarchar(4000),@p1068 nvarchar(4000),@p1069 nvarchar(4000),@p1070 nvarchar(4000),@p1071 nvarchar(4000),@p1072 nvarchar(4000),@p1073 nvarchar(4000),@p1074 nvarchar(4000),@p1075 datetime2(7),@p1076 nvarchar(4000),@p1077 nvarchar(4000),@p1078 int,@p1079 int,@p1080 int,@p1081 nvarchar(4000),@p1082 nvarchar(4000),@p1083 nvarchar(4000),@p1084 nvarchar(4000),@p1085 decimal(18,2),@p1086 nvarchar(4000),@p1087 nvarchar(4000),@p1088 decimal(18,2),@p1089 nvarchar(4000),@p1090 nvarchar(4000),@p1091 nvarchar(4000),@p1092 nvarchar(4000),@p1093 int,@p1094 nvarchar(4000),@p1095 nvarchar(4000),@p1096 nvarchar(4000),@p1097 nvarchar(4000),@p1098 nvarchar(4000),@p1099 nvarchar(4000),@p1100 nvarchar(4000),@p1101 nvarchar(4000),@p1102 nvarchar(4000),@p1103 nvarchar(4000),@p1104 int,@p1105 nvarchar(4000),@p1106 nvarchar(4000),@p1107 nvarchar(4000),@p1108 nvarchar(4000),@p1109 nvarchar(4000),@p1110 int,@p1111 nvarchar(4000),@p1112 int,@p1113 int,@p1114 datetime2(7),@p1115 datetime2(7),@p1116 datetime2(7),@p1117 nvarchar(4000),@p1118 nvarchar(4000),@p1119 nvarchar(4000),@p1120 nvarchar(4000),@p1121 nvarchar(4000),@p1122 nvarchar(4000),@p1123 nvarchar(4000),@p1124 nvarchar(4000),@p1125 nvarchar(4000),@p1126 nvarchar(4000),@p1127 nvarchar(4000),@p1128 nvarchar(4000),@p1129 nvarchar(4000),@p1130 nvarchar(4000),@p1131 datetime2(7),@p1132 nvarchar(4000),@p1133 nvarchar(4000),@p1134 int,@p1135 int,@p1136 int,@p1137 nvarchar(4000),@p1138 nvarchar(4000),@p1139 nvarchar(4000),@p1140 nvarchar(4000),@p1141 decimal(18,2),@p1142 nvarchar(4000),@p1143 nvarchar(4000),@p1144 decimal(18,2),@p1145 nvarchar(4000),@p1146 nvarchar(4000),@p1147 nvarchar(4000),@p1148 nvarchar(4000),@p1149 int,@p1150 nvarchar(4000),@p1151 nvarchar(4000),@p1152 nvarchar(4000),@p1153 nvarchar(4000),@p1154 nvarchar(4000),@p1155 nvarchar(4000),@p1156 nvarchar(4000),@p1157 nvarchar(4000),@p1158 nvarchar(4000),@p1159 nvarchar(4000),@p1160 int,@p1161 nvarchar(4000),@p1162 nvarchar(4000),@p1163 nvarchar(4000),@p1164 nvarchar(4000),@p1165 nvarchar(4000),@p1166 int,@p1167 nvarchar(4000),@p1168 int,@p1169 int,@p1170 datetime2(7),@p1171 datetime2(7),@p1172 datetime2(7),@p1173 nvarchar(4000),@p1174 nvarchar(4000),@p1175 nvarchar(4000),@p1176 nvarchar(4000),@p1177 nvarchar(4000),@p1178 nvarchar(4000),@p1179 nvarchar(4000),@p1180 nvarchar(4000),@p1181 nvarchar(4000),@p1182 nvarchar(4000),@p1183 nvarchar(4000),@p1184 nvarchar(4000),@p1185 nvarchar(4000),@p1186 nvarchar(4000),@p1187 datetime2(7),@p1188 nvarchar(4000),@p1189 nvarchar(4000),@p1190 int,@p1191 int,@p1192 int,@p1193 nvarchar(4000),@p1194 nvarchar(4000),@p1195 nvarchar(4000),@p1196 nvarchar(4000),@p1197 decimal(18,2),@p1198 nvarchar(4000),@p1199 nvarchar(4000),@p1200 decimal(18,2),@p1201 nvarchar(4000),@p1202 nvarchar(4000),@p1203 nvarchar(4000),@p1204 nvarchar(4000),@p1205 int,@p1206 nvarchar(4000),@p1207 nvarchar(4000),@p1208 nvarchar(4000),@p1209 nvarchar(4000),@p1210 nvarchar(4000),@p1211 nvarchar(4000),@p1212 nvarchar(4000),@p1213 nvarchar(4000),@p1214 nvarchar(4000),@p1215 nvarchar(4000),@p1216 int,@p1217 nvarchar(4000),@p1218 nvarchar(4000),@p1219 nvarchar(4000),@p1220 nvarchar(4000),@p1221 nvarchar(4000),@p1222 int,@p1223 nvarchar(4000),@p1224 int,@p1225 int,@p1226 datetime2(7),@p1227 datetime2(7),@p1228 datetime2(7),@p1229 nvarchar(4000),@p1230 nvarchar(4000),@p1231 nvarchar(4000),@p1232 nvarchar(4000),@p1233 nvarchar(4000),@p1234 nvarchar(4000),@p1235 nvarchar(4000),@p1236 nvarchar(4000),@p1237 nvarchar(4000),@p1238 nvarchar(4000),@p1239 nvarchar(4000),@p1240 nvarchar(4000),@p1241 nvarchar(4000),@p1242 nvarchar(4000),@p1243 datetime2(7),@p1244 nvarchar(4000),@p1245 nvarchar(4000),@p1246 int,@p1247 int,@p1248 int,@p1249 nvarchar(4000),@p1250 nvarchar(4000),@p1251 nvarchar(4000),@p1252 nvarchar(4000),@p1253 decimal(18,2),@p1254 nvarchar(4000),@p1255 nvarchar(4000),@p1256 decimal(18,2),@p1257 nvarchar(4000),@p1258 nvarchar(4000),@p1259 nvarchar(4000),@p1260 nvarchar(4000),@p1261 int,@p1262 nvarchar(4000),@p1263 nvarchar(4000),@p1264 nvarchar(4000),@p1265 nvarchar(4000),@p1266 nvarchar(4000),@p1267 nvarchar(4000),@p1268 nvarchar(4000),@p1269 nvarchar(4000),@p1270 nvarchar(4000),@p1271 nvarchar(4000),@p1272 int,@p1273 nvarchar(4000),@p1274 nvarchar(4000),@p1275 nvarchar(4000),@p1276 nvarchar(4000),@p1277 nvarchar(4000),@p1278 int,@p1279 nvarchar(4000),@p1280 int,@p1281 int,@p1282 datetime2(7),@p1283 datetime2(7),@p1284 datetime2(7),@p1285 nvarchar(4000),@p1286 nvarchar(4000),@p1287 nvarchar(4000),@p1288 nvarchar(4000),@p1289 nvarchar(4000),@p1290 nvarchar(4000),@p1291 nvarchar(4000),@p1292 nvarchar(4000),@p1293 nvarchar(4000),@p1294 nvarchar(4000),@p1295 nvarchar(4000),@p1296 nvarchar(4000),@p1297 nvarchar(4000),@p1298 nvarchar(4000),@p1299 datetime2(7),@p1300 nvarchar(4000),@p1301 nvarchar(4000),@p1302 int,@p1303 int,@p1304 int,@p1305 nvarchar(4000),@p1306 nvarchar(4000),@p1307 nvarchar(4000),@p1308 nvarchar(4000),@p1309 decimal(18,2),@p1310 nvarchar(4000),@p1311 nvarchar(4000),@p1312 decimal(18,2),@p1313 nvarchar(4000),@p1314 nvarchar(4000),@p1315 nvarchar(4000),@p1316 nvarchar(4000),@p1317 int,@p1318 nvarchar(4000),@p1319 nvarchar(4000),@p1320 nvarchar(4000),@p1321 nvarchar(4000),@p1322 nvarchar(4000),@p1323 nvarchar(4000),@p1324 nvarchar(4000),@p1325 nvarchar(4000),@p1326 nvarchar(4000),@p1327 nvarchar(4000),@p1328 int,@p1329 nvarchar(4000),@p1330 nvarchar(4000),@p1331 nvarchar(4000),@p1332 nvarchar(4000),@p1333 nvarchar(4000),@p1334 int,@p1335 nvarchar(4000),@p1336 int,@p1337 int,@p1338 datetime2(7),@p1339 datetime2(7),@p1340 datetime2(7),@p1341 nvarchar(4000),@p1342 nvarchar(4000),@p1343 nvarchar(4000),@p1344 nvarchar(4000),@p1345 nvarchar(4000),@p1346 nvarchar(4000),@p1347 nvarchar(4000),@p1348 nvarchar(4000),@p1349 nvarchar(4000),@p1350 nvarchar(4000),@p1351 nvarchar(4000),@p1352 nvarchar(4000),@p1353 nvarchar(4000),@p1354 nvarchar(4000),@p1355 datetime2(7),@p1356 nvarchar(4000),@p1357 nvarchar(4000),@p1358 int,@p1359 int,@p1360 int,@p1361 nvarchar(4000),@p1362 nvarchar(4000),@p1363 nvarchar(4000),@p1364 nvarchar(4000),@p1365 decimal(18,2),@p1366 nvarchar(4000),@p1367 nvarchar(4000),@p1368 decimal(18,2),@p1369 nvarchar(4000),@p1370 nvarchar(4000),@p1371 nvarchar(4000),@p1372 nvarchar(4000),@p1373 int,@p1374 nvarchar(4000),@p1375 nvarchar(4000),@p1376 nvarchar(4000),@p1377 nvarchar(4000),@p1378 nvarchar(4000),@p1379 nvarchar(4000),@p1380 nvarchar(4000),@p1381 nvarchar(4000),@p1382 nvarchar(4000),@p1383 nvarchar(4000),@p1384 int,@p1385 nvarchar(4000),@p1386 nvarchar(4000),@p1387 nvarchar(4000),@p1388 nvarchar(4000),@p1389 nvarchar(4000),@p1390 int,@p1391 nvarchar(4000),@p1392 int,@p1393 int,@p1394 datetime2(7),@p1395 datetime2(7),@p1396 datetime2(7),@p1397 nvarchar(4000),@p1398 nvarchar(4000),@p1399 nvarchar(4000),@p1400 nvarchar(4000),@p1401 nvarchar(4000),@p1402 nvarchar(4000),@p1403 nvarchar(4000),@p1404 nvarchar(4000),@p1405 nvarchar(4000),@p1406 nvarchar(4000),@p1407 nvarchar(4000),@p1408 nvarchar(4000),@p1409 nvarchar(4000),@p1410 nvarchar(4000),@p1411 datetime2(7),@p1412 nvarchar(4000),@p1413 nvarchar(4000),@p1414 int,@p1415 int,@p1416 int,@p1417 nvarchar(4000),@p1418 nvarchar(4000),@p1419 nvarchar(4000),@p1420 nvarchar(4000),@p1421 decimal(18,2),@p1422 nvarchar(4000),@p1423 nvarchar(4000),@p1424 decimal(18,2),@p1425 nvarchar(4000),@p1426 nvarchar(4000),@p1427 nvarchar(4000),@p1428 nvarchar(4000),@p1429 int,@p1430 nvarchar(4000),@p1431 nvarchar(4000),@p1432 nvarchar(4000),@p1433 nvarchar(4000),@p1434 nvarchar(4000),@p1435 nvarchar(4000),@p1436 nvarchar(4000),@p1437 nvarchar(4000),@p1438 nvarchar(4000),@p1439 nvarchar(4000),@p1440 int,@p1441 nvarchar(4000),@p1442 nvarchar(4000),@p1443 nvarchar(4000),@p1444 nvarchar(4000),@p1445 nvarchar(4000),@p1446 int,@p1447 nvarchar(4000),@p1448 int,@p1449 int,@p1450 datetime2(7),@p1451 datetime2(7),@p1452 datetime2(7),@p1453 nvarchar(4000),@p1454 nvarchar(4000),@p1455 nvarchar(4000),@p1456 nvarchar(4000),@p1457 nvarchar(4000),@p1458 nvarchar(4000),@p1459 nvarchar(4000),@p1460 nvarchar(4000),@p1461 nvarchar(4000),@p1462 nvarchar(4000),@p1463 nvarchar(4000),@p1464 nvarchar(4000),@p1465 nvarchar(4000),@p1466 nvarchar(4000),@p1467 datetime2(7),@p1468 nvarchar(4000),@p1469 nvarchar(4000),@p1470 int,@p1471 int,@p1472 int,@p1473 nvarchar(4000),@p1474 nvarchar(4000),@p1475 nvarchar(4000),@p1476 decimal(18,2),@p1477 decimal(18,2),@p1478 nvarchar(4000),@p1479 nvarchar(4000),@p1480 decimal(18,2),@p1481 nvarchar(4000),@p1482 nvarchar(4000),@p1483 nvarchar(4000),@p1484 nvarchar(4000),@p1485 int,@p1486 nvarchar(4000),@p1487 nvarchar(4000),@p1488 nvarchar(4000),@p1489 nvarchar(4000),@p1490 nvarchar(4000),@p1491 nvarchar(4000),@p1492 nvarchar(4000),@p1493 nvarchar(4000),@p1494 nvarchar(4000),@p1495 nvarchar(4000),@p1496 int,@p1497 nvarchar(4000),@p1498 nvarchar(4000),@p1499 nvarchar(4000),@p1500 nvarchar(4000),@p1501 nvarchar(4000),@p1502 int,@p1503 nvarchar(4000),@p1504 int,@p1505 int,@p1506 datetime2(7),@p1507 datetime2(7),@p1508 datetime2(7),@p1509 nvarchar(4000),@p1510 nvarchar(4000),@p1511 nvarchar(4000),@p1512 nvarchar(4000),@p1513 nvarchar(4000),@p1514 nvarchar(4000),@p1515 nvarchar(4000),@p1516 nvarchar(4000),@p1517 nvarchar(4000),@p1518 nvarchar(4000),@p1519 nvarchar(4000),@p1520 nvarchar(4000),@p1521 nvarchar(4000),@p1522 nvarchar(4000),@p1523 datetime2(7),@p1524 nvarchar(4000),@p1525 nvarchar(4000),@p1526 int,@p1527 int,@p1528 int,@p1529 nvarchar(4000),@p1530 nvarchar(4000),@p1531 nvarchar(4000),@p1532 decimal(18,2),@p1533 decimal(18,2),@p1534 nvarchar(4000),@p1535 nvarchar(4000),@p1536 decimal(18,2),@p1537 nvarchar(4000),@p1538 nvarchar(4000),@p1539 nvarchar(4000),@p1540 nvarchar(4000),@p1541 int,@p1542 nvarchar(4000),@p1543 nvarchar(4000),@p1544 nvarchar(4000),@p1545 nvarchar(4000),@p1546 nvarchar(4000),@p1547 nvarchar(4000),@p1548 nvarchar(4000),@p1549 nvarchar(4000),@p1550 nvarchar(4000),@p1551 nvarchar(4000),@p1552 int,@p1553 nvarchar(4000),@p1554 nvarchar(4000),@p1555 nvarchar(4000),@p1556 nvarchar(4000),@p1557 nvarchar(4000),@p1558 int,@p1559 nvarchar(4000),@p1560 int,@p1561 int,@p1562 datetime2(7),@p1563 datetime2(7),@p1564 datetime2(7),@p1565 nvarchar(4000),@p1566 nvarchar(4000),@p1567 nvarchar(4000),@p1568 nvarchar(4000),@p1569 nvarchar(4000),@p1570 nvarchar(4000),@p1571 nvarchar(4000),@p1572 nvarchar(4000),@p1573 nvarchar(4000),@p1574 nvarchar(4000),@p1575 nvarchar(4000),@p1576 nvarchar(4000),@p1577 nvarchar(4000),@p1578 nvarchar(4000),@p1579 datetime2(7),@p1580 nvarchar(4000),@p1581 nvarchar(4000),@p1582 int,@p1583 int,@p1584 int,@p1585 nvarchar(4000),@p1586 nvarchar(4000),@p1587 nvarchar(4000),@p1588 decimal(18,2),@p1589 decimal(18,2),@p1590 nvarchar(4000),@p1591 nvarchar(4000),@p1592 decimal(18,2),@p1593 nvarchar(4000),@p1594 nvarchar(4000),@p1595 nvarchar(4000),@p1596 nvarchar(4000),@p1597 int,@p1598 nvarchar(4000),@p1599 nvarchar(4000),@p1600 nvarchar(4000),@p1601 nvarchar(4000),@p1602 nvarchar(4000),@p1603 nvarchar(4000),@p1604 nvarchar(4000),@p1605 nvarchar(4000),@p1606 nvarchar(4000),@p1607 nvarchar(4000),@p1608 int,@p1609 nvarchar(4000),@p1610 nvarchar(4000),@p1611 nvarchar(4000),@p1612 nvarchar(4000),@p1613 nvarchar(4000),@p1614 int,@p1615 nvarchar(4000),@p1616 int,@p1617 int,@p1618 datetime2(7),@p1619 datetime2(7),@p1620 datetime2(7),@p1621 nvarchar(4000),@p1622 nvarchar(4000),@p1623 nvarchar(4000),@p1624 nvarchar(4000),@p1625 nvarchar(4000),@p1626 nvarchar(4000),@p1627 nvarchar(4000),@p1628 nvarchar(4000),@p1629 nvarchar(4000),@p1630 nvarchar(4000),@p1631 nvarchar(4000),@p1632 nvarchar(4000),@p1633 nvarchar(4000),@p1634 nvarchar(4000),@p1635 datetime2(7),@p1636 nvarchar(4000),@p1637 nvarchar(4000),@p1638 int,@p1639 int,@p1640 int,@p1641 nvarchar(4000),@p1642 nvarchar(4000),@p1643 nvarchar(4000),@p1644 decimal(18,2),@p1645 decimal(18,2),@p1646 nvarchar(4000),@p1647 nvarchar(4000),@p1648 decimal(18,2),@p1649 nvarchar(4000),@p1650 nvarchar(4000),@p1651 nvarchar(4000),@p1652 nvarchar(4000),@p1653 int,@p1654 nvarchar(4000),@p1655 nvarchar(4000),@p1656 nvarchar(4000),@p1657 nvarchar(4000),@p1658 nvarchar(4000),@p1659 nvarchar(4000),@p1660 nvarchar(4000),@p1661 nvarchar(4000),@p1662 nvarchar(4000),@p1663 nvarchar(4000),@p1664 int,@p1665 nvarchar(4000),@p1666 nvarchar(4000),@p1667 nvarchar(4000),@p1668 nvarchar(4000),@p1669 nvarchar(4000),@p1670 int,@p1671 nvarchar(4000),@p1672 int,@p1673 int,@p1674 datetime2(7),@p1675 datetime2(7),@p1676 datetime2(7),@p1677 nvarchar(4000),@p1678 nvarchar(4000),@p1679 nvarchar(4000),@p1680 nvarchar(4000),@p1681 nvarchar(4000),@p1682 nvarchar(4000),@p1683 nvarchar(4000),@p1684 nvarchar(4000),@p1685 nvarchar(4000),@p1686 nvarchar(4000),@p1687 nvarchar(4000),@p1688 nvarchar(4000),@p1689 nvarchar(4000),@p1690 nvarchar(4000),@p1691 datetime2(7),@p1692 nvarchar(4000),@p1693 nvarchar(4000),@p1694 int,@p1695 int,@p1696 int,@p1697 nvarchar(4000),@p1698 nvarchar(4000),@p1699 nvarchar(4000),@p1700 decimal(18,2),@p1701 decimal(18,2),@p1702 nvarchar(4000),@p1703 nvarchar(4000),@p1704 decimal(18,2),@p1705 nvarchar(4000),@p1706 nvarchar(4000),@p1707 nvarchar(4000),@p1708 nvarchar(4000),@p1709 int,@p1710 nvarchar(4000),@p1711 nvarchar(4000),@p1712 nvarchar(4000),@p1713 nvarchar(4000),@p1714 nvarchar(4000),@p1715 nvarchar(4000),@p1716 nvarchar(4000),@p1717 nvarchar(4000),@p1718 nvarchar(4000),@p1719 nvarchar(4000),@p1720 int,@p1721 nvarchar(4000),@p1722 nvarchar(4000),@p1723 nvarchar(4000),@p1724 nvarchar(4000),@p1725 nvarchar(4000),@p1726 int,@p1727 nvarchar(4000),@p1728 int,@p1729 int,@p1730 datetime2(7),@p1731 datetime2(7),@p1732 datetime2(7),@p1733 nvarchar(4000),@p1734 nvarchar(4000),@p1735 nvarchar(4000),@p1736 nvarchar(4000),@p1737 nvarchar(4000),@p1738 nvarchar(4000),@p1739 nvarchar(4000),@p1740 nvarchar(4000),@p1741 nvarchar(4000),@p1742 nvarchar(4000),@p1743 nvarchar(4000),@p1744 nvarchar(4000),@p1745 nvarchar(4000),@p1746 nvarchar(4000),@p1747 datetime2(7),@p1748 nvarchar(4000),@p1749 nvarchar(4000),@p1750 int,@p1751 int,@p1752 int,@p1753 nvarchar(4000),@p1754 nvarchar(4000),@p1755 nvarchar(4000),@p1756 decimal(18,2),@p1757 decimal(18,2),@p1758 nvarchar(4000),@p1759 nvarchar(4000),@p1760 decimal(18,2),@p1761 nvarchar(4000),@p1762 nvarchar(4000),@p1763 nvarchar(4000),@p1764 nvarchar(4000),@p1765 int,@p1766 nvarchar(4000),@p1767 nvarchar(4000),@p1768 nvarchar(4000),@p1769 nvarchar(4000),@p1770 nvarchar(4000),@p1771 nvarchar(4000),@p1772 nvarchar(4000),@p1773 nvarchar(4000),@p1774 nvarchar(4000),@p1775 nvarchar(4000),@p1776 int,@p1777 nvarchar(4000),@p1778 nvarchar(4000),@p1779 nvarchar(4000),@p1780 nvarchar(4000),@p1781 nvarchar(4000),@p1782 int,@p1783 nvarchar(4000),@p1784 int,@p1785 int,@p1786 datetime2(7),@p1787 datetime2(7),@p1788 datetime2(7),@p1789 nvarchar(4000),@p1790 nvarchar(4000),@p1791 nvarchar(4000),@p1792 nvarchar(4000),@p1793 nvarchar(4000),@p1794 nvarchar(4000),@p1795 nvarchar(4000),@p1796 nvarchar(4000),@p1797 nvarchar(4000),@p1798 nvarchar(4000),@p1799 nvarchar(4000),@p1800 nvarchar(4000),@p1801 nvarchar(4000),@p1802 nvarchar(4000),@p1803 datetime2(7),@p1804 nvarchar(4000),@p1805 nvarchar(4000),@p1806 int,@p1807 int,@p1808 int,@p1809 nvarchar(4000),@p1810 nvarchar(4000),@p1811 nvarchar(4000),@p1812 decimal(18,2),@p1813 decimal(18,2),@p1814 nvarchar(4000),@p1815 nvarchar(4000),@p1816 decimal(18,2),@p1817 nvarchar(4000),@p1818 nvarchar(4000),@p1819 nvarchar(4000),@p1820 nvarchar(4000),@p1821 int,@p1822 nvarchar(4000),@p1823 nvarchar(4000),@p1824 nvarchar(4000),@p1825 nvarchar(4000),@p1826 nvarchar(4000),@p1827 nvarchar(4000),@p1828 nvarchar(4000),@p1829 nvarchar(4000),@p1830 nvarchar(4000),@p1831 nvarchar(4000),@p1832 int,@p1833 nvarchar(4000),@p1834 nvarchar(4000),@p1835 nvarchar(4000),@p1836 nvarchar(4000),@p1837 nvarchar(4000),@p1838 int,@p1839 nvarchar(4000),@p1840 int,@p1841 int,@p1842 datetime2(7),@p1843 datetime2(7),@p1844 datetime2(7),@p1845 nvarchar(4000),@p1846 nvarchar(4000),@p1847 nvarchar(4000),@p1848 nvarchar(4000),@p1849 nvarchar(4000),@p1850 nvarchar(4000),@p1851 nvarchar(4000),@p1852 nvarchar(4000),@p1853 nvarchar(4000),@p1854 nvarchar(4000),@p1855 nvarchar(4000),@p1856 nvarchar(4000),@p1857 nvarchar(4000),@p1858 nvarchar(4000),@p1859 datetime2(7),@p1860 nvarchar(4000),@p1861 nvarchar(4000),@p1862 int,@p1863 int,@p1864 int,@p1865 nvarchar(4000),@p1866 nvarchar(4000),@p1867 nvarchar(4000),@p1868 decimal(18,2),@p1869 decimal(18,2),@p1870 nvarchar(4000),@p1871 nvarchar(4000),@p1872 decimal(18,2),@p1873 nvarchar(4000),@p1874 nvarchar(4000),@p1875 nvarchar(4000),@p1876 nvarchar(4000),@p1877 int,@p1878 nvarchar(4000),@p1879 nvarchar(4000),@p1880 nvarchar(4000),@p1881 nvarchar(4000),@p1882 nvarchar(4000),@p1883 nvarchar(4000),@p1884 nvarchar(4000),@p1885 nvarchar(4000),@p1886 nvarchar(4000),@p1887 nvarchar(4000),@p1888 int,@p1889 nvarchar(4000),@p1890 nvarchar(4000),@p1891 nvarchar(4000),@p1892 nvarchar(4000),@p1893 nvarchar(4000),@p1894 int,@p1895 nvarchar(4000),@p1896 int,@p1897 int,@p1898 datetime2(7),@p1899 datetime2(7),@p1900 datetime2(7),@p1901 nvarchar(4000),@p1902 nvarchar(4000),@p1903 nvarchar(4000),@p1904 nvarchar(4000),@p1905 nvarchar(4000),@p1906 nvarchar(4000),@p1907 nvarchar(4000),@p1908 nvarchar(4000),@p1909 nvarchar(4000),@p1910 nvarchar(4000),@p1911 nvarchar(4000),@p1912 nvarchar(4000),@p1913 nvarchar(4000),@p1914 nvarchar(4000),@p1915 datetime2(7),@p1916 nvarchar(4000),@p1917 nvarchar(4000),@p1918 int,@p1919 int,@p1920 int,@p1921 nvarchar(4000),@p1922 nvarchar(4000),@p1923 nvarchar(4000),@p1924 decimal(18,2),@p1925 decimal(18,2),@p1926 nvarchar(4000),@p1927 nvarchar(4000),@p1928 decimal(18,2),@p1929 nvarchar(4000),@p1930 nvarchar(4000),@p1931 nvarchar(4000),@p1932 nvarchar(4000),@p1933 int,@p1934 nvarchar(4000),@p1935 nvarchar(4000),@p1936 nvarchar(4000),@p1937 nvarchar(4000),@p1938 nvarchar(4000),@p1939 nvarchar(4000),@p1940 nvarchar(4000),@p1941 nvarchar(4000),@p1942 nvarchar(4000),@p1943 nvarchar(4000),@p1944 int,@p1945 nvarchar(4000),@p1946 nvarchar(4000),@p1947 nvarchar(4000),@p1948 nvarchar(4000),@p1949 nvarchar(4000),@p1950 int,@p1951 nvarchar(4000),@p1952 int,@p1953 int,@p1954 datetime2(7),@p1955 datetime2(7),@p1956 datetime2(7),@p1957 nvarchar(4000),@p1958 nvarchar(4000),@p1959 nvarchar(4000),@p1960 nvarchar(4000),@p1961 nvarchar(4000),@p1962 nvarchar(4000),@p1963 nvarchar(4000),@p1964 nvarchar(4000),@p1965 nvarchar(4000),@p1966 nvarchar(4000),@p1967 nvarchar(4000),@p1968 nvarchar(4000),@p1969 nvarchar(4000),@p1970 nvarchar(4000),@p1971 datetime2(7),@p1972 nvarchar(4000),@p1973 nvarchar(4000),@p1974 int,@p1975 int,@p1976 int,@p1977 nvarchar(4000),@p1978 nvarchar(4000),@p1979 nvarchar(4000),@p1980 decimal(18,2),@p1981 decimal(18,2),@p1982 nvarchar(4000),@p1983 nvarchar(4000),@p1984 decimal(18,2),@p1985 nvarchar(4000),@p1986 nvarchar(4000),@p1987 nvarchar(4000),@p1988 nvarchar(4000),@p1989 int,@p1990 nvarchar(4000),@p1991 nvarchar(4000),@p1992 nvarchar(4000),@p1993 nvarchar(4000),@p1994 nvarchar(4000),@p1995 nvarchar(4000),@p1996 nvarchar(4000),@p1997 nvarchar(4000),@p1998 nvarchar(4000),@p1999 nvarchar(4000),@p2000 int,@p2001 nvarchar(4000),@p2002 nvarchar(4000),@p2003 nvarchar(4000),@p2004 nvarchar(4000),@p2005 nvarchar(4000),@p2006 int,@p2007 nvarchar(4000),@p2008 int,@p2009 int,@p2010 datetime2(7),@p2011 datetime2(7),@p2012 datetime2(7),@p2013 nvarchar(4000),@p2014 nvarchar(4000),@p2015 nvarchar(4000),@p2016 nvarchar(4000),@p2017 nvarchar(4000),@p2018 nvarchar(4000),@p2019 nvarchar(4000),@p2020 nvarchar(4000),@p2021 nvarchar(4000),@p2022 nvarchar(4000),@p2023 nvarchar(4000),@p2024 nvarchar(4000),@p2025 nvarchar(4000),@p2026 nvarchar(4000),@p2027 datetime2(7),@p2028 nvarchar(4000),@p2029 nvarchar(4000),@p2030 int,@p2031 int,@p2032 int,@p2033 nvarchar(4000),@p2034 nvarchar(4000),@p2035 nvarchar(4000),@p2036 decimal(18,2),@p2037 decimal(18,2),@p2038 nvarchar(4000),@p2039 nvarchar(4000),@p2040 decimal(18,2),@p2041 nvarchar(4000),@p2042 nvarchar(4000),@p2043 nvarchar(4000),@p2044 nvarchar(4000),@p2045 int,@p2046 nvarchar(4000),@p2047 nvarchar(4000),@p2048 nvarchar(4000),@p2049 nvarchar(4000),@p2050 nvarchar(4000),@p2051 nvarchar(4000),@p2052 nvarchar(4000),@p2053 nvarchar(4000),@p2054 nvarchar(4000),@p2055 nvarchar(4000),@p2056 int,@p2057 nvarchar(4000),@p2058 nvarchar(4000),@p2059 nvarchar(4000),@p2060 nvarchar(4000),@p2061 nvarchar(4000),@p2062 int,@p2063 nvarchar(4000),@p2064 int,@p2065 int,@p2066 datetime2(7),@p2067 datetime2(7),@p2068 datetime2(7),@p2069 nvarchar(4000),@p2070 nvarchar(4000),@p2071 nvarchar(4000))SET NOCOUNT ON; DECLARE @inserted0 TABLE ([item_id] int, [_Position] [int]); MERGE [raw_data] USING ( VALUES (@p0, @p1, @p2, @p3, @p4, @p5, @p6, @p7, @p8, @p9, @p10, @p11, @p12, @p13, @p14, @p15, @p16, @p17, @p18, @p19, @p20, @p21, @p22, @p23, @p24, @p25, @p26, @p27, @p28, @p29, @p30, @p31, @p32, @p33, @p34, @p35, @p36, @p37, @p38, @p39, @p40, @p41, @p42, @p43, @p44, @p45, @p46, @p47, @p48, @p49, @p50, @p51, @p52, @p53, @p54, @p55, 0), (@p56, @p57, @p58, @p59, @p60, @p61, @p62, @p63, @p64, @p65, @p66, @p67, @p68, @p69, @p70, @p71, @p72, @p73, @p74, @p75, @p76, @p77, @p78, @p79, @p80, @p81, @p82, @p83, @p84, @p85, @p86, @p87, @p88, @p89, @p90, @p91, @p92, @p93, @p94, @p95, @p96, @p97, @p98, @p99, @p100, @p101, @p102, @p103, @p104, @p105, @p106, @p107, @p108, @p109, @p110, @p111, 1), (@p112, @p113, @p114, @p115, @p116, @p117, @p118, @p119, @p120, @p121, @p122, @p123, @p124, @p125, @p126, @p127, @p128, @p129, @p130, @p131, @p132, @p133, @p134, @p135, @p136, @p137, @p138, @p139, @p140, @p141, @p142, @p143, @p144, @p145, @p146, @p147, @p148, @p149, @p150, @p151, @p152, @p153, @p154, @p155, @p156, @p157, @p158, @p159, @p160, @p161, @p162, @p163, @p164, @p165, @p166, @p167, 2), (@p168, @p169, @p170, @p171, @p172, @p173, @p174, @p175, @p176, @p177, @p178, @p179, @p180, @p181, @p182, @p183, @p184, @p185, @p186, @p187, @p188, @p189, @p190, @p191, @p192, @p193, @p194, @p195, @p196, @p197, @p198, @p199, @p200, @p201, @p202, @p203, @p204, @p205, @p206, @p207, @p208, @p209, @p210, @p211, @p212, @p213, @p214, @p215, @p216, @p217, @p218, @p219, @p220, @p221, @p222, @p223, 3), (@p224, @p225, @p226, @p227, @p228, @p229, @p230, @p231, @p232, @p233, @p234, @p235, @p236, @p237, @p238, @p239, @p240, @p241, @p242, @p243, @p244, @p245, @p246, @p247, @p248, @p249, @p250, @p251, @p252, @p253, @p254, @p255, @p256, @p257, @p258, @p259, @p260, @p261, @p262, @p263, @p264, @p265, @p266, @p267, @p268, @p269, @p270, @p271, @p272, @p273, @p274, @p275, @p276, @p277, @p278, @p279, 4), (@p280, @p281, @p282, @p283, @p284, @p285, @p286, @p287, @p288, @p289, @p290, @p291, @p292, @p293, @p294, @p295, @p296, @p297, @p298, @p299, @p300, @p301, @p302, @p303, @p304, @p305, @p306, @p307, @p308, @p309, @p310, @p311, @p312, @p313, @p314, @p315, @p316, @p317, @p318, @p319, @p320, @p321, @p322, @p323, @p324, @p325, @p326, @p327, @p328, @p329, @p330, @p331, @p332, @p333, @p334, @p335, 5), (@p336, @p337, @p338, @p339, @p340, @p341, @p342, @p343, @p344, @p345, @p346, @p347, @p348, @p349, @p350, @p351, @p352, @p353, @p354, @p355, @p356, @p357, @p358, @p359, @p360, @p361, @p362, @p363, @p364, @p365, @p366, @p367, @p368, @p369, @p370, @p371, @p372, @p373, @p374, @p375, @p376, @p377, @p378, @p379, @p380, @p381, @p382, @p383, @p384, @p385, @p386, @p387, @p388, @p389, @p390, @p391, 6), (@p392, @p393, @p394, @p395, @p396, @p397, @p398, @p399, @p400, @p401, @p402, @p403, @p404, @p405, @p406, @p407, @p408, @p409, @p410, @p411, @p412, @p413, @p414, @p415, @p416, @p417, @p418, @p419, @p420, @p421, @p422, @p423, @p424, @p425, @p426, @p427, @p428, @p429, @p430, @p431, @p432, @p433, @p434, @p435, @p436, @p437, @p438, @p439, @p440, @p441, @p442, @p443, @p444, @p445, @p446, @p447, 7), (@p448, @p449, @p450, @p451, @p452, @p453, @p454, @p455, @p456, @p457, @p458, @p459, @p460, @p461, @p462, @p463, @p464, @p465, @p466, @p467, @p468, @p469, @p470, @p471, @p472, @p473, @p474, @p475, @p476, @p477, @p478, @p479, @p480, @p481, @p482, @p483, @p484, @p485, @p486, @p487, @p488, @p489, @p490, @p491, @p492, @p493, @p494, @p495, @p496, @p497, @p498, @p499, @p500, @p501, @p502, @p503, 8), (@p504, @p505, @p506, @p507, @p508, @p509, @p510, @p511, @p512, @p513, @p514, @p515, @p516, @p517, @p518, @p519, @p520, @p521, @p522, @p523, @p524, @p525, @p526, @p527, @p528, @p529, @p530, @p531, @p532, @p533, @p534, @p535, @p536, @p537, @p538, @p539, @p540, @p541, @p542, @p543, @p544, @p545, @p546, @p547, @p548, @p549, @p550, @p551, @p552, @p553, @p554, @p555, @p556, @p557, @p558, @p559, 9), (@p560, @p561, @p562, @p563, @p564, @p565, @p566, @p567, @p568, @p569, @p570, @p571, @p572, @p573, @p574, @p575, @p576, @p577, @p578, @p579, @p580, @p581, @p582, @p583, @p584, @p585, @p586, @p587, @p588, @p589, @p590, @p591, @p592, @p593, @p594, @p595, @p596, @p597, @p598, @p599, @p600, @p601, @p602, @p603, @p604, @p605, @p606, @p607, @p608, @p609, @p610, @p611, @p612, @p613, @p614, @p615, 10), (@p616, @p617, @p618, @p619, @p620, @p621, @p622, @p623, @p624, @p625, @p626, @p627, @p628, @p629, @p630, @p631, @p632, @p633, @p634, @p635, @p636, @p637, @p638, @p639, @p640, @p641, @p642, @p643, @p644, @p645, @p646, @p647, @p648, @p649, @p650, @p651, @p652, @p653, @p654, @p655, @p656, @p657, @p658, @p659, @p660, @p661, @p662, @p663, @p664, @p665, @p666, @p667, @p668, @p669, @p670, @p671, 11), (@p672, @p673, @p674, @p675, @p676, @p677, @p678, @p679, @p680, @p681, @p682, @p683, @p684, @p685, @p686, @p687, @p688, @p689, @p690, @p691, @p692, @p693, @p694, @p695, @p696, @p697, @p698, @p699, @p700, @p701, @p702, @p703, @p704, @p705, @p706, @p707, @p708, @p709, @p710, @p711, @p712, @p713, @p714, @p715, @p716, @p717, @p718, @p719, @p720, @p721, @p722, @p723, @p724, @p725, @p726, @p727, 12), (@p728, @p729, @p730, @p731, @p732, @p733, @p734, @p735, @p736, @p737, @p738, @p739, @p740, @p741, @p742, @p743, @p744, @p745, @p746, @p747, @p748, @p749, @p750, @p751, @p752, @p753, @p754, @p755, @p756, @p757, @p758, @p759, @p760, @p761, @p762, @p763, @p764, @p765, @p766, @p767, @p768, @p769, @p770, @p771, @p772, @p773, @p774, @p775, @p776, @p777, @p778, @p779, @p780, @p781, @p782, @p783, 13), (@p784, @p785, @p786, @p787, @p788, @p789, @p790, @p791, @p792, @p793, @p794, @p795, @p796, @p797, @p798, @p799, @p800, @p801, @p802, @p803, @p804, @p805, @p806, @p807, @p808, @p809, @p810, @p811, @p812, @p813, @p814, @p815, @p816, @p817, @p818, @p819, @p820, @p821, @p822, @p823, @p824, @p825, @p826, @p827, @p828, @p829, @p830, @p831, @p832, @p833, @p834, @p835, @p836, @p837, @p838, @p839, 14), (@p840, @p841, @p842, @p843, @p844, @p845, @p846, @p847, @p848, @p849, @p850, @p851, @p852, @p853, @p854, @p855, @p856, @p857, @p858, @p859, @p860, @p861, @p862, @p863, @p864, @p865, @p866, @p867, @p868, @p869, @p870, @p871, @p872, @p873, @p874, @p875, @p876, @p877, @p878, @p879, @p880, @p881, @p882, @p883, @p884, @p885, @p886, @p887, @p888, @p889, @p890, @p891, @p892, @p893, @p894, @p895, 15), (@p896, @p897, @p898, @p899, @p900, @p901, @p902, @p903, @p904, @p905, @p906, @p907, @p908, @p909, @p910, @p911, @p912, @p913, @p914, @p915, @p916, @p917, @p918, @p919, @p920, @p921, @p922, @p923, @p924, @p925, @p926, @p927, @p928, @p929, @p930, @p931, @p932, @p933, @p934, @p935, @p936, @p937, @p938, @p939, @p940, @p941, @p942, @p943, @p944, @p945, @p946, @p947, @p948, @p949, @p950, @p951, 16), (@p952, @p953, @p954, @p955, @p956, @p957, @p958, @p959, @p960, @p961, @p962, @p963, @p964, @p965, @p966, @p967, @p968, @p969, @p970, @p971, @p972, @p973, @p974, @p975, @p976, @p977, @p978, @p979, @p980, @p981, @p982, @p983, @p984, @p985, @p986, @p987, @p988, @p989, @p990, @p991, @p992, @p993, @p994, @p995, @p996, @p997, @p998, @p999, @p1000, @p1001, @p1002, @p1003, @p1004, @p1005, @p1006, @p1007, 17), (@p1008, @p1009, @p1010, @p1011, @p1012, @p1013, @p1014, @p1015, @p1016, @p1017, @p1018, @p1019, @p1020, @p1021, @p1022, @p1023, @p1024, @p1025, @p1026, @p1027, @p1028, @p1029, @p1030, @p1031, @p1032, @p1033, @p1034, @p1035, @p1036, @p1037, @p1038, @p1039, @p1040, @p1041, @p1042, @p1043, @p1044, @p1045, @p1046, @p1047, @p1048, @p1049, @p1050, @p1051, @p1052, @p1053, @p1054, @p1055, @p1056, @p1057, @p1058, @p1059, @p1060, @p1061, @p1062, @p1063, 18), (@p1064, @p1065, @p1066, @p1067, @p1068, @p1069, @p1070, @p1071, @p1072, @p1073, @p1074, @p1075, @p1076, @p1077, @p1078, @p1079, @p1080, @p1081, @p1082, @p1083, @p1084, @p1085, @p1086, @p1087, @p1088, @p1089, @p1090, @p1091, @p1092, @p1093, @p1094, @p1095, @p1096, @p1097, @p1098, @p1099, @p1100, @p1101, @p1102, @p1103, @p1104, @p1105, @p1106, @p1107, @p1108, @p1109, @p1110, @p1111, @p1112, @p1113, @p1114, @p1115, @p1116, @p1117, @p1118, @p1119, 19), (@p1120, @p1121, @p1122, @p1123, @p1124, @p1125, @p1126, @p1127, @p1128, @p1129, @p1130, @p1131, @p1132, @p1133, @p1134, @p1135, @p1136, @p1137, @p1138, @p1139, @p1140, @p1141, @p1142, @p1143, @p1144, @p1145, @p1146, @p1147, @p1148, @p1149, @p1150, @p1151, @p1152, @p1153, @p1154, @p1155, @p1156, @p1157, @p1158, @p1159, @p1160, @p1161, @p1162, @p1163, @p1164, @p1165, @p1166, @p1167, @p1168, @p1169, @p1170, @p1171, @p1172, @p1173, @p1174, @p1175, 20), (@p1176, @p1177, @p1178, @p1179, @p1180, @p1181, @p1182, @p1183, @p1184, @p1185, @p1186, @p1187, @p1188, @p1189, @p1190, @p1191, @p1192, @p1193, @p1194, @p1195, @p1196, @p1197, @p1198, @p1199, @p1200, @p1201, @p1202, @p1203, @p1204, @p1205, @p1206, @p1207, @p1208, @p1209, @p1210, @p1211, @p1212, @p1213, @p1214, @p1215, @p1216, @p1217, @p1218, @p1219, @p1220, @p1221, @p1222, @p1223, @p1224, @p1225, @p1226, @p1227, @p1228, @p1229, @p1230, @p1231, 21), (@p1232, @p1233, @p1234, @p1235, @p1236, @p1237, @p1238, @p1239, @p1240, @p1241, @p1242, @p1243, @p1244, @p1245, @p1246, @p1247, @p1248, @p1249, @p1250, @p1251, @p1252, @p1253, @p1254, @p1255, @p1256, @p1257, @p1258, @p1259, @p1260, @p1261, @p1262, @p1263, @p1264, @p1265, @p1266, @p1267, @p1268, @p1269, @p1270, @p1271, @p1272, @p1273, @p1274, @p1275, @p1276, @p1277, @p1278, @p1279, @p1280, @p1281, @p1282, @p1283, @p1284, @p1285, @p1286, @p1287, 22), (@p1288, @p1289, @p1290, @p1291, @p1292, @p1293, @p1294, @p1295, @p1296, @p1297, @p1298, @p1299, @p1300, @p1301, @p1302, @p1303, @p1304, @p1305, @p1306, @p1307, @p1308, @p1309, @p1310, @p1311, @p1312, @p1313, @p1314, @p1315, @p1316, @p1317, @p1318, @p1319, @p1320, @p1321, @p1322, @p1323, @p1324, @p1325, @p1326, @p1327, @p1328, @p1329, @p1330, @p1331, @p1332, @p1333, @p1334, @p1335, @p1336, @p1337, @p1338, @p1339, @p1340, @p1341, @p1342, @p1343, 23), (@p1344, @p1345, @p1346, @p1347, @p1348, @p1349, @p1350, @p1351, @p1352, @p1353, @p1354, @p1355, @p1356, @p1357, @p1358, @p1359, @p1360, @p1361, @p1362, @p1363, @p1364, @p1365, @p1366, @p1367, @p1368, @p1369, @p1370, @p1371, @p1372, @p1373, @p1374, @p1375, @p1376, @p1377, @p1378, @p1379, @p1380, @p1381, @p1382, @p1383, @p1384, @p1385, @p1386, @p1387, @p1388, @p1389, @p1390, @p1391, @p1392, @p1393, @p1394, @p1395, @p1396, @p1397, @p1398, @p1399, 24), (@p1400, @p1401, @p1402, @p1403, @p1404, @p1405, @p1406, @p1407, @p1408, @p1409, @p1410, @p1411, @p1412, @p1413, @p1414, @p1415, @p1416, @p1417, @p1418, @p1419, @p1420, @p1421, @p1422, @p1423, @p1424, @p1425, @p1426, @p1427, @p1428, @p1429, @p1430, @p1431, @p1432, @p1433, @p1434, @p1435, @p1436, @p1437, @p1438, @p1439, @p1440, @p1441, @p1442, @p1443, @p1444, @p1445, @p1446, @p1447, @p1448, @p1449, @p1450, @p1451, @p1452, @p1453, @p1454, @p1455, 25), (@p1456, @p1457, @p1458, @p1459, @p1460, @p1461, @p1462, @p1463, @p1464, @p1465, @p1466, @p1467, @p1468, @p1469, @p1470, @p1471, @p1472, @p1473, @p1474, @p1475, @p1476, @p1477, @p1478, @p1479, @p1480, @p1481, @p1482, @p1483, @p1484, @p1485, @p1486, @p1487, @p1488, @p1489, @p1490, @p1491, @p1492, @p1493, @p1494, @p1495, @p1496, @p1497, @p1498, @p1499, @p1500, @p1501, @p1502, @p1503, @p1504, @p1505, @p1506, @p1507, @p1508, @p1509, @p1510, @p1511, 26), (@p1512, @p1513, @p1514, @p1515, @p1516, @p1517, @p1518, @p1519, @p1520, @p1521, @p1522, @p1523, @p1524, @p1525, @p1526, @p1527, @p1528, @p1529, @p1530, @p1531, @p1532, @p1533, @p1534, @p1535, @p1536, @p1537, @p1538, @p1539, @p1540, @p1541, @p1542, @p1543, @p1544, @p1545, @p1546, @p1547, @p1548, @p1549, @p1550, @p1551, @p1552, @p1553, @p1554, @p1555, @p1556, @p1557, @p1558, @p1559, @p1560, @p1561, @p1562, @p1563, @p1564, @p1565, @p1566, @p1567, 27), (@p1568, @p1569, @p1570, @p1571, @p1572, @p1573, @p1574, @p1575, @p1576, @p1577, @p1578, @p1579, @p1580, @p1581, @p1582, @p1583, @p1584, @p1585, @p1586, @p1587, @p1588, @p1589, @p1590, @p1591, @p1592, @p1593, @p1594, @p1595, @p1596, @p1597, @p1598, @p1599, @p1600, @p1601, @p1602, @p1603, @p1604, @p1605, @p1606, @p1607, @p1608, @p1609, @p1610, @p1611, @p1612, @p1613, @p1614, @p1615, @p1616, @p1617, @p1618, @p1619, @p1620, @p1621, @p1622, @p1623, 28), (@p1624, @p1625, @p1626, @p1627, @p1628, @p1629, @p1630, @p1631, @p1632, @p1633, @p1634, @p1635, @p1636, @p1637, @p1638, @p1639, @p1640, @p1641, @p1642, @p1643, @p1644, @p1645, @p1646, @p1647, @p1648, @p1649, @p1650, @p1651, @p1652, @p1653, @p1654, @p1655, @p1656, @p1657, @p1658, @p1659, @p1660, @p1661, @p1662, @p1663, @p1664, @p1665, @p1666, @p1667, @p1668, @p1669, @p1670, @p1671, @p1672, @p1673, @p1674, @p1675, @p1676, @p1677, @p1678, @p1679, 29), (@p1680, @p1681, @p1682, @p1683, @p1684, @p1685, @p1686, @p1687, @p1688, @p1689, @p1690, @p1691, @p1692, @p1693, @p1694, @p1695, @p1696, @p1697, @p1698, @p1699, @p1700, @p1701, @p1702, @p1703, @p1704, @p1705, @p1706, @p1707, @p1708, @p1709, @p1710, @p1711, @p1712, @p1713, @p1714, @p1715, @p1716, @p1717, @p1718, @p1719, @p1720, @p1721, @p1722, @p1723, @p1724, @p1725, @p1726, @p1727, @p1728, @p1729, @p1730, @p1731, @p1732, @p1733, @p1734, @p1735, 30), (@p1736, @p1737, @p1738, @p1739, @p1740, @p1741, @p1742, @p1743, @p1744, @p1745, @p1746, @p1747, @p1748, @p1749, @p1750, @p1751, @p1752, @p1753, @p1754, @p1755, @p1756, @p1757, @p1758, @p1759, @p1760, @p1761, @p1762, @p1763, @p1764, @p1765, @p1766, @p1767, @p1768, @p1769, @p1770, @p1771, @p1772, @p1773, @p1774, @p1775, @p1776, @p1777, @p1778, @p1779, @p1780, @p1781, @p1782, @p1783, @p1784, @p1785, @p1786, @p1787, @p1788, @p1789, @p1790, @p1791, 31), (@p1792, @p1793, @p1794, @p1795, @p1796, @p1797, @p1798, @p1799, @p1800, @p1801, @p1802, @p1803, @p1804, @p1805, @p1806, @p1807, @p1808, @p1809, @p1810, @p1811, @p1812, @p1813, @p1814, @p1815, @p1816, @p1817, @p1818, @p1819, @p1820, @p1821, @p1822, @p1823, @p1824, @p1825, @p1826, @p1827, @p1828, @p1829, @p1830, @p1831, @p1832, @p1833, @p1834, @p1835, @p1836, @p1837, @p1838, @p1839, @p1840, @p1841, @p1842, @p1843, @p1844, @p1845, @p1846, @p1847, 32), (@p1848, @p1849, @p1850, @p1851, @p1852, @p1853, @p1854, @p1855, @p1856, @p1857, @p1858, @p1859, @p1860, @p1861, @p1862, @p1863, @p1864, @p1865, @p1866, @p1867, @p1868, @p1869, @p1870, @p1871, @p1872, @p1873, @p1874, @p1875, @p1876, @p1877, @p1878, @p1879, @p1880, @p1881, @p1882, @p1883, @p1884, @p1885, @p1886, @p1887, @p1888, @p1889, @p1890, @p1891, @p1892, @p1893, @p1894, @p1895, @p1896, @p1897, @p1898, @p1899, @p1900, @p1901, @p1902, @p1903, 33), (@p1904, @p1905, @p1906, @p1907, @p1908, @p1909, @p1910, @p1911, @p1912, @p1913, @p1914, @p1915, @p1916, @p1917, @p1918, @p1919, @p1920, @p1921, @p1922, @p1923, @p1924, @p1925, @p1926, @p1927, @p1928, @p1929, @p1930, @p1931, @p1932, @p1933, @p1934, @p1935, @p1936, @p1937, @p1938, @p1939, @p1940, @p1941, @p1942, @p1943, @p1944, @p1945, @p1946, @p1947, @p1948, @p1949, @p1950, @p1951, @p1952, @p1953, @p1954, @p1955, @p1956, @p1957, @p1958, @p1959, 34), (@p1960, @p1961, @p1962, @p1963, @p1964, @p1965, @p1966, @p1967, @p1968, @p1969, @p1970, @p1971, @p1972, @p1973, @p1974, @p1975, @p1976, @p1977, @p1978, @p1979, @p1980, @p1981, @p1982, @p1983, @p1984, @p1985, @p1986, @p1987, @p1988, @p1989, @p1990, @p1991, @p1992, @p1993, @p1994, @p1995, @p1996, @p1997, @p1998, @p1999, @p2000, @p2001, @p2002, @p2003, @p2004, @p2005, @p2006, @p2007, @p2008, @p2009, @p2010, @p2011, @p2012, @p2013, @p2014, @p2015, 35), (@p2016, @p2017, @p2018, @p2019, @p2020, @p2021, @p2022, @p2023, @p2024, @p2025, @p2026, @p2027, @p2028, @p2029, @p2030, @p2031, @p2032, @p2033, @p2034, @p2035, @p2036, @p2037, @p2038, @p2039, @p2040, @p2041, @p2042, @p2043, @p2044, @p2045, @p2046, @p2047, @p2048, @p2049, @p2050, @p2051, @p2052, @p2053, @p2054, @p2055, @p2056, @p2057, @p2058, @p2059, @p2060, @p2061, @p2062, @p2063, @p2064, @p2065, @p2066, @p2067, @p2068, @p2069, @p2070, @p2071, 36)) AS i ([addressee_cntry_cd], [addressee_city], [addressee_district], [addressee_email], [addressee_full_address], [addressee_home_address], [addressee_name], [addressee_postcode], [addressee_province], [addressee_subdistrict], [addressee_tel], [create_table], [delivery_code], [delivery_recipient_name], [delivery_relation_id], [delivery_status_id], [dest_outlet_id], [dest_outlet_port], [document_number], [item_barcode], [item_cod], [item_gross_weight], [item_height], [item_length], [item_price], [item_width], [lat], [log_id], [long], [outlet_id], [outlet_port], [podUrl], [remark], [scan_cntry_cd], [scan_cntry_postcode], [sender_cntry_cd], [sender_district], [sender_email], [sender_full_address], [sender_home_address], [member_id], [sender_name], [sender_postcode], [sender_province], [sender_subdistrict], [sender_tel], [server_id], [signatureUrl], [state], [status_code], [status_dtm], [timestamp], [transmit_dtm], [user_id], [wckt_id], [wkstn_no], _Position) ON 1=0 WHEN NOT MATCHED THEN INSERT ([addressee_cntry_cd], [addressee_city], [addressee_district], [addressee_email], [addressee_full_address], [addressee_home_address], [addressee_name], [addressee_postcode], [addressee_province], [addressee_subdistrict], [addressee_tel], [create_table], [delivery_code], [delivery_recipient_name], [delivery_relation_id], [delivery_status_id], [dest_outlet_id], [dest_outlet_port], [document_number], [item_barcode], [item_cod], [item_gross_weight], [item_height], [item_length], [item_price], [item_width], [lat], [log_id], [long], [outlet_id], [outlet_port], [podUrl], [remark], [scan_cntry_cd], [scan_cntry_postcode], [sender_cntry_cd], [sender_district], [sender_email], [sender_full_address], [sender_home_address], [member_id], [sender_name], [sender_postcode], [sender_province], [sender_subdistrict], [sender_tel], [server_id], [signatureUrl], [state], [status_code], [status_dtm], [timestamp], [transmit_dtm], [user_id], [wckt_id], [wkstn_no]) VALUES (i.[addressee_cntry_cd], i.[addressee_city], i.[addressee_district], i.[addressee_email], i.[addressee_full_address], i.[addressee_home_address], i.[addressee_name], i.[addressee_postcode], i.[addressee_province], i.[addressee_subdistrict], i.[addressee_tel], i.[create_table], i.[delivery_code], i.[delivery_recipient_name], i.[delivery_relation_id], i.[delivery_status_id], i.[dest_outlet_id], i.[dest_outlet_port], i.[document_number], i.[item_barcode], i.[item_cod], i.[item_gross_weight], i.[item_height], i.[item_length], i.[item_price], i.[item_width], i.[lat], i.[log_id], i.[long], i.[outlet_id], i.[outlet_port], i.[podUrl], i.[remark], i.[scan_cntry_cd], i.[scan_cntry_postcode], i.[sender_cntry_cd], i.[sender_district], i.[sender_email], i.[sender_full_address], i.[sender_home_address], i.[member_id], i.[sender_name], i.[sender_postcode], i.[sender_province], i.[sender_subdistrict], i.[sender_tel], i.[server_id], i.[signatureUrl], i.[state], i.[status_code], i.[status_dtm], i.[timestamp], i.[transmit_dtm], i.[user_id], i.[wckt_id], i.[wkstn_no]) OUTPUT INSERTED.[item_id], i._Position INTO @inserted0;  SELECT [t].[item_id] FROM [raw_data] t INNER JOIN @inserted0 i ON ([t].[item_id] = [i].[item_id]) ORDER BY [i].[_Position];  ",4,4,0,430,3,4
"(@p0 nvarchar(4000),@p1 nvarchar(4000),@p2 nvarchar(4000),@p3 nvarchar(4000),@p4 nvarchar(4000),@p5 nvarchar(4000),@p6 nvarchar(4000),@p7 nvarchar(4000),@p8 nvarchar(4000),@p9 nvarchar(4000),@p10 nvarchar(4000),@p11 datetime2(7),@p12 nvarchar(4000),@p13 nvarchar(4000),@p14 int,@p15 int,@p16 int,@p17 nvarchar(4000),@p18 nvarchar(4000),@p19 nvarchar(4000),@p20 nvarchar(4000),@p21 decimal(18,2),@p22 nvarchar(4000),@p23 nvarchar(4000),@p24 decimal(18,2),@p25 nvarchar(4000),@p26 nvarchar(4000),@p27 nvarchar(4000),@p28 nvarchar(4000),@p29 int,@p30 nvarchar(4000),@p31 nvarchar(4000),@p32 nvarchar(4000),@p33 nvarchar(4000),@p34 nvarchar(4000),@p35 nvarchar(4000),@p36 nvarchar(4000),@p37 nvarchar(4000),@p38 nvarchar(4000),@p39 nvarchar(4000),@p40 int,@p41 nvarchar(4000),@p42 nvarchar(4000),@p43 nvarchar(4000),@p44 nvarchar(4000),@p45 nvarchar(4000),@p46 int,@p47 nvarchar(4000),@p48 int,@p49 int,@p50 datetime2(7),@p51 datetime2(7),@p52 datetime2(7),@p53 nvarchar(4000),@p54 nvarchar(4000),@p55 nvarchar(4000),@p56 nvarchar(4000),@p57 nvarchar(4000),@p58 nvarchar(4000),@p59 nvarchar(4000),@p60 nvarchar(4000),@p61 nvarchar(4000),@p62 nvarchar(4000),@p63 nvarchar(4000),@p64 nvarchar(4000),@p65 nvarchar(4000),@p66 nvarchar(4000),@p67 datetime2(7),@p68 nvarchar(4000),@p69 nvarchar(4000),@p70 int,@p71 int,@p72 int,@p73 nvarchar(4000),@p74 nvarchar(4000),@p75 nvarchar(4000),@p76 nvarchar(4000),@p77 decimal(18,2),@p78 nvarchar(4000),@p79 nvarchar(4000),@p80 decimal(18,2),@p81 nvarchar(4000),@p82 nvarchar(4000),@p83 nvarchar(4000),@p84 nvarchar(4000),@p85 int,@p86 nvarchar(4000),@p87 nvarchar(4000),@p88 nvarchar(4000),@p89 nvarchar(4000),@p90 nvarchar(4000),@p91 nvarchar(4000),@p92 nvarchar(4000),@p93 nvarchar(4000),@p94 nvarchar(4000),@p95 nvarchar(4000),@p96 int,@p97 nvarchar(4000),@p98 nvarchar(4000),@p99 nvarchar(4000),@p100 nvarchar(4000),@p101 nvarchar(4000),@p102 int,@p103 nvarchar(4000),@p104 int,@p105 int,@p106 datetime2(7),@p107 datetime2(7),@p108 datetime2(7),@p109 nvarchar(4000),@p110 nvarchar(4000),@p111 nvarchar(4000),@p112 nvarchar(4000),@p113 nvarchar(4000),@p114 nvarchar(4000),@p115 nvarchar(4000),@p116 nvarchar(4000),@p117 nvarchar(4000),@p118 nvarchar(4000),@p119 nvarchar(4000),@p120 nvarchar(4000),@p121 nvarchar(4000),@p122 nvarchar(4000),@p123 datetime2(7),@p124 nvarchar(4000),@p125 nvarchar(4000),@p126 int,@p127 int,@p128 int,@p129 nvarchar(4000),@p130 nvarchar(4000),@p131 nvarchar(4000),@p132 nvarchar(4000),@p133 decimal(18,2),@p134 nvarchar(4000),@p135 nvarchar(4000),@p136 decimal(18,2),@p137 nvarchar(4000),@p138 nvarchar(4000),@p139 nvarchar(4000),@p140 nvarchar(4000),@p141 int,@p142 nvarchar(4000),@p143 nvarchar(4000),@p144 nvarchar(4000),@p145 nvarchar(4000),@p146 nvarchar(4000),@p147 nvarchar(4000),@p148 nvarchar(4000),@p149 nvarchar(4000),@p150 nvarchar(4000),@p151 nvarchar(4000),@p152 int,@p153 nvarchar(4000),@p154 nvarchar(4000),@p155 nvarchar(4000),@p156 nvarchar(4000),@p157 nvarchar(4000),@p158 int,@p159 nvarchar(4000),@p160 int,@p161 int,@p162 datetime2(7),@p163 datetime2(7),@p164 datetime2(7),@p165 nvarchar(4000),@p166 nvarchar(4000),@p167 nvarchar(4000),@p168 nvarchar(4000),@p169 nvarchar(4000),@p170 nvarchar(4000),@p171 nvarchar(4000),@p172 nvarchar(4000),@p173 nvarchar(4000),@p174 nvarchar(4000),@p175 nvarchar(4000),@p176 nvarchar(4000),@p177 nvarchar(4000),@p178 nvarchar(4000),@p179 datetime2(7),@p180 nvarchar(4000),@p181 nvarchar(4000),@p182 int,@p183 int,@p184 int,@p185 nvarchar(4000),@p186 nvarchar(4000),@p187 nvarchar(4000),@p188 nvarchar(4000),@p189 decimal(18,2),@p190 nvarchar(4000),@p191 nvarchar(4000),@p192 decimal(18,2),@p193 nvarchar(4000),@p194 nvarchar(4000),@p195 nvarchar(4000),@p196 nvarchar(4000),@p197 int,@p198 nvarchar(4000),@p199 nvarchar(4000),@p200 nvarchar(4000),@p201 nvarchar(4000),@p202 nvarchar(4000),@p203 nvarchar(4000),@p204 nvarchar(4000),@p205 nvarchar(4000),@p206 nvarchar(4000),@p207 nvarchar(4000),@p208 int,@p209 nvarchar(4000),@p210 nvarchar(4000),@p211 nvarchar(4000),@p212 nvarchar(4000),@p213 nvarchar(4000),@p214 int,@p215 nvarchar(4000),@p216 int,@p217 int,@p218 datetime2(7),@p219 datetime2(7),@p220 datetime2(7),@p221 nvarchar(4000),@p222 nvarchar(4000),@p223 nvarchar(4000),@p224 nvarchar(4000),@p225 nvarchar(4000),@p226 nvarchar(4000),@p227 nvarchar(4000),@p228 nvarchar(4000),@p229 nvarchar(4000),@p230 nvarchar(4000),@p231 nvarchar(4000),@p232 nvarchar(4000),@p233 nvarchar(4000),@p234 nvarchar(4000),@p235 datetime2(7),@p236 nvarchar(4000),@p237 nvarchar(4000),@p238 int,@p239 int,@p240 int,@p241 nvarchar(4000),@p242 nvarchar(4000),@p243 nvarchar(4000),@p244 decimal(18,2),@p245 decimal(18,2),@p246 nvarchar(4000),@p247 nvarchar(4000),@p248 decimal(18,2),@p249 nvarchar(4000),@p250 nvarchar(4000),@p251 nvarchar(4000),@p252 nvarchar(4000),@p253 int,@p254 nvarchar(4000),@p255 nvarchar(4000),@p256 nvarchar(4000),@p257 nvarchar(4000),@p258 nvarchar(4000),@p259 nvarchar(4000),@p260 nvarchar(4000),@p261 nvarchar(4000),@p262 nvarchar(4000),@p263 nvarchar(4000),@p264 int,@p265 nvarchar(4000),@p266 nvarchar(4000),@p267 nvarchar(4000),@p268 nvarchar(4000),@p269 nvarchar(4000),@p270 int,@p271 nvarchar(4000),@p272 int,@p273 int,@p274 datetime2(7),@p275 datetime2(7),@p276 datetime2(7),@p277 nvarchar(4000),@p278 nvarchar(4000),@p279 nvarchar(4000),@p280 nvarchar(4000),@p281 nvarchar(4000),@p282 nvarchar(4000),@p283 nvarchar(4000),@p284 nvarchar(4000),@p285 nvarchar(4000),@p286 nvarchar(4000),@p287 nvarchar(4000),@p288 nvarchar(4000),@p289 nvarchar(4000),@p290 nvarchar(4000),@p291 datetime2(7),@p292 nvarchar(4000),@p293 nvarchar(4000),@p294 int,@p295 int,@p296 int,@p297 nvarchar(4000),@p298 nvarchar(4000),@p299 nvarchar(4000),@p300 nvarchar(4000),@p301 decimal(18,2),@p302 nvarchar(4000),@p303 nvarchar(4000),@p304 decimal(18,2),@p305 nvarchar(4000),@p306 nvarchar(4000),@p307 nvarchar(4000),@p308 nvarchar(4000),@p309 int,@p310 nvarchar(4000),@p311 nvarchar(4000),@p312 nvarchar(4000),@p313 nvarchar(4000),@p314 nvarchar(4000),@p315 nvarchar(4000),@p316 nvarchar(4000),@p317 nvarchar(4000),@p318 nvarchar(4000),@p319 nvarchar(4000),@p320 int,@p321 nvarchar(4000),@p322 nvarchar(4000),@p323 nvarchar(4000),@p324 nvarchar(4000),@p325 nvarchar(4000),@p326 int,@p327 nvarchar(4000),@p328 int,@p329 int,@p330 datetime2(7),@p331 datetime2(7),@p332 datetime2(7),@p333 nvarchar(4000),@p334 nvarchar(4000),@p335 nvarchar(4000),@p336 nvarchar(4000),@p337 nvarchar(4000),@p338 nvarchar(4000),@p339 nvarchar(4000),@p340 nvarchar(4000),@p341 nvarchar(4000),@p342 nvarchar(4000),@p343 nvarchar(4000),@p344 nvarchar(4000),@p345 nvarchar(4000),@p346 nvarchar(4000),@p347 datetime2(7),@p348 nvarchar(4000),@p349 nvarchar(4000),@p350 int,@p351 int,@p352 int,@p353 nvarchar(4000),@p354 nvarchar(4000),@p355 nvarchar(4000),@p356 nvarchar(4000),@p357 decimal(18,2),@p358 nvarchar(4000),@p359 nvarchar(4000),@p360 decimal(18,2),@p361 nvarchar(4000),@p362 nvarchar(4000),@p363 nvarchar(4000),@p364 nvarchar(4000),@p365 int,@p366 nvarchar(4000),@p367 nvarchar(4000),@p368 nvarchar(4000),@p369 nvarchar(4000),@p370 nvarchar(4000),@p371 nvarchar(4000),@p372 nvarchar(4000),@p373 nvarchar(4000),@p374 nvarchar(4000),@p375 nvarchar(4000),@p376 int,@p377 nvarchar(4000),@p378 nvarchar(4000),@p379 nvarchar(4000),@p380 nvarchar(4000),@p381 nvarchar(4000),@p382 int,@p383 nvarchar(4000),@p384 int,@p385 int,@p386 datetime2(7),@p387 datetime2(7),@p388 datetime2(7),@p389 nvarchar(4000),@p390 nvarchar(4000),@p391 nvarchar(4000),@p392 nvarchar(4000),@p393 nvarchar(4000),@p394 nvarchar(4000),@p395 nvarchar(4000),@p396 nvarchar(4000),@p397 nvarchar(4000),@p398 nvarchar(4000),@p399 nvarchar(4000),@p400 nvarchar(4000),@p401 nvarchar(4000),@p402 nvarchar(4000),@p403 datetime2(7),@p404 nvarchar(4000),@p405 nvarchar(4000),@p406 int,@p407 int,@p408 int,@p409 nvarchar(4000),@p410 nvarchar(4000),@p411 nvarchar(4000),@p412 decimal(18,2),@p413 decimal(18,2),@p414 nvarchar(4000),@p415 nvarchar(4000),@p416 decimal(18,2),@p417 nvarchar(4000),@p418 nvarchar(4000),@p419 nvarchar(4000),@p420 nvarchar(4000),@p421 int,@p422 nvarchar(4000),@p423 nvarchar(4000),@p424 nvarchar(4000),@p425 nvarchar(4000),@p426 nvarchar(4000),@p427 nvarchar(4000),@p428 nvarchar(4000),@p429 nvarchar(4000),@p430 nvarchar(4000),@p431 nvarchar(4000),@p432 int,@p433 nvarchar(4000),@p434 nvarchar(4000),@p435 nvarchar(4000),@p436 nvarchar(4000),@p437 nvarchar(4000),@p438 int,@p439 nvarchar(4000),@p440 int,@p441 int,@p442 datetime2(7),@p443 datetime2(7),@p444 datetime2(7),@p445 nvarchar(4000),@p446 nvarchar(4000),@p447 nvarchar(4000),@p448 nvarchar(4000),@p449 nvarchar(4000),@p450 nvarchar(4000),@p451 nvarchar(4000),@p452 nvarchar(4000),@p453 nvarchar(4000),@p454 nvarchar(4000),@p455 nvarchar(4000),@p456 nvarchar(4000),@p457 nvarchar(4000),@p458 nvarchar(4000),@p459 datetime2(7),@p460 nvarchar(4000),@p461 nvarchar(4000),@p462 int,@p463 int,@p464 int,@p465 nvarchar(4000),@p466 nvarchar(4000),@p467 nvarchar(4000),@p468 decimal(18,2),@p469 decimal(18,2),@p470 nvarchar(4000),@p471 nvarchar(4000),@p472 decimal(18,2),@p473 nvarchar(4000),@p474 nvarchar(4000),@p475 nvarchar(4000),@p476 nvarchar(4000),@p477 int,@p478 nvarchar(4000),@p479 nvarchar(4000),@p480 nvarchar(4000),@p481 nvarchar(4000),@p482 nvarchar(4000),@p483 nvarchar(4000),@p484 nvarchar(4000),@p485 nvarchar(4000),@p486 nvarchar(4000),@p487 nvarchar(4000),@p488 int,@p489 nvarchar(4000),@p490 nvarchar(4000),@p491 nvarchar(4000),@p492 nvarchar(4000),@p493 nvarchar(4000),@p494 int,@p495 nvarchar(4000),@p496 int,@p497 int,@p498 datetime2(7),@p499 datetime2(7),@p500 datetime2(7),@p501 nvarchar(4000),@p502 nvarchar(4000),@p503 nvarchar(4000),@p504 nvarchar(4000),@p505 nvarchar(4000),@p506 nvarchar(4000),@p507 nvarchar(4000),@p508 nvarchar(4000),@p509 nvarchar(4000),@p510 nvarchar(4000),@p511 nvarchar(4000),@p512 nvarchar(4000),@p513 nvarchar(4000),@p514 nvarchar(4000),@p515 datetime2(7),@p516 nvarchar(4000),@p517 nvarchar(4000),@p518 int,@p519 int,@p520 int,@p521 nvarchar(4000),@p522 nvarchar(4000),@p523 nvarchar(4000),@p524 decimal(18,2),@p525 decimal(18,2),@p526 nvarchar(4000),@p527 nvarchar(4000),@p528 decimal(18,2),@p529 nvarchar(4000),@p530 nvarchar(4000),@p531 nvarchar(4000),@p532 nvarchar(4000),@p533 int,@p534 nvarchar(4000),@p535 nvarchar(4000),@p536 nvarchar(4000),@p537 nvarchar(4000),@p538 nvarchar(4000),@p539 nvarchar(4000),@p540 nvarchar(4000),@p541 nvarchar(4000),@p542 nvarchar(4000),@p543 nvarchar(4000),@p544 int,@p545 nvarchar(4000),@p546 nvarchar(4000),@p547 nvarchar(4000),@p548 nvarchar(4000),@p549 nvarchar(4000),@p550 int,@p551 nvarchar(4000),@p552 int,@p553 int,@p554 datetime2(7),@p555 datetime2(7),@p556 datetime2(7),@p557 nvarchar(4000),@p558 nvarchar(4000),@p559 nvarchar(4000),@p560 nvarchar(4000),@p561 nvarchar(4000),@p562 nvarchar(4000),@p563 nvarchar(4000),@p564 nvarchar(4000),@p565 nvarchar(4000),@p566 nvarchar(4000),@p567 nvarchar(4000),@p568 nvarchar(4000),@p569 nvarchar(4000),@p570 nvarchar(4000),@p571 datetime2(7),@p572 nvarchar(4000),@p573 nvarchar(4000),@p574 int,@p575 int,@p576 int,@p577 nvarchar(4000),@p578 nvarchar(4000),@p579 nvarchar(4000),@p580 decimal(18,2),@p581 decimal(18,2),@p582 nvarchar(4000),@p583 nvarchar(4000),@p584 decimal(18,2),@p585 nvarchar(4000),@p586 nvarchar(4000),@p587 nvarchar(4000),@p588 nvarchar(4000),@p589 int,@p590 nvarchar(4000),@p591 nvarchar(4000),@p592 nvarchar(4000),@p593 nvarchar(4000),@p594 nvarchar(4000),@p595 nvarchar(4000),@p596 nvarchar(4000),@p597 nvarchar(4000),@p598 nvarchar(4000),@p599 nvarchar(4000),@p600 int,@p601 nvarchar(4000),@p602 nvarchar(4000),@p603 nvarchar(4000),@p604 nvarchar(4000),@p605 nvarchar(4000),@p606 int,@p607 nvarchar(4000),@p608 int,@p609 int,@p610 datetime2(7),@p611 datetime2(7),@p612 datetime2(7),@p613 nvarchar(4000),@p614 nvarchar(4000),@p615 nvarchar(4000),@p616 nvarchar(4000),@p617 nvarchar(4000),@p618 nvarchar(4000),@p619 nvarchar(4000),@p620 nvarchar(4000),@p621 nvarchar(4000),@p622 nvarchar(4000),@p623 nvarchar(4000),@p624 nvarchar(4000),@p625 nvarchar(4000),@p626 nvarchar(4000),@p627 datetime2(7),@p628 nvarchar(4000),@p629 nvarchar(4000),@p630 int,@p631 int,@p632 int,@p633 nvarchar(4000),@p634 nvarchar(4000),@p635 nvarchar(4000),@p636 decimal(18,2),@p637 decimal(18,2),@p638 nvarchar(4000),@p639 nvarchar(4000),@p640 decimal(18,2),@p641 nvarchar(4000),@p642 nvarchar(4000),@p643 nvarchar(4000),@p644 nvarchar(4000),@p645 int,@p646 nvarchar(4000),@p647 nvarchar(4000),@p648 nvarchar(4000),@p649 nvarchar(4000),@p650 nvarchar(4000),@p651 nvarchar(4000),@p652 nvarchar(4000),@p653 nvarchar(4000),@p654 nvarchar(4000),@p655 nvarchar(4000),@p656 int,@p657 nvarchar(4000),@p658 nvarchar(4000),@p659 nvarchar(4000),@p660 nvarchar(4000),@p661 nvarchar(4000),@p662 int,@p663 nvarchar(4000),@p664 int,@p665 int,@p666 datetime2(7),@p667 datetime2(7),@p668 datetime2(7),@p669 nvarchar(4000),@p670 nvarchar(4000),@p671 nvarchar(4000),@p672 nvarchar(4000),@p673 nvarchar(4000),@p674 nvarchar(4000),@p675 nvarchar(4000),@p676 nvarchar(4000),@p677 nvarchar(4000),@p678 nvarchar(4000),@p679 nvarchar(4000),@p680 nvarchar(4000),@p681 nvarchar(4000),@p682 nvarchar(4000),@p683 datetime2(7),@p684 nvarchar(4000),@p685 nvarchar(4000),@p686 int,@p687 int,@p688 int,@p689 nvarchar(4000),@p690 nvarchar(4000),@p691 nvarchar(4000),@p692 nvarchar(4000),@p693 decimal(18,2),@p694 nvarchar(4000),@p695 nvarchar(4000),@p696 decimal(18,2),@p697 nvarchar(4000),@p698 nvarchar(4000),@p699 nvarchar(4000),@p700 nvarchar(4000),@p701 int,@p702 nvarchar(4000),@p703 nvarchar(4000),@p704 nvarchar(4000),@p705 nvarchar(4000),@p706 nvarchar(4000),@p707 nvarchar(4000),@p708 nvarchar(4000),@p709 nvarchar(4000),@p710 nvarchar(4000),@p711 nvarchar(4000),@p712 int,@p713 nvarchar(4000),@p714 nvarchar(4000),@p715 nvarchar(4000),@p716 nvarchar(4000),@p717 nvarchar(4000),@p718 int,@p719 nvarchar(4000),@p720 int,@p721 int,@p722 datetime2(7),@p723 datetime2(7),@p724 datetime2(7),@p725 nvarchar(4000),@p726 nvarchar(4000),@p727 nvarchar(4000),@p728 nvarchar(4000),@p729 nvarchar(4000),@p730 nvarchar(4000),@p731 nvarchar(4000),@p732 nvarchar(4000),@p733 nvarchar(4000),@p734 nvarchar(4000),@p735 nvarchar(4000),@p736 nvarchar(4000),@p737 nvarchar(4000),@p738 nvarchar(4000),@p739 datetime2(7),@p740 nvarchar(4000),@p741 nvarchar(4000),@p742 int,@p743 int,@p744 int,@p745 nvarchar(4000),@p746 nvarchar(4000),@p747 nvarchar(4000),@p748 nvarchar(4000),@p749 decimal(18,2),@p750 nvarchar(4000),@p751 nvarchar(4000),@p752 decimal(18,2),@p753 nvarchar(4000),@p754 nvarchar(4000),@p755 nvarchar(4000),@p756 nvarchar(4000),@p757 int,@p758 nvarchar(4000),@p759 nvarchar(4000),@p760 nvarchar(4000),@p761 nvarchar(4000),@p762 nvarchar(4000),@p763 nvarchar(4000),@p764 nvarchar(4000),@p765 nvarchar(4000),@p766 nvarchar(4000),@p767 nvarchar(4000),@p768 int,@p769 nvarchar(4000),@p770 nvarchar(4000),@p771 nvarchar(4000),@p772 nvarchar(4000),@p773 nvarchar(4000),@p774 int,@p775 nvarchar(4000),@p776 int,@p777 int,@p778 datetime2(7),@p779 datetime2(7),@p780 datetime2(7),@p781 nvarchar(4000),@p782 nvarchar(4000),@p783 nvarchar(4000),@p784 nvarchar(4000),@p785 nvarchar(4000),@p786 nvarchar(4000),@p787 nvarchar(4000),@p788 nvarchar(4000),@p789 nvarchar(4000),@p790 nvarchar(4000),@p791 nvarchar(4000),@p792 nvarchar(4000),@p793 nvarchar(4000),@p794 nvarchar(4000),@p795 datetime2(7),@p796 nvarchar(4000),@p797 nvarchar(4000),@p798 int,@p799 int,@p800 int,@p801 nvarchar(4000),@p802 nvarchar(4000),@p803 nvarchar(4000),@p804 nvarchar(4000),@p805 decimal(18,2),@p806 nvarchar(4000),@p807 nvarchar(4000),@p808 decimal(18,2),@p809 nvarchar(4000),@p810 nvarchar(4000),@p811 nvarchar(4000),@p812 nvarchar(4000),@p813 int,@p814 nvarchar(4000),@p815 nvarchar(4000),@p816 nvarchar(4000),@p817 nvarchar(4000),@p818 nvarchar(4000),@p819 nvarchar(4000),@p820 nvarchar(4000),@p821 nvarchar(4000),@p822 nvarchar(4000),@p823 nvarchar(4000),@p824 int,@p825 nvarchar(4000),@p826 nvarchar(4000),@p827 nvarchar(4000),@p828 nvarchar(4000),@p829 nvarchar(4000),@p830 int,@p831 nvarchar(4000),@p832 int,@p833 int,@p834 datetime2(7),@p835 datetime2(7),@p836 datetime2(7),@p837 nvarchar(4000),@p838 nvarchar(4000),@p839 nvarchar(4000),@p840 nvarchar(4000),@p841 nvarchar(4000),@p842 nvarchar(4000),@p843 nvarchar(4000),@p844 nvarchar(4000),@p845 nvarchar(4000),@p846 nvarchar(4000),@p847 nvarchar(4000),@p848 nvarchar(4000),@p849 nvarchar(4000),@p850 nvarchar(4000),@p851 datetime2(7),@p852 nvarchar(4000),@p853 nvarchar(4000),@p854 int,@p855 int,@p856 int,@p857 nvarchar(4000),@p858 nvarchar(4000),@p859 nvarchar(4000),@p860 nvarchar(4000),@p861 decimal(18,2),@p862 nvarchar(4000),@p863 nvarchar(4000),@p864 decimal(18,2),@p865 nvarchar(4000),@p866 nvarchar(4000),@p867 nvarchar(4000),@p868 nvarchar(4000),@p869 int,@p870 nvarchar(4000),@p871 nvarchar(4000),@p872 nvarchar(4000),@p873 nvarchar(4000),@p874 nvarchar(4000),@p875 nvarchar(4000),@p876 nvarchar(4000),@p877 nvarchar(4000),@p878 nvarchar(4000),@p879 nvarchar(4000),@p880 int,@p881 nvarchar(4000),@p882 nvarchar(4000),@p883 nvarchar(4000),@p884 nvarchar(4000),@p885 nvarchar(4000),@p886 int,@p887 nvarchar(4000),@p888 int,@p889 int,@p890 datetime2(7),@p891 datetime2(7),@p892 datetime2(7),@p893 nvarchar(4000),@p894 nvarchar(4000),@p895 nvarchar(4000),@p896 nvarchar(4000),@p897 nvarchar(4000),@p898 nvarchar(4000),@p899 nvarchar(4000),@p900 nvarchar(4000),@p901 nvarchar(4000),@p902 nvarchar(4000),@p903 nvarchar(4000),@p904 nvarchar(4000),@p905 nvarchar(4000),@p906 nvarchar(4000),@p907 datetime2(7),@p908 nvarchar(4000),@p909 nvarchar(4000),@p910 int,@p911 int,@p912 int,@p913 nvarchar(4000),@p914 nvarchar(4000),@p915 nvarchar(4000),@p916 nvarchar(4000),@p917 decimal(18,2),@p918 nvarchar(4000),@p919 nvarchar(4000),@p920 decimal(18,2),@p921 nvarchar(4000),@p922 nvarchar(4000),@p923 nvarchar(4000),@p924 nvarchar(4000),@p925 int,@p926 nvarchar(4000),@p927 nvarchar(4000),@p928 nvarchar(4000),@p929 nvarchar(4000),@p930 nvarchar(4000),@p931 nvarchar(4000),@p932 nvarchar(4000),@p933 nvarchar(4000),@p934 nvarchar(4000),@p935 nvarchar(4000),@p936 int,@p937 nvarchar(4000),@p938 nvarchar(4000),@p939 nvarchar(4000),@p940 nvarchar(4000),@p941 nvarchar(4000),@p942 int,@p943 nvarchar(4000),@p944 int,@p945 int,@p946 datetime2(7),@p947 datetime2(7),@p948 datetime2(7),@p949 nvarchar(4000),@p950 nvarchar(4000),@p951 nvarchar(4000),@p952 nvarchar(4000),@p953 nvarchar(4000),@p954 nvarchar(4000),@p955 nvarchar(4000),@p956 nvarchar(4000),@p957 nvarchar(4000),@p958 nvarchar(4000),@p959 nvarchar(4000),@p960 nvarchar(4000),@p961 nvarchar(4000),@p962 nvarchar(4000),@p963 datetime2(7),@p964 nvarchar(4000),@p965 nvarchar(4000),@p966 int,@p967 int,@p968 int,@p969 nvarchar(4000),@p970 nvarchar(4000),@p971 nvarchar(4000),@p972 nvarchar(4000),@p973 decimal(18,2),@p974 nvarchar(4000),@p975 nvarchar(4000),@p976 decimal(18,2),@p977 nvarchar(4000),@p978 nvarchar(4000),@p979 nvarchar(4000),@p980 nvarchar(4000),@p981 int,@p982 nvarchar(4000),@p983 nvarchar(4000),@p984 nvarchar(4000),@p985 nvarchar(4000),@p986 nvarchar(4000),@p987 nvarchar(4000),@p988 nvarchar(4000),@p989 nvarchar(4000),@p990 nvarchar(4000),@p991 nvarchar(4000),@p992 int,@p993 nvarchar(4000),@p994 nvarchar(4000),@p995 nvarchar(4000),@p996 nvarchar(4000),@p997 nvarchar(4000),@p998 int,@p999 nvarchar(4000),@p1000 int,@p1001 int,@p1002 datetime2(7),@p1003 datetime2(7),@p1004 datetime2(7),@p1005 nvarchar(4000),@p1006 nvarchar(4000),@p1007 nvarchar(4000),@p1008 nvarchar(4000),@p1009 nvarchar(4000),@p1010 nvarchar(4000),@p1011 nvarchar(4000),@p1012 nvarchar(4000),@p1013 nvarchar(4000),@p1014 nvarchar(4000),@p1015 nvarchar(4000),@p1016 nvarchar(4000),@p1017 nvarchar(4000),@p1018 nvarchar(4000),@p1019 datetime2(7),@p1020 nvarchar(4000),@p1021 nvarchar(4000),@p1022 int,@p1023 int,@p1024 int,@p1025 nvarchar(4000),@p1026 nvarchar(4000),@p1027 nvarchar(4000),@p1028 nvarchar(4000),@p1029 decimal(18,2),@p1030 nvarchar(4000),@p1031 nvarchar(4000),@p1032 decimal(18,2),@p1033 nvarchar(4000),@p1034 nvarchar(4000),@p1035 nvarchar(4000),@p1036 nvarchar(4000),@p1037 int,@p1038 nvarchar(4000),@p1039 nvarchar(4000),@p1040 nvarchar(4000),@p1041 nvarchar(4000),@p1042 nvarchar(4000),@p1043 nvarchar(4000),@p1044 nvarchar(4000),@p1045 nvarchar(4000),@p1046 nvarchar(4000),@p1047 nvarchar(4000),@p1048 int,@p1049 nvarchar(4000),@p1050 nvarchar(4000),@p1051 nvarchar(4000),@p1052 nvarchar(4000),@p1053 nvarchar(4000),@p1054 int,@p1055 nvarchar(4000),@p1056 int,@p1057 int,@p1058 datetime2(7),@p1059 datetime2(7),@p1060 datetime2(7),@p1061 nvarchar(4000),@p1062 nvarchar(4000),@p1063 nvarchar(4000),@p1064 nvarchar(4000),@p1065 nvarchar(4000),@p1066 nvarchar(4000),@p1067 nvarchar(4000),@p1068 nvarchar(4000),@p1069 nvarchar(4000),@p1070 nvarchar(4000),@p1071 nvarchar(4000),@p1072 nvarchar(4000),@p1073 nvarchar(4000),@p1074 nvarchar(4000),@p1075 datetime2(7),@p1076 nvarchar(4000),@p1077 nvarchar(4000),@p1078 int,@p1079 int,@p1080 int,@p1081 nvarchar(4000),@p1082 nvarchar(4000),@p1083 nvarchar(4000),@p1084 nvarchar(4000),@p1085 decimal(18,2),@p1086 nvarchar(4000),@p1087 nvarchar(4000),@p1088 decimal(18,2),@p1089 nvarchar(4000),@p1090 nvarchar(4000),@p1091 nvarchar(4000),@p1092 nvarchar(4000),@p1093 int,@p1094 nvarchar(4000),@p1095 nvarchar(4000),@p1096 nvarchar(4000),@p1097 nvarchar(4000),@p1098 nvarchar(4000),@p1099 nvarchar(4000),@p1100 nvarchar(4000),@p1101 nvarchar(4000),@p1102 nvarchar(4000),@p1103 nvarchar(4000),@p1104 int,@p1105 nvarchar(4000),@p1106 nvarchar(4000),@p1107 nvarchar(4000),@p1108 nvarchar(4000),@p1109 nvarchar(4000),@p1110 int,@p1111 nvarchar(4000),@p1112 int,@p1113 int,@p1114 datetime2(7),@p1115 datetime2(7),@p1116 datetime2(7),@p1117 nvarchar(4000),@p1118 nvarchar(4000),@p1119 nvarchar(4000),@p1120 nvarchar(4000),@p1121 nvarchar(4000),@p1122 nvarchar(4000),@p1123 nvarchar(4000),@p1124 nvarchar(4000),@p1125 nvarchar(4000),@p1126 nvarchar(4000),@p1127 nvarchar(4000),@p1128 nvarchar(4000),@p1129 nvarchar(4000),@p1130 nvarchar(4000),@p1131 datetime2(7),@p1132 nvarchar(4000),@p1133 nvarchar(4000),@p1134 int,@p1135 int,@p1136 int,@p1137 nvarchar(4000),@p1138 nvarchar(4000),@p1139 nvarchar(4000),@p1140 nvarchar(4000),@p1141 decimal(18,2),@p1142 nvarchar(4000),@p1143 nvarchar(4000),@p1144 decimal(18,2),@p1145 nvarchar(4000),@p1146 nvarchar(4000),@p1147 nvarchar(4000),@p1148 nvarchar(4000),@p1149 int,@p1150 nvarchar(4000),@p1151 nvarchar(4000),@p1152 nvarchar(4000),@p1153 nvarchar(4000),@p1154 nvarchar(4000),@p1155 nvarchar(4000),@p1156 nvarchar(4000),@p1157 nvarchar(4000),@p1158 nvarchar(4000),@p1159 nvarchar(4000),@p1160 int,@p1161 nvarchar(4000),@p1162 nvarchar(4000),@p1163 nvarchar(4000),@p1164 nvarchar(4000),@p1165 nvarchar(4000),@p1166 int,@p1167 nvarchar(4000),@p1168 int,@p1169 int,@p1170 datetime2(7),@p1171 datetime2(7),@p1172 datetime2(7),@p1173 nvarchar(4000),@p1174 nvarchar(4000),@p1175 nvarchar(4000),@p1176 nvarchar(4000),@p1177 nvarchar(4000),@p1178 nvarchar(4000),@p1179 nvarchar(4000),@p1180 nvarchar(4000),@p1181 nvarchar(4000),@p1182 nvarchar(4000),@p1183 nvarchar(4000),@p1184 nvarchar(4000),@p1185 nvarchar(4000),@p1186 nvarchar(4000),@p1187 datetime2(7),@p1188 nvarchar(4000),@p1189 nvarchar(4000),@p1190 int,@p1191 int,@p1192 int,@p1193 nvarchar(4000),@p1194 nvarchar(4000),@p1195 nvarchar(4000),@p1196 nvarchar(4000),@p1197 decimal(18,2),@p1198 nvarchar(4000),@p1199 nvarchar(4000),@p1200 decimal(18,2),@p1201 nvarchar(4000),@p1202 nvarchar(4000),@p1203 nvarchar(4000),@p1204 nvarchar(4000),@p1205 int,@p1206 nvarchar(4000),@p1207 nvarchar(4000),@p1208 nvarchar(4000),@p1209 nvarchar(4000),@p1210 nvarchar(4000),@p1211 nvarchar(4000),@p1212 nvarchar(4000),@p1213 nvarchar(4000),@p1214 nvarchar(4000),@p1215 nvarchar(4000),@p1216 int,@p1217 nvarchar(4000),@p1218 nvarchar(4000),@p1219 nvarchar(4000),@p1220 nvarchar(4000),@p1221 nvarchar(4000),@p1222 int,@p1223 nvarchar(4000),@p1224 int,@p1225 int,@p1226 datetime2(7),@p1227 datetime2(7),@p1228 datetime2(7),@p1229 nvarchar(4000),@p1230 nvarchar(4000),@p1231 nvarchar(4000),@p1232 nvarchar(4000),@p1233 nvarchar(4000),@p1234 nvarchar(4000),@p1235 nvarchar(4000),@p1236 nvarchar(4000),@p1237 nvarchar(4000),@p1238 nvarchar(4000),@p1239 nvarchar(4000),@p1240 nvarchar(4000),@p1241 nvarchar(4000),@p1242 nvarchar(4000),@p1243 datetime2(7),@p1244 nvarchar(4000),@p1245 nvarchar(4000),@p1246 int,@p1247 int,@p1248 int,@p1249 nvarchar(4000),@p1250 nvarchar(4000),@p1251 nvarchar(4000),@p1252 nvarchar(4000),@p1253 decimal(18,2),@p1254 nvarchar(4000),@p1255 nvarchar(4000),@p1256 decimal(18,2),@p1257 nvarchar(4000),@p1258 nvarchar(4000),@p1259 nvarchar(4000),@p1260 nvarchar(4000),@p1261 int,@p1262 nvarchar(4000),@p1263 nvarchar(4000),@p1264 nvarchar(4000),@p1265 nvarchar(4000),@p1266 nvarchar(4000),@p1267 nvarchar(4000),@p1268 nvarchar(4000),@p1269 nvarchar(4000),@p1270 nvarchar(4000),@p1271 nvarchar(4000),@p1272 int,@p1273 nvarchar(4000),@p1274 nvarchar(4000),@p1275 nvarchar(4000),@p1276 nvarchar(4000),@p1277 nvarchar(4000),@p1278 int,@p1279 nvarchar(4000),@p1280 int,@p1281 int,@p1282 datetime2(7),@p1283 datetime2(7),@p1284 datetime2(7),@p1285 nvarchar(4000),@p1286 nvarchar(4000),@p1287 nvarchar(4000),@p1288 nvarchar(4000),@p1289 nvarchar(4000),@p1290 nvarchar(4000),@p1291 nvarchar(4000),@p1292 nvarchar(4000),@p1293 nvarchar(4000),@p1294 nvarchar(4000),@p1295 nvarchar(4000),@p1296 nvarchar(4000),@p1297 nvarchar(4000),@p1298 nvarchar(4000),@p1299 datetime2(7),@p1300 nvarchar(4000),@p1301 nvarchar(4000),@p1302 int,@p1303 int,@p1304 int,@p1305 nvarchar(4000),@p1306 nvarchar(4000),@p1307 nvarchar(4000),@p1308 nvarchar(4000),@p1309 decimal(18,2),@p1310 nvarchar(4000),@p1311 nvarchar(4000),@p1312 decimal(18,2),@p1313 nvarchar(4000),@p1314 nvarchar(4000),@p1315 nvarchar(4000),@p1316 nvarchar(4000),@p1317 int,@p1318 nvarchar(4000),@p1319 nvarchar(4000),@p1320 nvarchar(4000),@p1321 nvarchar(4000),@p1322 nvarchar(4000),@p1323 nvarchar(4000),@p1324 nvarchar(4000),@p1325 nvarchar(4000),@p1326 nvarchar(4000),@p1327 nvarchar(4000),@p1328 int,@p1329 nvarchar(4000),@p1330 nvarchar(4000),@p1331 nvarchar(4000),@p1332 nvarchar(4000),@p1333 nvarchar(4000),@p1334 int,@p1335 nvarchar(4000),@p1336 int,@p1337 int,@p1338 datetime2(7),@p1339 datetime2(7),@p1340 datetime2(7),@p1341 nvarchar(4000),@p1342 nvarchar(4000),@p1343 nvarchar(4000),@p1344 nvarchar(4000),@p1345 nvarchar(4000),@p1346 nvarchar(4000),@p1347 nvarchar(4000),@p1348 nvarchar(4000),@p1349 nvarchar(4000),@p1350 nvarchar(4000),@p1351 nvarchar(4000),@p1352 nvarchar(4000),@p1353 nvarchar(4000),@p1354 nvarchar(4000),@p1355 datetime2(7),@p1356 nvarchar(4000),@p1357 nvarchar(4000),@p1358 int,@p1359 int,@p1360 int,@p1361 nvarchar(4000),@p1362 nvarchar(4000),@p1363 nvarchar(4000),@p1364 decimal(18,2),@p1365 decimal(18,2),@p1366 nvarchar(4000),@p1367 nvarchar(4000),@p1368 decimal(18,2),@p1369 nvarchar(4000),@p1370 nvarchar(4000),@p1371 nvarchar(4000),@p1372 nvarchar(4000),@p1373 int,@p1374 nvarchar(4000),@p1375 nvarchar(4000),@p1376 nvarchar(4000),@p1377 nvarchar(4000),@p1378 nvarchar(4000),@p1379 nvarchar(4000),@p1380 nvarchar(4000),@p1381 nvarchar(4000),@p1382 nvarchar(4000),@p1383 nvarchar(4000),@p1384 int,@p1385 nvarchar(4000),@p1386 nvarchar(4000),@p1387 nvarchar(4000),@p1388 nvarchar(4000),@p1389 nvarchar(4000),@p1390 int,@p1391 nvarchar(4000),@p1392 int,@p1393 int,@p1394 datetime2(7),@p1395 datetime2(7),@p1396 datetime2(7),@p1397 nvarchar(4000),@p1398 nvarchar(4000),@p1399 nvarchar(4000),@p1400 nvarchar(4000),@p1401 nvarchar(4000),@p1402 nvarchar(4000),@p1403 nvarchar(4000),@p1404 nvarchar(4000),@p1405 nvarchar(4000),@p1406 nvarchar(4000),@p1407 nvarchar(4000),@p1408 nvarchar(4000),@p1409 nvarchar(4000),@p1410 nvarchar(4000),@p1411 datetime2(7),@p1412 nvarchar(4000),@p1413 nvarchar(4000),@p1414 int,@p1415 int,@p1416 int,@p1417 nvarchar(4000),@p1418 nvarchar(4000),@p1419 nvarchar(4000),@p1420 decimal(18,2),@p1421 decimal(18,2),@p1422 nvarchar(4000),@p1423 nvarchar(4000),@p1424 decimal(18,2),@p1425 nvarchar(4000),@p1426 nvarchar(4000),@p1427 nvarchar(4000),@p1428 nvarchar(4000),@p1429 int,@p1430 nvarchar(4000),@p1431 nvarchar(4000),@p1432 nvarchar(4000),@p1433 nvarchar(4000),@p1434 nvarchar(4000),@p1435 nvarchar(4000),@p1436 nvarchar(4000),@p1437 nvarchar(4000),@p1438 nvarchar(4000),@p1439 nvarchar(4000),@p1440 int,@p1441 nvarchar(4000),@p1442 nvarchar(4000),@p1443 nvarchar(4000),@p1444 nvarchar(4000),@p1445 nvarchar(4000),@p1446 int,@p1447 nvarchar(4000),@p1448 int,@p1449 int,@p1450 datetime2(7),@p1451 datetime2(7),@p1452 datetime2(7),@p1453 nvarchar(4000),@p1454 nvarchar(4000),@p1455 nvarchar(4000),@p1456 nvarchar(4000),@p1457 nvarchar(4000),@p1458 nvarchar(4000),@p1459 nvarchar(4000),@p1460 nvarchar(4000),@p1461 nvarchar(4000),@p1462 nvarchar(4000),@p1463 nvarchar(4000),@p1464 nvarchar(4000),@p1465 nvarchar(4000),@p1466 nvarchar(4000),@p1467 datetime2(7),@p1468 nvarchar(4000),@p1469 nvarchar(4000),@p1470 int,@p1471 int,@p1472 int,@p1473 nvarchar(4000),@p1474 nvarchar(4000),@p1475 nvarchar(4000),@p1476 decimal(18,2),@p1477 decimal(18,2),@p1478 nvarchar(4000),@p1479 nvarchar(4000),@p1480 decimal(18,2),@p1481 nvarchar(4000),@p1482 nvarchar(4000),@p1483 nvarchar(4000),@p1484 nvarchar(4000),@p1485 int,@p1486 nvarchar(4000),@p1487 nvarchar(4000),@p1488 nvarchar(4000),@p1489 nvarchar(4000),@p1490 nvarchar(4000),@p1491 nvarchar(4000),@p1492 nvarchar(4000),@p1493 nvarchar(4000),@p1494 nvarchar(4000),@p1495 nvarchar(4000),@p1496 int,@p1497 nvarchar(4000),@p1498 nvarchar(4000),@p1499 nvarchar(4000),@p1500 nvarchar(4000),@p1501 nvarchar(4000),@p1502 int,@p1503 nvarchar(4000),@p1504 int,@p1505 int,@p1506 datetime2(7),@p1507 datetime2(7),@p1508 datetime2(7),@p1509 nvarchar(4000),@p1510 nvarchar(4000),@p1511 nvarchar(4000),@p1512 nvarchar(4000),@p1513 nvarchar(4000),@p1514 nvarchar(4000),@p1515 nvarchar(4000),@p1516 nvarchar(4000),@p1517 nvarchar(4000),@p1518 nvarchar(4000),@p1519 nvarchar(4000),@p1520 nvarchar(4000),@p1521 nvarchar(4000),@p1522 nvarchar(4000),@p1523 datetime2(7),@p1524 nvarchar(4000),@p1525 nvarchar(4000),@p1526 int,@p1527 int,@p1528 int,@p1529 nvarchar(4000),@p1530 nvarchar(4000),@p1531 nvarchar(4000),@p1532 decimal(18,2),@p1533 decimal(18,2),@p1534 nvarchar(4000),@p1535 nvarchar(4000),@p1536 decimal(18,2),@p1537 nvarchar(4000),@p1538 nvarchar(4000),@p1539 nvarchar(4000),@p1540 nvarchar(4000),@p1541 int,@p1542 nvarchar(4000),@p1543 nvarchar(4000),@p1544 nvarchar(4000),@p1545 nvarchar(4000),@p1546 nvarchar(4000),@p1547 nvarchar(4000),@p1548 nvarchar(4000),@p1549 nvarchar(4000),@p1550 nvarchar(4000),@p1551 nvarchar(4000),@p1552 int,@p1553 nvarchar(4000),@p1554 nvarchar(4000),@p1555 nvarchar(4000),@p1556 nvarchar(4000),@p1557 nvarchar(4000),@p1558 int,@p1559 nvarchar(4000),@p1560 int,@p1561 int,@p1562 datetime2(7),@p1563 datetime2(7),@p1564 datetime2(7),@p1565 nvarchar(4000),@p1566 nvarchar(4000),@p1567 nvarchar(4000),@p1568 nvarchar(4000),@p1569 nvarchar(4000),@p1570 nvarchar(4000),@p1571 nvarchar(4000),@p1572 nvarchar(4000),@p1573 nvarchar(4000),@p1574 nvarchar(4000),@p1575 nvarchar(4000),@p1576 nvarchar(4000),@p1577 nvarchar(4000),@p1578 nvarchar(4000),@p1579 datetime2(7),@p1580 nvarchar(4000),@p1581 nvarchar(4000),@p1582 int,@p1583 int,@p1584 int,@p1585 nvarchar(4000),@p1586 nvarchar(4000),@p1587 nvarchar(4000),@p1588 nvarchar(4000),@p1589 decimal(18,2),@p1590 nvarchar(4000),@p1591 nvarchar(4000),@p1592 decimal(18,2),@p1593 nvarchar(4000),@p1594 nvarchar(4000),@p1595 nvarchar(4000),@p1596 nvarchar(4000),@p1597 int,@p1598 nvarchar(4000),@p1599 nvarchar(4000),@p1600 nvarchar(4000),@p1601 nvarchar(4000),@p1602 nvarchar(4000),@p1603 nvarchar(4000),@p1604 nvarchar(4000),@p1605 nvarchar(4000),@p1606 nvarchar(4000),@p1607 nvarchar(4000),@p1608 int,@p1609 nvarchar(4000),@p1610 nvarchar(4000),@p1611 nvarchar(4000),@p1612 nvarchar(4000),@p1613 nvarchar(4000),@p1614 int,@p1615 nvarchar(4000),@p1616 int,@p1617 int,@p1618 datetime2(7),@p1619 datetime2(7),@p1620 datetime2(7),@p1621 nvarchar(4000),@p1622 nvarchar(4000),@p1623 nvarchar(4000),@p1624 nvarchar(4000),@p1625 nvarchar(4000),@p1626 nvarchar(4000),@p1627 nvarchar(4000),@p1628 nvarchar(4000),@p1629 nvarchar(4000),@p1630 nvarchar(4000),@p1631 nvarchar(4000),@p1632 nvarchar(4000),@p1633 nvarchar(4000),@p1634 nvarchar(4000),@p1635 datetime2(7),@p1636 nvarchar(4000),@p1637 nvarchar(4000),@p1638 int,@p1639 int,@p1640 int,@p1641 nvarchar(4000),@p1642 nvarchar(4000),@p1643 nvarchar(4000),@p1644 decimal(18,2),@p1645 decimal(18,2),@p1646 nvarchar(4000),@p1647 nvarchar(4000),@p1648 decimal(18,2),@p1649 nvarchar(4000),@p1650 nvarchar(4000),@p1651 nvarchar(4000),@p1652 nvarchar(4000),@p1653 int,@p1654 nvarchar(4000),@p1655 nvarchar(4000),@p1656 nvarchar(4000),@p1657 nvarchar(4000),@p1658 nvarchar(4000),@p1659 nvarchar(4000),@p1660 nvarchar(4000),@p1661 nvarchar(4000),@p1662 nvarchar(4000),@p1663 nvarchar(4000),@p1664 int,@p1665 nvarchar(4000),@p1666 nvarchar(4000),@p1667 nvarchar(4000),@p1668 nvarchar(4000),@p1669 nvarchar(4000),@p1670 int,@p1671 nvarchar(4000),@p1672 int,@p1673 int,@p1674 datetime2(7),@p1675 datetime2(7),@p1676 datetime2(7),@p1677 nvarchar(4000),@p1678 nvarchar(4000),@p1679 nvarchar(4000),@p1680 nvarchar(4000),@p1681 nvarchar(4000),@p1682 nvarchar(4000),@p1683 nvarchar(4000),@p1684 nvarchar(4000),@p1685 nvarchar(4000),@p1686 nvarchar(4000),@p1687 nvarchar(4000),@p1688 nvarchar(4000),@p1689 nvarchar(4000),@p1690 nvarchar(4000),@p1691 datetime2(7),@p1692 nvarchar(4000),@p1693 nvarchar(4000),@p1694 int,@p1695 int,@p1696 int,@p1697 nvarchar(4000),@p1698 nvarchar(4000),@p1699 nvarchar(4000),@p1700 decimal(18,2),@p1701 decimal(18,2),@p1702 nvarchar(4000),@p1703 nvarchar(4000),@p1704 decimal(18,2),@p1705 nvarchar(4000),@p1706 nvarchar(4000),@p1707 nvarchar(4000),@p1708 nvarchar(4000),@p1709 int,@p1710 nvarchar(4000),@p1711 nvarchar(4000),@p1712 nvarchar(4000),@p1713 nvarchar(4000),@p1714 nvarchar(4000),@p1715 nvarchar(4000),@p1716 nvarchar(4000),@p1717 nvarchar(4000),@p1718 nvarchar(4000),@p1719 nvarchar(4000),@p1720 int,@p1721 nvarchar(4000),@p1722 nvarchar(4000),@p1723 nvarchar(4000),@p1724 nvarchar(4000),@p1725 nvarchar(4000),@p1726 int,@p1727 nvarchar(4000),@p1728 int,@p1729 int,@p1730 datetime2(7),@p1731 datetime2(7),@p1732 datetime2(7),@p1733 nvarchar(4000),@p1734 nvarchar(4000),@p1735 nvarchar(4000),@p1736 nvarchar(4000),@p1737 nvarchar(4000),@p1738 nvarchar(4000),@p1739 nvarchar(4000),@p1740 nvarchar(4000),@p1741 nvarchar(4000),@p1742 nvarchar(4000),@p1743 nvarchar(4000),@p1744 nvarchar(4000),@p1745 nvarchar(4000),@p1746 nvarchar(4000),@p1747 datetime2(7),@p1748 nvarchar(4000),@p1749 nvarchar(4000),@p1750 int,@p1751 int,@p1752 int,@p1753 nvarchar(4000),@p1754 nvarchar(4000),@p1755 nvarchar(4000),@p1756 decimal(18,2),@p1757 decimal(18,2),@p1758 nvarchar(4000),@p1759 nvarchar(4000),@p1760 decimal(18,2),@p1761 nvarchar(4000),@p1762 nvarchar(4000),@p1763 nvarchar(4000),@p1764 nvarchar(4000),@p1765 int,@p1766 nvarchar(4000),@p1767 nvarchar(4000),@p1768 nvarchar(4000),@p1769 nvarchar(4000),@p1770 nvarchar(4000),@p1771 nvarchar(4000),@p1772 nvarchar(4000),@p1773 nvarchar(4000),@p1774 nvarchar(4000),@p1775 nvarchar(4000),@p1776 int,@p1777 nvarchar(4000),@p1778 nvarchar(4000),@p1779 nvarchar(4000),@p1780 nvarchar(4000),@p1781 nvarchar(4000),@p1782 int,@p1783 nvarchar(4000),@p1784 int,@p1785 int,@p1786 datetime2(7),@p1787 datetime2(7),@p1788 datetime2(7),@p1789 nvarchar(4000),@p1790 nvarchar(4000),@p1791 nvarchar(4000),@p1792 nvarchar(4000),@p1793 nvarchar(4000),@p1794 nvarchar(4000),@p1795 nvarchar(4000),@p1796 nvarchar(4000),@p1797 nvarchar(4000),@p1798 nvarchar(4000),@p1799 nvarchar(4000),@p1800 nvarchar(4000),@p1801 nvarchar(4000),@p1802 nvarchar(4000),@p1803 datetime2(7),@p1804 nvarchar(4000),@p1805 nvarchar(4000),@p1806 int,@p1807 int,@p1808 int,@p1809 nvarchar(4000),@p1810 nvarchar(4000),@p1811 nvarchar(4000),@p1812 decimal(18,2),@p1813 decimal(18,2),@p1814 nvarchar(4000),@p1815 nvarchar(4000),@p1816 decimal(18,2),@p1817 nvarchar(4000),@p1818 nvarchar(4000),@p1819 nvarchar(4000),@p1820 nvarchar(4000),@p1821 int,@p1822 nvarchar(4000),@p1823 nvarchar(4000),@p1824 nvarchar(4000),@p1825 nvarchar(4000),@p1826 nvarchar(4000),@p1827 nvarchar(4000),@p1828 nvarchar(4000),@p1829 nvarchar(4000),@p1830 nvarchar(4000),@p1831 nvarchar(4000),@p1832 int,@p1833 nvarchar(4000),@p1834 nvarchar(4000),@p1835 nvarchar(4000),@p1836 nvarchar(4000),@p1837 nvarchar(4000),@p1838 int,@p1839 nvarchar(4000),@p1840 int,@p1841 int,@p1842 datetime2(7),@p1843 datetime2(7),@p1844 datetime2(7),@p1845 nvarchar(4000),@p1846 nvarchar(4000),@p1847 nvarchar(4000),@p1848 nvarchar(4000),@p1849 nvarchar(4000),@p1850 nvarchar(4000),@p1851 nvarchar(4000),@p1852 nvarchar(4000),@p1853 nvarchar(4000),@p1854 nvarchar(4000),@p1855 nvarchar(4000),@p1856 nvarchar(4000),@p1857 nvarchar(4000),@p1858 nvarchar(4000),@p1859 datetime2(7),@p1860 nvarchar(4000),@p1861 nvarchar(4000),@p1862 int,@p1863 int,@p1864 int,@p1865 nvarchar(4000),@p1866 nvarchar(4000),@p1867 nvarchar(4000),@p1868 decimal(18,2),@p1869 decimal(18,2),@p1870 nvarchar(4000),@p1871 nvarchar(4000),@p1872 decimal(18,2),@p1873 nvarchar(4000),@p1874 nvarchar(4000),@p1875 nvarchar(4000),@p1876 nvarchar(4000),@p1877 int,@p1878 nvarchar(4000),@p1879 nvarchar(4000),@p1880 nvarchar(4000),@p1881 nvarchar(4000),@p1882 nvarchar(4000),@p1883 nvarchar(4000),@p1884 nvarchar(4000),@p1885 nvarchar(4000),@p1886 nvarchar(4000),@p1887 nvarchar(4000),@p1888 int,@p1889 nvarchar(4000),@p1890 nvarchar(4000),@p1891 nvarchar(4000),@p1892 nvarchar(4000),@p1893 nvarchar(4000),@p1894 int,@p1895 nvarchar(4000),@p1896 int,@p1897 int,@p1898 datetime2(7),@p1899 datetime2(7),@p1900 datetime2(7),@p1901 nvarchar(4000),@p1902 nvarchar(4000),@p1903 nvarchar(4000),@p1904 nvarchar(4000),@p1905 nvarchar(4000),@p1906 nvarchar(4000),@p1907 nvarchar(4000),@p1908 nvarchar(4000),@p1909 nvarchar(4000),@p1910 nvarchar(4000),@p1911 nvarchar(4000),@p1912 nvarchar(4000),@p1913 nvarchar(4000),@p1914 nvarchar(4000),@p1915 datetime2(7),@p1916 nvarchar(4000),@p1917 nvarchar(4000),@p1918 int,@p1919 int,@p1920 int,@p1921 nvarchar(4000),@p1922 nvarchar(4000),@p1923 nvarchar(4000),@p1924 decimal(18,2),@p1925 decimal(18,2),@p1926 nvarchar(4000),@p1927 nvarchar(4000),@p1928 decimal(18,2),@p1929 nvarchar(4000),@p1930 nvarchar(4000),@p1931 nvarchar(4000),@p1932 nvarchar(4000),@p1933 int,@p1934 nvarchar(4000),@p1935 nvarchar(4000),@p1936 nvarchar(4000),@p1937 nvarchar(4000),@p1938 nvarchar(4000),@p1939 nvarchar(4000),@p1940 nvarchar(4000),@p1941 nvarchar(4000),@p1942 nvarchar(4000),@p1943 nvarchar(4000),@p1944 int,@p1945 nvarchar(4000),@p1946 nvarchar(4000),@p1947 nvarchar(4000),@p1948 nvarchar(4000),@p1949 nvarchar(4000),@p1950 int,@p1951 nvarchar(4000),@p1952 int,@p1953 int,@p1954 datetime2(7),@p1955 datetime2(7),@p1956 datetime2(7),@p1957 nvarchar(4000),@p1958 nvarchar(4000),@p1959 nvarchar(4000),@p1960 nvarchar(4000),@p1961 nvarchar(4000),@p1962 nvarchar(4000),@p1963 nvarchar(4000),@p1964 nvarchar(4000),@p1965 nvarchar(4000),@p1966 nvarchar(4000),@p1967 nvarchar(4000),@p1968 nvarchar(4000),@p1969 nvarchar(4000),@p1970 nvarchar(4000),@p1971 datetime2(7),@p1972 nvarchar(4000),@p1973 nvarchar(4000),@p1974 int,@p1975 int,@p1976 int,@p1977 nvarchar(4000),@p1978 nvarchar(4000),@p1979 nvarchar(4000),@p1980 decimal(18,2),@p1981 decimal(18,2),@p1982 nvarchar(4000),@p1983 nvarchar(4000),@p1984 decimal(18,2),@p1985 nvarchar(4000),@p1986 nvarchar(4000),@p1987 nvarchar(4000),@p1988 nvarchar(4000),@p1989 int,@p1990 nvarchar(4000),@p1991 nvarchar(4000),@p1992 nvarchar(4000),@p1993 nvarchar(4000),@p1994 nvarchar(4000),@p1995 nvarchar(4000),@p1996 nvarchar(4000),@p1997 nvarchar(4000),@p1998 nvarchar(4000),@p1999 nvarchar(4000),@p2000 int,@p2001 nvarchar(4000),@p2002 nvarchar(4000),@p2003 nvarchar(4000),@p2004 nvarchar(4000),@p2005 nvarchar(4000),@p2006 int,@p2007 nvarchar(4000),@p2008 int,@p2009 int,@p2010 datetime2(7),@p2011 datetime2(7),@p2012 datetime2(7),@p2013 nvarchar(4000),@p2014 nvarchar(4000),@p2015 nvarchar(4000),@p2016 nvarchar(4000),@p2017 nvarchar(4000),@p2018 nvarchar(4000),@p2019 nvarchar(4000),@p2020 nvarchar(4000),@p2021 nvarchar(4000),@p2022 nvarchar(4000),@p2023 nvarchar(4000),@p2024 nvarchar(4000),@p2025 nvarchar(4000),@p2026 nvarchar(4000),@p2027 datetime2(7),@p2028 nvarchar(4000),@p2029 nvarchar(4000),@p2030 int,@p2031 int,@p2032 int,@p2033 nvarchar(4000),@p2034 nvarchar(4000),@p2035 nvarchar(4000),@p2036 nvarchar(4000),@p2037 decimal(18,2),@p2038 nvarchar(4000),@p2039 nvarchar(4000),@p2040 decimal(18,2),@p2041 nvarchar(4000),@p2042 nvarchar(4000),@p2043 nvarchar(4000),@p2044 nvarchar(4000),@p2045 int,@p2046 nvarchar(4000),@p2047 nvarchar(4000),@p2048 nvarchar(4000),@p2049 nvarchar(4000),@p2050 nvarchar(4000),@p2051 nvarchar(4000),@p2052 nvarchar(4000),@p2053 nvarchar(4000),@p2054 nvarchar(4000),@p2055 nvarchar(4000),@p2056 int,@p2057 nvarchar(4000),@p2058 nvarchar(4000),@p2059 nvarchar(4000),@p2060 nvarchar(4000),@p2061 nvarchar(4000),@p2062 int,@p2063 nvarchar(4000),@p2064 int,@p2065 int,@p2066 datetime2(7),@p2067 datetime2(7),@p2068 datetime2(7),@p2069 nvarchar(4000),@p2070 nvarchar(4000),@p2071 nvarchar(4000))SET NOCOUNT ON; DECLARE @inserted0 TABLE ([item_id] int, [_Position] [int]); MERGE [raw_data] USING ( VALUES (@p0, @p1, @p2, @p3, @p4, @p5, @p6, @p7, @p8, @p9, @p10, @p11, @p12, @p13, @p14, @p15, @p16, @p17, @p18, @p19, @p20, @p21, @p22, @p23, @p24, @p25, @p26, @p27, @p28, @p29, @p30, @p31, @p32, @p33, @p34, @p35, @p36, @p37, @p38, @p39, @p40, @p41, @p42, @p43, @p44, @p45, @p46, @p47, @p48, @p49, @p50, @p51, @p52, @p53, @p54, @p55, 0), (@p56, @p57, @p58, @p59, @p60, @p61, @p62, @p63, @p64, @p65, @p66, @p67, @p68, @p69, @p70, @p71, @p72, @p73, @p74, @p75, @p76, @p77, @p78, @p79, @p80, @p81, @p82, @p83, @p84, @p85, @p86, @p87, @p88, @p89, @p90, @p91, @p92, @p93, @p94, @p95, @p96, @p97, @p98, @p99, @p100, @p101, @p102, @p103, @p104, @p105, @p106, @p107, @p108, @p109, @p110, @p111, 1), (@p112, @p113, @p114, @p115, @p116, @p117, @p118, @p119, @p120, @p121, @p122, @p123, @p124, @p125, @p126, @p127, @p128, @p129, @p130, @p131, @p132, @p133, @p134, @p135, @p136, @p137, @p138, @p139, @p140, @p141, @p142, @p143, @p144, @p145, @p146, @p147, @p148, @p149, @p150, @p151, @p152, @p153, @p154, @p155, @p156, @p157, @p158, @p159, @p160, @p161, @p162, @p163, @p164, @p165, @p166, @p167, 2), (@p168, @p169, @p170, @p171, @p172, @p173, @p174, @p175, @p176, @p177, @p178, @p179, @p180, @p181, @p182, @p183, @p184, @p185, @p186, @p187, @p188, @p189, @p190, @p191, @p192, @p193, @p194, @p195, @p196, @p197, @p198, @p199, @p200, @p201, @p202, @p203, @p204, @p205, @p206, @p207, @p208, @p209, @p210, @p211, @p212, @p213, @p214, @p215, @p216, @p217, @p218, @p219, @p220, @p221, @p222, @p223, 3), (@p224, @p225, @p226, @p227, @p228, @p229, @p230, @p231, @p232, @p233, @p234, @p235, @p236, @p237, @p238, @p239, @p240, @p241, @p242, @p243, @p244, @p245, @p246, @p247, @p248, @p249, @p250, @p251, @p252, @p253, @p254, @p255, @p256, @p257, @p258, @p259, @p260, @p261, @p262, @p263, @p264, @p265, @p266, @p267, @p268, @p269, @p270, @p271, @p272, @p273, @p274, @p275, @p276, @p277, @p278, @p279, 4), (@p280, @p281, @p282, @p283, @p284, @p285, @p286, @p287, @p288, @p289, @p290, @p291, @p292, @p293, @p294, @p295, @p296, @p297, @p298, @p299, @p300, @p301, @p302, @p303, @p304, @p305, @p306, @p307, @p308, @p309, @p310, @p311, @p312, @p313, @p314, @p315, @p316, @p317, @p318, @p319, @p320, @p321, @p322, @p323, @p324, @p325, @p326, @p327, @p328, @p329, @p330, @p331, @p332, @p333, @p334, @p335, 5), (@p336, @p337, @p338, @p339, @p340, @p341, @p342, @p343, @p344, @p345, @p346, @p347, @p348, @p349, @p350, @p351, @p352, @p353, @p354, @p355, @p356, @p357, @p358, @p359, @p360, @p361, @p362, @p363, @p364, @p365, @p366, @p367, @p368, @p369, @p370, @p371, @p372, @p373, @p374, @p375, @p376, @p377, @p378, @p379, @p380, @p381, @p382, @p383, @p384, @p385, @p386, @p387, @p388, @p389, @p390, @p391, 6), (@p392, @p393, @p394, @p395, @p396, @p397, @p398, @p399, @p400, @p401, @p402, @p403, @p404, @p405, @p406, @p407, @p408, @p409, @p410, @p411, @p412, @p413, @p414, @p415, @p416, @p417, @p418, @p419, @p420, @p421, @p422, @p423, @p424, @p425, @p426, @p427, @p428, @p429, @p430, @p431, @p432, @p433, @p434, @p435, @p436, @p437, @p438, @p439, @p440, @p441, @p442, @p443, @p444, @p445, @p446, @p447, 7), (@p448, @p449, @p450, @p451, @p452, @p453, @p454, @p455, @p456, @p457, @p458, @p459, @p460, @p461, @p462, @p463, @p464, @p465, @p466, @p467, @p468, @p469, @p470, @p471, @p472, @p473, @p474, @p475, @p476, @p477, @p478, @p479, @p480, @p481, @p482, @p483, @p484, @p485, @p486, @p487, @p488, @p489, @p490, @p491, @p492, @p493, @p494, @p495, @p496, @p497, @p498, @p499, @p500, @p501, @p502, @p503, 8), (@p504, @p505, @p506, @p507, @p508, @p509, @p510, @p511, @p512, @p513, @p514, @p515, @p516, @p517, @p518, @p519, @p520, @p521, @p522, @p523, @p524, @p525, @p526, @p527, @p528, @p529, @p530, @p531, @p532, @p533, @p534, @p535, @p536, @p537, @p538, @p539, @p540, @p541, @p542, @p543, @p544, @p545, @p546, @p547, @p548, @p549, @p550, @p551, @p552, @p553, @p554, @p555, @p556, @p557, @p558, @p559, 9), (@p560, @p561, @p562, @p563, @p564, @p565, @p566, @p567, @p568, @p569, @p570, @p571, @p572, @p573, @p574, @p575, @p576, @p577, @p578, @p579, @p580, @p581, @p582, @p583, @p584, @p585, @p586, @p587, @p588, @p589, @p590, @p591, @p592, @p593, @p594, @p595, @p596, @p597, @p598, @p599, @p600, @p601, @p602, @p603, @p604, @p605, @p606, @p607, @p608, @p609, @p610, @p611, @p612, @p613, @p614, @p615, 10), (@p616, @p617, @p618, @p619, @p620, @p621, @p622, @p623, @p624, @p625, @p626, @p627, @p628, @p629, @p630, @p631, @p632, @p633, @p634, @p635, @p636, @p637, @p638, @p639, @p640, @p641, @p642, @p643, @p644, @p645, @p646, @p647, @p648, @p649, @p650, @p651, @p652, @p653, @p654, @p655, @p656, @p657, @p658, @p659, @p660, @p661, @p662, @p663, @p664, @p665, @p666, @p667, @p668, @p669, @p670, @p671, 11), (@p672, @p673, @p674, @p675, @p676, @p677, @p678, @p679, @p680, @p681, @p682, @p683, @p684, @p685, @p686, @p687, @p688, @p689, @p690, @p691, @p692, @p693, @p694, @p695, @p696, @p697, @p698, @p699, @p700, @p701, @p702, @p703, @p704, @p705, @p706, @p707, @p708, @p709, @p710, @p711, @p712, @p713, @p714, @p715, @p716, @p717, @p718, @p719, @p720, @p721, @p722, @p723, @p724, @p725, @p726, @p727, 12), (@p728, @p729, @p730, @p731, @p732, @p733, @p734, @p735, @p736, @p737, @p738, @p739, @p740, @p741, @p742, @p743, @p744, @p745, @p746, @p747, @p748, @p749, @p750, @p751, @p752, @p753, @p754, @p755, @p756, @p757, @p758, @p759, @p760, @p761, @p762, @p763, @p764, @p765, @p766, @p767, @p768, @p769, @p770, @p771, @p772, @p773, @p774, @p775, @p776, @p777, @p778, @p779, @p780, @p781, @p782, @p783, 13), (@p784, @p785, @p786, @p787, @p788, @p789, @p790, @p791, @p792, @p793, @p794, @p795, @p796, @p797, @p798, @p799, @p800, @p801, @p802, @p803, @p804, @p805, @p806, @p807, @p808, @p809, @p810, @p811, @p812, @p813, @p814, @p815, @p816, @p817, @p818, @p819, @p820, @p821, @p822, @p823, @p824, @p825, @p826, @p827, @p828, @p829, @p830, @p831, @p832, @p833, @p834, @p835, @p836, @p837, @p838, @p839, 14), (@p840, @p841, @p842, @p843, @p844, @p845, @p846, @p847, @p848, @p849, @p850, @p851, @p852, @p853, @p854, @p855, @p856, @p857, @p858, @p859, @p860, @p861, @p862, @p863, @p864, @p865, @p866, @p867, @p868, @p869, @p870, @p871, @p872, @p873, @p874, @p875, @p876, @p877, @p878, @p879, @p880, @p881, @p882, @p883, @p884, @p885, @p886, @p887, @p888, @p889, @p890, @p891, @p892, @p893, @p894, @p895, 15), (@p896, @p897, @p898, @p899, @p900, @p901, @p902, @p903, @p904, @p905, @p906, @p907, @p908, @p909, @p910, @p911, @p912, @p913, @p914, @p915, @p916, @p917, @p918, @p919, @p920, @p921, @p922, @p923, @p924, @p925, @p926, @p927, @p928, @p929, @p930, @p931, @p932, @p933, @p934, @p935, @p936, @p937, @p938, @p939, @p940, @p941, @p942, @p943, @p944, @p945, @p946, @p947, @p948, @p949, @p950, @p951, 16), (@p952, @p953, @p954, @p955, @p956, @p957, @p958, @p959, @p960, @p961, @p962, @p963, @p964, @p965, @p966, @p967, @p968, @p969, @p970, @p971, @p972, @p973, @p974, @p975, @p976, @p977, @p978, @p979, @p980, @p981, @p982, @p983, @p984, @p985, @p986, @p987, @p988, @p989, @p990, @p991, @p992, @p993, @p994, @p995, @p996, @p997, @p998, @p999, @p1000, @p1001, @p1002, @p1003, @p1004, @p1005, @p1006, @p1007, 17), (@p1008, @p1009, @p1010, @p1011, @p1012, @p1013, @p1014, @p1015, @p1016, @p1017, @p1018, @p1019, @p1020, @p1021, @p1022, @p1023, @p1024, @p1025, @p1026, @p1027, @p1028, @p1029, @p1030, @p1031, @p1032, @p1033, @p1034, @p1035, @p1036, @p1037, @p1038, @p1039, @p1040, @p1041, @p1042, @p1043, @p1044, @p1045, @p1046, @p1047, @p1048, @p1049, @p1050, @p1051, @p1052, @p1053, @p1054, @p1055, @p1056, @p1057, @p1058, @p1059, @p1060, @p1061, @p1062, @p1063, 18), (@p1064, @p1065, @p1066, @p1067, @p1068, @p1069, @p1070, @p1071, @p1072, @p1073, @p1074, @p1075, @p1076, @p1077, @p1078, @p1079, @p1080, @p1081, @p1082, @p1083, @p1084, @p1085, @p1086, @p1087, @p1088, @p1089, @p1090, @p1091, @p1092, @p1093, @p1094, @p1095, @p1096, @p1097, @p1098, @p1099, @p1100, @p1101, @p1102, @p1103, @p1104, @p1105, @p1106, @p1107, @p1108, @p1109, @p1110, @p1111, @p1112, @p1113, @p1114, @p1115, @p1116, @p1117, @p1118, @p1119, 19), (@p1120, @p1121, @p1122, @p1123, @p1124, @p1125, @p1126, @p1127, @p1128, @p1129, @p1130, @p1131, @p1132, @p1133, @p1134, @p1135, @p1136, @p1137, @p1138, @p1139, @p1140, @p1141, @p1142, @p1143, @p1144, @p1145, @p1146, @p1147, @p1148, @p1149, @p1150, @p1151, @p1152, @p1153, @p1154, @p1155, @p1156, @p1157, @p1158, @p1159, @p1160, @p1161, @p1162, @p1163, @p1164, @p1165, @p1166, @p1167, @p1168, @p1169, @p1170, @p1171, @p1172, @p1173, @p1174, @p1175, 20), (@p1176, @p1177, @p1178, @p1179, @p1180, @p1181, @p1182, @p1183, @p1184, @p1185, @p1186, @p1187, @p1188, @p1189, @p1190, @p1191, @p1192, @p1193, @p1194, @p1195, @p1196, @p1197, @p1198, @p1199, @p1200, @p1201, @p1202, @p1203, @p1204, @p1205, @p1206, @p1207, @p1208, @p1209, @p1210, @p1211, @p1212, @p1213, @p1214, @p1215, @p1216, @p1217, @p1218, @p1219, @p1220, @p1221, @p1222, @p1223, @p1224, @p1225, @p1226, @p1227, @p1228, @p1229, @p1230, @p1231, 21), (@p1232, @p1233, @p1234, @p1235, @p1236, @p1237, @p1238, @p1239, @p1240, @p1241, @p1242, @p1243, @p1244, @p1245, @p1246, @p1247, @p1248, @p1249, @p1250, @p1251, @p1252, @p1253, @p1254, @p1255, @p1256, @p1257, @p1258, @p1259, @p1260, @p1261, @p1262, @p1263, @p1264, @p1265, @p1266, @p1267, @p1268, @p1269, @p1270, @p1271, @p1272, @p1273, @p1274, @p1275, @p1276, @p1277, @p1278, @p1279, @p1280, @p1281, @p1282, @p1283, @p1284, @p1285, @p1286, @p1287, 22), (@p1288, @p1289, @p1290, @p1291, @p1292, @p1293, @p1294, @p1295, @p1296, @p1297, @p1298, @p1299, @p1300, @p1301, @p1302, @p1303, @p1304, @p1305, @p1306, @p1307, @p1308, @p1309, @p1310, @p1311, @p1312, @p1313, @p1314, @p1315, @p1316, @p1317, @p1318, @p1319, @p1320, @p1321, @p1322, @p1323, @p1324, @p1325, @p1326, @p1327, @p1328, @p1329, @p1330, @p1331, @p1332, @p1333, @p1334, @p1335, @p1336, @p1337, @p1338, @p1339, @p1340, @p1341, @p1342, @p1343, 23), (@p1344, @p1345, @p1346, @p1347, @p1348, @p1349, @p1350, @p1351, @p1352, @p1353, @p1354, @p1355, @p1356, @p1357, @p1358, @p1359, @p1360, @p1361, @p1362, @p1363, @p1364, @p1365, @p1366, @p1367, @p1368, @p1369, @p1370, @p1371, @p1372, @p1373, @p1374, @p1375, @p1376, @p1377, @p1378, @p1379, @p1380, @p1381, @p1382, @p1383, @p1384, @p1385, @p1386, @p1387, @p1388, @p1389, @p1390, @p1391, @p1392, @p1393, @p1394, @p1395, @p1396, @p1397, @p1398, @p1399, 24), (@p1400, @p1401, @p1402, @p1403, @p1404, @p1405, @p1406, @p1407, @p1408, @p1409, @p1410, @p1411, @p1412, @p1413, @p1414, @p1415, @p1416, @p1417, @p1418, @p1419, @p1420, @p1421, @p1422, @p1423, @p1424, @p1425, @p1426, @p1427, @p1428, @p1429, @p1430, @p1431, @p1432, @p1433, @p1434, @p1435, @p1436, @p1437, @p1438, @p1439, @p1440, @p1441, @p1442, @p1443, @p1444, @p1445, @p1446, @p1447, @p1448, @p1449, @p1450, @p1451, @p1452, @p1453, @p1454, @p1455, 25), (@p1456, @p1457, @p1458, @p1459, @p1460, @p1461, @p1462, @p1463, @p1464, @p1465, @p1466, @p1467, @p1468, @p1469, @p1470, @p1471, @p1472, @p1473, @p1474, @p1475, @p1476, @p1477, @p1478, @p1479, @p1480, @p1481, @p1482, @p1483, @p1484, @p1485, @p1486, @p1487, @p1488, @p1489, @p1490, @p1491, @p1492, @p1493, @p1494, @p1495, @p1496, @p1497, @p1498, @p1499, @p1500, @p1501, @p1502, @p1503, @p1504, @p1505, @p1506, @p1507, @p1508, @p1509, @p1510, @p1511, 26), (@p1512, @p1513, @p1514, @p1515, @p1516, @p1517, @p1518, @p1519, @p1520, @p1521, @p1522, @p1523, @p1524, @p1525, @p1526, @p1527, @p1528, @p1529, @p1530, @p1531, @p1532, @p1533, @p1534, @p1535, @p1536, @p1537, @p1538, @p1539, @p1540, @p1541, @p1542, @p1543, @p1544, @p1545, @p1546, @p1547, @p1548, @p1549, @p1550, @p1551, @p1552, @p1553, @p1554, @p1555, @p1556, @p1557, @p1558, @p1559, @p1560, @p1561, @p1562, @p1563, @p1564, @p1565, @p1566, @p1567, 27), (@p1568, @p1569, @p1570, @p1571, @p1572, @p1573, @p1574, @p1575, @p1576, @p1577, @p1578, @p1579, @p1580, @p1581, @p1582, @p1583, @p1584, @p1585, @p1586, @p1587, @p1588, @p1589, @p1590, @p1591, @p1592, @p1593, @p1594, @p1595, @p1596, @p1597, @p1598, @p1599, @p1600, @p1601, @p1602, @p1603, @p1604, @p1605, @p1606, @p1607, @p1608, @p1609, @p1610, @p1611, @p1612, @p1613, @p1614, @p1615, @p1616, @p1617, @p1618, @p1619, @p1620, @p1621, @p1622, @p1623, 28), (@p1624, @p1625, @p1626, @p1627, @p1628, @p1629, @p1630, @p1631, @p1632, @p1633, @p1634, @p1635, @p1636, @p1637, @p1638, @p1639, @p1640, @p1641, @p1642, @p1643, @p1644, @p1645, @p1646, @p1647, @p1648, @p1649, @p1650, @p1651, @p1652, @p1653, @p1654, @p1655, @p1656, @p1657, @p1658, @p1659, @p1660, @p1661, @p1662, @p1663, @p1664, @p1665, @p1666, @p1667, @p1668, @p1669, @p1670, @p1671, @p1672, @p1673, @p1674, @p1675, @p1676, @p1677, @p1678, @p1679, 29), (@p1680, @p1681, @p1682, @p1683, @p1684, @p1685, @p1686, @p1687, @p1688, @p1689, @p1690, @p1691, @p1692, @p1693, @p1694, @p1695, @p1696, @p1697, @p1698, @p1699, @p1700, @p1701, @p1702, @p1703, @p1704, @p1705, @p1706, @p1707, @p1708, @p1709, @p1710, @p1711, @p1712, @p1713, @p1714, @p1715, @p1716, @p1717, @p1718, @p1719, @p1720, @p1721, @p1722, @p1723, @p1724, @p1725, @p1726, @p1727, @p1728, @p1729, @p1730, @p1731, @p1732, @p1733, @p1734, @p1735, 30), (@p1736, @p1737, @p1738, @p1739, @p1740, @p1741, @p1742, @p1743, @p1744, @p1745, @p1746, @p1747, @p1748, @p1749, @p1750, @p1751, @p1752, @p1753, @p1754, @p1755, @p1756, @p1757, @p1758, @p1759, @p1760, @p1761, @p1762, @p1763, @p1764, @p1765, @p1766, @p1767, @p1768, @p1769, @p1770, @p1771, @p1772, @p1773, @p1774, @p1775, @p1776, @p1777, @p1778, @p1779, @p1780, @p1781, @p1782, @p1783, @p1784, @p1785, @p1786, @p1787, @p1788, @p1789, @p1790, @p1791, 31), (@p1792, @p1793, @p1794, @p1795, @p1796, @p1797, @p1798, @p1799, @p1800, @p1801, @p1802, @p1803, @p1804, @p1805, @p1806, @p1807, @p1808, @p1809, @p1810, @p1811, @p1812, @p1813, @p1814, @p1815, @p1816, @p1817, @p1818, @p1819, @p1820, @p1821, @p1822, @p1823, @p1824, @p1825, @p1826, @p1827, @p1828, @p1829, @p1830, @p1831, @p1832, @p1833, @p1834, @p1835, @p1836, @p1837, @p1838, @p1839, @p1840, @p1841, @p1842, @p1843, @p1844, @p1845, @p1846, @p1847, 32), (@p1848, @p1849, @p1850, @p1851, @p1852, @p1853, @p1854, @p1855, @p1856, @p1857, @p1858, @p1859, @p1860, @p1861, @p1862, @p1863, @p1864, @p1865, @p1866, @p1867, @p1868, @p1869, @p1870, @p1871, @p1872, @p1873, @p1874, @p1875, @p1876, @p1877, @p1878, @p1879, @p1880, @p1881, @p1882, @p1883, @p1884, @p1885, @p1886, @p1887, @p1888, @p1889, @p1890, @p1891, @p1892, @p1893, @p1894, @p1895, @p1896, @p1897, @p1898, @p1899, @p1900, @p1901, @p1902, @p1903, 33), (@p1904, @p1905, @p1906, @p1907, @p1908, @p1909, @p1910, @p1911, @p1912, @p1913, @p1914, @p1915, @p1916, @p1917, @p1918, @p1919, @p1920, @p1921, @p1922, @p1923, @p1924, @p1925, @p1926, @p1927, @p1928, @p1929, @p1930, @p1931, @p1932, @p1933, @p1934, @p1935, @p1936, @p1937, @p1938, @p1939, @p1940, @p1941, @p1942, @p1943, @p1944, @p1945, @p1946, @p1947, @p1948, @p1949, @p1950, @p1951, @p1952, @p1953, @p1954, @p1955, @p1956, @p1957, @p1958, @p1959, 34), (@p1960, @p1961, @p1962, @p1963, @p1964, @p1965, @p1966, @p1967, @p1968, @p1969, @p1970, @p1971, @p1972, @p1973, @p1974, @p1975, @p1976, @p1977, @p1978, @p1979, @p1980, @p1981, @p1982, @p1983, @p1984, @p1985, @p1986, @p1987, @p1988, @p1989, @p1990, @p1991, @p1992, @p1993, @p1994, @p1995, @p1996, @p1997, @p1998, @p1999, @p2000, @p2001, @p2002, @p2003, @p2004, @p2005, @p2006, @p2007, @p2008, @p2009, @p2010, @p2011, @p2012, @p2013, @p2014, @p2015, 35), (@p2016, @p2017, @p2018, @p2019, @p2020, @p2021, @p2022, @p2023, @p2024, @p2025, @p2026, @p2027, @p2028, @p2029, @p2030, @p2031, @p2032, @p2033, @p2034, @p2035, @p2036, @p2037, @p2038, @p2039, @p2040, @p2041, @p2042, @p2043, @p2044, @p2045, @p2046, @p2047, @p2048, @p2049, @p2050, @p2051, @p2052, @p2053, @p2054, @p2055, @p2056, @p2057, @p2058, @p2059, @p2060, @p2061, @p2062, @p2063, @p2064, @p2065, @p2066, @p2067, @p2068, @p2069, @p2070, @p2071, 36)) AS i ([addressee_cntry_cd], [addressee_city], [addressee_district], [addressee_email], [addressee_full_address], [addressee_home_address], [addressee_name], [addressee_postcode], [addressee_province], [addressee_subdistrict], [addressee_tel], [create_table], [delivery_code], [delivery_recipient_name], [delivery_relation_id], [delivery_status_id], [dest_outlet_id], [dest_outlet_port], [document_number], [item_barcode], [item_cod], [item_gross_weight], [item_height], [item_length], [item_price], [item_width], [lat], [log_id], [long], [outlet_id], [outlet_port], [podUrl], [remark], [scan_cntry_cd], [scan_cntry_postcode], [sender_cntry_cd], [sender_district], [sender_email], [sender_full_address], [sender_home_address], [member_id], [sender_name], [sender_postcode], [sender_province], [sender_subdistrict], [sender_tel], [server_id], [signatureUrl], [state], [status_code], [status_dtm], [timestamp], [transmit_dtm], [user_id], [wckt_id], [wkstn_no], _Position) ON 1=0 WHEN NOT MATCHED THEN INSERT ([addressee_cntry_cd], [addressee_city], [addressee_district], [addressee_email], [addressee_full_address], [addressee_home_address], [addressee_name], [addressee_postcode], [addressee_province], [addressee_subdistrict], [addressee_tel], [create_table], [delivery_code], [delivery_recipient_name], [delivery_relation_id], [delivery_status_id], [dest_outlet_id], [dest_outlet_port], [document_number], [item_barcode], [item_cod], [item_gross_weight], [item_height], [item_length], [item_price], [item_width], [lat], [log_id], [long], [outlet_id], [outlet_port], [podUrl], [remark], [scan_cntry_cd], [scan_cntry_postcode], [sender_cntry_cd], [sender_district], [sender_email], [sender_full_address], [sender_home_address], [member_id], [sender_name], [sender_postcode], [sender_province], [sender_subdistrict], [sender_tel], [server_id], [signatureUrl], [state], [status_code], [status_dtm], [timestamp], [transmit_dtm], [user_id], [wckt_id], [wkstn_no]) VALUES (i.[addressee_cntry_cd], i.[addressee_city], i.[addressee_district], i.[addressee_email], i.[addressee_full_address], i.[addressee_home_address], i.[addressee_name], i.[addressee_postcode], i.[addressee_province], i.[addressee_subdistrict], i.[addressee_tel], i.[create_table], i.[delivery_code], i.[delivery_recipient_name], i.[delivery_relation_id], i.[delivery_status_id], i.[dest_outlet_id], i.[dest_outlet_port], i.[document_number], i.[item_barcode], i.[item_cod], i.[item_gross_weight], i.[item_height], i.[item_length], i.[item_price], i.[item_width], i.[lat], i.[log_id], i.[long], i.[outlet_id], i.[outlet_port], i.[podUrl], i.[remark], i.[scan_cntry_cd], i.[scan_cntry_postcode], i.[sender_cntry_cd], i.[sender_district], i.[sender_email], i.[sender_full_address], i.[sender_home_address], i.[member_id], i.[sender_name], i.[sender_postcode], i.[sender_province], i.[sender_subdistrict], i.[sender_tel], i.[server_id], i.[signatureUrl], i.[state], i.[status_code], i.[status_dtm], i.[timestamp], i.[transmit_dtm], i.[user_id], i.[wckt_id], i.[wkstn_no]) OUTPUT INSERTED.[item_id], i._Position INTO @inserted0;  SELECT [t].[item_id] FROM [raw_data] t INNER JOIN @inserted0 i ON ([t].[item_id] = [i].[item_id]) ORDER BY [i].[_Position];  ",4,4,0,438,2,4
"SELECT     DB_NAME (database_id) as [Database Name],     name as [Database File Name],     [Type] = CASE WHEN Type_Desc = 'ROWS' THEN 'Data File(s)'             WHEN Type_Desc = 'LOG'  THEN 'Log File(s)'             ELSE Type_Desc END,     size*8/1024 as 'Size (MB)',     physical_name as [Database_File_Location] FROM sys.master_files ORDER BY 1,3  IF OBJECT_ID('tempdb.dbo.#space') IS NOT NULL     DROP TABLE #space  CREATE TABLE #space (       database_id INT PRIMARY KEY     , data_used_size DECIMAL(18,2)     , log_used_size DECIMAL(18,2) )  DECLARE @SQL NVARCHAR(MAX)  SELECT @SQL = STUFF((     SELECT '     USE [' + d.name + ']     INSERT INTO #space (database_id, data_used_size, log_used_size)     SELECT           DB_ID()         , SUM(CASE WHEN [type] = 0 THEN space_used END)         , SUM(CASE WHEN [type] = 1 THEN space_used END)     FROM (         SELECT s.[type], space_used = SUM(FILEPROPERTY(s.name, ''SpaceUsed'') * 8. / 1024)         FROM sys.database_files s         GROUP BY s.[type]     ) t;'     FROM sys.databases d     WHERE d.[state] = 0     FOR XML PATH(''), TYPE).value('.', 'NVARCHAR(MAX)'), 1, 2, '')  EXEC sys.sp_executesql @SQL  SELECT       d.database_id     , d.name     , d.state_desc     , d.recovery_model_desc     , t.total_size     , t.data_size     , s.data_used_size     , t.log_size     , s.log_used_size     , bu.full_last_date     , bu.full_size     , bu.log_last_date     , bu.log_size FROM (     SELECT           database_id         , log_size = CAST(SUM(CASE WHEN [type] = 1 THEN size END) * 8. / 1024 AS DECIMAL(18,2))         , data_size = CAST(SUM(CASE WHEN [type] = 0 THEN size END) * 8. / 1024 AS DECIMAL(18,2))         , total_size = CAST(SUM(size) * 8. / 1024 AS DECIMAL(18,2))     FROM sys.master_files     GROUP BY database_id ) t JOIN sys.databases d ON d.database_id = t.database_id LEFT JOIN #space s ON d.database_id = s.database_id LEFT JOIN (     SELECT           database_name         , full_last_date = MAX(CASE WHEN [type] = 'D' THEN backup_finish_date END)         , full_size = MAX(CASE WHEN [type] = 'D' THEN backup_size END)         , log_last_date = MAX(CASE WHEN [type] = 'L' THEN backup_finish_date END)         , log_size = MAX(CASE WHEN [type] = 'L' THEN backup_size END)     FROM (         SELECT               s.database_name             , s.[type]             , s.backup_finish_date             , backup_size =                         CAST(CASE WHEN s.backup_size = s.compressed_backup_size                                     THEN s.backup_size                                     ELSE s.compressed_backup_size                         END / 1048576.0 AS DECIMAL(18,2))             , RowNum = ROW_NUMBER() OVER (PARTITION BY s.database_name, s.[type] ORDER BY s.backup_finish_date DESC)         FROM msdb.dbo.backupset s         WHERE s.[type] IN ('D', 'L')     ) f     WHERE f.RowNum = 1     GROUP BY f.database_name ) bu ON d.name = bu.database_name ORDER BY t.total_size DESC  SELECT      req.session_id     , req.total_elapsed_time AS duration_ms     , req.cpu_time AS cpu_time_ms     , req.total_elapsed_time - req.cpu_time AS wait_time     , req.logical_reads     , SUBSTRING (REPLACE (REPLACE (SUBSTRING (ST.text, (req.statement_start_offset/2) + 1,         ((CASE statement_end_offset            WHEN -1            THEN DATALENGTH(ST.text)              ELSE req.statement_end_offset          END - req.statement_start_offset)/2) + 1) , CHAR(10), ' '), CHAR(13), ' '),        1, 512)  AS statement_text   FROM sys.dm_exec_requests AS req     CROSS APPLY sys.dm_exec_sql_text(req.sql_handle) AS ST ORDER BY total_elapsed_time DESC;  SELECT top 100 t.text,      (qs.total_elapsed_time/1000) / qs.execution_count AS avg_elapsed_time,      (qs.total_worker_time/1000) / qs.execution_count AS avg_cpu_time,      ((qs.total_elapsed_time/1000) / qs.execution_count ) - ((qs.total_worker_time/1000) / qs.execution_count) AS avg_wait_time,      qs.total_logical_reads / qs.execution_count AS avg_logical_reads,      qs.total_logical_writes / qs.execution_count AS avg_writes,      (qs.total_elapsed_time/1000) AS cumulative_elapsed_time_all_executions FROM sys.dm_exec_query_stats qs      CROSS apply sys.Dm_exec_sql_text (sql_handle) t -- WHERE t.text like '<Your Query>%' -- Replace <Your Query> with your query or the beginning part of your query. The special chars like '[','_','%','^' in the query should be escaped. ORDER BY (qs.total_elapsed_time / qs.execution_count) DESC  --Deadlock sql check SELECT     session_id,     start_time,      [status],     command,     blocking_session_id,     wait_type,     wait_time,     open_transaction_count,     transaction_id,     total_elapsed_time,     Definition = CAST(text AS VARCHAR(MAX)) FROM     SYS.DM_EXEC_REQUESTS     CROSS APPLY sys.dm_exec_sql_text(sql_handle)  WHERE blocking_session_id != 0   ",4,4,0,0,0,16
