"DECLARE @preferredReplica int  SET @preferredReplica = (SELECT [master].sys.fn_hadr_backup_is_preferred_replica('western'))  IF (@preferredReplica = 1) BEGIN     BACKUP LOG [western] TO  DISK = N'G:\Backup_SQL\WU\Transaction\western\western_backup_2024_04_02_110003_1099425.trn' WITH  RETAINDAYS = 7, NOFORMAT, NOINIT,  NAME = N'western_backup_2024_04_02_110003_1099425', SKIP, REWIND, NOUNLOAD, COMPRESSION,  STATS = 10 END ",1082,444,638,236,0,1082
"       SELECT       db_id() AS database_id,       c.system_type_id,       c.user_type_id,       c.is_sparse,       c.is_column_set,       c.is_filestream,       c.encryption_type,       CASE WHEN o.object_id IS NOT NULL THEN 1 ELSE 0 END AS is_user,       COUNT_BIG(*) AS [ColCount],       CASE WHEN c.collation_name IS NULL THEN CONVERT(VARCHAR(128), SERVERPROPERTY('Collation')) ELSE c.collation_name END AS collation_name,       AVG(c.max_length) AS avg_max_length       FROM sys.columns c WITH (NOLOCK)       LEFT OUTER JOIN sys.objects o WITH (NOLOCK)       ON o.object_id = c.object_id       AND o.type = 'U'       GROUP BY       c.system_type_id,       c.user_type_id,       c.is_sparse,       c.is_column_set,       c.encryption_type,       c.is_filestream,       CASE WHEN o.object_id IS NOT NULL THEN 1 ELSE 0 END,       CASE WHEN c.collation_name IS NULL THEN CONVERT(VARCHAR(128), SERVERPROPERTY('Collation')) ELSE c.collation_name END     ",791,468,323,262,0,78380
"()                 begin try                 declare @enable int;                 select top 1 @enable = convert(int,value_in_use) from sys.configurations where name = 'default trace enabled'                 if @enable = 1 --default trace is enabled                 begin                 declare @curr_tracefilename varchar(500);                 declare @base_tracefilename varchar(500);                 declare @indx int ;                 declare @temp_trace table (                 StartTime datetime                 ,       EventSubClass int                 ,       IntegerData int                 );                 declare @path_separator CHAR(1) ;                 set @path_separator = ISNULL(CONVERT(CHAR(1), serverproperty('PathSeparator')), '\') ;                  select @curr_tracefilename = path from sys.traces where is_default = 1 ;                 set @curr_tracefilename = reverse(@curr_tracefilename)                 select @indx  = PATINDEX('%'+@path_separator+'%', @curr_tracefilename)                 set @curr_tracefilename = reverse(@curr_tracefilename)                 set @base_tracefilename = LEFT( @curr_tracefilename, len(@curr_tracefilename) - @indx) + @path_separator + 'log.trc';                  insert into @temp_trace                 select StartTime                 ,       EventSubClass                 ,       IntegerData                 from ::fn_trace_gettable( @base_tracefilename, default )                 where EventClass = 81;                  update @temp_trace set IntegerData = -IntegerData where EventSubClass = 2;                  select   1 as row_no                 ,       StartTime                 ,       EventSubClass                 ,       IntegerData                 ,       case when IntegerData < 0                 then -IntegerData                 else IntegerData                 end ""Absolute""                 from @temp_trace                 where (datediff(dd,StartTime,getdate()) < 7) order by StartTime ;                 end                 else                 begin                 select top 0 1 as row_no, 1 as StartTime , 1 as EventSubClass, 1 as IntegerData, 1 as Absolute                 end                 end try                 begin catch                 select  -100 as row_no                 ,       ERROR_NUMBER()  as StartTime                 ,       ERROR_SEVERITY() as EventSubClass                 ,       ERROR_STATE()  as   IntegerData                 ,       ERROR_MESSAGE() as Absolute                 end catch               ",473,472,1,0,0,1421
"DECLARE @preferredReplica int  SET @preferredReplica = (SELECT [master].sys.fn_hadr_backup_is_preferred_replica('western'))  IF (@preferredReplica = 1) BEGIN     BACKUP LOG [western] TO  DISK = N'G:\Backup_SQL\WU\Transaction\western\western_backup_2024_04_09_230001_6997904.trn' WITH  RETAINDAYS = 7, NOFORMAT, NOINIT,  NAME = N'western_backup_2024_04_09_230001_6997904', SKIP, REWIND, NOUNLOAD, COMPRESSION,  STATS = 10 END ",281,179,102,236,0,281
"SELECT     DB_NAME (database_id) as [Database Name],     name as [Database File Name],     [Type] = CASE WHEN Type_Desc = 'ROWS' THEN 'Data File(s)'             WHEN Type_Desc = 'LOG'  THEN 'Log File(s)'             ELSE Type_Desc END,     size*8/1024 as 'Size (MB)',     physical_name as [Database_File_Location] FROM sys.master_files ORDER BY 1,3  IF OBJECT_ID('tempdb.dbo.#space') IS NOT NULL     DROP TABLE #space  CREATE TABLE #space (       database_id INT PRIMARY KEY     , data_used_size DECIMAL(18,2)     , log_used_size DECIMAL(18,2) )  DECLARE @SQL NVARCHAR(MAX)  SELECT @SQL = STUFF((     SELECT '     USE [' + d.name + ']     INSERT INTO #space (database_id, data_used_size, log_used_size)     SELECT           DB_ID()         , SUM(CASE WHEN [type] = 0 THEN space_used END)         , SUM(CASE WHEN [type] = 1 THEN space_used END)     FROM (         SELECT s.[type], space_used = SUM(FILEPROPERTY(s.name, ''SpaceUsed'') * 8. / 1024)         FROM sys.database_files s         GROUP BY s.[type]     ) t;'     FROM sys.databases d     WHERE d.[state] = 0     FOR XML PATH(''), TYPE).value('.', 'NVARCHAR(MAX)'), 1, 2, '')  EXEC sys.sp_executesql @SQL  SELECT       d.database_id     , d.name     , d.state_desc     , d.recovery_model_desc     , t.total_size     , t.data_size     , s.data_used_size     , t.log_size     , s.log_used_size     , bu.full_last_date     , bu.full_size     , bu.log_last_date     , bu.log_size FROM (     SELECT           database_id         , log_size = CAST(SUM(CASE WHEN [type] = 1 THEN size END) * 8. / 1024 AS DECIMAL(18,2))         , data_size = CAST(SUM(CASE WHEN [type] = 0 THEN size END) * 8. / 1024 AS DECIMAL(18,2))         , total_size = CAST(SUM(size) * 8. / 1024 AS DECIMAL(18,2))     FROM sys.master_files     GROUP BY database_id ) t JOIN sys.databases d ON d.database_id = t.database_id LEFT JOIN #space s ON d.database_id = s.database_id LEFT JOIN (     SELECT           database_name         , full_last_date = MAX(CASE WHEN [type] = 'D' THEN backup_finish_date END)         , full_size = MAX(CASE WHEN [type] = 'D' THEN backup_size END)         , log_last_date = MAX(CASE WHEN [type] = 'L' THEN backup_finish_date END)         , log_size = MAX(CASE WHEN [type] = 'L' THEN backup_size END)     FROM (         SELECT               s.database_name             , s.[type]             , s.backup_finish_date             , backup_size =                         CAST(CASE WHEN s.backup_size = s.compressed_backup_size                                     THEN s.backup_size                                     ELSE s.compressed_backup_size                         END / 1048576.0 AS DECIMAL(18,2))             , RowNum = ROW_NUMBER() OVER (PARTITION BY s.database_name, s.[type] ORDER BY s.backup_finish_date DESC)         FROM msdb.dbo.backupset s         WHERE s.[type] IN ('D', 'L')     ) f     WHERE f.RowNum = 1     GROUP BY f.database_name ) bu ON d.name = bu.database_name ORDER BY t.total_size DESC  SELECT      req.session_id     , req.total_elapsed_time AS duration_ms     , req.cpu_time AS cpu_time_ms     , req.total_elapsed_time - req.cpu_time AS wait_time     , req.logical_reads     , SUBSTRING (REPLACE (REPLACE (SUBSTRING (ST.text, (req.statement_start_offset/2) + 1,         ((CASE statement_end_offset            WHEN -1            THEN DATALENGTH(ST.text)              ELSE req.statement_end_offset          END - req.statement_start_offset)/2) + 1) , CHAR(10), ' '), CHAR(13), ' '),        1, 512)  AS statement_text   FROM sys.dm_exec_requests AS req     CROSS APPLY sys.dm_exec_sql_text(req.sql_handle) AS ST ORDER BY total_elapsed_time DESC;  SELECT top 100 t.text,      (qs.total_elapsed_time/1000) / qs.execution_count AS avg_elapsed_time,      (qs.total_worker_time/1000) / qs.execution_count AS avg_cpu_time,      ((qs.total_elapsed_time/1000) / qs.execution_count ) - ((qs.total_worker_time/1000) / qs.execution_count) AS avg_wait_time,      qs.total_logical_reads / qs.execution_count AS avg_logical_reads,      qs.total_logical_writes / qs.execution_count AS avg_writes,      (qs.total_elapsed_time/1000) AS cumulative_elapsed_time_all_executions FROM sys.dm_exec_query_stats qs      CROSS apply sys.Dm_exec_sql_text (sql_handle) t -- WHERE t.text like '<Your Query>%' -- Replace <Your Query> with your query or the beginning part of your query. The special chars like '[','_','%','^' in the query should be escaped. ORDER BY (qs.total_elapsed_time / qs.execution_count) DESC  --Deadlock sql check SELECT     session_id,     start_time,      [status],     command,     blocking_session_id,     wait_type,     wait_time,     open_transaction_count,     transaction_id,     total_elapsed_time,     Definition = CAST(text AS VARCHAR(MAX)) FROM     SYS.DM_EXEC_REQUESTS     CROSS APPLY sys.dm_exec_sql_text(sql_handle)  WHERE blocking_session_id != 0  SELECT sqlserver_start_time, (committed_kb/1024) AS Total_Server_Memory_MB, (committed_target_kb/1024)  AS Target_Server_Memory_MB FROM sys.dm_os_sys_info; ",212,56,156,17362,877,424
"DECLARE @preferredReplica int  SET @preferredReplica = (SELECT [master].sys.fn_hadr_backup_is_preferred_replica('western'))  IF (@preferredReplica = 1) BEGIN     BACKUP LOG [western] TO  DISK = N'G:\Backup_SQL\WU\Transaction\western\western_backup_2024_04_21_230001_1672678.trn' WITH  RETAINDAYS = 7, NOFORMAT, NOINIT,  NAME = N'western_backup_2024_04_21_230001_1672678', SKIP, REWIND, NOUNLOAD, COMPRESSION,  STATS = 10 END ",198,121,77,236,0,198
"DECLARE @preferredReplica int  SET @preferredReplica = (SELECT [master].sys.fn_hadr_backup_is_preferred_replica('western'))  IF (@preferredReplica = 1) BEGIN     BACKUP LOG [western] TO  DISK = N'G:\Backup_SQL\WU\Transaction\western\western_backup_2024_03_20_230001_2157887.trn' WITH  RETAINDAYS = 7, NOFORMAT, NOINIT,  NAME = N'western_backup_2024_03_20_230001_2157887', SKIP, REWIND, NOUNLOAD, COMPRESSION,  STATS = 10 END ",181,115,66,236,0,181
"declare @Path nvarchar(255) declare @Name nvarchar(255)   select @Path = N'G:\Backup_SQL\WU\Transaction'   select @Name = null;           create table #filetmpfin (Name nvarchar(255) NOT NULL, IsFile bit NULL, FullName nvarchar(300) not NULL)         declare @FullName nvarchar(300)         declare @UseLegacyXPs bit = 1          if exists (select 1 from sys.all_objects where name = 'dm_os_enumerate_filesystem' and type = 'IF' and is_ms_shipped = 1)            select @UseLegacyXPs = IIF((LOWER(@Name) = N'nul') AND (exists (select 1 from sys.dm_os_host_info where host_platform = 'Windows')), 1, 0)          if @UseLegacyXPs = 0         begin            if (@Name is null)           begin                insert #filetmpfin select file_or_directory_name, 1 - is_directory, full_filesystem_path from sys.dm_os_enumerate_filesystem(@Path, '*') where [level] = 0           end            if (NOT @Name is null)           begin              if(@Path is null)                select @FullName = @Name             else               select @FullName = @Path 	+ convert(nvarchar(1), serverproperty('PathSeparator')) + @Name              create table #filetmp3 ( Exist bit NOT NULL, IsDir bit NOT NULL, DirExist bit NULL )              insert #filetmp3 select file_exists, file_is_a_directory, parent_directory_exists from sys.dm_os_file_exists(@FullName)              insert #filetmpfin select @Name, 1-IsDir, @FullName from #filetmp3 where Exist = 1 or IsDir = 1              drop table #filetmp3            end         end         else         begin           if(@Name is null)           begin             if (right(@Path, 1) = '\')               select @Path= substring(@Path, 1, len(@Path) - charindex('\', reverse(@Path)))             create table #filetmp (Name nvarchar(255) NOT NULL, depth int NOT NULL, IsFile bit NULL )             insert #filetmp EXECUTE master.dbo.xp_dirtree @Path, 1, 1             insert #filetmpfin select Name, IsFile, @Path + '\' + Name from #filetmp f             drop table #filetmp           end            if(NOT @Name is null)           begin             if(@Path is null)               select @FullName = @Name             else               select @FullName = @Path +  '\' + @Name             if (right(@FullName, 1) = '\')               select @Path= substring(@Path, 1, len(@FullName) - charindex('\', reverse(@FullName)))             create table #filetmp2 ( Exist bit NOT NULL, IsDir bit NOT NULL, DirExist bit NULL )             insert #filetmp2 EXECUTE master.dbo.xp_fileexist @FullName             insert #filetmpfin select @Name, 1-IsDir, @FullName from #filetmp2 where Exist = 1 or IsDir = 1              drop table #filetmp2           end          end           SELECT Name AS [Name], IsFile AS [IsFile], FullName AS [FullName] FROM #filetmpfin ORDER BY [IsFile] ASC,[Name] ASC drop table #filetmpfin ",177,60,117,5285,70,177
"DECLARE @preferredReplica int  SET @preferredReplica = (SELECT [master].sys.fn_hadr_backup_is_preferred_replica('western'))  IF (@preferredReplica = 1) BEGIN     BACKUP LOG [western] TO  DISK = N'G:\Backup_SQL\WU\Transaction\western\western_backup_2024_04_17_230001_8296526.trn' WITH  RETAINDAYS = 7, NOFORMAT, NOINIT,  NAME = N'western_backup_2024_04_17_230001_8296526', SKIP, REWIND, NOUNLOAD, COMPRESSION,  STATS = 10 END ",171,124,47,272,0,171
"DECLARE @preferredReplica int  SET @preferredReplica = (SELECT [master].sys.fn_hadr_backup_is_preferred_replica('western'))  IF (@preferredReplica = 1) BEGIN     BACKUP LOG [western] TO  DISK = N'G:\Backup_SQL\WU\Transaction\western\western_backup_2024_04_20_230001_2991906.trn' WITH  RETAINDAYS = 7, NOFORMAT, NOINIT,  NAME = N'western_backup_2024_04_20_230001_2991906', SKIP, REWIND, NOUNLOAD, COMPRESSION,  STATS = 10 END ",157,113,44,236,0,157
"SELECT     DB_NAME (database_id) as [Database Name],     name as [Database File Name],     [Type] = CASE WHEN Type_Desc = 'ROWS' THEN 'Data File(s)'             WHEN Type_Desc = 'LOG'  THEN 'Log File(s)'             ELSE Type_Desc END,     size*8/1024 as 'Size (MB)',     physical_name as [Database_File_Location] FROM sys.master_files ORDER BY 1,3  IF OBJECT_ID('tempdb.dbo.#space') IS NOT NULL     DROP TABLE #space  CREATE TABLE #space (       database_id INT PRIMARY KEY     , data_used_size DECIMAL(18,2)     , log_used_size DECIMAL(18,2) )  DECLARE @SQL NVARCHAR(MAX)  SELECT @SQL = STUFF((     SELECT '     USE [' + d.name + ']     INSERT INTO #space (database_id, data_used_size, log_used_size)     SELECT           DB_ID()         , SUM(CASE WHEN [type] = 0 THEN space_used END)         , SUM(CASE WHEN [type] = 1 THEN space_used END)     FROM (         SELECT s.[type], space_used = SUM(FILEPROPERTY(s.name, ''SpaceUsed'') * 8. / 1024)         FROM sys.database_files s         GROUP BY s.[type]     ) t;'     FROM sys.databases d     WHERE d.[state] = 0     FOR XML PATH(''), TYPE).value('.', 'NVARCHAR(MAX)'), 1, 2, '')  EXEC sys.sp_executesql @SQL  SELECT       d.database_id     , d.name     , d.state_desc     , d.recovery_model_desc     , t.total_size     , t.data_size     , s.data_used_size     , t.log_size     , s.log_used_size     , bu.full_last_date     , bu.full_size     , bu.log_last_date     , bu.log_size FROM (     SELECT           database_id         , log_size = CAST(SUM(CASE WHEN [type] = 1 THEN size END) * 8. / 1024 AS DECIMAL(18,2))         , data_size = CAST(SUM(CASE WHEN [type] = 0 THEN size END) * 8. / 1024 AS DECIMAL(18,2))         , total_size = CAST(SUM(size) * 8. / 1024 AS DECIMAL(18,2))     FROM sys.master_files     GROUP BY database_id ) t JOIN sys.databases d ON d.database_id = t.database_id LEFT JOIN #space s ON d.database_id = s.database_id LEFT JOIN (     SELECT           database_name         , full_last_date = MAX(CASE WHEN [type] = 'D' THEN backup_finish_date END)         , full_size = MAX(CASE WHEN [type] = 'D' THEN backup_size END)         , log_last_date = MAX(CASE WHEN [type] = 'L' THEN backup_finish_date END)         , log_size = MAX(CASE WHEN [type] = 'L' THEN backup_size END)     FROM (         SELECT               s.database_name             , s.[type]             , s.backup_finish_date             , backup_size =                         CAST(CASE WHEN s.backup_size = s.compressed_backup_size                                     THEN s.backup_size                                     ELSE s.compressed_backup_size                         END / 1048576.0 AS DECIMAL(18,2))             , RowNum = ROW_NUMBER() OVER (PARTITION BY s.database_name, s.[type] ORDER BY s.backup_finish_date DESC)         FROM msdb.dbo.backupset s         WHERE s.[type] IN ('D', 'L')     ) f     WHERE f.RowNum = 1     GROUP BY f.database_name ) bu ON d.name = bu.database_name ORDER BY t.total_size DESC  SELECT      req.session_id     , req.total_elapsed_time AS duration_ms     , req.cpu_time AS cpu_time_ms     , req.total_elapsed_time - req.cpu_time AS wait_time     , req.logical_reads     , SUBSTRING (REPLACE (REPLACE (SUBSTRING (ST.text, (req.statement_start_offset/2) + 1,         ((CASE statement_end_offset            WHEN -1            THEN DATALENGTH(ST.text)              ELSE req.statement_end_offset          END - req.statement_start_offset)/2) + 1) , CHAR(10), ' '), CHAR(13), ' '),        1, 512)  AS statement_text   FROM sys.dm_exec_requests AS req     CROSS APPLY sys.dm_exec_sql_text(req.sql_handle) AS ST ORDER BY total_elapsed_time DESC;  SELECT top 100 t.text,      (qs.total_elapsed_time/1000) / qs.execution_count AS avg_elapsed_time,      (qs.total_worker_time/1000) / qs.execution_count AS avg_cpu_time,      ((qs.total_elapsed_time/1000) / qs.execution_count ) - ((qs.total_worker_time/1000) / qs.execution_count) AS avg_wait_time,      qs.total_logical_reads / qs.execution_count AS avg_logical_reads,      qs.total_logical_writes / qs.execution_count AS avg_writes,      (qs.total_elapsed_time/1000) AS cumulative_elapsed_time_all_executions FROM sys.dm_exec_query_stats qs      CROSS apply sys.Dm_exec_sql_text (sql_handle) t -- WHERE t.text like '<Your Query>%' -- Replace <Your Query> with your query or the beginning part of your query. The special chars like '[','_','%','^' in the query should be escaped. ORDER BY (qs.total_elapsed_time / qs.execution_count) DESC  --Deadlock sql check SELECT     session_id,     start_time,      [status],     command,     blocking_session_id,     wait_type,     wait_time,     open_transaction_count,     transaction_id,     total_elapsed_time,     Definition = CAST(text AS VARCHAR(MAX)) FROM     SYS.DM_EXEC_REQUESTS     CROSS APPLY sys.dm_exec_sql_text(sql_handle)  WHERE blocking_session_id != 0   ",157,25,132,9019,515,471
"DECLARE @preferredReplica int  SET @preferredReplica = (SELECT [master].sys.fn_hadr_backup_is_preferred_replica('western'))  IF (@preferredReplica = 1) BEGIN     BACKUP LOG [western] TO  DISK = N'G:\Backup_SQL\WU\Transaction\western\western_backup_2024_03_27_230001_7404796.trn' WITH  RETAINDAYS = 7, NOFORMAT, NOINIT,  NAME = N'western_backup_2024_03_27_230001_7404796', SKIP, REWIND, NOUNLOAD, COMPRESSION,  STATS = 10 END ",147,92,55,236,0,147
"DECLARE @preferredReplica int  SET @preferredReplica = (SELECT [master].sys.fn_hadr_backup_is_preferred_replica('western'))  IF (@preferredReplica = 1) BEGIN     BACKUP LOG [western] TO  DISK = N'G:\Backup_SQL\WU\Transaction\western\western_backup_2024_04_04_080000_8155076.trn' WITH  RETAINDAYS = 7, NOFORMAT, NOINIT,  NAME = N'western_backup_2024_04_04_080000_8155076', SKIP, REWIND, NOUNLOAD, COMPRESSION,  STATS = 10 END ",145,82,63,236,0,145
"DECLARE @preferredReplica int  SET @preferredReplica = (SELECT [master].sys.fn_hadr_backup_is_preferred_replica('western'))  IF (@preferredReplica = 1) BEGIN     BACKUP LOG [western] TO  DISK = N'G:\Backup_SQL\WU\Transaction\western\western_backup_2024_04_09_190001_5731751.trn' WITH  RETAINDAYS = 7, NOFORMAT, NOINIT,  NAME = N'western_backup_2024_04_09_190001_5731751', SKIP, REWIND, NOUNLOAD, COMPRESSION,  STATS = 10 END ",135,64,71,151,0,135
"DECLARE @preferredReplica int  SET @preferredReplica = (SELECT [master].sys.fn_hadr_backup_is_preferred_replica('western'))  IF (@preferredReplica = 1) BEGIN     BACKUP LOG [western] TO  DISK = N'G:\Backup_SQL\WU\Transaction\western\western_backup_2024_04_04_230001_2332196.trn' WITH  RETAINDAYS = 7, NOFORMAT, NOINIT,  NAME = N'western_backup_2024_04_04_230001_2332196', SKIP, REWIND, NOUNLOAD, COMPRESSION,  STATS = 10 END ",134,84,50,236,0,134
"DECLARE @preferredReplica int  SET @preferredReplica = (SELECT [master].sys.fn_hadr_backup_is_preferred_replica('western'))  IF (@preferredReplica = 1) BEGIN     BACKUP LOG [western] TO  DISK = N'G:\Backup_SQL\WU\Transaction\western\western_backup_2024_03_22_110001_5469605.trn' WITH  RETAINDAYS = 7, NOFORMAT, NOINIT,  NAME = N'western_backup_2024_03_22_110001_5469605', SKIP, REWIND, NOUNLOAD, COMPRESSION,  STATS = 10 END ",131,80,51,236,0,131
"DECLARE @preferredReplica int  SET @preferredReplica = (SELECT [master].sys.fn_hadr_backup_is_preferred_replica('western'))  IF (@preferredReplica = 1) BEGIN     BACKUP LOG [western] TO  DISK = N'G:\Backup_SQL\WU\Transaction\western\western_backup_2024_04_13_230000_9232385.trn' WITH  RETAINDAYS = 7, NOFORMAT, NOINIT,  NAME = N'western_backup_2024_04_13_230000_9232385', SKIP, REWIND, NOUNLOAD, COMPRESSION,  STATS = 10 END ",123,95,28,236,0,123
"DECLARE @preferredReplica int  SET @preferredReplica = (SELECT [master].sys.fn_hadr_backup_is_preferred_replica('western'))  IF (@preferredReplica = 1) BEGIN     BACKUP LOG [western] TO  DISK = N'G:\Backup_SQL\WU\Transaction\western\western_backup_2024_03_31_230001_2423882.trn' WITH  RETAINDAYS = 7, NOFORMAT, NOINIT,  NAME = N'western_backup_2024_03_31_230001_2423882', SKIP, REWIND, NOUNLOAD, COMPRESSION,  STATS = 10 END ",120,92,28,236,0,120
"DECLARE @preferredReplica int  SET @preferredReplica = (SELECT [master].sys.fn_hadr_backup_is_preferred_replica('western'))  IF (@preferredReplica = 1) BEGIN     BACKUP LOG [western] TO  DISK = N'G:\Backup_SQL\WU\Transaction\western\western_backup_2024_04_21_170001_0790779.trn' WITH  RETAINDAYS = 7, NOFORMAT, NOINIT,  NAME = N'western_backup_2024_04_21_170001_0790779', SKIP, REWIND, NOUNLOAD, COMPRESSION,  STATS = 10 END ",110,65,45,236,0,110
"DECLARE @preferredReplica int  SET @preferredReplica = (SELECT [master].sys.fn_hadr_backup_is_preferred_replica('western'))  IF (@preferredReplica = 1) BEGIN     BACKUP LOG [western] TO  DISK = N'G:\Backup_SQL\WU\Transaction\western\western_backup_2024_04_11_230001_5643405.trn' WITH  RETAINDAYS = 7, NOFORMAT, NOINIT,  NAME = N'western_backup_2024_04_11_230001_5643405', SKIP, REWIND, NOUNLOAD, COMPRESSION,  STATS = 10 END ",109,80,29,236,0,109
"DECLARE @preferredReplica int  SET @preferredReplica = (SELECT [master].sys.fn_hadr_backup_is_preferred_replica('western'))  IF (@preferredReplica = 1) BEGIN     BACKUP LOG [western] TO  DISK = N'G:\Backup_SQL\WU\Transaction\western\western_backup_2024_03_29_230001_5037886.trn' WITH  RETAINDAYS = 7, NOFORMAT, NOINIT,  NAME = N'western_backup_2024_03_29_230001_5037886', SKIP, REWIND, NOUNLOAD, COMPRESSION,  STATS = 10 END ",107,73,34,236,0,107
"DECLARE @preferredReplica int  SET @preferredReplica = (SELECT [master].sys.fn_hadr_backup_is_preferred_replica('western'))  IF (@preferredReplica = 1) BEGIN     BACKUP LOG [western] TO  DISK = N'G:\Backup_SQL\WU\Transaction\western\western_backup_2024_04_01_230002_2706266.trn' WITH  RETAINDAYS = 7, NOFORMAT, NOINIT,  NAME = N'western_backup_2024_04_01_230002_2706266', SKIP, REWIND, NOUNLOAD, COMPRESSION,  STATS = 10 END ",106,80,26,236,0,106
"DECLARE @preferredReplica int  SET @preferredReplica = (SELECT [master].sys.fn_hadr_backup_is_preferred_replica('western'))  IF (@preferredReplica = 1) BEGIN     BACKUP LOG [western] TO  DISK = N'G:\Backup_SQL\WU\Transaction\western\western_backup_2024_04_15_230002_0996354.trn' WITH  RETAINDAYS = 7, NOFORMAT, NOINIT,  NAME = N'western_backup_2024_04_15_230002_0996354', SKIP, REWIND, NOUNLOAD, COMPRESSION,  STATS = 10 END ",99,62,37,236,0,99
"DECLARE @preferredReplica int  SET @preferredReplica = (SELECT [master].sys.fn_hadr_backup_is_preferred_replica('western'))  IF (@preferredReplica = 1) BEGIN     BACKUP LOG [western] TO  DISK = N'G:\Backup_SQL\WU\Transaction\western\western_backup_2024_04_10_160000_8488605.trn' WITH  RETAINDAYS = 7, NOFORMAT, NOINIT,  NAME = N'western_backup_2024_04_10_160000_8488605', SKIP, REWIND, NOUNLOAD, COMPRESSION,  STATS = 10 END ",99,59,40,151,0,99
"DECLARE @preferredReplica int  SET @preferredReplica = (SELECT [master].sys.fn_hadr_backup_is_preferred_replica('western'))  IF (@preferredReplica = 1) BEGIN     BACKUP LOG [western] TO  DISK = N'G:\Backup_SQL\WU\Transaction\western\western_backup_2024_04_23_020001_2460421.trn' WITH  RETAINDAYS = 7, NOFORMAT, NOINIT,  NAME = N'western_backup_2024_04_23_020001_2460421', SKIP, REWIND, NOUNLOAD, COMPRESSION,  STATS = 10 END ",98,88,10,236,0,98
"DECLARE @preferredReplica int  SET @preferredReplica = (SELECT [master].sys.fn_hadr_backup_is_preferred_replica('western'))  IF (@preferredReplica = 1) BEGIN     BACKUP LOG [western] TO  DISK = N'G:\Backup_SQL\WU\Transaction\western\western_backup_2024_04_21_080001_1075634.trn' WITH  RETAINDAYS = 7, NOFORMAT, NOINIT,  NAME = N'western_backup_2024_04_21_080001_1075634', SKIP, REWIND, NOUNLOAD, COMPRESSION,  STATS = 10 END ",95,59,36,236,0,95
"DECLARE @preferredReplica int  SET @preferredReplica = (SELECT [master].sys.fn_hadr_backup_is_preferred_replica('western'))  IF (@preferredReplica = 1) BEGIN     BACKUP LOG [western] TO  DISK = N'G:\Backup_SQL\WU\Transaction\western\western_backup_2024_04_16_230001_9593358.trn' WITH  RETAINDAYS = 7, NOFORMAT, NOINIT,  NAME = N'western_backup_2024_04_16_230001_9593358', SKIP, REWIND, NOUNLOAD, COMPRESSION,  STATS = 10 END ",93,67,26,236,0,93
"DECLARE @preferredReplica int  SET @preferredReplica = (SELECT [master].sys.fn_hadr_backup_is_preferred_replica('western'))  IF (@preferredReplica = 1) BEGIN     BACKUP LOG [western] TO  DISK = N'G:\Backup_SQL\WU\Transaction\western\western_backup_2024_04_14_110000_8943340.trn' WITH  RETAINDAYS = 7, NOFORMAT, NOINIT,  NAME = N'western_backup_2024_04_14_110000_8943340', SKIP, REWIND, NOUNLOAD, COMPRESSION,  STATS = 10 END ",93,77,16,236,0,93
"DECLARE @preferredReplica int  SET @preferredReplica = (SELECT [master].sys.fn_hadr_backup_is_preferred_replica('western'))  IF (@preferredReplica = 1) BEGIN     BACKUP LOG [western] TO  DISK = N'G:\Backup_SQL\WU\Transaction\western\western_backup_2024_03_20_110001_7484383.trn' WITH  RETAINDAYS = 7, NOFORMAT, NOINIT,  NAME = N'western_backup_2024_03_20_110001_7484383', SKIP, REWIND, NOUNLOAD, COMPRESSION,  STATS = 10 END ",93,66,27,236,0,93
"DECLARE @preferredReplica int  SET @preferredReplica = (SELECT [master].sys.fn_hadr_backup_is_preferred_replica('western'))  IF (@preferredReplica = 1) BEGIN     BACKUP LOG [western] TO  DISK = N'G:\Backup_SQL\WU\Transaction\western\western_backup_2024_04_09_200001_0077557.trn' WITH  RETAINDAYS = 7, NOFORMAT, NOINIT,  NAME = N'western_backup_2024_04_09_200001_0077557', SKIP, REWIND, NOUNLOAD, COMPRESSION,  STATS = 10 END ",91,73,18,236,0,91
"DECLARE @preferredReplica int  SET @preferredReplica = (SELECT [master].sys.fn_hadr_backup_is_preferred_replica('western'))  IF (@preferredReplica = 1) BEGIN     BACKUP LOG [western] TO  DISK = N'G:\Backup_SQL\WU\Transaction\western\western_backup_2024_04_07_020001_2485746.trn' WITH  RETAINDAYS = 7, NOFORMAT, NOINIT,  NAME = N'western_backup_2024_04_07_020001_2485746', SKIP, REWIND, NOUNLOAD, COMPRESSION,  STATS = 10 END ",91,74,17,236,0,91
"DECLARE @preferredReplica int  SET @preferredReplica = (SELECT [master].sys.fn_hadr_backup_is_preferred_replica('western'))  IF (@preferredReplica = 1) BEGIN     BACKUP LOG [western] TO  DISK = N'G:\Backup_SQL\WU\Transaction\western\western_backup_2024_03_28_230001_4614814.trn' WITH  RETAINDAYS = 7, NOFORMAT, NOINIT,  NAME = N'western_backup_2024_03_28_230001_4614814', SKIP, REWIND, NOUNLOAD, COMPRESSION,  STATS = 10 END ",90,69,21,236,0,90
"DECLARE @preferredReplica int  SET @preferredReplica = (SELECT [master].sys.fn_hadr_backup_is_preferred_replica('western'))  IF (@preferredReplica = 1) BEGIN     BACKUP LOG [western] TO  DISK = N'G:\Backup_SQL\WU\Transaction\western\western_backup_2024_03_24_230001_6253222.trn' WITH  RETAINDAYS = 7, NOFORMAT, NOINIT,  NAME = N'western_backup_2024_03_24_230001_6253222', SKIP, REWIND, NOUNLOAD, COMPRESSION,  STATS = 10 END ",89,84,5,272,0,89
"DECLARE @preferredReplica int  SET @preferredReplica = (SELECT [master].sys.fn_hadr_backup_is_preferred_replica('western'))  IF (@preferredReplica = 1) BEGIN     BACKUP LOG [western] TO  DISK = N'G:\Backup_SQL\WU\Transaction\western\western_backup_2024_04_14_200001_0129181.trn' WITH  RETAINDAYS = 7, NOFORMAT, NOINIT,  NAME = N'western_backup_2024_04_14_200001_0129181', SKIP, REWIND, NOUNLOAD, COMPRESSION,  STATS = 10 END ",89,73,16,237,0,89
"DECLARE @preferredReplica int  SET @preferredReplica = (SELECT [master].sys.fn_hadr_backup_is_preferred_replica('western'))  IF (@preferredReplica = 1) BEGIN     BACKUP LOG [western] TO  DISK = N'G:\Backup_SQL\WU\Transaction\western\western_backup_2024_04_12_230001_4280567.trn' WITH  RETAINDAYS = 7, NOFORMAT, NOINIT,  NAME = N'western_backup_2024_04_12_230001_4280567', SKIP, REWIND, NOUNLOAD, COMPRESSION,  STATS = 10 END ",88,80,8,236,0,88
"DECLARE @preferredReplica int  SET @preferredReplica = (SELECT [master].sys.fn_hadr_backup_is_preferred_replica('western'))  IF (@preferredReplica = 1) BEGIN     BACKUP LOG [western] TO  DISK = N'G:\Backup_SQL\WU\Transaction\western\western_backup_2024_04_11_110001_0317036.trn' WITH  RETAINDAYS = 7, NOFORMAT, NOINIT,  NAME = N'western_backup_2024_04_11_110001_0317036', SKIP, REWIND, NOUNLOAD, COMPRESSION,  STATS = 10 END ",88,58,30,236,0,88
"DECLARE @preferredReplica int  SET @preferredReplica = (SELECT [master].sys.fn_hadr_backup_is_preferred_replica('western'))  IF (@preferredReplica = 1) BEGIN     BACKUP LOG [western] TO  DISK = N'G:\Backup_SQL\WU\Transaction\western\western_backup_2024_04_09_180001_0037553.trn' WITH  RETAINDAYS = 7, NOFORMAT, NOINIT,  NAME = N'western_backup_2024_04_09_180001_0037553', SKIP, REWIND, NOUNLOAD, COMPRESSION,  STATS = 10 END ",88,55,33,151,0,88
"DECLARE @preferredReplica int  SET @preferredReplica = (SELECT [master].sys.fn_hadr_backup_is_preferred_replica('western'))  IF (@preferredReplica = 1) BEGIN     BACKUP LOG [western] TO  DISK = N'G:\Backup_SQL\WU\Transaction\western\western_backup_2024_04_22_110001_4162784.trn' WITH  RETAINDAYS = 7, NOFORMAT, NOINIT,  NAME = N'western_backup_2024_04_22_110001_4162784', SKIP, REWIND, NOUNLOAD, COMPRESSION,  STATS = 10 END ",87,66,21,236,0,87
"(@_msparam_0 nvarchar(4000))       select * into #tmpag_availability_groups from master.sys.availability_groups        SELECT arcn.replica_server_name AS [ReplicaName], cm.member_name AS [NodeName], cm.member_type AS [MemberType], cm.member_state AS [MemberState], ISNULL(cm.number_of_quorum_votes, -1) AS [NumberOfQuorumVotes], 'Server[@Name=' + quotename(CAST(         serverproperty(N'Servername')        AS sysname),'''') + ']' + '/AvailabilityGroup[@Name=' + quotename(AG.name,'''') + ']' + '/ReplicaClusterNode[@ReplicaName=' + quotename(arcn.replica_server_name,'''') + ' and @NodeName=' + quotename(cm.member_name,'''') + ']' AS [Urn] FROM #tmpag_availability_groups AS AG INNER JOIN master.sys.dm_hadr_availability_replica_cluster_nodes AS arcn ON arcn.group_name=AG.name LEFT OUTER JOIN master.sys.dm_hadr_cluster_members AS cm ON UPPER(arcn.node_name) = UPPER(cm.member_name) WHERE (AG.name=@_msparam_0)        drop table #tmpag_availability_groups       ",85,66,19,5,0,85
"DECLARE @preferredReplica int  SET @preferredReplica = (SELECT [master].sys.fn_hadr_backup_is_preferred_replica('western'))  IF (@preferredReplica = 1) BEGIN     BACKUP LOG [western] TO  DISK = N'G:\Backup_SQL\WU\Transaction\western\western_backup_2024_04_11_180001_1747613.trn' WITH  RETAINDAYS = 7, NOFORMAT, NOINIT,  NAME = N'western_backup_2024_04_11_180001_1747613', SKIP, REWIND, NOUNLOAD, COMPRESSION,  STATS = 10 END ",85,56,29,151,0,85
"DECLARE @preferredReplica int  SET @preferredReplica = (SELECT [master].sys.fn_hadr_backup_is_preferred_replica('western'))  IF (@preferredReplica = 1) BEGIN     BACKUP LOG [western] TO  DISK = N'G:\Backup_SQL\WU\Transaction\western\western_backup_2024_04_14_230002_3330654.trn' WITH  RETAINDAYS = 7, NOFORMAT, NOINIT,  NAME = N'western_backup_2024_04_14_230002_3330654', SKIP, REWIND, NOUNLOAD, COMPRESSION,  STATS = 10 END ",84,66,18,236,0,84
"DECLARE @preferredReplica int  SET @preferredReplica = (SELECT [master].sys.fn_hadr_backup_is_preferred_replica('western'))  IF (@preferredReplica = 1) BEGIN     BACKUP LOG [western] TO  DISK = N'G:\Backup_SQL\WU\Transaction\western\western_backup_2024_04_01_100001_1009546.trn' WITH  RETAINDAYS = 7, NOFORMAT, NOINIT,  NAME = N'western_backup_2024_04_01_100001_1009546', SKIP, REWIND, NOUNLOAD, COMPRESSION,  STATS = 10 END ",83,57,26,151,0,83
"DECLARE @preferredReplica int  SET @preferredReplica = (SELECT [master].sys.fn_hadr_backup_is_preferred_replica('western'))  IF (@preferredReplica = 1) BEGIN     BACKUP LOG [western] TO  DISK = N'G:\Backup_SQL\WU\Transaction\western\western_backup_2024_04_21_100000_9406523.trn' WITH  RETAINDAYS = 7, NOFORMAT, NOINIT,  NAME = N'western_backup_2024_04_21_100000_9406523', SKIP, REWIND, NOUNLOAD, COMPRESSION,  STATS = 10 END ",83,47,36,151,0,83
"DECLARE @preferredReplica int  SET @preferredReplica = (SELECT [master].sys.fn_hadr_backup_is_preferred_replica('western'))  IF (@preferredReplica = 1) BEGIN     BACKUP LOG [western] TO  DISK = N'G:\Backup_SQL\WU\Transaction\western\western_backup_2024_04_13_010000_9296993.trn' WITH  RETAINDAYS = 7, NOFORMAT, NOINIT,  NAME = N'western_backup_2024_04_13_010000_9296993', SKIP, REWIND, NOUNLOAD, COMPRESSION,  STATS = 10 END ",82,56,26,151,0,82
"DECLARE @preferredReplica int  SET @preferredReplica = (SELECT [master].sys.fn_hadr_backup_is_preferred_replica('western'))  IF (@preferredReplica = 1) BEGIN     BACKUP LOG [western] TO  DISK = N'G:\Backup_SQL\WU\Transaction\western\western_backup_2024_04_03_230002_0587906.trn' WITH  RETAINDAYS = 7, NOFORMAT, NOINIT,  NAME = N'western_backup_2024_04_03_230002_0587906', SKIP, REWIND, NOUNLOAD, COMPRESSION,  STATS = 10 END ",82,59,23,236,0,82
"DECLARE @preferredReplica int  SET @preferredReplica = (SELECT [master].sys.fn_hadr_backup_is_preferred_replica('western'))  IF (@preferredReplica = 1) BEGIN     BACKUP LOG [western] TO  DISK = N'G:\Backup_SQL\WU\Transaction\western\western_backup_2024_03_30_140001_0431244.trn' WITH  RETAINDAYS = 7, NOFORMAT, NOINIT,  NAME = N'western_backup_2024_03_30_140001_0431244', SKIP, REWIND, NOUNLOAD, COMPRESSION,  STATS = 10 END ",82,67,15,236,0,82
"DECLARE @preferredReplica int  SET @preferredReplica = (SELECT [master].sys.fn_hadr_backup_is_preferred_replica('western'))  IF (@preferredReplica = 1) BEGIN     BACKUP LOG [western] TO  DISK = N'G:\Backup_SQL\WU\Transaction\western\western_backup_2024_04_10_050000_8067678.trn' WITH  RETAINDAYS = 7, NOFORMAT, NOINIT,  NAME = N'western_backup_2024_04_10_050000_8067678', SKIP, REWIND, NOUNLOAD, COMPRESSION,  STATS = 10 END ",82,66,16,236,0,82
"DECLARE @preferredReplica int  SET @preferredReplica = (SELECT [master].sys.fn_hadr_backup_is_preferred_replica('western'))  IF (@preferredReplica = 1) BEGIN     BACKUP LOG [western] TO  DISK = N'G:\Backup_SQL\WU\Transaction\western\western_backup_2024_04_09_050000_9651597.trn' WITH  RETAINDAYS = 7, NOFORMAT, NOINIT,  NAME = N'western_backup_2024_04_09_050000_9651597', SKIP, REWIND, NOUNLOAD, COMPRESSION,  STATS = 10 END ",81,72,9,236,0,81
"DECLARE @preferredReplica int  SET @preferredReplica = (SELECT [master].sys.fn_hadr_backup_is_preferred_replica('western'))  IF (@preferredReplica = 1) BEGIN     BACKUP LOG [western] TO  DISK = N'G:\Backup_SQL\WU\Transaction\western\western_backup_2024_04_06_170000_8508712.trn' WITH  RETAINDAYS = 7, NOFORMAT, NOINIT,  NAME = N'western_backup_2024_04_06_170000_8508712', SKIP, REWIND, NOUNLOAD, COMPRESSION,  STATS = 10 END ",81,72,9,236,0,81
"DECLARE @preferredReplica int  SET @preferredReplica = (SELECT [master].sys.fn_hadr_backup_is_preferred_replica('western'))  IF (@preferredReplica = 1) BEGIN     BACKUP LOG [western] TO  DISK = N'G:\Backup_SQL\WU\Transaction\western\western_backup_2024_04_08_200000_8669830.trn' WITH  RETAINDAYS = 7, NOFORMAT, NOINIT,  NAME = N'western_backup_2024_04_08_200000_8669830', SKIP, REWIND, NOUNLOAD, COMPRESSION,  STATS = 10 END ",80,63,17,236,0,80
"DECLARE @preferredReplica int  SET @preferredReplica = (SELECT [master].sys.fn_hadr_backup_is_preferred_replica('western'))  IF (@preferredReplica = 1) BEGIN     BACKUP LOG [western] TO  DISK = N'G:\Backup_SQL\WU\Transaction\western\western_backup_2024_04_10_180000_8501208.trn' WITH  RETAINDAYS = 7, NOFORMAT, NOINIT,  NAME = N'western_backup_2024_04_10_180000_8501208', SKIP, REWIND, NOUNLOAD, COMPRESSION,  STATS = 10 END ",80,56,24,151,0,80
"       WITH TablesAndViews AS       (SELECT object_id, 'table' AS object_type FROM sys.tables WITH(nolock) UNION ALL SELECT object_id, 'view' AS object_type FROM sys.views WITH(nolock))       SELECT       db_id() as database_id,       i.type,       i.is_unique,       i.is_primary_key,       i.is_unique_constraint,       i.is_disabled,       i.has_filter,       i.optimize_for_sequential_key,       COUNT_BIG(1) CountOfIndexes,       t.object_type       FROM sys.indexes i WITH(nolock)       INNER JOIN TablesAndViews t       ON t.object_id = i.object_id       GROUP BY i.type,       i.is_unique,       i.is_primary_key,       i.is_unique_constraint,       i.has_filter,       i.optimize_for_sequential_key,       t.object_type,       i.is_disabled     ",80,47,33,331,0,7951
"DECLARE @preferredReplica int  SET @preferredReplica = (SELECT [master].sys.fn_hadr_backup_is_preferred_replica('western'))  IF (@preferredReplica = 1) BEGIN     BACKUP LOG [western] TO  DISK = N'G:\Backup_SQL\WU\Transaction\western\western_backup_2024_04_09_090000_9030801.trn' WITH  RETAINDAYS = 7, NOFORMAT, NOINIT,  NAME = N'western_backup_2024_04_09_090000_9030801', SKIP, REWIND, NOUNLOAD, COMPRESSION,  STATS = 10 END ",79,49,30,151,0,79
"DECLARE @preferredReplica int  SET @preferredReplica = (SELECT [master].sys.fn_hadr_backup_is_preferred_replica('western'))  IF (@preferredReplica = 1) BEGIN     BACKUP LOG [western] TO  DISK = N'G:\Backup_SQL\WU\Transaction\western\western_backup_2024_04_19_230001_5154748.trn' WITH  RETAINDAYS = 7, NOFORMAT, NOINIT,  NAME = N'western_backup_2024_04_19_230001_5154748', SKIP, REWIND, NOUNLOAD, COMPRESSION,  STATS = 10 END ",78,68,10,236,0,78
"(@_msparam_0 nvarchar(4000),@_msparam_1 nvarchar(4000),@_msparam_2 nvarchar(4000))SELECT SCHEMA_NAME(sp.schema_id) AS [Schema], sp.name AS [Name], sp.object_id AS [ID], CAST(  case      when sp.is_ms_shipped = 1 then 1     when (         select              major_id          from              sys.extended_properties          where              major_id = sp.object_id and              minor_id = 0 and              class = 1 and              name = N'microsoft_database_tools_support')          is not null then 1     else 0 end                        AS bit) AS [IsSystemObject], CASE WHEN sp.type = N'P' THEN 1 WHEN sp.type = N'PC' THEN 2 ELSE 1 END AS [ImplementationType], CAST(CASE WHEN ISNULL(smsp.definition, ssmsp.definition) IS NULL THEN 1 ELSE 0 END AS bit) AS [IsEncrypted] FROM sys.all_objects AS sp LEFT OUTER JOIN sys.sql_modules AS smsp ON smsp.object_id = sp.object_id LEFT OUTER JOIN sys.system_sql_modules AS ssmsp ON ssmsp.object_id = sp.object_id WHERE (sp.type = @_msparam_0 OR sp.type = @_msparam_1 OR sp.type=@_msparam_2) ORDER BY [Schema] ASC,[Name] ASC",77,62,15,87016,0,465
"DECLARE @preferredReplica int  SET @preferredReplica = (SELECT [master].sys.fn_hadr_backup_is_preferred_replica('western'))  IF (@preferredReplica = 1) BEGIN     BACKUP LOG [western] TO  DISK = N'G:\Backup_SQL\WU\Transaction\western\western_backup_2024_04_16_020001_1331296.trn' WITH  RETAINDAYS = 7, NOFORMAT, NOINIT,  NAME = N'western_backup_2024_04_16_020001_1331296', SKIP, REWIND, NOUNLOAD, COMPRESSION,  STATS = 10 END ",76,63,13,236,0,76
"       SELECT       db_id() AS database_id,       o.[type] AS object_type,       i.[type] AS index_type,       p.[data_compression],       COUNT_BIG(DISTINCT p.[object_id]) AS NumTables,       COUNT_BIG(DISTINCT CAST(p.[object_id] AS VARCHAR(30)) + '|' + CAST(p.[index_id] AS VARCHAR(10))) AS NumIndexes,       ISNULL(px.[IsPartitioned], 0) AS IsPartitioned,       IIF(px.[IsPartitioned] = 1, COUNT_BIG(1), 0) NumPartitions,       SUM(p.[rows]) NumRows       FROM sys.partitions p       INNER JOIN sys.objects o       ON o.[object_id] = p.[object_id]       INNER JOIN sys.indexes i       ON i.[object_id] = p.[object_id]       AND i.[index_id] = p.[index_id]       OUTER APPLY (SELECT       x.[object_id], 1 AS [IsPartitioned]       FROM sys.partitions x       WHERE x.[object_id] = p.[object_id]       GROUP by       x.[object_id]       HAVING MAX(x.partition_number) > 1) px       WHERE o.[type] NOT IN ('S', 'IT')       GROUP BY       o.[type]       ,i.[type]       ,p.[data_compression]       ,px.[IsPartitioned]     ",75,46,29,1570,0,7479
"DECLARE @preferredReplica int  SET @preferredReplica = (SELECT [master].sys.fn_hadr_backup_is_preferred_replica('western'))  IF (@preferredReplica = 1) BEGIN     BACKUP LOG [western] TO  DISK = N'G:\Backup_SQL\WU\Transaction\western\western_backup_2024_04_16_110001_0675333.trn' WITH  RETAINDAYS = 7, NOFORMAT, NOINIT,  NAME = N'western_backup_2024_04_16_110001_0675333', SKIP, REWIND, NOUNLOAD, COMPRESSION,  STATS = 10 END ",74,66,8,236,0,74
"DECLARE @preferredReplica int  SET @preferredReplica = (SELECT [master].sys.fn_hadr_backup_is_preferred_replica('western'))  IF (@preferredReplica = 1) BEGIN     BACKUP LOG [western] TO  DISK = N'G:\Backup_SQL\WU\Transaction\western\western_backup_2024_04_01_030000_9069612.trn' WITH  RETAINDAYS = 7, NOFORMAT, NOINIT,  NAME = N'western_backup_2024_04_01_030000_9069612', SKIP, REWIND, NOUNLOAD, COMPRESSION,  STATS = 10 END ",74,53,21,151,0,74
"DECLARE @preferredReplica int  SET @preferredReplica = (SELECT [master].sys.fn_hadr_backup_is_preferred_replica('western'))  IF (@preferredReplica = 1) BEGIN     BACKUP LOG [western] TO  DISK = N'G:\Backup_SQL\WU\Transaction\western\western_backup_2024_04_14_020001_6393461.trn' WITH  RETAINDAYS = 7, NOFORMAT, NOINIT,  NAME = N'western_backup_2024_04_14_020001_6393461', SKIP, REWIND, NOUNLOAD, COMPRESSION,  STATS = 10 END ",74,67,7,236,0,74
"DECLARE @preferredReplica int  SET @preferredReplica = (SELECT [master].sys.fn_hadr_backup_is_preferred_replica('western'))  IF (@preferredReplica = 1) BEGIN     BACKUP LOG [western] TO  DISK = N'G:\Backup_SQL\WU\Transaction\western\western_backup_2024_04_10_200000_8713636.trn' WITH  RETAINDAYS = 7, NOFORMAT, NOINIT,  NAME = N'western_backup_2024_04_10_200000_8713636', SKIP, REWIND, NOUNLOAD, COMPRESSION,  STATS = 10 END ",73,69,4,236,0,73
"DECLARE @preferredReplica int  SET @preferredReplica = (SELECT [master].sys.fn_hadr_backup_is_preferred_replica('western'))  IF (@preferredReplica = 1) BEGIN     BACKUP LOG [western] TO  DISK = N'G:\Backup_SQL\WU\Transaction\western\western_backup_2024_03_29_030000_8457994.trn' WITH  RETAINDAYS = 7, NOFORMAT, NOINIT,  NAME = N'western_backup_2024_03_29_030000_8457994', SKIP, REWIND, NOUNLOAD, COMPRESSION,  STATS = 10 END ",73,43,30,151,0,73
"DECLARE @preferredReplica int  SET @preferredReplica = (SELECT [master].sys.fn_hadr_backup_is_preferred_replica('western'))  IF (@preferredReplica = 1) BEGIN     BACKUP LOG [western] TO  DISK = N'G:\Backup_SQL\WU\Transaction\western\western_backup_2024_04_06_230002_1108371.trn' WITH  RETAINDAYS = 7, NOFORMAT, NOINIT,  NAME = N'western_backup_2024_04_06_230002_1108371', SKIP, REWIND, NOUNLOAD, COMPRESSION,  STATS = 10 END ",73,60,13,236,0,73
"DECLARE @preferredReplica int  SET @preferredReplica = (SELECT [master].sys.fn_hadr_backup_is_preferred_replica('western'))  IF (@preferredReplica = 1) BEGIN     BACKUP LOG [western] TO  DISK = N'G:\Backup_SQL\WU\Transaction\western\western_backup_2024_03_28_100001_7082741.trn' WITH  RETAINDAYS = 7, NOFORMAT, NOINIT,  NAME = N'western_backup_2024_03_28_100001_7082741', SKIP, REWIND, NOUNLOAD, COMPRESSION,  STATS = 10 END ",72,56,16,151,0,72
"(@_msparam_0 nvarchar(4000),@_msparam_1 nvarchar(4000))SELECT 'XEStore[@Name=' + quotename(CAST(SERVERPROPERTY(N'ServerName') AS sysname),'''') + ']' + '/Session[@Name=' + quotename(session.name,'''') + ']' + '/Event[@Name=' + quotename(event.package + '.' + event.name,'''') + ']' AS [Urn], event.event_id AS [ID], event.package + '.' + event.name AS [Name], event.module AS [ModuleID], event.package AS [PackageName], event.predicate AS [PredicateExpression], event.predicate_xml AS [PredicateXml], object2.description AS [Description] FROM sys.server_event_sessions AS session LEFT OUTER JOIN sys.dm_xe_sessions AS running ON running.name = session.name, sys.server_event_session_events AS event INNER JOIN sys.dm_xe_objects AS object2 ON event.name = object2.name AND object2.object_type='event' INNER JOIN sys.dm_xe_packages AS package2 ON event.module = package2.module_guid AND event.package = package2.name AND package2.guid = object2.package_guid WHERE (session.event_session_id = event.event_session_id)and((session.name=@_msparam_0)and((CAST(SERVERPROPERTY(N'ServerName') AS sysname)=@_msparam_1)))",72,70,2,115,0,72
"DECLARE @preferredReplica int  SET @preferredReplica = (SELECT [master].sys.fn_hadr_backup_is_preferred_replica('western'))  IF (@preferredReplica = 1) BEGIN     BACKUP LOG [western] TO  DISK = N'G:\Backup_SQL\WU\Transaction\western\western_backup_2024_03_30_180001_2475689.trn' WITH  RETAINDAYS = 7, NOFORMAT, NOINIT,  NAME = N'western_backup_2024_03_30_180001_2475689', SKIP, REWIND, NOUNLOAD, COMPRESSION,  STATS = 10 END ",72,57,15,151,0,72
"DECLARE @preferredReplica int  SET @preferredReplica = (SELECT [master].sys.fn_hadr_backup_is_preferred_replica('western'))  IF (@preferredReplica = 1) BEGIN     BACKUP LOG [western] TO  DISK = N'G:\Backup_SQL\WU\Transaction\western\western_backup_2024_04_22_080000_8686576.trn' WITH  RETAINDAYS = 7, NOFORMAT, NOINIT,  NAME = N'western_backup_2024_04_22_080000_8686576', SKIP, REWIND, NOUNLOAD, COMPRESSION,  STATS = 10 END ",71,65,6,236,0,71
"DECLARE @preferredReplica int  SET @preferredReplica = (SELECT [master].sys.fn_hadr_backup_is_preferred_replica('western'))  IF (@preferredReplica = 1) BEGIN     BACKUP LOG [western] TO  DISK = N'G:\Backup_SQL\WU\Transaction\western\western_backup_2024_04_08_180000_9678869.trn' WITH  RETAINDAYS = 7, NOFORMAT, NOINIT,  NAME = N'western_backup_2024_04_08_180000_9678869', SKIP, REWIND, NOUNLOAD, COMPRESSION,  STATS = 10 END ",71,56,15,151,0,71
"DECLARE @preferredReplica int  SET @preferredReplica = (SELECT [master].sys.fn_hadr_backup_is_preferred_replica('western'))  IF (@preferredReplica = 1) BEGIN     BACKUP LOG [western] TO  DISK = N'G:\Backup_SQL\WU\Transaction\western\western_backup_2024_04_05_080000_8684769.trn' WITH  RETAINDAYS = 7, NOFORMAT, NOINIT,  NAME = N'western_backup_2024_04_05_080000_8684769', SKIP, REWIND, NOUNLOAD, COMPRESSION,  STATS = 10 END ",70,65,5,236,0,70
"DECLARE @preferredReplica int  SET @preferredReplica = (SELECT [master].sys.fn_hadr_backup_is_preferred_replica('western'))  IF (@preferredReplica = 1) BEGIN     BACKUP LOG [western] TO  DISK = N'G:\Backup_SQL\WU\Transaction\western\western_backup_2024_03_26_230001_7419254.trn' WITH  RETAINDAYS = 7, NOFORMAT, NOINIT,  NAME = N'western_backup_2024_03_26_230001_7419254', SKIP, REWIND, NOUNLOAD, COMPRESSION,  STATS = 10 END ",70,66,4,236,0,70
"DECLARE @preferredReplica int  SET @preferredReplica = (SELECT [master].sys.fn_hadr_backup_is_preferred_replica('western'))  IF (@preferredReplica = 1) BEGIN     BACKUP LOG [western] TO  DISK = N'G:\Backup_SQL\WU\Transaction\western\western_backup_2024_04_15_020001_3961107.trn' WITH  RETAINDAYS = 7, NOFORMAT, NOINIT,  NAME = N'western_backup_2024_04_15_020001_3961107', SKIP, REWIND, NOUNLOAD, COMPRESSION,  STATS = 10 END ",70,66,4,236,0,70
"DECLARE @preferredReplica int  SET @preferredReplica = (SELECT [master].sys.fn_hadr_backup_is_preferred_replica('western'))  IF (@preferredReplica = 1) BEGIN     BACKUP LOG [western] TO  DISK = N'G:\Backup_SQL\WU\Transaction\western\western_backup_2024_03_25_230001_7763544.trn' WITH  RETAINDAYS = 7, NOFORMAT, NOINIT,  NAME = N'western_backup_2024_03_25_230001_7763544', SKIP, REWIND, NOUNLOAD, COMPRESSION,  STATS = 10 END ",70,63,7,236,0,70
"DECLARE @preferredReplica int  SET @preferredReplica = (SELECT [master].sys.fn_hadr_backup_is_preferred_replica('western'))  IF (@preferredReplica = 1) BEGIN     BACKUP DATABASE [western] TO  DISK = N'G:\Backup_SQL\WU\Full\western\western_backup_2024_03_19_144110_1241377.bak' WITH  RETAINDAYS = 7, NOFORMAT, NOINIT,  NAME = N'western_backup_2024_03_19_144110_1241377', SKIP, REWIND, NOUNLOAD, COMPRESSION,  STATS = 10 END ",69,63,6,366,0,69
"DECLARE @preferredReplica int  SET @preferredReplica = (SELECT [master].sys.fn_hadr_backup_is_preferred_replica('western'))  IF (@preferredReplica = 1) BEGIN     BACKUP LOG [western] TO  DISK = N'G:\Backup_SQL\WU\Transaction\western\western_backup_2024_04_10_230001_7994445.trn' WITH  RETAINDAYS = 7, NOFORMAT, NOINIT,  NAME = N'western_backup_2024_04_10_230001_7994445', SKIP, REWIND, NOUNLOAD, COMPRESSION,  STATS = 10 END ",69,60,9,236,0,69
"DECLARE @preferredReplica int  SET @preferredReplica = (SELECT [master].sys.fn_hadr_backup_is_preferred_replica('western'))  IF (@preferredReplica = 1) BEGIN     BACKUP LOG [western] TO  DISK = N'G:\Backup_SQL\WU\Transaction\western\western_backup_2024_04_08_090000_7158636.trn' WITH  RETAINDAYS = 7, NOFORMAT, NOINIT,  NAME = N'western_backup_2024_04_08_090000_7158636', SKIP, REWIND, NOUNLOAD, COMPRESSION,  STATS = 10 END ",69,52,17,151,0,69
" 	SELECT 	CASE 		WHEN name like  '%msdtcprx.dll%' THEN 'msdtcprx' 		WHEN name like  '%sqljdbc_xa.dll%' THEN 'sqljdbc_xa' 		ELSE NULL 	END AS LoadedModules, 	COUNT(1) AS ModuleCount         FROM sys.dm_os_loaded_modules WITH (NOLOCK)         WHERE name like  '%msdtcprx.dll%' 	OR name like  '%sqljdbc_xa.dll%'         GROUP BY 	CASE WHEN name like  '%msdtcprx.dll%' THEN 'msdtcprx' 		WHEN name like  '%sqljdbc_xa.dll%' THEN 'sqljdbc_xa' 		ELSE NULL 	END;     ",68,68,0,0,0,6807
"DECLARE @preferredReplica int  SET @preferredReplica = (SELECT [master].sys.fn_hadr_backup_is_preferred_replica('western'))  IF (@preferredReplica = 1) BEGIN     BACKUP LOG [western] TO  DISK = N'G:\Backup_SQL\WU\Transaction\western\western_backup_2024_04_22_150000_9331124.trn' WITH  RETAINDAYS = 7, NOFORMAT, NOINIT,  NAME = N'western_backup_2024_04_22_150000_9331124', SKIP, REWIND, NOUNLOAD, COMPRESSION,  STATS = 10 END ",68,51,17,151,0,68
"DECLARE @preferredReplica int  SET @preferredReplica = (SELECT [master].sys.fn_hadr_backup_is_preferred_replica('western'))  IF (@preferredReplica = 1) BEGIN     BACKUP LOG [western] TO  DISK = N'G:\Backup_SQL\WU\Transaction\western\western_backup_2024_03_21_080000_9836661.trn' WITH  RETAINDAYS = 7, NOFORMAT, NOINIT,  NAME = N'western_backup_2024_03_21_080000_9836661', SKIP, REWIND, NOUNLOAD, COMPRESSION,  STATS = 10 END ",67,65,2,236,0,67
"DECLARE @preferredReplica int  SET @preferredReplica = (SELECT [master].sys.fn_hadr_backup_is_preferred_replica('western'))  IF (@preferredReplica = 1) BEGIN     BACKUP LOG [western] TO  DISK = N'G:\Backup_SQL\WU\Transaction\western\western_backup_2024_04_13_200001_0799281.trn' WITH  RETAINDAYS = 7, NOFORMAT, NOINIT,  NAME = N'western_backup_2024_04_13_200001_0799281', SKIP, REWIND, NOUNLOAD, COMPRESSION,  STATS = 10 END ",67,65,2,236,0,67
"DECLARE @preferredReplica int  SET @preferredReplica = (SELECT [master].sys.fn_hadr_backup_is_preferred_replica('western'))  IF (@preferredReplica = 1) BEGIN     BACKUP LOG [western] TO  DISK = N'G:\Backup_SQL\WU\Transaction\western\western_backup_2024_04_04_020001_5381664.trn' WITH  RETAINDAYS = 7, NOFORMAT, NOINIT,  NAME = N'western_backup_2024_04_04_020001_5381664', SKIP, REWIND, NOUNLOAD, COMPRESSION,  STATS = 10 END ",66,64,2,236,0,66
"DECLARE @preferredReplica int  SET @preferredReplica = (SELECT [master].sys.fn_hadr_backup_is_preferred_replica('western'))  IF (@preferredReplica = 1) BEGIN     BACKUP LOG [western] TO  DISK = N'G:\Backup_SQL\WU\Transaction\western\western_backup_2024_03_26_110001_1551884.trn' WITH  RETAINDAYS = 7, NOFORMAT, NOINIT,  NAME = N'western_backup_2024_03_26_110001_1551884', SKIP, REWIND, NOUNLOAD, COMPRESSION,  STATS = 10 END ",66,61,5,236,0,66
"DECLARE @preferredReplica int  SET @preferredReplica = (SELECT [master].sys.fn_hadr_backup_is_preferred_replica('western'))  IF (@preferredReplica = 1) BEGIN     BACKUP LOG [western] TO  DISK = N'G:\Backup_SQL\WU\Transaction\western\western_backup_2024_04_04_060000_9739196.trn' WITH  RETAINDAYS = 7, NOFORMAT, NOINIT,  NAME = N'western_backup_2024_04_04_060000_9739196', SKIP, REWIND, NOUNLOAD, COMPRESSION,  STATS = 10 END ",66,49,17,151,0,66
"DECLARE @preferredReplica int  SET @preferredReplica = (SELECT [master].sys.fn_hadr_backup_is_preferred_replica('western'))  IF (@preferredReplica = 1) BEGIN     BACKUP LOG [western] TO  DISK = N'G:\Backup_SQL\WU\Transaction\western\western_backup_2024_04_16_200001_1130179.trn' WITH  RETAINDAYS = 7, NOFORMAT, NOINIT,  NAME = N'western_backup_2024_04_16_200001_1130179', SKIP, REWIND, NOUNLOAD, COMPRESSION,  STATS = 10 END ",66,56,10,236,0,66
"DECLARE @preferredReplica int  SET @preferredReplica = (SELECT [master].sys.fn_hadr_backup_is_preferred_replica('western'))  IF (@preferredReplica = 1) BEGIN     BACKUP LOG [western] TO  DISK = N'G:\Backup_SQL\WU\Transaction\western\western_backup_2024_04_08_230001_6410738.trn' WITH  RETAINDAYS = 7, NOFORMAT, NOINIT,  NAME = N'western_backup_2024_04_08_230001_6410738', SKIP, REWIND, NOUNLOAD, COMPRESSION,  STATS = 10 END ",66,60,6,236,0,66
"DECLARE @preferredReplica int  SET @preferredReplica = (SELECT [master].sys.fn_hadr_backup_is_preferred_replica('western'))  IF (@preferredReplica = 1) BEGIN     BACKUP LOG [western] TO  DISK = N'G:\Backup_SQL\WU\Transaction\western\western_backup_2024_04_02_230001_3062652.trn' WITH  RETAINDAYS = 7, NOFORMAT, NOINIT,  NAME = N'western_backup_2024_04_02_230001_3062652', SKIP, REWIND, NOUNLOAD, COMPRESSION,  STATS = 10 END ",65,61,4,236,0,65
"DECLARE @preferredReplica int  SET @preferredReplica = (SELECT [master].sys.fn_hadr_backup_is_preferred_replica('western'))  IF (@preferredReplica = 1) BEGIN     BACKUP DATABASE [western] TO  DISK = N'G:\Backup_SQL\WU\Full\western\western_backup_2024_03_20_110001_7314655.bak' WITH  RETAINDAYS = 7, NOFORMAT, NOINIT,  NAME = N'western_backup_2024_03_20_110001_7314655', SKIP, REWIND, NOUNLOAD, COMPRESSION,  STATS = 10 END ",65,50,15,151,0,65
"DECLARE @preferredReplica int  SET @preferredReplica = (SELECT [master].sys.fn_hadr_backup_is_preferred_replica('western'))  IF (@preferredReplica = 1) BEGIN     BACKUP LOG [western] TO  DISK = N'G:\Backup_SQL\WU\Transaction\western\western_backup_2024_03_23_150001_0147863.trn' WITH  RETAINDAYS = 7, NOFORMAT, NOINIT,  NAME = N'western_backup_2024_03_23_150001_0147863', SKIP, REWIND, NOUNLOAD, COMPRESSION,  STATS = 10 END ",65,39,26,151,0,65
"DECLARE @preferredReplica int  SET @preferredReplica = (SELECT [master].sys.fn_hadr_backup_is_preferred_replica('western'))  IF (@preferredReplica = 1) BEGIN     BACKUP LOG [western] TO  DISK = N'G:\Backup_SQL\WU\Transaction\western\western_backup_2024_04_16_210001_5491951.trn' WITH  RETAINDAYS = 7, NOFORMAT, NOINIT,  NAME = N'western_backup_2024_04_16_210001_5491951', SKIP, REWIND, NOUNLOAD, COMPRESSION,  STATS = 10 END ",65,48,17,151,0,65
"DECLARE @preferredReplica int  SET @preferredReplica = (SELECT [master].sys.fn_hadr_backup_is_preferred_replica('western'))  IF (@preferredReplica = 1) BEGIN     BACKUP LOG [western] TO  DISK = N'G:\Backup_SQL\WU\Transaction\western\western_backup_2024_03_22_230001_9829502.trn' WITH  RETAINDAYS = 7, NOFORMAT, NOINIT,  NAME = N'western_backup_2024_03_22_230001_9829502', SKIP, REWIND, NOUNLOAD, COMPRESSION,  STATS = 10 END ",65,60,5,236,0,65
"DECLARE @preferredReplica int  SET @preferredReplica = (SELECT [master].sys.fn_hadr_backup_is_preferred_replica('western'))  IF (@preferredReplica = 1) BEGIN     BACKUP LOG [western] TO  DISK = N'G:\Backup_SQL\WU\Transaction\western\western_backup_2024_04_09_070000_8843770.trn' WITH  RETAINDAYS = 7, NOFORMAT, NOINIT,  NAME = N'western_backup_2024_04_09_070000_8843770', SKIP, REWIND, NOUNLOAD, COMPRESSION,  STATS = 10 END ",64,44,20,151,0,64
"DECLARE @preferredReplica int  SET @preferredReplica = (SELECT [master].sys.fn_hadr_backup_is_preferred_replica('western'))  IF (@preferredReplica = 1) BEGIN     BACKUP LOG [western] TO  DISK = N'G:\Backup_SQL\WU\Transaction\western\western_backup_2024_04_02_170001_2871808.trn' WITH  RETAINDAYS = 7, NOFORMAT, NOINIT,  NAME = N'western_backup_2024_04_02_170001_2871808', SKIP, REWIND, NOUNLOAD, COMPRESSION,  STATS = 10 END ",64,58,6,236,0,64
"DECLARE @preferredReplica int  SET @preferredReplica = (SELECT [master].sys.fn_hadr_backup_is_preferred_replica('western'))  IF (@preferredReplica = 1) BEGIN     BACKUP LOG [western] TO  DISK = N'G:\Backup_SQL\WU\Transaction\western\western_backup_2024_04_07_130001_0302739.trn' WITH  RETAINDAYS = 7, NOFORMAT, NOINIT,  NAME = N'western_backup_2024_04_07_130001_0302739', SKIP, REWIND, NOUNLOAD, COMPRESSION,  STATS = 10 END ",64,57,7,190,0,64
"DECLARE @preferredReplica int  SET @preferredReplica = (SELECT [master].sys.fn_hadr_backup_is_preferred_replica('western'))  IF (@preferredReplica = 1) BEGIN     BACKUP LOG [western] TO  DISK = N'G:\Backup_SQL\WU\Transaction\western\western_backup_2024_03_23_020001_4251061.trn' WITH  RETAINDAYS = 7, NOFORMAT, NOINIT,  NAME = N'western_backup_2024_03_23_020001_4251061', SKIP, REWIND, NOUNLOAD, COMPRESSION,  STATS = 10 END ",63,60,3,236,0,63
"DECLARE @preferredReplica int  SET @preferredReplica = (SELECT [master].sys.fn_hadr_backup_is_preferred_replica('western'))  IF (@preferredReplica = 1) BEGIN     BACKUP LOG [western] TO  DISK = N'G:\Backup_SQL\WU\Transaction\western\western_backup_2024_03_25_110000_9680824.trn' WITH  RETAINDAYS = 7, NOFORMAT, NOINIT,  NAME = N'western_backup_2024_03_25_110000_9680824', SKIP, REWIND, NOUNLOAD, COMPRESSION,  STATS = 10 END ",63,59,4,236,0,63
"DECLARE @preferredReplica int  SET @preferredReplica = (SELECT [master].sys.fn_hadr_backup_is_preferred_replica('western'))  IF (@preferredReplica = 1) BEGIN     BACKUP LOG [western] TO  DISK = N'G:\Backup_SQL\WU\Transaction\western\western_backup_2024_04_07_170000_9781980.trn' WITH  RETAINDAYS = 7, NOFORMAT, NOINIT,  NAME = N'western_backup_2024_04_07_170000_9781980', SKIP, REWIND, NOUNLOAD, COMPRESSION,  STATS = 10 END ",63,60,3,236,0,63
"DECLARE @preferredReplica int  SET @preferredReplica = (SELECT [master].sys.fn_hadr_backup_is_preferred_replica('western'))  IF (@preferredReplica = 1) BEGIN     BACKUP LOG [western] TO  DISK = N'G:\Backup_SQL\WU\Transaction\western\western_backup_2024_04_06_200001_3744997.trn' WITH  RETAINDAYS = 7, NOFORMAT, NOINIT,  NAME = N'western_backup_2024_04_06_200001_3744997', SKIP, REWIND, NOUNLOAD, COMPRESSION,  STATS = 10 END ",63,59,4,236,0,63
"DECLARE @preferredReplica int  SET @preferredReplica = (SELECT [master].sys.fn_hadr_backup_is_preferred_replica('western'))  IF (@preferredReplica = 1) BEGIN     BACKUP LOG [western] TO  DISK = N'G:\Backup_SQL\WU\Transaction\western\western_backup_2024_04_18_230001_7908615.trn' WITH  RETAINDAYS = 7, NOFORMAT, NOINIT,  NAME = N'western_backup_2024_04_18_230001_7908615', SKIP, REWIND, NOUNLOAD, COMPRESSION,  STATS = 10 END ",63,61,2,236,0,63
"DECLARE @preferredReplica int  SET @preferredReplica = (SELECT [master].sys.fn_hadr_backup_is_preferred_replica('western'))  IF (@preferredReplica = 1) BEGIN     BACKUP LOG [western] TO  DISK = N'G:\Backup_SQL\WU\Transaction\western\western_backup_2024_04_05_170001_1284854.trn' WITH  RETAINDAYS = 7, NOFORMAT, NOINIT,  NAME = N'western_backup_2024_04_05_170001_1284854', SKIP, REWIND, NOUNLOAD, COMPRESSION,  STATS = 10 END ",62,58,4,236,0,62
"DECLARE @preferredReplica int  SET @preferredReplica = (SELECT [master].sys.fn_hadr_backup_is_preferred_replica('western'))  IF (@preferredReplica = 1) BEGIN     BACKUP LOG [western] TO  DISK = N'G:\Backup_SQL\WU\Transaction\western\western_backup_2024_03_21_230001_2855454.trn' WITH  RETAINDAYS = 7, NOFORMAT, NOINIT,  NAME = N'western_backup_2024_03_21_230001_2855454', SKIP, REWIND, NOUNLOAD, COMPRESSION,  STATS = 10 END ",62,60,2,236,0,62
"DECLARE @preferredReplica int  SET @preferredReplica = (SELECT [master].sys.fn_hadr_backup_is_preferred_replica('western'))  IF (@preferredReplica = 1) BEGIN     BACKUP LOG [western] TO  DISK = N'G:\Backup_SQL\WU\Transaction\western\western_backup_2024_04_19_140000_9095872.trn' WITH  RETAINDAYS = 7, NOFORMAT, NOINIT,  NAME = N'western_backup_2024_04_19_140000_9095872', SKIP, REWIND, NOUNLOAD, COMPRESSION,  STATS = 10 END ",62,58,4,236,0,62
