"         SELECT             c.id AS course,             u.id AS userid,             crc.id AS completionid,             ue.timestart AS timeenrolled,             ue.timecreated         FROM             mdl_user u         INNER JOIN             mdl_user_enrolments ue          ON ue.userid = u.id         INNER JOIN             mdl_enrol e          ON e.id = ue.enrolid         INNER JOIN             mdl_course c          ON c.id = e.courseid         INNER JOIN             mdl_role_assignments ra          ON ra.userid = u.id         LEFT JOIN             mdl_course_completions crc          ON crc.course = c.id         AND crc.userid = u.id         WHERE             c.enablecompletion = 1         AND crc.timeenrolled IS NULL         AND ue.status = 0         AND e.status = 0         AND u.deleted = 0         AND ue.timestart < '1713846111'         AND (ue.timeend > '1713846111' OR ue.timeend = 0)              AND ra.roleid IN (5,7)         ORDER BY             course,             userid     ",64442,375792,-311350,26830212,72,64442
select id from mdl_user,41177,9,41168,90,0,138273711
"         SELECT DISTINCT             c.id AS course,             cr.id AS criteriaid,             crc.userid AS userid,             cr.criteriatype AS criteriatype,             cc.timecompleted AS timecompleted         FROM             mdl_course_completion_criteria cr         INNER JOIN             mdl_course c          ON cr.course = c.id         INNER JOIN             mdl_course_completions crc          ON crc.course = c.id         LEFT JOIN             mdl_course_completion_crit_compl cc          ON cc.criteriaid = cr.id         AND crc.userid = cc.userid         WHERE             c.enablecompletion = 1         AND crc.timecompleted IS NULL         AND crc.reaggregate > 0         AND crc.reaggregate < '1713846180'         ORDER BY             course,             userid     ",4479,696,3783,74958,0,4479
SELECT * FROM mdl_user,2170,184,1986,4377,0,4341
"SELECT e.*, ue.userid                   FROM mdl_user_enrolments ue                   JOIN mdl_enrol e ON (e.id = ue.enrolid AND e.enrol = 'self' AND e.customint2 > 0)                   JOIN mdl_user u ON u.id = ue.userid                  WHERE '1713847609' - u.lastaccess > e.customint2                        ",2162,1996,166,247526,281,2162
"SELECT e.*, ue.userid                   FROM mdl_user_enrolments ue                   JOIN mdl_enrol e ON (e.id = ue.enrolid AND e.enrol = 'self' AND e.customint2 > 0)                   JOIN mdl_user u ON u.id = ue.userid                  WHERE '1713848513' - u.lastaccess > e.customint2                        ",1966,1906,60,247537,278,1966
"SELECT e.*, ue.userid                   FROM mdl_user_enrolments ue                   JOIN mdl_enrol e ON (e.id = ue.enrolid AND e.enrol = 'self' AND e.customint2 > 0)                   JOIN mdl_user u ON u.id = ue.userid                  WHERE '1713840412' - u.lastaccess > e.customint2                        ",1947,1947,0,247457,277,1947
"SELECT e.*, ue.userid                   FROM mdl_user_enrolments ue                   JOIN mdl_enrol e ON (e.id = ue.enrolid AND e.enrol = 'self' AND e.customint2 > 0)                   JOIN mdl_user u ON u.id = ue.userid                  WHERE '1713835014' - u.lastaccess > e.customint2                        ",1944,1944,0,247475,276,1944
"SELECT e.*, ue.userid                   FROM mdl_user_enrolments ue                   JOIN mdl_enrol e ON (e.id = ue.enrolid AND e.enrol = 'self' AND e.customint2 > 0)                   JOIN mdl_user u ON u.id = ue.userid                  WHERE '1713828709' - u.lastaccess > e.customint2                        ",1930,1930,0,247476,275,1930
"SELECT e.*, ue.userid                   FROM mdl_user_enrolments ue                   JOIN mdl_enrol e ON (e.id = ue.enrolid AND e.enrol = 'self' AND e.customint2 > 0)                   JOIN mdl_user u ON u.id = ue.userid                  WHERE '1713817009' - u.lastaccess > e.customint2                        ",1930,1930,0,247379,269,1930
"SELECT e.*, ue.userid                   FROM mdl_user_enrolments ue                   JOIN mdl_enrol e ON (e.id = ue.enrolid AND e.enrol = 'self' AND e.customint2 > 0)                   JOIN mdl_user u ON u.id = ue.userid                  WHERE '1713844913' - u.lastaccess > e.customint2                        ",1924,1924,0,247556,288,1924
"SELECT e.*, ue.userid                   FROM mdl_user_enrolments ue                   JOIN mdl_enrol e ON (e.id = ue.enrolid AND e.enrol = 'self' AND e.customint2 > 0)                   JOIN mdl_user u ON u.id = ue.userid                  WHERE '1713837709' - u.lastaccess > e.customint2                        ",1922,1922,0,247568,285,1922
"SELECT e.*, ue.userid                   FROM mdl_user_enrolments ue                   JOIN mdl_enrol e ON (e.id = ue.enrolid AND e.enrol = 'self' AND e.customint2 > 0)                   JOIN mdl_user u ON u.id = ue.userid                  WHERE '1713852113' - u.lastaccess > e.customint2                        ",1920,1920,0,247346,271,1920
"SELECT e.*, ue.userid                   FROM mdl_user_enrolments ue                   JOIN mdl_enrol e ON (e.id = ue.enrolid AND e.enrol = 'self' AND e.customint2 > 0)                   JOIN mdl_user u ON u.id = ue.userid                  WHERE '1713838613' - u.lastaccess > e.customint2                        ",1916,1915,1,247569,281,1916
"SELECT e.*, ue.userid                   FROM mdl_user_enrolments ue                   JOIN mdl_enrol e ON (e.id = ue.enrolid AND e.enrol = 'self' AND e.customint2 > 0)                   JOIN mdl_user u ON u.id = ue.userid                  WHERE '1713839509' - u.lastaccess > e.customint2                        ",1914,1914,0,247555,284,1914
"SELECT e.*, ue.userid                   FROM mdl_user_enrolments ue                   JOIN mdl_enrol e ON (e.id = ue.enrolid AND e.enrol = 'self' AND e.customint2 > 0)                   JOIN mdl_user u ON u.id = ue.userid                  WHERE '1713833213' - u.lastaccess > e.customint2                        ",1911,1911,0,247467,283,1911
"SELECT e.*, ue.userid                   FROM mdl_user_enrolments ue                   JOIN mdl_enrol e ON (e.id = ue.enrolid AND e.enrol = 'self' AND e.customint2 > 0)                   JOIN mdl_user u ON u.id = ue.userid                  WHERE '1713836813' - u.lastaccess > e.customint2                        ",1910,1910,0,247575,286,1910
"SELECT e.*, ue.userid                   FROM mdl_user_enrolments ue                   JOIN mdl_enrol e ON (e.id = ue.enrolid AND e.enrol = 'self' AND e.customint2 > 0)                   JOIN mdl_user u ON u.id = ue.userid                  WHERE '1713842213' - u.lastaccess > e.customint2                        ",1907,1907,0,247388,275,1907
"SELECT e.*, ue.userid                   FROM mdl_user_enrolments ue                   JOIN mdl_enrol e ON (e.id = ue.enrolid AND e.enrol = 'self' AND e.customint2 > 0)                   JOIN mdl_user u ON u.id = ue.userid                  WHERE '1713835910' - u.lastaccess > e.customint2                        ",1907,1907,0,247575,281,1907
"SELECT e.*, ue.userid                   FROM mdl_user_enrolments ue                   JOIN mdl_enrol e ON (e.id = ue.enrolid AND e.enrol = 'self' AND e.customint2 > 0)                   JOIN mdl_user u ON u.id = ue.userid                  WHERE '1713853909' - u.lastaccess > e.customint2                        ",1907,1906,1,247449,279,1907
"SELECT e.*, ue.userid                   FROM mdl_user_enrolments ue                   JOIN mdl_enrol e ON (e.id = ue.enrolid AND e.enrol = 'self' AND e.customint2 > 0)                   JOIN mdl_user u ON u.id = ue.userid                  WHERE '1713821513' - u.lastaccess > e.customint2                        ",1905,1905,0,247452,283,1905
"SELECT e.*, ue.userid                   FROM mdl_user_enrolments ue                   JOIN mdl_enrol e ON (e.id = ue.enrolid AND e.enrol = 'self' AND e.customint2 > 0)                   JOIN mdl_user u ON u.id = ue.userid                  WHERE '1713827814' - u.lastaccess > e.customint2                        ",1904,1904,0,247479,284,1904
"SELECT e.*, ue.userid                   FROM mdl_user_enrolments ue                   JOIN mdl_enrol e ON (e.id = ue.enrolid AND e.enrol = 'self' AND e.customint2 > 0)                   JOIN mdl_user u ON u.id = ue.userid                  WHERE '1713844009' - u.lastaccess > e.customint2                        ",1904,1904,0,247475,280,1904
"SELECT e.*, ue.userid                   FROM mdl_user_enrolments ue                   JOIN mdl_enrol e ON (e.id = ue.enrolid AND e.enrol = 'self' AND e.customint2 > 0)                   JOIN mdl_user u ON u.id = ue.userid                  WHERE '1713832309' - u.lastaccess > e.customint2                        ",1904,1904,0,247473,276,1904
"SELECT e.*, ue.userid                   FROM mdl_user_enrolments ue                   JOIN mdl_enrol e ON (e.id = ue.enrolid AND e.enrol = 'self' AND e.customint2 > 0)                   JOIN mdl_user u ON u.id = ue.userid                  WHERE '1713853013' - u.lastaccess > e.customint2                        ",1903,1903,0,247438,272,1903
"SELECT e.*, ue.userid                   FROM mdl_user_enrolments ue                   JOIN mdl_enrol e ON (e.id = ue.enrolid AND e.enrol = 'self' AND e.customint2 > 0)                   JOIN mdl_user u ON u.id = ue.userid                  WHERE '1713817914' - u.lastaccess > e.customint2                        ",1903,1903,0,247476,275,1903
"SELECT e.*, ue.userid                   FROM mdl_user_enrolments ue                   JOIN mdl_enrol e ON (e.id = ue.enrolid AND e.enrol = 'self' AND e.customint2 > 0)                   JOIN mdl_user u ON u.id = ue.userid                  WHERE '1713846713' - u.lastaccess > e.customint2                        ",1902,1901,1,247448,274,1902
"SELECT e.*, ue.userid                   FROM mdl_user_enrolments ue                   JOIN mdl_enrol e ON (e.id = ue.enrolid AND e.enrol = 'self' AND e.customint2 > 0)                   JOIN mdl_user u ON u.id = ue.userid                  WHERE '1713830509' - u.lastaccess > e.customint2                        ",1900,1899,1,247561,283,1900
"SELECT e.*, ue.userid                   FROM mdl_user_enrolments ue                   JOIN mdl_enrol e ON (e.id = ue.enrolid AND e.enrol = 'self' AND e.customint2 > 0)                   JOIN mdl_user u ON u.id = ue.userid                  WHERE '1713834110' - u.lastaccess > e.customint2                        ",1899,1899,0,247473,284,1899
"SELECT e.*, ue.userid                   FROM mdl_user_enrolments ue                   JOIN mdl_enrol e ON (e.id = ue.enrolid AND e.enrol = 'self' AND e.customint2 > 0)                   JOIN mdl_user u ON u.id = ue.userid                  WHERE '1713829613' - u.lastaccess > e.customint2                        ",1898,1898,0,247570,282,1898
"SELECT e.*, ue.userid                   FROM mdl_user_enrolments ue                   JOIN mdl_enrol e ON (e.id = ue.enrolid AND e.enrol = 'self' AND e.customint2 > 0)                   JOIN mdl_user u ON u.id = ue.userid                  WHERE '1713851209' - u.lastaccess > e.customint2                        ",1898,1897,1,247521,285,1898
"SELECT e.*, ue.userid                   FROM mdl_user_enrolments ue                   JOIN mdl_enrol e ON (e.id = ue.enrolid AND e.enrol = 'self' AND e.customint2 > 0)                   JOIN mdl_user u ON u.id = ue.userid                  WHERE '1713822409' - u.lastaccess > e.customint2                        ",1898,1897,1,247483,279,1898
"SELECT e.*, ue.userid                   FROM mdl_user_enrolments ue                   JOIN mdl_enrol e ON (e.id = ue.enrolid AND e.enrol = 'self' AND e.customint2 > 0)                   JOIN mdl_user u ON u.id = ue.userid                  WHERE '1713843114' - u.lastaccess > e.customint2                        ",1897,1896,1,247553,286,1897
"SELECT e.*, ue.userid                   FROM mdl_user_enrolments ue                   JOIN mdl_enrol e ON (e.id = ue.enrolid AND e.enrol = 'self' AND e.customint2 > 0)                   JOIN mdl_user u ON u.id = ue.userid                  WHERE '1713849409' - u.lastaccess > e.customint2                        ",1896,1896,0,247339,268,1896
"SELECT e.*, ue.userid                   FROM mdl_user_enrolments ue                   JOIN mdl_enrol e ON (e.id = ue.enrolid AND e.enrol = 'self' AND e.customint2 > 0)                   JOIN mdl_user u ON u.id = ue.userid                  WHERE '1713825113' - u.lastaccess > e.customint2                        ",1895,1895,0,247482,282,1895
"SELECT e.*, ue.userid                   FROM mdl_user_enrolments ue                   JOIN mdl_enrol e ON (e.id = ue.enrolid AND e.enrol = 'self' AND e.customint2 > 0)                   JOIN mdl_user u ON u.id = ue.userid                  WHERE '1713823313' - u.lastaccess > e.customint2                        ",1895,1895,0,247548,283,1895
"SELECT e.*, ue.userid                   FROM mdl_user_enrolments ue                   JOIN mdl_enrol e ON (e.id = ue.enrolid AND e.enrol = 'self' AND e.customint2 > 0)                   JOIN mdl_user u ON u.id = ue.userid                  WHERE '1713819715' - u.lastaccess > e.customint2                        ",1894,1894,0,247575,280,1894
"SELECT e.*, ue.userid                   FROM mdl_user_enrolments ue                   JOIN mdl_enrol e ON (e.id = ue.enrolid AND e.enrol = 'self' AND e.customint2 > 0)                   JOIN mdl_user u ON u.id = ue.userid                  WHERE '1713831413' - u.lastaccess > e.customint2                        ",1893,1893,0,247402,273,1893
"SELECT e.*, ue.userid                   FROM mdl_user_enrolments ue                   JOIN mdl_enrol e ON (e.id = ue.enrolid AND e.enrol = 'self' AND e.customint2 > 0)                   JOIN mdl_user u ON u.id = ue.userid                  WHERE '1713826910' - u.lastaccess > e.customint2                        ",1892,1892,0,247532,277,1892
"SELECT e.*, ue.userid                   FROM mdl_user_enrolments ue                   JOIN mdl_enrol e ON (e.id = ue.enrolid AND e.enrol = 'self' AND e.customint2 > 0)                   JOIN mdl_user u ON u.id = ue.userid                  WHERE '1713841310' - u.lastaccess > e.customint2                        ",1892,1892,0,247581,284,1892
"SELECT e.*, ue.userid                   FROM mdl_user_enrolments ue                   JOIN mdl_enrol e ON (e.id = ue.enrolid AND e.enrol = 'self' AND e.customint2 > 0)                   JOIN mdl_user u ON u.id = ue.userid                  WHERE '1713824209' - u.lastaccess > e.customint2                        ",1891,1891,0,247479,276,1891
"SELECT e.*, ue.userid                   FROM mdl_user_enrolments ue                   JOIN mdl_enrol e ON (e.id = ue.enrolid AND e.enrol = 'self' AND e.customint2 > 0)                   JOIN mdl_user u ON u.id = ue.userid                  WHERE '1713854814' - u.lastaccess > e.customint2                        ",1890,1889,1,247436,275,1890
"SELECT e.*, ue.userid                   FROM mdl_user_enrolments ue                   JOIN mdl_enrol e ON (e.id = ue.enrolid AND e.enrol = 'self' AND e.customint2 > 0)                   JOIN mdl_user u ON u.id = ue.userid                  WHERE '1713845809' - u.lastaccess > e.customint2                        ",1889,1889,0,247460,271,1889
"SELECT e.*, ue.userid                   FROM mdl_user_enrolments ue                   JOIN mdl_enrol e ON (e.id = ue.enrolid AND e.enrol = 'self' AND e.customint2 > 0)                   JOIN mdl_user u ON u.id = ue.userid                  WHERE '1713818809' - u.lastaccess > e.customint2                        ",1887,1887,0,247470,272,1887
"SELECT e.*, ue.userid                   FROM mdl_user_enrolments ue                   JOIN mdl_enrol e ON (e.id = ue.enrolid AND e.enrol = 'self' AND e.customint2 > 0)                   JOIN mdl_user u ON u.id = ue.userid                  WHERE '1713850313' - u.lastaccess > e.customint2                        ",1886,1885,1,247432,271,1886
"SELECT e.*, ue.userid                   FROM mdl_user_enrolments ue                   JOIN mdl_enrol e ON (e.id = ue.enrolid AND e.enrol = 'self' AND e.customint2 > 0)                   JOIN mdl_user u ON u.id = ue.userid                  WHERE '1713820609' - u.lastaccess > e.customint2                        ",1884,1884,0,247575,283,1884
"SELECT e.*, ue.userid                   FROM mdl_user_enrolments ue                   JOIN mdl_enrol e ON (e.id = ue.enrolid AND e.enrol = 'self' AND e.customint2 > 0)                   JOIN mdl_user u ON u.id = ue.userid                  WHERE '1713826014' - u.lastaccess > e.customint2                        ",1884,1884,0,247482,275,1884
"             SELECT DISTINCT                 c.id AS course,                 cr.id AS criteriaid,                 ra.userid AS userid,                 mc.timemodified AS timecompleted             FROM                 mdl_course_completion_criteria cr             INNER JOIN                 mdl_course c              ON cr.course = c.id             INNER JOIN                 mdl_context con              ON con.instanceid = c.id             INNER JOIN                 mdl_role_assignments ra               ON ra.contextid = con.id             INNER JOIN                 mdl_course_modules_completion mc              ON mc.coursemoduleid = cr.moduleinstance             AND mc.userid = ra.userid             LEFT JOIN                 mdl_course_completion_crit_compl cc              ON cc.criteriaid = cr.id             AND cc.userid = ra.userid             WHERE                 cr.criteriatype = 4             AND con.contextlevel = 50             AND c.enablecompletion = 1             AND cc.id IS NULL             AND (                 mc.completionstate = 1              OR mc.completionstate = 2              OR mc.completionstate = 3                 )         ",1789,11639,-9850,98076,0,15774500
"SELECT e.*, ue.userid                   FROM mdl_user_enrolments ue                   JOIN mdl_enrol e ON (e.id = ue.enrolid AND e.enrol = 'self' AND e.customint2 > 0)                   JOIN mdl_user_lastaccess ul ON (ul.userid = ue.userid AND ul.courseid = e.courseid)                  WHERE '1713842213' - ul.timeaccess > e.customint2                        ",1116,1116,0,442582,977,1116
"SELECT e.*, ue.userid                   FROM mdl_user_enrolments ue                   JOIN mdl_enrol e ON (e.id = ue.enrolid AND e.enrol = 'self' AND e.customint2 > 0)                   JOIN mdl_user_lastaccess ul ON (ul.userid = ue.userid AND ul.courseid = e.courseid)                  WHERE '1713847609' - ul.timeaccess > e.customint2                        ",1090,1090,0,442715,983,1090
"SELECT e.*, ue.userid                   FROM mdl_user_enrolments ue                   JOIN mdl_enrol e ON (e.id = ue.enrolid AND e.enrol = 'self' AND e.customint2 > 0)                   JOIN mdl_user_lastaccess ul ON (ul.userid = ue.userid AND ul.courseid = e.courseid)                  WHERE '1713846713' - ul.timeaccess > e.customint2                        ",1076,1076,0,442717,984,1076
"SELECT e.*, ue.userid                   FROM mdl_user_enrolments ue                   JOIN mdl_enrol e ON (e.id = ue.enrolid AND e.enrol = 'self' AND e.customint2 > 0)                   JOIN mdl_user_lastaccess ul ON (ul.userid = ue.userid AND ul.courseid = e.courseid)                  WHERE '1713828709' - ul.timeaccess > e.customint2                        ",1074,1074,0,442645,985,1074
"SELECT e.*, ue.userid                   FROM mdl_user_enrolments ue                   JOIN mdl_enrol e ON (e.id = ue.enrolid AND e.enrol = 'self' AND e.customint2 > 0)                   JOIN mdl_user_lastaccess ul ON (ul.userid = ue.userid AND ul.courseid = e.courseid)                  WHERE '1713837709' - ul.timeaccess > e.customint2                        ",1071,1071,0,442656,985,1071
"SELECT e.*, ue.userid                   FROM mdl_user_enrolments ue                   JOIN mdl_enrol e ON (e.id = ue.enrolid AND e.enrol = 'self' AND e.customint2 > 0)                   JOIN mdl_user_lastaccess ul ON (ul.userid = ue.userid AND ul.courseid = e.courseid)                  WHERE '1713819715' - ul.timeaccess > e.customint2                        ",1067,1067,0,442546,984,1067
"SELECT e.*, ue.userid                   FROM mdl_user_enrolments ue                   JOIN mdl_enrol e ON (e.id = ue.enrolid AND e.enrol = 'self' AND e.customint2 > 0)                   JOIN mdl_user_lastaccess ul ON (ul.userid = ue.userid AND ul.courseid = e.courseid)                  WHERE '1713853013' - ul.timeaccess > e.customint2                        ",1065,1065,0,442786,984,1065
"SELECT e.*, ue.userid                   FROM mdl_user_enrolments ue                   JOIN mdl_enrol e ON (e.id = ue.enrolid AND e.enrol = 'self' AND e.customint2 > 0)                   JOIN mdl_user_lastaccess ul ON (ul.userid = ue.userid AND ul.courseid = e.courseid)                  WHERE '1713841310' - ul.timeaccess > e.customint2                        ",1064,1064,0,442684,984,1064
"SELECT e.*, ue.userid                   FROM mdl_user_enrolments ue                   JOIN mdl_enrol e ON (e.id = ue.enrolid AND e.enrol = 'self' AND e.customint2 > 0)                   JOIN mdl_user_lastaccess ul ON (ul.userid = ue.userid AND ul.courseid = e.courseid)                  WHERE '1713824209' - ul.timeaccess > e.customint2                        ",1062,1062,0,442546,978,1062
"SELECT e.*, ue.userid                   FROM mdl_user_enrolments ue                   JOIN mdl_enrol e ON (e.id = ue.enrolid AND e.enrol = 'self' AND e.customint2 > 0)                   JOIN mdl_user_lastaccess ul ON (ul.userid = ue.userid AND ul.courseid = e.courseid)                  WHERE '1713848513' - ul.timeaccess > e.customint2                        ",1061,1061,0,442738,983,1061
"SELECT e.*, ue.userid                   FROM mdl_user_enrolments ue                   JOIN mdl_enrol e ON (e.id = ue.enrolid AND e.enrol = 'self' AND e.customint2 > 0)                   JOIN mdl_user_lastaccess ul ON (ul.userid = ue.userid AND ul.courseid = e.courseid)                  WHERE '1713817914' - ul.timeaccess > e.customint2                        ",1061,1060,1,442546,978,1061
"SELECT e.*, ue.userid                   FROM mdl_user_enrolments ue                   JOIN mdl_enrol e ON (e.id = ue.enrolid AND e.enrol = 'self' AND e.customint2 > 0)                   JOIN mdl_user_lastaccess ul ON (ul.userid = ue.userid AND ul.courseid = e.courseid)                  WHERE '1713853909' - ul.timeaccess > e.customint2                        ",1059,1059,0,442785,986,1059
"SELECT e.*, ue.userid                   FROM mdl_user_enrolments ue                   JOIN mdl_enrol e ON (e.id = ue.enrolid AND e.enrol = 'self' AND e.customint2 > 0)                   JOIN mdl_user_lastaccess ul ON (ul.userid = ue.userid AND ul.courseid = e.courseid)                  WHERE '1713849409' - ul.timeaccess > e.customint2                        ",1059,1059,0,442746,984,1059
"SELECT e.*, ue.userid                   FROM mdl_user_enrolments ue                   JOIN mdl_enrol e ON (e.id = ue.enrolid AND e.enrol = 'self' AND e.customint2 > 0)                   JOIN mdl_user_lastaccess ul ON (ul.userid = ue.userid AND ul.courseid = e.courseid)                  WHERE '1713817009' - ul.timeaccess > e.customint2                        ",1059,1059,0,442644,985,1059
"SELECT e.*, ue.userid                   FROM mdl_user_enrolments ue                   JOIN mdl_enrol e ON (e.id = ue.enrolid AND e.enrol = 'self' AND e.customint2 > 0)                   JOIN mdl_user_lastaccess ul ON (ul.userid = ue.userid AND ul.courseid = e.courseid)                  WHERE '1713854814' - ul.timeaccess > e.customint2                        ",1058,1058,0,442697,986,1058
"SELECT e.*, ue.userid                   FROM mdl_user_enrolments ue                   JOIN mdl_enrol e ON (e.id = ue.enrolid AND e.enrol = 'self' AND e.customint2 > 0)                   JOIN mdl_user_lastaccess ul ON (ul.userid = ue.userid AND ul.courseid = e.courseid)                  WHERE '1713844009' - ul.timeaccess > e.customint2                        ",1057,1057,0,442695,987,1057
"SELECT e.*, ue.userid                   FROM mdl_user_enrolments ue                   JOIN mdl_enrol e ON (e.id = ue.enrolid AND e.enrol = 'self' AND e.customint2 > 0)                   JOIN mdl_user_lastaccess ul ON (ul.userid = ue.userid AND ul.courseid = e.courseid)                  WHERE '1713831413' - ul.timeaccess > e.customint2                        ",1057,1057,0,442558,985,1057
"SELECT e.*, ue.userid                   FROM mdl_user_enrolments ue                   JOIN mdl_enrol e ON (e.id = ue.enrolid AND e.enrol = 'self' AND e.customint2 > 0)                   JOIN mdl_user_lastaccess ul ON (ul.userid = ue.userid AND ul.courseid = e.courseid)                  WHERE '1713835910' - ul.timeaccess > e.customint2                        ",1057,1057,0,442551,986,1057
"SELECT e.*, ue.userid                   FROM mdl_user_enrolments ue                   JOIN mdl_enrol e ON (e.id = ue.enrolid AND e.enrol = 'self' AND e.customint2 > 0)                   JOIN mdl_user_lastaccess ul ON (ul.userid = ue.userid AND ul.courseid = e.courseid)                  WHERE '1713822409' - ul.timeaccess > e.customint2                        ",1056,1056,0,442648,985,1056
"SELECT e.*, ue.userid                   FROM mdl_user_enrolments ue                   JOIN mdl_enrol e ON (e.id = ue.enrolid AND e.enrol = 'self' AND e.customint2 > 0)                   JOIN mdl_user_lastaccess ul ON (ul.userid = ue.userid AND ul.courseid = e.courseid)                  WHERE '1713835014' - ul.timeaccess > e.customint2                        ",1056,1056,0,442648,985,1056
"SELECT e.*, ue.userid                   FROM mdl_user_enrolments ue                   JOIN mdl_enrol e ON (e.id = ue.enrolid AND e.enrol = 'self' AND e.customint2 > 0)                   JOIN mdl_user_lastaccess ul ON (ul.userid = ue.userid AND ul.courseid = e.courseid)                  WHERE '1713829613' - ul.timeaccess > e.customint2                        ",1054,1054,0,442636,985,1054
"SELECT e.*, ue.userid                   FROM mdl_user_enrolments ue                   JOIN mdl_enrol e ON (e.id = ue.enrolid AND e.enrol = 'self' AND e.customint2 > 0)                   JOIN mdl_user_lastaccess ul ON (ul.userid = ue.userid AND ul.courseid = e.courseid)                  WHERE '1713827814' - ul.timeaccess > e.customint2                        ",1054,1054,0,442546,978,1054
"SELECT e.*, ue.userid                   FROM mdl_user_enrolments ue                   JOIN mdl_enrol e ON (e.id = ue.enrolid AND e.enrol = 'self' AND e.customint2 > 0)                   JOIN mdl_user_lastaccess ul ON (ul.userid = ue.userid AND ul.courseid = e.courseid)                  WHERE '1713826014' - ul.timeaccess > e.customint2                        ",1053,1053,0,442639,985,1053
"SELECT e.*, ue.userid                   FROM mdl_user_enrolments ue                   JOIN mdl_enrol e ON (e.id = ue.enrolid AND e.enrol = 'self' AND e.customint2 > 0)                   JOIN mdl_user_lastaccess ul ON (ul.userid = ue.userid AND ul.courseid = e.courseid)                  WHERE '1713845809' - ul.timeaccess > e.customint2                        ",1053,1053,0,442613,977,1053
"SELECT e.*, ue.userid                   FROM mdl_user_enrolments ue                   JOIN mdl_enrol e ON (e.id = ue.enrolid AND e.enrol = 'self' AND e.customint2 > 0)                   JOIN mdl_user_lastaccess ul ON (ul.userid = ue.userid AND ul.courseid = e.courseid)                  WHERE '1713852113' - ul.timeaccess > e.customint2                        ",1053,1053,0,442774,984,1053
"SELECT e.*, ue.userid                   FROM mdl_user_enrolments ue                   JOIN mdl_enrol e ON (e.id = ue.enrolid AND e.enrol = 'self' AND e.customint2 > 0)                   JOIN mdl_user_lastaccess ul ON (ul.userid = ue.userid AND ul.courseid = e.courseid)                  WHERE '1713850313' - ul.timeaccess > e.customint2                        ",1053,1053,0,442753,986,1053
"SELECT e.*, ue.userid                   FROM mdl_user_enrolments ue                   JOIN mdl_enrol e ON (e.id = ue.enrolid AND e.enrol = 'self' AND e.customint2 > 0)                   JOIN mdl_user_lastaccess ul ON (ul.userid = ue.userid AND ul.courseid = e.courseid)                  WHERE '1713843114' - ul.timeaccess > e.customint2                        ",1053,1053,0,442684,985,1053
"SELECT e.*, ue.userid                   FROM mdl_user_enrolments ue                   JOIN mdl_enrol e ON (e.id = ue.enrolid AND e.enrol = 'self' AND e.customint2 > 0)                   JOIN mdl_user_lastaccess ul ON (ul.userid = ue.userid AND ul.courseid = e.courseid)                  WHERE '1713826910' - ul.timeaccess > e.customint2                        ",1053,1053,0,442624,984,1053
"SELECT e.*, ue.userid                   FROM mdl_user_enrolments ue                   JOIN mdl_enrol e ON (e.id = ue.enrolid AND e.enrol = 'self' AND e.customint2 > 0)                   JOIN mdl_user_lastaccess ul ON (ul.userid = ue.userid AND ul.courseid = e.courseid)                  WHERE '1713834110' - ul.timeaccess > e.customint2                        ",1053,1052,1,442643,985,1053
"SELECT e.*, ue.userid                   FROM mdl_user_enrolments ue                   JOIN mdl_enrol e ON (e.id = ue.enrolid AND e.enrol = 'self' AND e.customint2 > 0)                   JOIN mdl_user_lastaccess ul ON (ul.userid = ue.userid AND ul.courseid = e.courseid)                  WHERE '1713825113' - ul.timeaccess > e.customint2                        ",1051,1051,0,442544,985,1051
"SELECT e.*, ue.userid                   FROM mdl_user_enrolments ue                   JOIN mdl_enrol e ON (e.id = ue.enrolid AND e.enrol = 'self' AND e.customint2 > 0)                   JOIN mdl_user_lastaccess ul ON (ul.userid = ue.userid AND ul.courseid = e.courseid)                  WHERE '1713840412' - ul.timeaccess > e.customint2                        ",1050,1050,0,442666,986,1050
"SELECT e.*, ue.userid                   FROM mdl_user_enrolments ue                   JOIN mdl_enrol e ON (e.id = ue.enrolid AND e.enrol = 'self' AND e.customint2 > 0)                   JOIN mdl_user_lastaccess ul ON (ul.userid = ue.userid AND ul.courseid = e.courseid)                  WHERE '1713851209' - ul.timeaccess > e.customint2                        ",1050,1050,0,442671,986,1050
"SELECT e.*, ue.userid                   FROM mdl_user_enrolments ue                   JOIN mdl_enrol e ON (e.id = ue.enrolid AND e.enrol = 'self' AND e.customint2 > 0)                   JOIN mdl_user_lastaccess ul ON (ul.userid = ue.userid AND ul.courseid = e.courseid)                  WHERE '1713836813' - ul.timeaccess > e.customint2                        ",1050,1050,0,442557,983,1050
"SELECT e.*, ue.userid                   FROM mdl_user_enrolments ue                   JOIN mdl_enrol e ON (e.id = ue.enrolid AND e.enrol = 'self' AND e.customint2 > 0)                   JOIN mdl_user_lastaccess ul ON (ul.userid = ue.userid AND ul.courseid = e.courseid)                  WHERE '1713823313' - ul.timeaccess > e.customint2                        ",1050,1050,0,442632,984,1050
"SELECT e.*, ue.userid                   FROM mdl_user_enrolments ue                   JOIN mdl_enrol e ON (e.id = ue.enrolid AND e.enrol = 'self' AND e.customint2 > 0)                   JOIN mdl_user_lastaccess ul ON (ul.userid = ue.userid AND ul.courseid = e.courseid)                  WHERE '1713844913' - ul.timeaccess > e.customint2                        ",1050,1050,0,442702,984,1050
"SELECT e.*, ue.userid                   FROM mdl_user_enrolments ue                   JOIN mdl_enrol e ON (e.id = ue.enrolid AND e.enrol = 'self' AND e.customint2 > 0)                   JOIN mdl_user_lastaccess ul ON (ul.userid = ue.userid AND ul.courseid = e.courseid)                  WHERE '1713820609' - ul.timeaccess > e.customint2                        ",1047,1047,0,442554,985,1047
"SELECT e.*, ue.userid                   FROM mdl_user_enrolments ue                   JOIN mdl_enrol e ON (e.id = ue.enrolid AND e.enrol = 'self' AND e.customint2 > 0)                   JOIN mdl_user_lastaccess ul ON (ul.userid = ue.userid AND ul.courseid = e.courseid)                  WHERE '1713832309' - ul.timeaccess > e.customint2                        ",1046,1046,0,442636,985,1046
"SELECT e.*, ue.userid                   FROM mdl_user_enrolments ue                   JOIN mdl_enrol e ON (e.id = ue.enrolid AND e.enrol = 'self' AND e.customint2 > 0)                   JOIN mdl_user_lastaccess ul ON (ul.userid = ue.userid AND ul.courseid = e.courseid)                  WHERE '1713821513' - ul.timeaccess > e.customint2                        ",1046,1046,0,442640,984,1046
"SELECT e.*, ue.userid                   FROM mdl_user_enrolments ue                   JOIN mdl_enrol e ON (e.id = ue.enrolid AND e.enrol = 'self' AND e.customint2 > 0)                   JOIN mdl_user_lastaccess ul ON (ul.userid = ue.userid AND ul.courseid = e.courseid)                  WHERE '1713833213' - ul.timeaccess > e.customint2                        ",1045,1045,0,442558,985,1045
"SELECT e.*, ue.userid                   FROM mdl_user_enrolments ue                   JOIN mdl_enrol e ON (e.id = ue.enrolid AND e.enrol = 'self' AND e.customint2 > 0)                   JOIN mdl_user_lastaccess ul ON (ul.userid = ue.userid AND ul.courseid = e.courseid)                  WHERE '1713818809' - ul.timeaccess > e.customint2                        ",1044,1044,0,442633,985,1044
"SELECT e.*, ue.userid                   FROM mdl_user_enrolments ue                   JOIN mdl_enrol e ON (e.id = ue.enrolid AND e.enrol = 'self' AND e.customint2 > 0)                   JOIN mdl_user_lastaccess ul ON (ul.userid = ue.userid AND ul.courseid = e.courseid)                  WHERE '1713838613' - ul.timeaccess > e.customint2                        ",1044,1044,0,442672,985,1044
"SELECT e.*, ue.userid                   FROM mdl_user_enrolments ue                   JOIN mdl_enrol e ON (e.id = ue.enrolid AND e.enrol = 'self' AND e.customint2 > 0)                   JOIN mdl_user_lastaccess ul ON (ul.userid = ue.userid AND ul.courseid = e.courseid)                  WHERE '1713839509' - ul.timeaccess > e.customint2                        ",1043,1043,0,442674,986,1043
"SELECT e.*, ue.userid                   FROM mdl_user_enrolments ue                   JOIN mdl_enrol e ON (e.id = ue.enrolid AND e.enrol = 'self' AND e.customint2 > 0)                   JOIN mdl_user_lastaccess ul ON (ul.userid = ue.userid AND ul.courseid = e.courseid)                  WHERE '1713830509' - ul.timeaccess > e.customint2                        ",1041,1041,0,442554,984,1041
"  SELECT distinct userid 	FROM mdl_logstore_standard_log 	where action = 'loggedin' and CAST(CONVERT(VARCHAR,dateadd(s, timecreated, '1970-01-01 00:00:00'),1) AS DATE) > '2020-11-30'",441,2457,-2016,469070,0,758087
"(SELECT ctx.path, rc.roleid, rc.capability, rc.permission                      FROM mdl_role_capabilities rc                      JOIN mdl_context ctx                           ON (ctx.id = rc.contextid)                      JOIN mdl_context pctx                           ON (pctx.id = '1'                               AND (ctx.id = pctx.id                                    OR ctx.path LIKE   CAST(pctx.path AS NVARCHAR(255))  +  CAST('/%' AS NVARCHAR(255))                                      OR pctx.path LIKE   CAST(ctx.path AS NVARCHAR(255))  +  CAST('/%' AS NVARCHAR(255))  ))                 LEFT JOIN mdl_block_instances bi                           ON (ctx.contextlevel = 80 AND bi.id = ctx.instanceid)                 LEFT JOIN mdl_context bpctx                           ON (bpctx.id = bi.parentcontextid)                     WHERE rc.roleid = '7'                           AND (ctx.contextlevel <= 50 OR bpctx.contextlevel < 50)                    ) UNION (SELECT ctx.path, rc.roleid, rc.capability, rc.permission                      FROM mdl_role_capabilities rc                      JOIN mdl_context ctx                           ON (ctx.id = rc.contextid)                      JOIN mdl_context pctx                           ON (pctx.id = '2'                               AND (ctx.id = pctx.id                                    OR ctx.path LIKE   CAST(pctx.path AS NVARCHAR(255))  +  CAST('/%' AS NVARCHAR(255))                                      OR pctx.path LIKE   CAST(ctx.path AS NVARCHAR(255))  +  CAST('/%' AS NVARCHAR(255))  ))                 LEFT JOIN mdl_block_instances bi                           ON (ctx.contextlevel = 80 AND bi.id = ctx.instanceid)                 LEFT JOIN mdl_context bpctx                           ON (bpctx.id = bi.parentcontextid)                     WHERE rc.roleid = '8'                           AND (ctx.contextlevel <= 50 OR bpctx.contextlevel < 50)                    ) UNION (SELECT ctx.path, rc.roleid, rc.capability, rc.permission                      FROM mdl_role_capabilities rc                      JOIN mdl_context ctx                           ON (ctx.id = rc.contextid)                      JOIN mdl_context pctx                           ON (pctx.id IN ('55','5723','7374','29529','29551','30016','30070','30085','30103','30111','30117','30204','32833','32838','33013','34083','34894','34900','35322','35676','35696','35953','36197','36361','36377','36405','36527','36552','36559','36565','36571','36579','36585','36591','36697','36703','36709','36739','36920','36926','36933','36939','36948','36974','36980','36986','37016','37022','37028','37045','37056','37062','37068','37074','37126','37132','37138','37147','37153','37159','37300','37313','37328','37806','37813','37819','37825','37880','37886','37892','37898','37965','37971','37977','38039','38045','38051','38089','38095','38101','38107','38145','38151','38293','38299','38305','38311','38322','38341','38347','38361','38367','38373','38379','38440','38452','38458','38464','38472','38483','38489','38495','38506','38512','38518','38524','38530','38536','38543','38549','38555','38671','38704','38709','38773','39123','39129','39135','39141','43067','43364','43370','43376','43382','44665','44671','44677','44683','45298','45304','45310','45422','45437','45442','45448','45454','45460','45482','45487','45588','45596','45741','45760','45766','45772','45778','45799','45823','45835','45842','45866','46068','46074','46080','55049','55496','55683','55701','55707','55713','55756','55799','55805','55817','55823','55864')                               AND (ctx.id = pctx.id                                    OR ctx.path LIKE   CAST(pctx.path AS NVARCHAR(255))  +  CAST('/%' AS NVARCHAR(255))                                      OR pctx.path LIKE   CAST(ctx.path AS NVARCHAR(255))  +  CAST('/%' AS NVARCHAR(255))  ))                 LEFT JOIN mdl_block_instances bi                           ON (ctx.contextlevel = 80 AND bi.id = ctx.instanceid)                 LEFT JOIN mdl_context bpctx                           ON (bpctx.id = bi.parentcontextid)                     WHERE rc.roleid = '5'                           AND (ctx.contextlevel <= 50 OR bpctx.contextlevel < 50)                    ) UNION (SELECT ctx.path, rc.roleid, rc.capability, rc.permission                      FROM mdl_role_capabilities rc                      JOIN mdl_context ctx                           ON (ctx.id = rc.contextid)                      JOIN mdl_context pctx                           ON (pctx.id IN ('34906','35703','35754','36227','36411','37103','37264','37273','37370','38006','38317','43210','45293','45380','45533','45688','45805','45850','55751')                               AND (ctx.id = pctx.id                                    OR ctx.path LIKE   CAST(pctx.path AS NVARCHAR(255))  +  CAST('/%' AS NVARCHAR(255))                                      OR pctx.path LIKE   CAST(ctx.path AS NVARCHAR(255))  +  CAST('/%' AS NVARCHAR(255))  ))                 LEFT JOIN mdl_block_instances bi                           ON (ctx.contextlevel = 80 AND bi.id = ctx.instanceid)                 LEFT JOIN mdl_context bpctx                           ON (bpctx.id = bi.parentcontextid)                     WHERE rc.roleid = '3'                           AND (ctx.contextlevel <= 50 OR bpctx.contextlevel < 50)                    )ORDER BY capability",387,381,6,57741,0,271367
"SELECT distinct userid 	FROM [LEARN].[dbo].[mdl_logstore_standard_log] 	where action = 'loggedin' and CAST(CONVERT(VARCHAR,dateadd(s, timecreated, '1970-01-01 00:00:00'),1) AS DATE) > '2020-11-30'",367,2456,-2089,469048,0,93243
"             SELECT DISTINCT                 c.id AS course,                 cr.id AS criteriaid,                 ra.userid AS userid,                 cc.timecompleted AS timecompleted             FROM                 mdl_course_completion_criteria cr             INNER JOIN                 mdl_course c              ON cr.course = c.id             INNER JOIN                 mdl_context con              ON con.instanceid = c.id             INNER JOIN                 mdl_role_assignments ra               ON ra.contextid = con.id             INNER JOIN                 mdl_course_completions cc              ON cc.course = cr.courseinstance             AND cc.userid = ra.userid             LEFT JOIN                 mdl_course_completion_crit_compl ccc              ON ccc.criteriaid = cr.id             AND ccc.userid = ra.userid             WHERE                 cr.criteriatype = 8             AND con.contextlevel = 50             AND c.enablecompletion = 1             AND ccc.id IS NULL             AND cc.timecompleted IS NOT NULL         ",337,337,0,961213,0,4707456
"SELECT  count(ip) as counter 				FROM mdl_logstore_standard_log 				where action = 'loggedin' and CAST(CONVERT(VARCHAR,dateadd(s, timecreated, '1970-01-01 00:00:00'),1) AS DATE) > '2020-11-30'",311,2436,-2125,469070,0,533821
"SELECT  count(ip) as counter FROM [LEARN].[dbo].[mdl_logstore_standard_log] where action = 'loggedin' and CAST(CONVERT(VARCHAR,dateadd(s, timecreated, '1970-01-01 00:00:00'),1) AS DATE) > '2020-11-30'",310,2431,-2121,469048,0,78770
"         SELECT DISTINCT             c.id AS course,             cr.id AS criteriaid,             crc.userid AS userid,             cr.criteriatype AS criteriatype,             cc.timecompleted AS timecompleted         FROM             mdl_course_completion_criteria cr         INNER JOIN             mdl_course c          ON cr.course = c.id         INNER JOIN             mdl_course_completions crc          ON crc.course = c.id         LEFT JOIN             mdl_course_completion_crit_compl cc          ON cc.criteriaid = cr.id         AND crc.userid = cc.userid         WHERE             c.enablecompletion = 1         AND crc.timecompleted IS NULL         AND crc.reaggregate > 0         AND crc.reaggregate < '1713853312'         ORDER BY             course,             userid     ",195,719,-524,74959,0,195
" SELECT     quba.id AS qubaid,     quba.contextid,     quba.component,     quba.preferredbehaviour,     qa.id AS questionattemptid,     qa.questionusageid,     qa.slot,     qa.behaviour,     qa.questionid,     qa.variant,     qa.maxmark,     qa.minfraction,     qa.maxfraction,     qa.flagged,     qa.questionsummary,     qa.rightanswer,     qa.responsesummary,     qa.timemodified,     qas.id AS attemptstepid,     qas.sequencenumber,     qas.state,     qas.fraction,     qas.timecreated,     qas.userid,     qasd.name,     qasd.value  FROM      mdl_question_usages            quba LEFT JOIN mdl_question_attempts          qa   ON qa.questionusageid    = quba.id LEFT JOIN mdl_question_attempt_steps     qas  ON qas.questionattemptid = qa.id LEFT JOIN mdl_question_attempt_step_data qasd ON qasd.attemptstepid    = qas.id  WHERE     quba.id = '250041'  ORDER BY     qa.slot,     qas.sequencenumber     ",195,3,192,1209,0,195
" SELECT     quba.id AS qubaid,     quba.contextid,     quba.component,     quba.preferredbehaviour,     qa.id AS questionattemptid,     qa.questionusageid,     qa.slot,     qa.behaviour,     qa.questionid,     qa.variant,     qa.maxmark,     qa.minfraction,     qa.maxfraction,     qa.flagged,     qa.questionsummary,     qa.rightanswer,     qa.responsesummary,     qa.timemodified,     qas.id AS attemptstepid,     qas.sequencenumber,     qas.state,     qas.fraction,     qas.timecreated,     qas.userid,     qasd.name,     qasd.value  FROM      mdl_question_usages            quba LEFT JOIN mdl_question_attempts          qa   ON qa.questionusageid    = quba.id LEFT JOIN mdl_question_attempt_steps     qas  ON qas.questionattemptid = qa.id LEFT JOIN mdl_question_attempt_step_data qasd ON qasd.attemptstepid    = qas.id  WHERE     quba.id = '116160'  ORDER BY     qa.slot,     qas.sequencenumber     ",171,2,169,834,0,171
