"()                 begin try                 declare @enable int;                 select top 1 @enable = convert(int,value_in_use) from sys.configurations where name = 'default trace enabled'                 if @enable = 1 --default trace is enabled                 begin                 declare @curr_tracefilename varchar(500);                 declare @base_tracefilename varchar(500);                 declare @indx int ;                 declare @temp_trace table (                 StartTime datetime                 ,       EventSubClass int                 ,       IntegerData int                 );                 declare @path_separator CHAR(1) ;                 set @path_separator = ISNULL(CONVERT(CHAR(1), serverproperty('PathSeparator')), '\') ;                  select @curr_tracefilename = path from sys.traces where is_default = 1 ;                 set @curr_tracefilename = reverse(@curr_tracefilename)                 select @indx  = PATINDEX('%'+@path_separator+'%', @curr_tracefilename)                 set @curr_tracefilename = reverse(@curr_tracefilename)                 set @base_tracefilename = LEFT( @curr_tracefilename, len(@curr_tracefilename) - @indx) + @path_separator + 'log.trc';                  insert into @temp_trace                 select StartTime                 ,       EventSubClass                 ,       IntegerData                 from ::fn_trace_gettable( @base_tracefilename, default )                 where EventClass = 81;                  update @temp_trace set IntegerData = -IntegerData where EventSubClass = 2;                  select   1 as row_no                 ,       StartTime                 ,       EventSubClass                 ,       IntegerData                 ,       case when IntegerData < 0                 then -IntegerData                 else IntegerData                 end ""Absolute""                 from @temp_trace                 where (datediff(dd,StartTime,getdate()) < 7) order by StartTime ;                 end                 else                 begin                 select top 0 1 as row_no, 1 as StartTime , 1 as EventSubClass, 1 as IntegerData, 1 as Absolute                 end                 end try                 begin catch                 select  -100 as row_no                 ,       ERROR_NUMBER()  as StartTime                 ,       ERROR_SEVERITY() as EventSubClass                 ,       ERROR_STATE()  as   IntegerData                 ,       ERROR_MESSAGE() as Absolute                 end catch               ",469,468,1,0,0,1409
"DECLARE @preferredReplica int  SET @preferredReplica = (SELECT [master].sys.fn_hadr_backup_is_preferred_replica('iemo'))  IF (@preferredReplica = 1) BEGIN     BACKUP LOG [iemo] TO  DISK = N'G:\Backup_SQL\IEMO\Transaction\iemo\iemo_backup_2024_04_02_110003_0480418.trn' WITH  RETAINDAYS = 7, NOFORMAT, NOINIT,  NAME = N'iemo_backup_2024_04_02_110003_0480418', SKIP, REWIND, NOUNLOAD, COMPRESSION,  STATS = 10 END ",362,96,266,151,0,362
"       SELECT       db_id() AS database_id,       c.system_type_id,       c.user_type_id,       c.is_sparse,       c.is_column_set,       c.is_filestream,       c.encryption_type,       CASE WHEN o.object_id IS NOT NULL THEN 1 ELSE 0 END AS is_user,       COUNT_BIG(*) AS [ColCount],       CASE WHEN c.collation_name IS NULL THEN CONVERT(VARCHAR(128), SERVERPROPERTY('Collation')) ELSE c.collation_name END AS collation_name,       AVG(c.max_length) AS avg_max_length       FROM sys.columns c WITH (NOLOCK)       LEFT OUTER JOIN sys.objects o WITH (NOLOCK)       ON o.object_id = c.object_id       AND o.type = 'U'       GROUP BY       c.system_type_id,       c.user_type_id,       c.is_sparse,       c.is_column_set,       c.encryption_type,       c.is_filestream,       CASE WHEN o.object_id IS NOT NULL THEN 1 ELSE 0 END,       CASE WHEN c.collation_name IS NULL THEN CONVERT(VARCHAR(128), SERVERPROPERTY('Collation')) ELSE c.collation_name END     ",335,193,142,115,0,33200
"declare @Path nvarchar(255) declare @Name nvarchar(255)   select @Path = N'G:\Backup_SQL\IEMO\Transaction'   select @Name = null;           create table #filetmpfin (Name nvarchar(255) NOT NULL, IsFile bit NULL, FullName nvarchar(300) not NULL)         declare @FullName nvarchar(300)         declare @UseLegacyXPs bit = 1          if exists (select 1 from sys.all_objects where name = 'dm_os_enumerate_filesystem' and type = 'IF' and is_ms_shipped = 1)            select @UseLegacyXPs = IIF((LOWER(@Name) = N'nul') AND (exists (select 1 from sys.dm_os_host_info where host_platform = 'Windows')), 1, 0)          if @UseLegacyXPs = 0         begin            if (@Name is null)           begin                insert #filetmpfin select file_or_directory_name, 1 - is_directory, full_filesystem_path from sys.dm_os_enumerate_filesystem(@Path, '*') where [level] = 0           end            if (NOT @Name is null)           begin              if(@Path is null)                select @FullName = @Name             else               select @FullName = @Path 	+ convert(nvarchar(1), serverproperty('PathSeparator')) + @Name              create table #filetmp3 ( Exist bit NOT NULL, IsDir bit NOT NULL, DirExist bit NULL )              insert #filetmp3 select file_exists, file_is_a_directory, parent_directory_exists from sys.dm_os_file_exists(@FullName)              insert #filetmpfin select @Name, 1-IsDir, @FullName from #filetmp3 where Exist = 1 or IsDir = 1              drop table #filetmp3            end         end         else         begin           if(@Name is null)           begin             if (right(@Path, 1) = '\')               select @Path= substring(@Path, 1, len(@Path) - charindex('\', reverse(@Path)))             create table #filetmp (Name nvarchar(255) NOT NULL, depth int NOT NULL, IsFile bit NULL )             insert #filetmp EXECUTE master.dbo.xp_dirtree @Path, 1, 1             insert #filetmpfin select Name, IsFile, @Path + '\' + Name from #filetmp f             drop table #filetmp           end            if(NOT @Name is null)           begin             if(@Path is null)               select @FullName = @Name             else               select @FullName = @Path +  '\' + @Name             if (right(@FullName, 1) = '\')               select @Path= substring(@Path, 1, len(@FullName) - charindex('\', reverse(@FullName)))             create table #filetmp2 ( Exist bit NOT NULL, IsDir bit NOT NULL, DirExist bit NULL )             insert #filetmp2 EXECUTE master.dbo.xp_fileexist @FullName             insert #filetmpfin select @Name, 1-IsDir, @FullName from #filetmp2 where Exist = 1 or IsDir = 1              drop table #filetmp2           end          end           SELECT Name AS [Name], IsFile AS [IsFile], FullName AS [FullName] FROM #filetmpfin ORDER BY [IsFile] ASC,[Name] ASC drop table #filetmpfin ",247,74,173,5213,50,495
"DECLARE @preferredReplica int  SET @preferredReplica = (SELECT [master].sys.fn_hadr_backup_is_preferred_replica('iemo'))  IF (@preferredReplica = 1) BEGIN     BACKUP LOG [iemo] TO  DISK = N'G:\Backup_SQL\IEMO\Transaction\iemo\iemo_backup_2024_04_06_170001_4778545.trn' WITH  RETAINDAYS = 7, NOFORMAT, NOINIT,  NAME = N'iemo_backup_2024_04_06_170001_4778545', SKIP, REWIND, NOUNLOAD, COMPRESSION,  STATS = 10 END ",193,57,136,151,0,193
"DECLARE @preferredReplica int  SET @preferredReplica = (SELECT [master].sys.fn_hadr_backup_is_preferred_replica('iemo'))  IF (@preferredReplica = 1) BEGIN     BACKUP LOG [iemo] TO  DISK = N'G:\Backup_SQL\IEMO\Transaction\iemo\iemo_backup_2024_03_28_020000_8310241.trn' WITH  RETAINDAYS = 7, NOFORMAT, NOINIT,  NAME = N'iemo_backup_2024_03_28_020000_8310241', SKIP, REWIND, NOUNLOAD, COMPRESSION,  STATS = 10 END ",188,115,73,151,0,188
"SELECT     DB_NAME (database_id) as [Database Name],     name as [Database File Name],     [Type] = CASE WHEN Type_Desc = 'ROWS' THEN 'Data File(s)'             WHEN Type_Desc = 'LOG'  THEN 'Log File(s)'             ELSE Type_Desc END,     size*8/1024 as 'Size (MB)',     physical_name as [Database_File_Location] FROM sys.master_files ORDER BY 1,3  IF OBJECT_ID('tempdb.dbo.#space') IS NOT NULL     DROP TABLE #space  CREATE TABLE #space (       database_id INT PRIMARY KEY     , data_used_size DECIMAL(18,2)     , log_used_size DECIMAL(18,2) )  DECLARE @SQL NVARCHAR(MAX)  SELECT @SQL = STUFF((     SELECT '     USE [' + d.name + ']     INSERT INTO #space (database_id, data_used_size, log_used_size)     SELECT           DB_ID()         , SUM(CASE WHEN [type] = 0 THEN space_used END)         , SUM(CASE WHEN [type] = 1 THEN space_used END)     FROM (         SELECT s.[type], space_used = SUM(FILEPROPERTY(s.name, ''SpaceUsed'') * 8. / 1024)         FROM sys.database_files s         GROUP BY s.[type]     ) t;'     FROM sys.databases d     WHERE d.[state] = 0     FOR XML PATH(''), TYPE).value('.', 'NVARCHAR(MAX)'), 1, 2, '')  EXEC sys.sp_executesql @SQL  SELECT       d.database_id     , d.name     , d.state_desc     , d.recovery_model_desc     , t.total_size     , t.data_size     , s.data_used_size     , t.log_size     , s.log_used_size     , bu.full_last_date     , bu.full_size     , bu.log_last_date     , bu.log_size FROM (     SELECT           database_id         , log_size = CAST(SUM(CASE WHEN [type] = 1 THEN size END) * 8. / 1024 AS DECIMAL(18,2))         , data_size = CAST(SUM(CASE WHEN [type] = 0 THEN size END) * 8. / 1024 AS DECIMAL(18,2))         , total_size = CAST(SUM(size) * 8. / 1024 AS DECIMAL(18,2))     FROM sys.master_files     GROUP BY database_id ) t JOIN sys.databases d ON d.database_id = t.database_id LEFT JOIN #space s ON d.database_id = s.database_id LEFT JOIN (     SELECT           database_name         , full_last_date = MAX(CASE WHEN [type] = 'D' THEN backup_finish_date END)         , full_size = MAX(CASE WHEN [type] = 'D' THEN backup_size END)         , log_last_date = MAX(CASE WHEN [type] = 'L' THEN backup_finish_date END)         , log_size = MAX(CASE WHEN [type] = 'L' THEN backup_size END)     FROM (         SELECT               s.database_name             , s.[type]             , s.backup_finish_date             , backup_size =                         CAST(CASE WHEN s.backup_size = s.compressed_backup_size                                     THEN s.backup_size                                     ELSE s.compressed_backup_size                         END / 1048576.0 AS DECIMAL(18,2))             , RowNum = ROW_NUMBER() OVER (PARTITION BY s.database_name, s.[type] ORDER BY s.backup_finish_date DESC)         FROM msdb.dbo.backupset s         WHERE s.[type] IN ('D', 'L')     ) f     WHERE f.RowNum = 1     GROUP BY f.database_name ) bu ON d.name = bu.database_name ORDER BY t.total_size DESC  SELECT      req.session_id     , req.total_elapsed_time AS duration_ms     , req.cpu_time AS cpu_time_ms     , req.total_elapsed_time - req.cpu_time AS wait_time     , req.logical_reads     , SUBSTRING (REPLACE (REPLACE (SUBSTRING (ST.text, (req.statement_start_offset/2) + 1,         ((CASE statement_end_offset            WHEN -1            THEN DATALENGTH(ST.text)              ELSE req.statement_end_offset          END - req.statement_start_offset)/2) + 1) , CHAR(10), ' '), CHAR(13), ' '),        1, 512)  AS statement_text   FROM sys.dm_exec_requests AS req     CROSS APPLY sys.dm_exec_sql_text(req.sql_handle) AS ST ORDER BY total_elapsed_time DESC;  SELECT top 100 t.text,      (qs.total_elapsed_time/1000) / qs.execution_count AS avg_elapsed_time,      (qs.total_worker_time/1000) / qs.execution_count AS avg_cpu_time,      ((qs.total_elapsed_time/1000) / qs.execution_count ) - ((qs.total_worker_time/1000) / qs.execution_count) AS avg_wait_time,      qs.total_logical_reads / qs.execution_count AS avg_logical_reads,      qs.total_logical_writes / qs.execution_count AS avg_writes,      (qs.total_elapsed_time/1000) AS cumulative_elapsed_time_all_executions FROM sys.dm_exec_query_stats qs      CROSS apply sys.Dm_exec_sql_text (sql_handle) t -- WHERE t.text like '<Your Query>%' -- Replace <Your Query> with your query or the beginning part of your query. The special chars like '[','_','%','^' in the query should be escaped. ORDER BY (qs.total_elapsed_time / qs.execution_count) DESC  --Deadlock sql check SELECT     session_id,     start_time,      [status],     command,     blocking_session_id,     wait_type,     wait_time,     open_transaction_count,     transaction_id,     total_elapsed_time,     Definition = CAST(text AS VARCHAR(MAX)) FROM     SYS.DM_EXEC_REQUESTS     CROSS APPLY sys.dm_exec_sql_text(sql_handle)  WHERE blocking_session_id != 0  SELECT sqlserver_start_time, (committed_kb/1024) AS Total_Server_Memory_MB, (committed_target_kb/1024)  AS Target_Server_Memory_MB FROM sys.dm_os_sys_info; ",183,47,136,17003,894,551
"DECLARE @preferredReplica int  SET @preferredReplica = (SELECT [master].sys.fn_hadr_backup_is_preferred_replica('iemo'))  IF (@preferredReplica = 1) BEGIN     BACKUP LOG [iemo] TO  DISK = N'G:\Backup_SQL\IEMO\Transaction\iemo\iemo_backup_2024_04_22_000000_7868958.trn' WITH  RETAINDAYS = 7, NOFORMAT, NOINIT,  NAME = N'iemo_backup_2024_04_22_000000_7868958', SKIP, REWIND, NOUNLOAD, COMPRESSION,  STATS = 10 END ",183,96,87,151,0,183
"DECLARE @preferredReplica int  SET @preferredReplica = (SELECT [master].sys.fn_hadr_backup_is_preferred_replica('iemo'))  IF (@preferredReplica = 1) BEGIN     BACKUP LOG [iemo] TO  DISK = N'G:\Backup_SQL\IEMO\Transaction\iemo\iemo_backup_2024_04_03_130000_8190388.trn' WITH  RETAINDAYS = 7, NOFORMAT, NOINIT,  NAME = N'iemo_backup_2024_04_03_130000_8190388', SKIP, REWIND, NOUNLOAD, COMPRESSION,  STATS = 10 END ",175,100,75,236,0,175
"SELECT     DB_NAME (database_id) as [Database Name],     name as [Database File Name],     [Type] = CASE WHEN Type_Desc = 'ROWS' THEN 'Data File(s)'             WHEN Type_Desc = 'LOG'  THEN 'Log File(s)'             ELSE Type_Desc END,     size*8/1024 as 'Size (MB)',     physical_name as [Database_File_Location] FROM sys.master_files ORDER BY 1,3  IF OBJECT_ID('tempdb.dbo.#space') IS NOT NULL     DROP TABLE #space  CREATE TABLE #space (       database_id INT PRIMARY KEY     , data_used_size DECIMAL(18,2)     , log_used_size DECIMAL(18,2) )  DECLARE @SQL NVARCHAR(MAX)  SELECT @SQL = STUFF((     SELECT '     USE [' + d.name + ']     INSERT INTO #space (database_id, data_used_size, log_used_size)     SELECT           DB_ID()         , SUM(CASE WHEN [type] = 0 THEN space_used END)         , SUM(CASE WHEN [type] = 1 THEN space_used END)     FROM (         SELECT s.[type], space_used = SUM(FILEPROPERTY(s.name, ''SpaceUsed'') * 8. / 1024)         FROM sys.database_files s         GROUP BY s.[type]     ) t;'     FROM sys.databases d     WHERE d.[state] = 0     FOR XML PATH(''), TYPE).value('.', 'NVARCHAR(MAX)'), 1, 2, '')  EXEC sys.sp_executesql @SQL  SELECT       d.database_id     , d.name     , d.state_desc     , d.recovery_model_desc     , t.total_size     , t.data_size     , s.data_used_size     , t.log_size     , s.log_used_size     , bu.full_last_date     , bu.full_size     , bu.log_last_date     , bu.log_size FROM (     SELECT           database_id         , log_size = CAST(SUM(CASE WHEN [type] = 1 THEN size END) * 8. / 1024 AS DECIMAL(18,2))         , data_size = CAST(SUM(CASE WHEN [type] = 0 THEN size END) * 8. / 1024 AS DECIMAL(18,2))         , total_size = CAST(SUM(size) * 8. / 1024 AS DECIMAL(18,2))     FROM sys.master_files     GROUP BY database_id ) t JOIN sys.databases d ON d.database_id = t.database_id LEFT JOIN #space s ON d.database_id = s.database_id LEFT JOIN (     SELECT           database_name         , full_last_date = MAX(CASE WHEN [type] = 'D' THEN backup_finish_date END)         , full_size = MAX(CASE WHEN [type] = 'D' THEN backup_size END)         , log_last_date = MAX(CASE WHEN [type] = 'L' THEN backup_finish_date END)         , log_size = MAX(CASE WHEN [type] = 'L' THEN backup_size END)     FROM (         SELECT               s.database_name             , s.[type]             , s.backup_finish_date             , backup_size =                         CAST(CASE WHEN s.backup_size = s.compressed_backup_size                                     THEN s.backup_size                                     ELSE s.compressed_backup_size                         END / 1048576.0 AS DECIMAL(18,2))             , RowNum = ROW_NUMBER() OVER (PARTITION BY s.database_name, s.[type] ORDER BY s.backup_finish_date DESC)         FROM msdb.dbo.backupset s         WHERE s.[type] IN ('D', 'L')     ) f     WHERE f.RowNum = 1     GROUP BY f.database_name ) bu ON d.name = bu.database_name ORDER BY t.total_size DESC  SELECT      req.session_id     , req.total_elapsed_time AS duration_ms     , req.cpu_time AS cpu_time_ms     , req.total_elapsed_time - req.cpu_time AS wait_time     , req.logical_reads     , SUBSTRING (REPLACE (REPLACE (SUBSTRING (ST.text, (req.statement_start_offset/2) + 1,         ((CASE statement_end_offset            WHEN -1            THEN DATALENGTH(ST.text)              ELSE req.statement_end_offset          END - req.statement_start_offset)/2) + 1) , CHAR(10), ' '), CHAR(13), ' '),        1, 512)  AS statement_text   FROM sys.dm_exec_requests AS req     CROSS APPLY sys.dm_exec_sql_text(req.sql_handle) AS ST ORDER BY total_elapsed_time DESC;  SELECT top 100 t.text,      (qs.total_elapsed_time/1000) / qs.execution_count AS avg_elapsed_time,      (qs.total_worker_time/1000) / qs.execution_count AS avg_cpu_time,      ((qs.total_elapsed_time/1000) / qs.execution_count ) - ((qs.total_worker_time/1000) / qs.execution_count) AS avg_wait_time,      qs.total_logical_reads / qs.execution_count AS avg_logical_reads,      qs.total_logical_writes / qs.execution_count AS avg_writes,      (qs.total_elapsed_time/1000) AS cumulative_elapsed_time_all_executions FROM sys.dm_exec_query_stats qs      CROSS apply sys.Dm_exec_sql_text (sql_handle) t -- WHERE t.text like '<Your Query>%' -- Replace <Your Query> with your query or the beginning part of your query. The special chars like '[','_','%','^' in the query should be escaped. ORDER BY (qs.total_elapsed_time / qs.execution_count) DESC  --Deadlock sql check SELECT     session_id,     start_time,      [status],     command,     blocking_session_id,     wait_type,     wait_time,     open_transaction_count,     transaction_id,     total_elapsed_time,     Definition = CAST(text AS VARCHAR(MAX)) FROM     SYS.DM_EXEC_REQUESTS     CROSS APPLY sys.dm_exec_sql_text(sql_handle)  WHERE blocking_session_id != 0   ",165,26,139,9579,567,495
"DECLARE @preferredReplica int  SET @preferredReplica = (SELECT [master].sys.fn_hadr_backup_is_preferred_replica('iemo'))  IF (@preferredReplica = 1) BEGIN     BACKUP LOG [iemo] TO  DISK = N'G:\Backup_SQL\IEMO\Transaction\iemo\iemo_backup_2024_04_01_070000_9442114.trn' WITH  RETAINDAYS = 7, NOFORMAT, NOINIT,  NAME = N'iemo_backup_2024_04_01_070000_9442114', SKIP, REWIND, NOUNLOAD, COMPRESSION,  STATS = 10 END ",156,104,52,236,0,156
"DECLARE @preferredReplica int  SET @preferredReplica = (SELECT [master].sys.fn_hadr_backup_is_preferred_replica('iemo'))  IF (@preferredReplica = 1) BEGIN     BACKUP DATABASE [iemo] TO  DISK = N'G:\Backup_SQL\IEMO\Full\iemo\iemo_backup_2024_04_14_230002_0904593.bak' WITH  RETAINDAYS = 7, NOFORMAT, NOINIT,  NAME = N'iemo_backup_2024_04_14_230002_0904593', SKIP, REWIND, NOUNLOAD, COMPRESSION,  STATS = 10 END ",147,67,80,151,0,147
"DECLARE @preferredReplica int  SET @preferredReplica = (SELECT [master].sys.fn_hadr_backup_is_preferred_replica('iemo'))  IF (@preferredReplica = 1) BEGIN     BACKUP LOG [iemo] TO  DISK = N'G:\Backup_SQL\IEMO\Transaction\iemo\iemo_backup_2024_04_07_180000_8669348.trn' WITH  RETAINDAYS = 7, NOFORMAT, NOINIT,  NAME = N'iemo_backup_2024_04_07_180000_8669348', SKIP, REWIND, NOUNLOAD, COMPRESSION,  STATS = 10 END ",144,74,70,151,0,144
"DECLARE @preferredReplica int  SET @preferredReplica = (SELECT [master].sys.fn_hadr_backup_is_preferred_replica('iemo'))  IF (@preferredReplica = 1) BEGIN     BACKUP LOG [iemo] TO  DISK = N'G:\Backup_SQL\IEMO\Transaction\iemo\iemo_backup_2024_03_29_090001_1383724.trn' WITH  RETAINDAYS = 7, NOFORMAT, NOINIT,  NAME = N'iemo_backup_2024_03_29_090001_1383724', SKIP, REWIND, NOUNLOAD, COMPRESSION,  STATS = 10 END ",143,83,60,151,0,143
"DECLARE @preferredReplica int  SET @preferredReplica = (SELECT [master].sys.fn_hadr_backup_is_preferred_replica('iemo'))  IF (@preferredReplica = 1) BEGIN     BACKUP LOG [iemo] TO  DISK = N'G:\Backup_SQL\IEMO\Transaction\iemo\iemo_backup_2024_04_14_230001_9946169.trn' WITH  RETAINDAYS = 7, NOFORMAT, NOINIT,  NAME = N'iemo_backup_2024_04_14_230001_9946169', SKIP, REWIND, NOUNLOAD, COMPRESSION,  STATS = 10 END ",140,97,43,272,0,140
"DECLARE @preferredReplica int  SET @preferredReplica = (SELECT [master].sys.fn_hadr_backup_is_preferred_replica('iemo'))  IF (@preferredReplica = 1) BEGIN     BACKUP DATABASE [iemo] TO  DISK = N'G:\Backup_SQL\IEMO\Full\iemo\iemo_backup_2024_04_05_230001_5469073.bak' WITH  RETAINDAYS = 7, NOFORMAT, NOINIT,  NAME = N'iemo_backup_2024_04_05_230001_5469073', SKIP, REWIND, NOUNLOAD, COMPRESSION,  STATS = 10 END ",132,69,63,151,0,132
"DECLARE @preferredReplica int  SET @preferredReplica = (SELECT [master].sys.fn_hadr_backup_is_preferred_replica('iemo'))  IF (@preferredReplica = 1) BEGIN     BACKUP LOG [iemo] TO  DISK = N'G:\Backup_SQL\IEMO\Transaction\iemo\iemo_backup_2024_04_17_230001_1457543.trn' WITH  RETAINDAYS = 7, NOFORMAT, NOINIT,  NAME = N'iemo_backup_2024_04_17_230001_1457543', SKIP, REWIND, NOUNLOAD, COMPRESSION,  STATS = 10 END ",131,96,35,236,0,131
"DECLARE @preferredReplica int  SET @preferredReplica = (SELECT [master].sys.fn_hadr_backup_is_preferred_replica('iemo'))  IF (@preferredReplica = 1) BEGIN     BACKUP LOG [iemo] TO  DISK = N'G:\Backup_SQL\IEMO\Transaction\iemo\iemo_backup_2024_04_01_200000_9469831.trn' WITH  RETAINDAYS = 7, NOFORMAT, NOINIT,  NAME = N'iemo_backup_2024_04_01_200000_9469831', SKIP, REWIND, NOUNLOAD, COMPRESSION,  STATS = 10 END ",128,80,48,151,0,128
"DECLARE @preferredReplica int  SET @preferredReplica = (SELECT [master].sys.fn_hadr_backup_is_preferred_replica('iemo'))  IF (@preferredReplica = 1) BEGIN     BACKUP LOG [iemo] TO  DISK = N'G:\Backup_SQL\IEMO\Transaction\iemo\iemo_backup_2024_03_28_100001_7272437.trn' WITH  RETAINDAYS = 7, NOFORMAT, NOINIT,  NAME = N'iemo_backup_2024_03_28_100001_7272437', SKIP, REWIND, NOUNLOAD, COMPRESSION,  STATS = 10 END ",119,93,26,236,0,119
"DECLARE @preferredReplica int  SET @preferredReplica = (SELECT [master].sys.fn_hadr_backup_is_preferred_replica('iemo'))  IF (@preferredReplica = 1) BEGIN     BACKUP DATABASE [iemo] TO  DISK = N'G:\Backup_SQL\IEMO\Full\iemo\iemo_backup_2024_04_04_230001_9171220.bak' WITH  RETAINDAYS = 7, NOFORMAT, NOINIT,  NAME = N'iemo_backup_2024_04_04_230001_9171220', SKIP, REWIND, NOUNLOAD, COMPRESSION,  STATS = 10 END ",118,74,44,151,0,118
"       SELECT       db_id() as database_id,       sm.[is_inlineable] AS InlineableScalarCount,​       sm.[inline_type] AS InlineType,​       COUNT_BIG(*) AS ScalarCount, ​       COUNT_BIG(CASE WHEN sm.[definition] LIKE '%getdate%' OR       sm.[definition] LIKE '%getutcdate%' OR ​       sm.[definition] LIKE '%sysdatetime%' OR​       sm.[definition] LIKE '%sysu​tcdatetime%' OR​       sm.[definition] LIKE '%sysdatetimeoffset%' OR​       sm.[definition] LIKE '%CURRENT_TIMESTAMP%'​       THEN 1       END) AS ScalarCountWithDate       FROM    [sys].[objects] o​       INNER JOIN    [sys].[sql_modules] sm       ON o.[object_id] = sm.[object_id]​       WHERE   o.[type] = 'FN'​       GROUP BY ​       sm.[is_inlineable],​       sm.[inline_type]     ",116,70,46,186,0,11494
"DECLARE @preferredReplica int  SET @preferredReplica = (SELECT [master].sys.fn_hadr_backup_is_preferred_replica('iemo'))  IF (@preferredReplica = 1) BEGIN     BACKUP DATABASE [iemo] TO  DISK = N'G:\Backup_SQL\IEMO\Full\iemo\iemo_backup_2024_04_21_230002_0518560.bak' WITH  RETAINDAYS = 7, NOFORMAT, NOINIT,  NAME = N'iemo_backup_2024_04_21_230002_0518560', SKIP, REWIND, NOUNLOAD, COMPRESSION,  STATS = 10 END ",112,64,48,151,0,112
"DECLARE @preferredReplica int  SET @preferredReplica = (SELECT [master].sys.fn_hadr_backup_is_preferred_replica('iemo'))  IF (@preferredReplica = 1) BEGIN     BACKUP LOG [iemo] TO  DISK = N'G:\Backup_SQL\IEMO\Transaction\iemo\iemo_backup_2024_04_22_230001_8995470.trn' WITH  RETAINDAYS = 7, NOFORMAT, NOINIT,  NAME = N'iemo_backup_2024_04_22_230001_8995470', SKIP, REWIND, NOUNLOAD, COMPRESSION,  STATS = 10 END ",111,76,35,236,0,111
"DECLARE @preferredReplica int  SET @preferredReplica = (SELECT [master].sys.fn_hadr_backup_is_preferred_replica('iemo'))  IF (@preferredReplica = 1) BEGIN     BACKUP LOG [iemo] TO  DISK = N'G:\Backup_SQL\IEMO\Transaction\iemo\iemo_backup_2024_04_21_180000_8854998.trn' WITH  RETAINDAYS = 7, NOFORMAT, NOINIT,  NAME = N'iemo_backup_2024_04_21_180000_8854998', SKIP, REWIND, NOUNLOAD, COMPRESSION,  STATS = 10 END ",110,71,39,151,0,110
"DECLARE @preferredReplica int  SET @preferredReplica = (SELECT [master].sys.fn_hadr_backup_is_preferred_replica('iemo'))  IF (@preferredReplica = 1) BEGIN     BACKUP LOG [iemo] TO  DISK = N'G:\Backup_SQL\IEMO\Transaction\iemo\iemo_backup_2024_04_03_230001_4847360.trn' WITH  RETAINDAYS = 7, NOFORMAT, NOINIT,  NAME = N'iemo_backup_2024_04_03_230001_4847360', SKIP, REWIND, NOUNLOAD, COMPRESSION,  STATS = 10 END ",110,73,37,236,0,110
"DECLARE @preferredReplica int  SET @preferredReplica = (SELECT [master].sys.fn_hadr_backup_is_preferred_replica('iemo'))  IF (@preferredReplica = 1) BEGIN     BACKUP LOG [iemo] TO  DISK = N'G:\Backup_SQL\IEMO\Transaction\iemo\iemo_backup_2024_04_04_230001_9340930.trn' WITH  RETAINDAYS = 7, NOFORMAT, NOINIT,  NAME = N'iemo_backup_2024_04_04_230001_9340930', SKIP, REWIND, NOUNLOAD, COMPRESSION,  STATS = 10 END ",109,75,34,236,0,109
"DECLARE @preferredReplica int  SET @preferredReplica = (SELECT [master].sys.fn_hadr_backup_is_preferred_replica('iemo'))  IF (@preferredReplica = 1) BEGIN     BACKUP DATABASE [iemo] TO  DISK = N'G:\Backup_SQL\IEMO\Full\iemo\iemo_backup_2024_03_29_230001_8252697.bak' WITH  RETAINDAYS = 7, NOFORMAT, NOINIT,  NAME = N'iemo_backup_2024_03_29_230001_8252697', SKIP, REWIND, NOUNLOAD, COMPRESSION,  STATS = 10 END ",107,63,44,151,0,107
"DECLARE @preferredReplica int  SET @preferredReplica = (SELECT [master].sys.fn_hadr_backup_is_preferred_replica('iemo'))  IF (@preferredReplica = 1) BEGIN     BACKUP DATABASE [iemo] TO  DISK = N'G:\Backup_SQL\IEMO\Full\iemo\iemo_backup_2024_04_16_230001_6248694.bak' WITH  RETAINDAYS = 7, NOFORMAT, NOINIT,  NAME = N'iemo_backup_2024_04_16_230001_6248694', SKIP, REWIND, NOUNLOAD, COMPRESSION,  STATS = 10 END ",105,65,40,151,0,105
"DECLARE @preferredReplica int  SET @preferredReplica = (SELECT [master].sys.fn_hadr_backup_is_preferred_replica('iemo'))  IF (@preferredReplica = 1) BEGIN     BACKUP LOG [iemo] TO  DISK = N'G:\Backup_SQL\IEMO\Transaction\iemo\iemo_backup_2024_04_01_160001_3007229.trn' WITH  RETAINDAYS = 7, NOFORMAT, NOINIT,  NAME = N'iemo_backup_2024_04_01_160001_3007229', SKIP, REWIND, NOUNLOAD, COMPRESSION,  STATS = 10 END ",104,81,23,236,0,104
"DECLARE @preferredReplica int  SET @preferredReplica = (SELECT [master].sys.fn_hadr_backup_is_preferred_replica('iemo'))  IF (@preferredReplica = 1) BEGIN     BACKUP DATABASE [iemo] TO  DISK = N'G:\Backup_SQL\IEMO\Full\iemo\iemo_backup_2024_03_26_230001_8367686.bak' WITH  RETAINDAYS = 7, NOFORMAT, NOINIT,  NAME = N'iemo_backup_2024_03_26_230001_8367686', SKIP, REWIND, NOUNLOAD, COMPRESSION,  STATS = 10 END ",101,57,44,151,0,101
"DECLARE @preferredReplica int  SET @preferredReplica = (SELECT [master].sys.fn_hadr_backup_is_preferred_replica('iemo'))  IF (@preferredReplica = 1) BEGIN     BACKUP LOG [iemo] TO  DISK = N'G:\Backup_SQL\IEMO\Transaction\iemo\iemo_backup_2024_04_20_230002_2406812.trn' WITH  RETAINDAYS = 7, NOFORMAT, NOINIT,  NAME = N'iemo_backup_2024_04_20_230002_2406812', SKIP, REWIND, NOUNLOAD, COMPRESSION,  STATS = 10 END ",100,66,34,236,0,100
"DECLARE @preferredReplica int  SET @preferredReplica = (SELECT [master].sys.fn_hadr_backup_is_preferred_replica('iemo'))  IF (@preferredReplica = 1) BEGIN     BACKUP LOG [iemo] TO  DISK = N'G:\Backup_SQL\IEMO\Transaction\iemo\iemo_backup_2024_03_21_100000_8657480.trn' WITH  RETAINDAYS = 7, NOFORMAT, NOINIT,  NAME = N'iemo_backup_2024_03_21_100000_8657480', SKIP, REWIND, NOUNLOAD, COMPRESSION,  STATS = 10 END ",99,53,46,151,0,99
"DECLARE @preferredReplica int  SET @preferredReplica = (SELECT [master].sys.fn_hadr_backup_is_preferred_replica('iemo'))  IF (@preferredReplica = 1) BEGIN     BACKUP LOG [iemo] TO  DISK = N'G:\Backup_SQL\IEMO\Transaction\iemo\iemo_backup_2024_04_17_170001_1222182.trn' WITH  RETAINDAYS = 7, NOFORMAT, NOINIT,  NAME = N'iemo_backup_2024_04_17_170001_1222182', SKIP, REWIND, NOUNLOAD, COMPRESSION,  STATS = 10 END ",97,61,36,151,0,97
"DECLARE @preferredReplica int  SET @preferredReplica = (SELECT [master].sys.fn_hadr_backup_is_preferred_replica('iemo'))  IF (@preferredReplica = 1) BEGIN     BACKUP LOG [iemo] TO  DISK = N'G:\Backup_SQL\IEMO\Transaction\iemo\iemo_backup_2024_04_18_230001_3825141.trn' WITH  RETAINDAYS = 7, NOFORMAT, NOINIT,  NAME = N'iemo_backup_2024_04_18_230001_3825141', SKIP, REWIND, NOUNLOAD, COMPRESSION,  STATS = 10 END ",96,85,11,272,0,96
"DECLARE @preferredReplica int  SET @preferredReplica = (SELECT [master].sys.fn_hadr_backup_is_preferred_replica('iemo'))  IF (@preferredReplica = 1) BEGIN     BACKUP LOG [iemo] TO  DISK = N'G:\Backup_SQL\IEMO\Transaction\iemo\iemo_backup_2024_03_22_110001_7546266.trn' WITH  RETAINDAYS = 7, NOFORMAT, NOINIT,  NAME = N'iemo_backup_2024_03_22_110001_7546266', SKIP, REWIND, NOUNLOAD, COMPRESSION,  STATS = 10 END ",95,61,34,151,0,95
"DECLARE @preferredReplica int  SET @preferredReplica = (SELECT [master].sys.fn_hadr_backup_is_preferred_replica('iemo'))  IF (@preferredReplica = 1) BEGIN     BACKUP LOG [iemo] TO  DISK = N'G:\Backup_SQL\IEMO\Transaction\iemo\iemo_backup_2024_03_31_050000_8492310.trn' WITH  RETAINDAYS = 7, NOFORMAT, NOINIT,  NAME = N'iemo_backup_2024_03_31_050000_8492310', SKIP, REWIND, NOUNLOAD, COMPRESSION,  STATS = 10 END ",95,56,39,151,0,95
"DECLARE @preferredReplica int  SET @preferredReplica = (SELECT [master].sys.fn_hadr_backup_is_preferred_replica('iemo'))  IF (@preferredReplica = 1) BEGIN     BACKUP LOG [iemo] TO  DISK = N'G:\Backup_SQL\IEMO\Transaction\iemo\iemo_backup_2024_04_03_110000_8318085.trn' WITH  RETAINDAYS = 7, NOFORMAT, NOINIT,  NAME = N'iemo_backup_2024_04_03_110000_8318085', SKIP, REWIND, NOUNLOAD, COMPRESSION,  STATS = 10 END ",94,54,40,151,0,94
"DECLARE @preferredReplica int  SET @preferredReplica = (SELECT [master].sys.fn_hadr_backup_is_preferred_replica('iemo'))  IF (@preferredReplica = 1) BEGIN     BACKUP LOG [iemo] TO  DISK = N'G:\Backup_SQL\IEMO\Transaction\iemo\iemo_backup_2024_03_26_230001_7379310.trn' WITH  RETAINDAYS = 7, NOFORMAT, NOINIT,  NAME = N'iemo_backup_2024_03_26_230001_7379310', SKIP, REWIND, NOUNLOAD, COMPRESSION,  STATS = 10 END ",94,77,17,236,0,94
"DECLARE @preferredReplica int  SET @preferredReplica = (SELECT [master].sys.fn_hadr_backup_is_preferred_replica('iemo'))  IF (@preferredReplica = 1) BEGIN     BACKUP LOG [iemo] TO  DISK = N'G:\Backup_SQL\IEMO\Transaction\iemo\iemo_backup_2024_03_31_180000_8857321.trn' WITH  RETAINDAYS = 7, NOFORMAT, NOINIT,  NAME = N'iemo_backup_2024_03_31_180000_8857321', SKIP, REWIND, NOUNLOAD, COMPRESSION,  STATS = 10 END ",91,63,28,151,0,91
"DECLARE @preferredReplica int  SET @preferredReplica = (SELECT [master].sys.fn_hadr_backup_is_preferred_replica('iemo'))  IF (@preferredReplica = 1) BEGIN     BACKUP LOG [iemo] TO  DISK = N'G:\Backup_SQL\IEMO\Transaction\iemo\iemo_backup_2024_04_18_080000_8637985.trn' WITH  RETAINDAYS = 7, NOFORMAT, NOINIT,  NAME = N'iemo_backup_2024_04_18_080000_8637985', SKIP, REWIND, NOUNLOAD, COMPRESSION,  STATS = 10 END ",88,60,28,151,0,88
"DECLARE @preferredReplica int  SET @preferredReplica = (SELECT [master].sys.fn_hadr_backup_is_preferred_replica('iemo'))  IF (@preferredReplica = 1) BEGIN     BACKUP LOG [iemo] TO  DISK = N'G:\Backup_SQL\IEMO\Transaction\iemo\iemo_backup_2024_04_13_230002_0664152.trn' WITH  RETAINDAYS = 7, NOFORMAT, NOINIT,  NAME = N'iemo_backup_2024_04_13_230002_0664152', SKIP, REWIND, NOUNLOAD, COMPRESSION,  STATS = 10 END ",88,68,20,236,0,88
"DECLARE @preferredReplica int  SET @preferredReplica = (SELECT [master].sys.fn_hadr_backup_is_preferred_replica('iemo'))  IF (@preferredReplica = 1) BEGIN     BACKUP LOG [iemo] TO  DISK = N'G:\Backup_SQL\IEMO\Transaction\iemo\iemo_backup_2024_04_19_230002_2712270.trn' WITH  RETAINDAYS = 7, NOFORMAT, NOINIT,  NAME = N'iemo_backup_2024_04_19_230002_2712270', SKIP, REWIND, NOUNLOAD, COMPRESSION,  STATS = 10 END ",88,62,26,236,0,88
"DECLARE @preferredReplica int  SET @preferredReplica = (SELECT [master].sys.fn_hadr_backup_is_preferred_replica('iemo'))  IF (@preferredReplica = 1) BEGIN     BACKUP LOG [iemo] TO  DISK = N'G:\Backup_SQL\IEMO\Transaction\iemo\iemo_backup_2024_04_01_100001_3904894.trn' WITH  RETAINDAYS = 7, NOFORMAT, NOINIT,  NAME = N'iemo_backup_2024_04_01_100001_3904894', SKIP, REWIND, NOUNLOAD, COMPRESSION,  STATS = 10 END ",87,71,16,236,0,87
"DECLARE @preferredReplica int  SET @preferredReplica = (SELECT [master].sys.fn_hadr_backup_is_preferred_replica('iemo'))  IF (@preferredReplica = 1) BEGIN     BACKUP LOG [iemo] TO  DISK = N'G:\Backup_SQL\IEMO\Transaction\iemo\iemo_backup_2024_04_09_230002_3367659.trn' WITH  RETAINDAYS = 7, NOFORMAT, NOINIT,  NAME = N'iemo_backup_2024_04_09_230002_3367659', SKIP, REWIND, NOUNLOAD, COMPRESSION,  STATS = 10 END ",87,66,21,236,0,87
"DECLARE @preferredReplica int  SET @preferredReplica = (SELECT [master].sys.fn_hadr_backup_is_preferred_replica('iemo'))  IF (@preferredReplica = 1) BEGIN     BACKUP LOG [iemo] TO  DISK = N'G:\Backup_SQL\IEMO\Transaction\iemo\iemo_backup_2024_04_05_000000_8549986.trn' WITH  RETAINDAYS = 7, NOFORMAT, NOINIT,  NAME = N'iemo_backup_2024_04_05_000000_8549986', SKIP, REWIND, NOUNLOAD, COMPRESSION,  STATS = 10 END ",86,55,31,151,0,86
"DECLARE @preferredReplica int  SET @preferredReplica = (SELECT [master].sys.fn_hadr_backup_is_preferred_replica('iemo'))  IF (@preferredReplica = 1) BEGIN     BACKUP LOG [iemo] TO  DISK = N'G:\Backup_SQL\IEMO\Transaction\iemo\iemo_backup_2024_04_05_230001_5389199.trn' WITH  RETAINDAYS = 7, NOFORMAT, NOINIT,  NAME = N'iemo_backup_2024_04_05_230001_5389199', SKIP, REWIND, NOUNLOAD, COMPRESSION,  STATS = 10 END ",86,69,17,236,0,86
"(@_msparam_0 nvarchar(4000))       select * into #tmpag_availability_groups from master.sys.availability_groups        SELECT arcn.replica_server_name AS [ReplicaName], cm.member_name AS [NodeName], cm.member_type AS [MemberType], cm.member_state AS [MemberState], ISNULL(cm.number_of_quorum_votes, -1) AS [NumberOfQuorumVotes], 'Server[@Name=' + quotename(CAST(         serverproperty(N'Servername')        AS sysname),'''') + ']' + '/AvailabilityGroup[@Name=' + quotename(AG.name,'''') + ']' + '/ReplicaClusterNode[@ReplicaName=' + quotename(arcn.replica_server_name,'''') + ' and @NodeName=' + quotename(cm.member_name,'''') + ']' AS [Urn] FROM #tmpag_availability_groups AS AG INNER JOIN master.sys.dm_hadr_availability_replica_cluster_nodes AS arcn ON arcn.group_name=AG.name LEFT OUTER JOIN master.sys.dm_hadr_cluster_members AS cm ON UPPER(arcn.node_name) = UPPER(cm.member_name) WHERE (AG.name=@_msparam_0)        drop table #tmpag_availability_groups       ",83,67,16,5,0,83
"DECLARE @preferredReplica int  SET @preferredReplica = (SELECT [master].sys.fn_hadr_backup_is_preferred_replica('iemo'))  IF (@preferredReplica = 1) BEGIN     BACKUP LOG [iemo] TO  DISK = N'G:\Backup_SQL\IEMO\Transaction\iemo\iemo_backup_2024_04_08_110001_3137914.trn' WITH  RETAINDAYS = 7, NOFORMAT, NOINIT,  NAME = N'iemo_backup_2024_04_08_110001_3137914', SKIP, REWIND, NOUNLOAD, COMPRESSION,  STATS = 10 END ",82,56,26,151,0,82
"DECLARE @preferredReplica int  SET @preferredReplica = (SELECT [master].sys.fn_hadr_backup_is_preferred_replica('iemo'))  IF (@preferredReplica = 1) BEGIN     BACKUP DATABASE [iemo] TO  DISK = N'G:\Backup_SQL\IEMO\Full\iemo\iemo_backup_2024_03_20_230001_4793694.bak' WITH  RETAINDAYS = 7, NOFORMAT, NOINIT,  NAME = N'iemo_backup_2024_03_20_230001_4793694', SKIP, REWIND, NOUNLOAD, COMPRESSION,  STATS = 10 END ",80,55,25,151,0,80
"DECLARE @preferredReplica int  SET @preferredReplica = (SELECT [master].sys.fn_hadr_backup_is_preferred_replica('iemo'))  IF (@preferredReplica = 1) BEGIN     BACKUP LOG [iemo] TO  DISK = N'G:\Backup_SQL\IEMO\Transaction\iemo\iemo_backup_2024_03_29_230001_7284264.trn' WITH  RETAINDAYS = 7, NOFORMAT, NOINIT,  NAME = N'iemo_backup_2024_03_29_230001_7284264', SKIP, REWIND, NOUNLOAD, COMPRESSION,  STATS = 10 END ",80,69,11,236,0,80
"DECLARE @preferredReplica int  SET @preferredReplica = (SELECT [master].sys.fn_hadr_backup_is_preferred_replica('iemo'))  IF (@preferredReplica = 1) BEGIN     BACKUP LOG [iemo] TO  DISK = N'G:\Backup_SQL\IEMO\Transaction\iemo\iemo_backup_2024_03_29_050000_8704252.trn' WITH  RETAINDAYS = 7, NOFORMAT, NOINIT,  NAME = N'iemo_backup_2024_03_29_050000_8704252', SKIP, REWIND, NOUNLOAD, COMPRESSION,  STATS = 10 END ",80,48,32,151,0,80
"DECLARE @preferredReplica int  SET @preferredReplica = (SELECT [master].sys.fn_hadr_backup_is_preferred_replica('iemo'))  IF (@preferredReplica = 1) BEGIN     BACKUP LOG [iemo] TO  DISK = N'G:\Backup_SQL\IEMO\Transaction\iemo\iemo_backup_2024_04_18_190000_8095296.trn' WITH  RETAINDAYS = 7, NOFORMAT, NOINIT,  NAME = N'iemo_backup_2024_04_18_190000_8095296', SKIP, REWIND, NOUNLOAD, COMPRESSION,  STATS = 10 END ",80,66,14,236,0,80
"DECLARE @preferredReplica int  SET @preferredReplica = (SELECT [master].sys.fn_hadr_backup_is_preferred_replica('iemo'))  IF (@preferredReplica = 1) BEGIN     BACKUP LOG [iemo] TO  DISK = N'G:\Backup_SQL\IEMO\Transaction\iemo\iemo_backup_2024_04_01_230001_5667579.trn' WITH  RETAINDAYS = 7, NOFORMAT, NOINIT,  NAME = N'iemo_backup_2024_04_01_230001_5667579', SKIP, REWIND, NOUNLOAD, COMPRESSION,  STATS = 10 END ",80,71,9,236,0,80
"DECLARE @preferredReplica int  SET @preferredReplica = (SELECT [master].sys.fn_hadr_backup_is_preferred_replica('iemo'))  IF (@preferredReplica = 1) BEGIN     BACKUP LOG [iemo] TO  DISK = N'G:\Backup_SQL\IEMO\Transaction\iemo\iemo_backup_2024_04_17_210000_9139105.trn' WITH  RETAINDAYS = 7, NOFORMAT, NOINIT,  NAME = N'iemo_backup_2024_04_17_210000_9139105', SKIP, REWIND, NOUNLOAD, COMPRESSION,  STATS = 10 END ",78,53,25,151,0,78
"DECLARE @preferredReplica int  SET @preferredReplica = (SELECT [master].sys.fn_hadr_backup_is_preferred_replica('iemo'))  IF (@preferredReplica = 1) BEGIN     BACKUP LOG [iemo] TO  DISK = N'G:\Backup_SQL\IEMO\Transaction\iemo\iemo_backup_2024_04_02_230001_7225974.trn' WITH  RETAINDAYS = 7, NOFORMAT, NOINIT,  NAME = N'iemo_backup_2024_04_02_230001_7225974', SKIP, REWIND, NOUNLOAD, COMPRESSION,  STATS = 10 END ",78,65,13,236,0,78
" 	SELECT 	CASE 		WHEN name like  '%msdtcprx.dll%' THEN 'msdtcprx' 		WHEN name like  '%sqljdbc_xa.dll%' THEN 'sqljdbc_xa' 		ELSE NULL 	END AS LoadedModules, 	COUNT(1) AS ModuleCount         FROM sys.dm_os_loaded_modules WITH (NOLOCK)         WHERE name like  '%msdtcprx.dll%' 	OR name like  '%sqljdbc_xa.dll%'         GROUP BY 	CASE WHEN name like  '%msdtcprx.dll%' THEN 'msdtcprx' 		WHEN name like  '%sqljdbc_xa.dll%' THEN 'sqljdbc_xa' 		ELSE NULL 	END;     ",77,77,0,0,0,7811
"DECLARE @preferredReplica int  SET @preferredReplica = (SELECT [master].sys.fn_hadr_backup_is_preferred_replica('iemo'))  IF (@preferredReplica = 1) BEGIN     BACKUP LOG [iemo] TO  DISK = N'G:\Backup_SQL\IEMO\Transaction\iemo\iemo_backup_2024_04_13_190001_5708812.trn' WITH  RETAINDAYS = 7, NOFORMAT, NOINIT,  NAME = N'iemo_backup_2024_04_13_190001_5708812', SKIP, REWIND, NOUNLOAD, COMPRESSION,  STATS = 10 END ",77,66,11,236,0,77
"DECLARE @preferredReplica int  SET @preferredReplica = (SELECT [master].sys.fn_hadr_backup_is_preferred_replica('iemo'))  IF (@preferredReplica = 1) BEGIN     BACKUP LOG [iemo] TO  DISK = N'G:\Backup_SQL\IEMO\Transaction\iemo\iemo_backup_2024_04_03_000000_8201705.trn' WITH  RETAINDAYS = 7, NOFORMAT, NOINIT,  NAME = N'iemo_backup_2024_04_03_000000_8201705', SKIP, REWIND, NOUNLOAD, COMPRESSION,  STATS = 10 END ",76,51,25,151,0,76
"DECLARE @preferredReplica int  SET @preferredReplica = (SELECT [master].sys.fn_hadr_backup_is_preferred_replica('iemo'))  IF (@preferredReplica = 1) BEGIN     BACKUP LOG [iemo] TO  DISK = N'G:\Backup_SQL\IEMO\Transaction\iemo\iemo_backup_2024_04_05_160001_3124733.trn' WITH  RETAINDAYS = 7, NOFORMAT, NOINIT,  NAME = N'iemo_backup_2024_04_05_160001_3124733', SKIP, REWIND, NOUNLOAD, COMPRESSION,  STATS = 10 END ",76,64,12,236,0,76
"DECLARE @preferredReplica int  SET @preferredReplica = (SELECT [master].sys.fn_hadr_backup_is_preferred_replica('iemo'))  IF (@preferredReplica = 1) BEGIN     BACKUP LOG [iemo] TO  DISK = N'G:\Backup_SQL\IEMO\Transaction\iemo\iemo_backup_2024_04_13_180000_9534663.trn' WITH  RETAINDAYS = 7, NOFORMAT, NOINIT,  NAME = N'iemo_backup_2024_04_13_180000_9534663', SKIP, REWIND, NOUNLOAD, COMPRESSION,  STATS = 10 END ",76,51,25,151,0,76
"DECLARE @preferredReplica int  SET @preferredReplica = (SELECT [master].sys.fn_hadr_backup_is_preferred_replica('iemo'))  IF (@preferredReplica = 1) BEGIN     BACKUP LOG [iemo] TO  DISK = N'G:\Backup_SQL\IEMO\Transaction\iemo\iemo_backup_2024_03_25_230001_7154520.trn' WITH  RETAINDAYS = 7, NOFORMAT, NOINIT,  NAME = N'iemo_backup_2024_03_25_230001_7154520', SKIP, REWIND, NOUNLOAD, COMPRESSION,  STATS = 10 END ",75,62,13,236,0,75
"DECLARE @preferredReplica int  SET @preferredReplica = (SELECT [master].sys.fn_hadr_backup_is_preferred_replica('iemo'))  IF (@preferredReplica = 1) BEGIN     BACKUP LOG [iemo] TO  DISK = N'G:\Backup_SQL\IEMO\Transaction\iemo\iemo_backup_2024_03_27_230001_8952307.trn' WITH  RETAINDAYS = 7, NOFORMAT, NOINIT,  NAME = N'iemo_backup_2024_03_27_230001_8952307', SKIP, REWIND, NOUNLOAD, COMPRESSION,  STATS = 10 END ",75,62,13,236,0,75
"DECLARE @preferredReplica int  SET @preferredReplica = (SELECT [master].sys.fn_hadr_backup_is_preferred_replica('iemo'))  IF (@preferredReplica = 1) BEGIN     BACKUP LOG [iemo] TO  DISK = N'G:\Backup_SQL\IEMO\Transaction\iemo\iemo_backup_2024_03_24_230001_6333093.trn' WITH  RETAINDAYS = 7, NOFORMAT, NOINIT,  NAME = N'iemo_backup_2024_03_24_230001_6333093', SKIP, REWIND, NOUNLOAD, COMPRESSION,  STATS = 10 END ",75,64,11,236,0,75
"DECLARE @preferredReplica int  SET @preferredReplica = (SELECT [master].sys.fn_hadr_backup_is_preferred_replica('iemo'))  IF (@preferredReplica = 1) BEGIN     BACKUP DATABASE [iemo] TO  DISK = N'G:\Backup_SQL\IEMO\Full\iemo\iemo_backup_2024_04_20_230002_2905974.bak' WITH  RETAINDAYS = 7, NOFORMAT, NOINIT,  NAME = N'iemo_backup_2024_04_20_230002_2905974', SKIP, REWIND, NOUNLOAD, COMPRESSION,  STATS = 10 END ",75,50,25,151,0,75
"DECLARE @preferredReplica int  SET @preferredReplica = (SELECT [master].sys.fn_hadr_backup_is_preferred_replica('iemo'))  IF (@preferredReplica = 1) BEGIN     BACKUP LOG [iemo] TO  DISK = N'G:\Backup_SQL\IEMO\Transaction\iemo\iemo_backup_2024_03_28_230001_6891199.trn' WITH  RETAINDAYS = 7, NOFORMAT, NOINIT,  NAME = N'iemo_backup_2024_03_28_230001_6891199', SKIP, REWIND, NOUNLOAD, COMPRESSION,  STATS = 10 END ",74,62,12,236,0,74
"DECLARE @preferredReplica int  SET @preferredReplica = (SELECT [master].sys.fn_hadr_backup_is_preferred_replica('iemo'))  IF (@preferredReplica = 1) BEGIN     BACKUP LOG [iemo] TO  DISK = N'G:\Backup_SQL\IEMO\Transaction\iemo\iemo_backup_2024_04_18_010000_7908739.trn' WITH  RETAINDAYS = 7, NOFORMAT, NOINIT,  NAME = N'iemo_backup_2024_04_18_010000_7908739', SKIP, REWIND, NOUNLOAD, COMPRESSION,  STATS = 10 END ",74,67,7,236,0,74
"DECLARE @preferredReplica int  SET @preferredReplica = (SELECT [master].sys.fn_hadr_backup_is_preferred_replica('iemo'))  IF (@preferredReplica = 1) BEGIN     BACKUP LOG [iemo] TO  DISK = N'G:\Backup_SQL\IEMO\Transaction\iemo\iemo_backup_2024_04_18_060000_8965332.trn' WITH  RETAINDAYS = 7, NOFORMAT, NOINIT,  NAME = N'iemo_backup_2024_04_18_060000_8965332', SKIP, REWIND, NOUNLOAD, COMPRESSION,  STATS = 10 END ",73,54,19,151,0,73
"(@_msparam_0 nvarchar(4000),@_msparam_1 nvarchar(4000))SELECT 'XEStore[@Name=' + quotename(CAST(SERVERPROPERTY(N'ServerName') AS sysname),'''') + ']' + '/Session[@Name=' + quotename(session.name,'''') + ']' + '/Event[@Name=' + quotename(event.package + '.' + event.name,'''') + ']' AS [Urn], event.event_id AS [ID], event.package + '.' + event.name AS [Name], event.module AS [ModuleID], event.package AS [PackageName], event.predicate AS [PredicateExpression], event.predicate_xml AS [PredicateXml], object2.description AS [Description] FROM sys.server_event_sessions AS session LEFT OUTER JOIN sys.dm_xe_sessions AS running ON running.name = session.name, sys.server_event_session_events AS event INNER JOIN sys.dm_xe_objects AS object2 ON event.name = object2.name AND object2.object_type='event' INNER JOIN sys.dm_xe_packages AS package2 ON event.module = package2.module_guid AND event.package = package2.name AND package2.guid = object2.package_guid WHERE (session.event_session_id = event.event_session_id)and((session.name=@_msparam_0)and((CAST(SERVERPROPERTY(N'ServerName') AS sysname)=@_msparam_1)))",73,73,0,182,0,73
"DECLARE @preferredReplica int  SET @preferredReplica = (SELECT [master].sys.fn_hadr_backup_is_preferred_replica('iemo'))  IF (@preferredReplica = 1) BEGIN     BACKUP LOG [iemo] TO  DISK = N'G:\Backup_SQL\IEMO\Transaction\iemo\iemo_backup_2024_04_02_010001_0045911.trn' WITH  RETAINDAYS = 7, NOFORMAT, NOINIT,  NAME = N'iemo_backup_2024_04_02_010001_0045911', SKIP, REWIND, NOUNLOAD, COMPRESSION,  STATS = 10 END ",73,68,5,236,0,73
" CREATE   PROCEDURE autoadmin_fetch_system_flags AS BEGIN 	BEGIN TRANSACTION 		DECLARE @value NVARCHAR(MAX)  		SELECT @value = value FROM autoadmin_system_flags WHERE LOWER(name) = LOWER(N'SSMBackup2WAEverConfigured') 		 		IF (LOWER(ISNULL(@value, '')) <> N'true') 		BEGIN 			DECLARE @is_configured BIT 			SET @is_configured = 0 			 			IF EXISTS (SELECT TOP 1 container_url FROM managed_backup.fn_backup_db_config(NULL) WHERE container_url IS NOT NULL) 			BEGIN 				SET @is_configured = 1	 			END 			ELSE IF EXISTS (SELECT TOP 1 container_url FROM managed_backup.fn_backup_instance_config() WHERE container_url IS NOT NULL) 			BEGIN 				SET @is_configured = 1	 			END 			ELSE IF EXISTS (SELECT TOP 1 credential_name FROM smart_admin.fn_backup_db_config(NULL) WHERE credential_name IS NOT NULL) 			BEGIN 				SET @is_configured = 1	 			END 			ELSE IF EXISTS (SELECT TOP 1 credential_name FROM smart_admin.fn_backup_instance_config() WHERE credential_name IS NOT NULL) 			BEGIN 				SET @is_configured = 1	 			END 			 			IF (@is_configured = 1) 			BEGIN 				MERGE autoadmin_system_flags AS target 				USING (SELECT LOWER(N'SSMBackup2WAEverConfigured') as name) AS source 				ON source.name = target.name 				WHEN MATCHED THEN UPDATE SET target.value = N'true' 				WHEN NOT MATCHED THEN INSERT VALUES (N'SSMBackup2WAEverConfigured', N'true'); 			END 		END 	COMMIT TRANSACTION 	     SELECT name, 	value  	FROM autoadmin_system_flags END ",72,72,0,613,8,72
"DECLARE @preferredReplica int  SET @preferredReplica = (SELECT [master].sys.fn_hadr_backup_is_preferred_replica('iemo'))  IF (@preferredReplica = 1) BEGIN     BACKUP LOG [iemo] TO  DISK = N'G:\Backup_SQL\IEMO\Transaction\iemo\iemo_backup_2024_04_06_230001_8282925.trn' WITH  RETAINDAYS = 7, NOFORMAT, NOINIT,  NAME = N'iemo_backup_2024_04_06_230001_8282925', SKIP, REWIND, NOUNLOAD, COMPRESSION,  STATS = 10 END ",72,65,7,236,0,72
"DECLARE @preferredReplica int  SET @preferredReplica = (SELECT [master].sys.fn_hadr_backup_is_preferred_replica('iemo'))  IF (@preferredReplica = 1) BEGIN     BACKUP LOG [iemo] TO  DISK = N'G:\Backup_SQL\IEMO\Transaction\iemo\iemo_backup_2024_04_15_070001_0678547.trn' WITH  RETAINDAYS = 7, NOFORMAT, NOINIT,  NAME = N'iemo_backup_2024_04_15_070001_0678547', SKIP, REWIND, NOUNLOAD, COMPRESSION,  STATS = 10 END ",72,59,13,236,0,72
"DECLARE @preferredReplica int  SET @preferredReplica = (SELECT [master].sys.fn_hadr_backup_is_preferred_replica('iemo'))  IF (@preferredReplica = 1) BEGIN     BACKUP LOG [iemo] TO  DISK = N'G:\Backup_SQL\IEMO\Transaction\iemo\iemo_backup_2024_03_23_230001_1359101.trn' WITH  RETAINDAYS = 7, NOFORMAT, NOINIT,  NAME = N'iemo_backup_2024_03_23_230001_1359101', SKIP, REWIND, NOUNLOAD, COMPRESSION,  STATS = 10 END ",72,65,7,236,0,72
"DECLARE @preferredReplica int  SET @preferredReplica = (SELECT [master].sys.fn_hadr_backup_is_preferred_replica('iemo'))  IF (@preferredReplica = 1) BEGIN     BACKUP LOG [iemo] TO  DISK = N'G:\Backup_SQL\IEMO\Transaction\iemo\iemo_backup_2024_04_02_070000_7427866.trn' WITH  RETAINDAYS = 7, NOFORMAT, NOINIT,  NAME = N'iemo_backup_2024_04_02_070000_7427866', SKIP, REWIND, NOUNLOAD, COMPRESSION,  STATS = 10 END ",71,66,5,236,0,71
"DECLARE @preferredReplica int  SET @preferredReplica = (SELECT [master].sys.fn_hadr_backup_is_preferred_replica('iemo'))  IF (@preferredReplica = 1) BEGIN     BACKUP LOG [iemo] TO  DISK = N'G:\Backup_SQL\IEMO\Transaction\iemo\iemo_backup_2024_04_15_090000_8475911.trn' WITH  RETAINDAYS = 7, NOFORMAT, NOINIT,  NAME = N'iemo_backup_2024_04_15_090000_8475911', SKIP, REWIND, NOUNLOAD, COMPRESSION,  STATS = 10 END ",70,41,29,151,0,70
"DECLARE @preferredReplica int  SET @preferredReplica = (SELECT [master].sys.fn_hadr_backup_is_preferred_replica('iemo'))  IF (@preferredReplica = 1) BEGIN     BACKUP LOG [iemo] TO  DISK = N'G:\Backup_SQL\IEMO\Transaction\iemo\iemo_backup_2024_04_17_100000_9876756.trn' WITH  RETAINDAYS = 7, NOFORMAT, NOINIT,  NAME = N'iemo_backup_2024_04_17_100000_9876756', SKIP, REWIND, NOUNLOAD, COMPRESSION,  STATS = 10 END ",70,65,5,236,0,70
"(@_msparam_0 nvarchar(4000),@_msparam_1 nvarchar(4000),@_msparam_2 nvarchar(4000))SELECT SCHEMA_NAME(sp.schema_id) AS [Schema], sp.name AS [Name], sp.object_id AS [ID], CAST(  case      when sp.is_ms_shipped = 1 then 1     when (         select              major_id          from              sys.extended_properties          where              major_id = sp.object_id and              minor_id = 0 and              class = 1 and              name = N'microsoft_database_tools_support')          is not null then 1     else 0 end                        AS bit) AS [IsSystemObject], CASE WHEN sp.type = N'P' THEN 1 WHEN sp.type = N'PC' THEN 2 ELSE 1 END AS [ImplementationType], CAST(CASE WHEN ISNULL(smsp.definition, ssmsp.definition) IS NULL THEN 1 ELSE 0 END AS bit) AS [IsEncrypted] FROM sys.all_objects AS sp LEFT OUTER JOIN sys.sql_modules AS smsp ON smsp.object_id = sp.object_id LEFT OUTER JOIN sys.system_sql_modules AS ssmsp ON ssmsp.object_id = sp.object_id WHERE (sp.type = @_msparam_0 OR sp.type = @_msparam_1 OR sp.type=@_msparam_2) ORDER BY [Schema] ASC,[Name] ASC",70,59,11,86492,0,494
"DECLARE @preferredReplica int  SET @preferredReplica = (SELECT [master].sys.fn_hadr_backup_is_preferred_replica('iemo'))  IF (@preferredReplica = 1) BEGIN     BACKUP LOG [iemo] TO  DISK = N'G:\Backup_SQL\IEMO\Transaction\iemo\iemo_backup_2024_04_13_110000_7897776.trn' WITH  RETAINDAYS = 7, NOFORMAT, NOINIT,  NAME = N'iemo_backup_2024_04_13_110000_7897776', SKIP, REWIND, NOUNLOAD, COMPRESSION,  STATS = 10 END ",70,45,25,151,0,70
"DECLARE @preferredReplica int  SET @preferredReplica = (SELECT [master].sys.fn_hadr_backup_is_preferred_replica('iemo'))  IF (@preferredReplica = 1) BEGIN     BACKUP LOG [iemo] TO  DISK = N'G:\Backup_SQL\IEMO\Transaction\iemo\iemo_backup_2024_03_29_030001_0235168.trn' WITH  RETAINDAYS = 7, NOFORMAT, NOINIT,  NAME = N'iemo_backup_2024_03_29_030001_0235168', SKIP, REWIND, NOUNLOAD, COMPRESSION,  STATS = 10 END ",70,59,11,190,0,70
"DECLARE @preferredReplica int  SET @preferredReplica = (SELECT [master].sys.fn_hadr_backup_is_preferred_replica('iemo'))  IF (@preferredReplica = 1) BEGIN     BACKUP LOG [iemo] TO  DISK = N'G:\Backup_SQL\IEMO\Transaction\iemo\iemo_backup_2024_04_09_120000_8588731.trn' WITH  RETAINDAYS = 7, NOFORMAT, NOINIT,  NAME = N'iemo_backup_2024_04_09_120000_8588731', SKIP, REWIND, NOUNLOAD, COMPRESSION,  STATS = 10 END ",69,49,20,151,0,69
"DECLARE @preferredReplica int  SET @preferredReplica = (SELECT [master].sys.fn_hadr_backup_is_preferred_replica('iemo'))  IF (@preferredReplica = 1) BEGIN     BACKUP LOG [iemo] TO  DISK = N'G:\Backup_SQL\IEMO\Transaction\iemo\iemo_backup_2024_04_08_130001_2965481.trn' WITH  RETAINDAYS = 7, NOFORMAT, NOINIT,  NAME = N'iemo_backup_2024_04_08_130001_2965481', SKIP, REWIND, NOUNLOAD, COMPRESSION,  STATS = 10 END ",69,68,1,272,0,69
"DECLARE @preferredReplica int  SET @preferredReplica = (SELECT [master].sys.fn_hadr_backup_is_preferred_replica('iemo'))  IF (@preferredReplica = 1) BEGIN     BACKUP LOG [iemo] TO  DISK = N'G:\Backup_SQL\IEMO\Transaction\iemo\iemo_backup_2024_03_27_110000_8901783.trn' WITH  RETAINDAYS = 7, NOFORMAT, NOINIT,  NAME = N'iemo_backup_2024_03_27_110000_8901783', SKIP, REWIND, NOUNLOAD, COMPRESSION,  STATS = 10 END ",69,44,25,151,0,69
"DECLARE @preferredReplica int  SET @preferredReplica = (SELECT [master].sys.fn_hadr_backup_is_preferred_replica('iemo'))  IF (@preferredReplica = 1) BEGIN     BACKUP LOG [iemo] TO  DISK = N'G:\Backup_SQL\IEMO\Transaction\iemo\iemo_backup_2024_04_17_190000_9671804.trn' WITH  RETAINDAYS = 7, NOFORMAT, NOINIT,  NAME = N'iemo_backup_2024_04_17_190000_9671804', SKIP, REWIND, NOUNLOAD, COMPRESSION,  STATS = 10 END ",68,63,5,236,0,68
"DECLARE @preferredReplica int  SET @preferredReplica = (SELECT [master].sys.fn_hadr_backup_is_preferred_replica('iemo'))  IF (@preferredReplica = 1) BEGIN     BACKUP LOG [iemo] TO  DISK = N'G:\Backup_SQL\IEMO\Transaction\iemo\iemo_backup_2024_04_17_010001_0141855.trn' WITH  RETAINDAYS = 7, NOFORMAT, NOINIT,  NAME = N'iemo_backup_2024_04_17_010001_0141855', SKIP, REWIND, NOUNLOAD, COMPRESSION,  STATS = 10 END ",68,58,10,236,0,68
"DECLARE @preferredReplica int  SET @preferredReplica = (SELECT [master].sys.fn_hadr_backup_is_preferred_replica('iemo'))  IF (@preferredReplica = 1) BEGIN     BACKUP LOG [iemo] TO  DISK = N'G:\Backup_SQL\IEMO\Transaction\iemo\iemo_backup_2024_04_15_000000_8207223.trn' WITH  RETAINDAYS = 7, NOFORMAT, NOINIT,  NAME = N'iemo_backup_2024_04_15_000000_8207223', SKIP, REWIND, NOUNLOAD, COMPRESSION,  STATS = 10 END ",67,53,14,152,0,67
"DECLARE @preferredReplica int  SET @preferredReplica = (SELECT [master].sys.fn_hadr_backup_is_preferred_replica('iemo'))  IF (@preferredReplica = 1) BEGIN     BACKUP LOG [iemo] TO  DISK = N'G:\Backup_SQL\IEMO\Transaction\iemo\iemo_backup_2024_04_06_160001_0068267.trn' WITH  RETAINDAYS = 7, NOFORMAT, NOINIT,  NAME = N'iemo_backup_2024_04_06_160001_0068267', SKIP, REWIND, NOUNLOAD, COMPRESSION,  STATS = 10 END ",67,63,4,236,0,67
"DECLARE @preferredReplica int  SET @preferredReplica = (SELECT [master].sys.fn_hadr_backup_is_preferred_replica('iemo'))  IF (@preferredReplica = 1) BEGIN     BACKUP LOG [iemo] TO  DISK = N'G:\Backup_SQL\IEMO\Transaction\iemo\iemo_backup_2024_04_15_230001_6972763.trn' WITH  RETAINDAYS = 7, NOFORMAT, NOINIT,  NAME = N'iemo_backup_2024_04_15_230001_6972763', SKIP, REWIND, NOUNLOAD, COMPRESSION,  STATS = 10 END ",66,59,7,236,0,66
"DECLARE @preferredReplica int  SET @preferredReplica = (SELECT [master].sys.fn_hadr_backup_is_preferred_replica('iemo'))  IF (@preferredReplica = 1) BEGIN     BACKUP LOG [iemo] TO  DISK = N'G:\Backup_SQL\IEMO\Transaction\iemo\iemo_backup_2024_04_18_170000_8773553.trn' WITH  RETAINDAYS = 7, NOFORMAT, NOINIT,  NAME = N'iemo_backup_2024_04_18_170000_8773553', SKIP, REWIND, NOUNLOAD, COMPRESSION,  STATS = 10 END ",66,54,12,151,0,66
"DECLARE @preferredReplica int  SET @preferredReplica = (SELECT [master].sys.fn_hadr_backup_is_preferred_replica('iemo'))  IF (@preferredReplica = 1) BEGIN     BACKUP LOG [iemo] TO  DISK = N'G:\Backup_SQL\IEMO\Transaction\iemo\iemo_backup_2024_04_23_090000_7840026.trn' WITH  RETAINDAYS = 7, NOFORMAT, NOINIT,  NAME = N'iemo_backup_2024_04_23_090000_7840026', SKIP, REWIND, NOUNLOAD, COMPRESSION,  STATS = 10 END ",66,49,17,151,0,66
"DECLARE @preferredReplica int  SET @preferredReplica = (SELECT [master].sys.fn_hadr_backup_is_preferred_replica('iemo'))  IF (@preferredReplica = 1) BEGIN     BACKUP LOG [iemo] TO  DISK = N'G:\Backup_SQL\IEMO\Transaction\iemo\iemo_backup_2024_04_13_160001_1667730.trn' WITH  RETAINDAYS = 7, NOFORMAT, NOINIT,  NAME = N'iemo_backup_2024_04_13_160001_1667730', SKIP, REWIND, NOUNLOAD, COMPRESSION,  STATS = 10 END ",66,63,3,236,0,66
"DECLARE @preferredReplica int  SET @preferredReplica = (SELECT [master].sys.fn_hadr_backup_is_preferred_replica('iemo'))  IF (@preferredReplica = 1) BEGIN     BACKUP LOG [iemo] TO  DISK = N'G:\Backup_SQL\IEMO\Transaction\iemo\iemo_backup_2024_04_21_230001_9809696.trn' WITH  RETAINDAYS = 7, NOFORMAT, NOINIT,  NAME = N'iemo_backup_2024_04_21_230001_9809696', SKIP, REWIND, NOUNLOAD, COMPRESSION,  STATS = 10 END ",65,58,7,236,0,65
"DECLARE @preferredReplica int  SET @preferredReplica = (SELECT [master].sys.fn_hadr_backup_is_preferred_replica('iemo'))  IF (@preferredReplica = 1) BEGIN     BACKUP LOG [iemo] TO  DISK = N'G:\Backup_SQL\IEMO\Transaction\iemo\iemo_backup_2024_04_18_130001_1667564.trn' WITH  RETAINDAYS = 7, NOFORMAT, NOINIT,  NAME = N'iemo_backup_2024_04_18_130001_1667564', SKIP, REWIND, NOUNLOAD, COMPRESSION,  STATS = 10 END ",65,60,5,236,0,65
"DECLARE @preferredReplica int  SET @preferredReplica = (SELECT [master].sys.fn_hadr_backup_is_preferred_replica('iemo'))  IF (@preferredReplica = 1) BEGIN     BACKUP LOG [iemo] TO  DISK = N'G:\Backup_SQL\IEMO\Transaction\iemo\iemo_backup_2024_03_31_230001_7375830.trn' WITH  RETAINDAYS = 7, NOFORMAT, NOINIT,  NAME = N'iemo_backup_2024_03_31_230001_7375830', SKIP, REWIND, NOUNLOAD, COMPRESSION,  STATS = 10 END ",65,60,5,236,0,65
"DECLARE @preferredReplica int  SET @preferredReplica = (SELECT [master].sys.fn_hadr_backup_is_preferred_replica('iemo'))  IF (@preferredReplica = 1) BEGIN     BACKUP LOG [iemo] TO  DISK = N'G:\Backup_SQL\IEMO\Transaction\iemo\iemo_backup_2024_04_10_230002_1349058.trn' WITH  RETAINDAYS = 7, NOFORMAT, NOINIT,  NAME = N'iemo_backup_2024_04_10_230002_1349058', SKIP, REWIND, NOUNLOAD, COMPRESSION,  STATS = 10 END ",64,57,7,236,0,64
"DECLARE @preferredReplica int  SET @preferredReplica = (SELECT [master].sys.fn_hadr_backup_is_preferred_replica('iemo'))  IF (@preferredReplica = 1) BEGIN     BACKUP LOG [iemo] TO  DISK = N'G:\Backup_SQL\IEMO\Transaction\iemo\iemo_backup_2024_04_04_010001_1136732.trn' WITH  RETAINDAYS = 7, NOFORMAT, NOINIT,  NAME = N'iemo_backup_2024_04_04_010001_1136732', SKIP, REWIND, NOUNLOAD, COMPRESSION,  STATS = 10 END ",64,56,8,236,0,64
"DECLARE @preferredReplica int  SET @preferredReplica = (SELECT [master].sys.fn_hadr_backup_is_preferred_replica('iemo'))  IF (@preferredReplica = 1) BEGIN     BACKUP LOG [iemo] TO  DISK = N'G:\Backup_SQL\IEMO\Transaction\iemo\iemo_backup_2024_04_05_010001_3084355.trn' WITH  RETAINDAYS = 7, NOFORMAT, NOINIT,  NAME = N'iemo_backup_2024_04_05_010001_3084355', SKIP, REWIND, NOUNLOAD, COMPRESSION,  STATS = 10 END ",63,62,1,236,0,63
"DECLARE @preferredReplica int  SET @preferredReplica = (SELECT [master].sys.fn_hadr_backup_is_preferred_replica('iemo'))  IF (@preferredReplica = 1) BEGIN     BACKUP LOG [iemo] TO  DISK = N'G:\Backup_SQL\IEMO\Transaction\iemo\iemo_backup_2024_04_20_130000_9455519.trn' WITH  RETAINDAYS = 7, NOFORMAT, NOINIT,  NAME = N'iemo_backup_2024_04_20_130000_9455519', SKIP, REWIND, NOUNLOAD, COMPRESSION,  STATS = 10 END ",63,62,1,236,0,63
"DECLARE @preferredReplica int  SET @preferredReplica = (SELECT [master].sys.fn_hadr_backup_is_preferred_replica('iemo'))  IF (@preferredReplica = 1) BEGIN     BACKUP LOG [iemo] TO  DISK = N'G:\Backup_SQL\IEMO\Transaction\iemo\iemo_backup_2024_04_11_230002_1383962.trn' WITH  RETAINDAYS = 7, NOFORMAT, NOINIT,  NAME = N'iemo_backup_2024_04_11_230002_1383962', SKIP, REWIND, NOUNLOAD, COMPRESSION,  STATS = 10 END ",63,58,5,236,0,63
"DECLARE @preferredReplica int  SET @preferredReplica = (SELECT [master].sys.fn_hadr_backup_is_preferred_replica('iemo'))  IF (@preferredReplica = 1) BEGIN     BACKUP LOG [iemo] TO  DISK = N'G:\Backup_SQL\IEMO\Transaction\iemo\iemo_backup_2024_04_08_100000_8527578.trn' WITH  RETAINDAYS = 7, NOFORMAT, NOINIT,  NAME = N'iemo_backup_2024_04_08_100000_8527578', SKIP, REWIND, NOUNLOAD, COMPRESSION,  STATS = 10 END ",63,62,1,236,0,63
"DECLARE @preferredReplica int  SET @preferredReplica = (SELECT [master].sys.fn_hadr_backup_is_preferred_replica('iemo'))  IF (@preferredReplica = 1) BEGIN     BACKUP LOG [iemo] TO  DISK = N'G:\Backup_SQL\IEMO\Transaction\iemo\iemo_backup_2024_04_12_230001_9212659.trn' WITH  RETAINDAYS = 7, NOFORMAT, NOINIT,  NAME = N'iemo_backup_2024_04_12_230001_9212659', SKIP, REWIND, NOUNLOAD, COMPRESSION,  STATS = 10 END ",63,56,7,236,0,63
